,Country of origin,Year,helper,Female 0 - 4,Female 5 - 11,Female 12 - 17,Female 18 - 59,Female 60,Female other,Female total,Male 0 - 4,Male 5 - 11,Male 12 - 17,Male 18 - 59,Male 60,Male other,Male total,Total
0,Afghanistan,2001,2001Afghanistan,0,0,0,0,0,0,0,0,0,0,0,0,0,0,83646
1,Afghanistan,2001,2001Afghanistan,0,0,0,0,0,0,0,0,0,0,5,0,0,5,15
2,Afghanistan,2001,2001Afghanistan,0,0,0,0,0,0,0,0,0,0,7,0,0,7,7
3,Afghanistan,2001,2001Afghanistan,0,0,0,0,0,0,0,0,0,0,9,0,0,9,9
4,Afghanistan,2001,2001Afghanistan,0,0,0,0,0,0,0,0,0,0,40,0,0,40,40
5,Afghanistan,2001,2001Afghanistan,0,0,0,0,0,0,0,0,5,0,0,0,0,5,5
6,Afghanistan,2001,2001Afghanistan,0,0,0,0,0,15,15,0,0,0,0,0,43,43,58
7,Afghanistan,2001,2001Afghanistan,0,0,0,0,0,144,144,0,0,0,0,0,213,213,357
8,Afghanistan,2001,2001Afghanistan,0,0,0,0,0,578,578,0,0,0,0,0,706,706,1284
9,Afghanistan,2001,2001Afghanistan,0,0,0,0,0,629,629,0,0,0,0,0,817,817,1446
10,Afghanistan,2001,2001Afghanistan,0,0,0,0,0,640,640,0,0,0,0,0,875,875,1515
11,Afghanistan,2001,2001Afghanistan,0,0,0,5,0,0,5,0,5,0,7,0,0,12,17
12,Afghanistan,2001,2001Afghanistan,0,0,0,7,7,0,14,0,0,0,26,8,0,34,48
13,Afghanistan,2001,2001Afghanistan,0,0,5,0,0,0,5,0,0,0,14,0,0,14,19
14,Afghanistan,2001,2001Afghanistan,0,0,6,0,0,0,6,0,0,0,0,0,0,0,6
15,Afghanistan,2001,2001Afghanistan,0,0,7,13,0,0,20,0,5,5,15,0,0,25,45
16,Afghanistan,2001,2001Afghanistan,0,5,0,0,0,0,5,0,6,0,7,0,0,13,79
17,Afghanistan,2001,2001Afghanistan,0,5,0,7,0,0,12,0,5,6,21,0,0,32,44
18,Afghanistan,2001,2001Afghanistan,0,5,13,8,0,0,26,0,13,0,43,0,0,56,82
19,Afghanistan,2001,2001Afghanistan,0,6,0,0,0,0,6,0,0,0,0,0,0,0,6
20,Afghanistan,2001,2001Afghanistan,0,7,7,11,5,0,30,5,5,5,32,0,0,47,77
21,Afghanistan,2001,2001Afghanistan,0,8,0,0,0,0,8,0,0,6,12,0,0,18,26
22,Afghanistan,2001,2001Afghanistan,0,12,10,30,5,0,57,6,9,7,65,5,0,92,149
23,Afghanistan,2001,2001Afghanistan,5,0,0,0,0,0,5,0,0,0,0,0,0,0,5
24,Afghanistan,2001,2001Afghanistan,5,0,0,9,0,0,14,0,0,9,43,0,0,52,66
25,Afghanistan,2001,2001Afghanistan,8,10,10,28,0,0,56,0,16,11,23,0,0,50,106
26,Afghanistan,2001,2001Afghanistan,8,12,10,38,0,0,68,9,26,22,118,0,0,175,243
27,Afghanistan,2001,2001Afghanistan,9,40,36,81,6,0,172,9,34,35,199,5,0,282,454
28,Afghanistan,2001,2001Afghanistan,11,12,10,35,0,0,68,7,17,15,32,0,0,71,295
29,Afghanistan,2001,2001Afghanistan,22,48,42,70,5,0,187,28,54,47,77,14,0,220,407
30,Afghanistan,2001,2001Afghanistan,40,101,87,189,18,0,435,36,125,107,863,21,0,1152,1587
31,Afghanistan,2001,2001Afghanistan,64,68,59,257,19,0,467,59,53,46,285,12,0,455,922
32,Afghanistan,2001,2001Afghanistan,79,292,252,580,16,0,1219,93,314,270,645,28,0,1350,9569
33,Afghanistan,2001,2001Afghanistan,185,1198,1027,3469,318,0,6197,248,1241,1063,2881,342,0,5775,11972
34,Afghanistan,2001,2001Afghanistan,188,385,329,607,90,4658,6257,363,593,508,1095,239,6064,8862,15336
35,Afghanistan,2001,2001Afghanistan,68918,127037,108889,248624,16065,0,569533,73877,145845,125010,539272,28463,0,912467,1482000
36,Afghanistan,2001,2001Afghanistan,122591,174858,149878,327785,23976,0,799088,120689,174524,149590,236912,28231,0,709946,2197821
37,Afghanistan,2002,2002Afghanistan,0,0,0,0,0,0,0,0,0,0,0,0,0,0,1252352
38,Afghanistan,2002,2002Afghanistan,0,0,0,0,0,0,0,0,0,0,5,0,0,5,20
39,Afghanistan,2002,2002Afghanistan,0,0,0,0,0,0,0,0,0,0,7,0,0,7,7
40,Afghanistan,2002,2002Afghanistan,0,0,0,0,0,0,0,0,0,0,40,0,0,40,40
41,Afghanistan,2002,2002Afghanistan,0,0,0,0,0,0,0,0,0,5,6,0,0,11,137
42,Afghanistan,2002,2002Afghanistan,0,0,0,0,0,0,0,0,5,0,0,0,0,5,5
43,Afghanistan,2002,2002Afghanistan,0,0,0,0,0,0,0,0,8,0,0,0,0,8,8
44,Afghanistan,2002,2002Afghanistan,0,0,0,0,0,6,6,0,0,0,0,0,56,56,62
45,Afghanistan,2002,2002Afghanistan,0,0,0,0,0,435,435,0,0,0,0,0,506,506,1365
46,Afghanistan,2002,2002Afghanistan,0,0,0,0,0,572,572,0,0,0,0,0,684,684,1256
47,Afghanistan,2002,2002Afghanistan,0,0,0,0,0,675,675,0,0,0,0,0,1575,1575,2250
48,Afghanistan,2002,2002Afghanistan,0,0,0,5,0,0,5,0,0,0,10,0,0,10,15
49,Afghanistan,2002,2002Afghanistan,0,0,0,7,7,0,14,0,0,5,22,6,0,33,47
50,Afghanistan,2002,2002Afghanistan,0,0,0,8,0,0,8,0,5,0,30,0,0,35,43
51,Afghanistan,2002,2002Afghanistan,0,0,5,0,0,0,5,0,0,0,0,0,0,0,5
52,Afghanistan,2002,2002Afghanistan,0,0,5,0,0,0,5,0,0,0,9,0,0,9,14
53,Afghanistan,2002,2002Afghanistan,0,0,6,0,0,0,6,0,0,0,0,0,0,0,6
54,Afghanistan,2002,2002Afghanistan,0,5,13,8,0,0,26,0,13,0,43,0,0,56,82
55,Afghanistan,2002,2002Afghanistan,0,6,0,0,0,0,6,0,0,0,0,0,0,0,6
56,Afghanistan,2002,2002Afghanistan,0,7,0,7,0,0,14,5,0,0,17,0,0,22,36
57,Afghanistan,2002,2002Afghanistan,0,7,7,19,0,0,33,0,7,6,32,0,0,45,78
58,Afghanistan,2002,2002Afghanistan,0,8,0,0,0,0,8,0,0,6,10,0,0,16,24
59,Afghanistan,2002,2002Afghanistan,0,10,6,7,0,0,23,0,8,0,18,0,0,26,84
60,Afghanistan,2002,2002Afghanistan,0,10,9,33,5,0,57,6,9,7,25,5,0,52,149
61,Afghanistan,2002,2002Afghanistan,0,11,15,23,0,0,49,0,6,11,37,0,0,54,103
62,Afghanistan,2002,2002Afghanistan,0,14,13,34,0,0,61,6,20,18,43,0,0,87,148
63,Afghanistan,2002,2002Afghanistan,6,16,14,39,0,0,75,7,32,28,115,0,0,182,257
64,Afghanistan,2002,2002Afghanistan,10,47,42,87,7,0,193,13,37,33,197,5,0,285,478
65,Afghanistan,2002,2002Afghanistan,12,35,30,67,5,1700,1849,14,27,23,68,5,1441,1578,3427
66,Afghanistan,2002,2002Afghanistan,20,48,42,86,5,0,201,21,57,48,85,16,0,227,428
67,Afghanistan,2002,2002Afghanistan,40,100,86,187,20,0,433,36,124,106,852,21,0,1139,1572
68,Afghanistan,2002,2002Afghanistan,47,108,96,290,15,0,556,84,125,109,341,48,0,707,1263
69,Afghanistan,2002,2002Afghanistan,61,273,233,635,16,0,1218,72,305,263,725,28,0,1393,5716
70,Afghanistan,2002,2002Afghanistan,76,46,40,239,12,0,413,83,52,44,266,13,0,458,871
71,Afghanistan,2002,2002Afghanistan,193,1087,931,3415,321,0,5947,226,1131,970,2747,350,0,5424,11371
72,Afghanistan,2002,2002Afghanistan,100629,143189,122734,263478,19486,0,649516,98099,141385,121188,193438,22943,0,577053,1226569
73,Afghanistan,2003,2003Afghanistan,0,0,0,0,0,0,0,0,0,0,0,0,0,0,150481
74,Afghanistan,2003,2003Afghanistan,0,0,0,0,0,0,0,0,0,0,5,0,0,5,10
75,Afghanistan,2003,2003Afghanistan,0,0,0,0,0,0,0,0,0,0,6,0,0,6,6
76,Afghanistan,2003,2003Afghanistan,0,0,0,0,0,0,0,0,0,0,7,0,0,7,7
77,Afghanistan,2003,2003Afghanistan,0,0,0,0,0,0,0,0,0,0,12,0,0,12,135
78,Afghanistan,2003,2003Afghanistan,0,0,0,0,0,0,0,0,0,0,40,0,0,40,40
79,Afghanistan,2003,2003Afghanistan,0,0,0,0,0,0,0,0,5,0,0,0,0,5,5
80,Afghanistan,2003,2003Afghanistan,0,0,0,0,0,0,0,0,8,0,0,0,0,8,8
81,Afghanistan,2003,2003Afghanistan,0,0,0,0,0,5,5,0,0,0,0,0,56,56,61
82,Afghanistan,2003,2003Afghanistan,0,0,0,0,0,455,455,0,0,0,0,0,521,521,1598
83,Afghanistan,2003,2003Afghanistan,0,0,0,0,0,527,527,0,0,0,0,0,640,640,1167
84,Afghanistan,2003,2003Afghanistan,0,0,0,0,0,1817,1817,0,0,0,0,0,1487,1487,3304
85,Afghanistan,2003,2003Afghanistan,0,0,0,5,0,0,5,0,0,0,8,0,0,8,13
86,Afghanistan,2003,2003Afghanistan,0,0,0,12,5,0,17,0,0,5,21,6,0,32,49
87,Afghanistan,2003,2003Afghanistan,0,0,5,0,0,0,5,0,0,0,0,0,0,0,70
88,Afghanistan,2003,2003Afghanistan,0,0,5,0,0,0,5,0,0,0,7,0,0,7,12
89,Afghanistan,2003,2003Afghanistan,0,0,6,0,0,0,6,0,0,0,0,0,0,0,6
90,Afghanistan,2003,2003Afghanistan,0,0,8,0,0,0,8,0,0,5,10,0,0,15,23
91,Afghanistan,2003,2003Afghanistan,0,0,15,21,0,0,36,0,0,19,28,0,0,47,83
92,Afghanistan,2003,2003Afghanistan,0,5,0,0,0,0,5,0,0,0,0,0,0,0,5
93,Afghanistan,2003,2003Afghanistan,0,5,0,0,0,0,5,0,7,0,0,0,0,7,12
94,Afghanistan,2003,2003Afghanistan,0,6,0,0,0,0,6,5,0,0,7,0,0,12,18
95,Afghanistan,2003,2003Afghanistan,0,7,7,19,0,0,33,0,7,6,32,0,0,45,78
96,Afghanistan,2003,2003Afghanistan,0,10,9,31,5,0,55,5,9,7,25,6,0,52,107
97,Afghanistan,2003,2003Afghanistan,5,0,0,0,0,0,5,5,0,0,25,0,0,30,35
98,Afghanistan,2003,2003Afghanistan,5,6,6,9,0,0,26,0,5,6,45,0,0,56,82
99,Afghanistan,2003,2003Afghanistan,5,7,6,21,0,0,39,0,12,10,18,0,0,40,79
100,Afghanistan,2003,2003Afghanistan,5,10,8,30,0,0,53,6,22,19,71,0,0,118,171
101,Afghanistan,2003,2003Afghanistan,14,44,29,86,7,0,180,15,29,25,205,5,0,279,459
102,Afghanistan,2003,2003Afghanistan,21,45,39,91,5,0,201,22,52,45,88,17,0,224,425
103,Afghanistan,2003,2003Afghanistan,38,97,84,190,17,0,426,31,121,103,814,15,0,1084,1510
104,Afghanistan,2003,2003Afghanistan,43,108,94,288,15,0,548,76,120,104,327,49,0,676,1224
105,Afghanistan,2003,2003Afghanistan,51,38,32,136,18,0,275,54,45,39,238,6,0,382,657
106,Afghanistan,2003,2003Afghanistan,69,256,220,572,22,0,1139,89,279,238,670,26,0,1302,5470
107,Afghanistan,2003,2003Afghanistan,162,928,795,3274,324,0,5483,181,974,834,2490,321,0,4800,10283
108,Afghanistan,2003,2003Afghanistan,33170,32142,100541,140975,8293,0,315121,41464,36369,112898,306824,16585,0,514140,834699
109,Afghanistan,2003,2003Afghanistan,92591,129841,111294,238886,22472,0,595084,89893,127058,108908,180455,22249,0,528563,1123647
110,Afghanistan,2004,2004Afghanistan,0,0,0,0,0,0,0,0,0,0,0,0,0,0,149501
111,Afghanistan,2004,2004Afghanistan,0,0,0,0,0,0,0,0,0,0,5,0,0,5,155
112,Afghanistan,2004,2004Afghanistan,0,0,0,0,0,0,0,0,0,0,6,0,0,6,6
113,Afghanistan,2004,2004Afghanistan,0,0,0,0,0,0,0,0,0,0,7,0,0,7,14
114,Afghanistan,2004,2004Afghanistan,0,0,0,0,0,0,0,0,0,0,9,0,0,9,9
115,Afghanistan,2004,2004Afghanistan,0,0,0,0,0,0,0,0,0,0,40,0,0,40,40
116,Afghanistan,2004,2004Afghanistan,0,0,0,0,0,0,0,0,7,0,0,0,0,7,7
117,Afghanistan,2004,2004Afghanistan,0,0,0,0,0,5,5,0,0,0,0,0,56,56,61
118,Afghanistan,2004,2004Afghanistan,0,0,0,5,0,0,5,0,5,0,7,0,0,12,17
119,Afghanistan,2004,2004Afghanistan,0,0,0,5,0,0,5,5,0,0,5,0,0,10,15
120,Afghanistan,2004,2004Afghanistan,0,0,0,7,0,0,7,6,0,0,13,0,0,19,26
121,Afghanistan,2004,2004Afghanistan,0,0,0,9,0,0,9,0,0,0,9,0,0,9,280
122,Afghanistan,2004,2004Afghanistan,0,0,0,10,0,0,10,5,0,0,16,0,0,21,31
123,Afghanistan,2004,2004Afghanistan,0,0,7,0,0,0,7,0,0,8,0,0,0,8,15
124,Afghanistan,2004,2004Afghanistan,0,5,0,0,0,0,5,0,0,0,0,0,0,0,5
125,Afghanistan,2004,2004Afghanistan,0,5,0,0,0,0,5,0,0,0,6,0,0,6,11
126,Afghanistan,2004,2004Afghanistan,0,7,0,0,0,0,7,0,5,5,5,0,0,15,22
127,Afghanistan,2004,2004Afghanistan,0,7,0,10,0,0,17,0,5,5,18,0,0,28,45
128,Afghanistan,2004,2004Afghanistan,0,7,7,19,0,0,33,0,7,6,32,0,0,45,78
129,Afghanistan,2004,2004Afghanistan,0,7,25,6,0,0,38,0,6,5,15,0,0,26,64
130,Afghanistan,2004,2004Afghanistan,5,0,0,0,0,0,5,5,0,0,25,0,0,30,35
131,Afghanistan,2004,2004Afghanistan,5,9,8,25,0,0,47,5,20,18,58,0,0,101,148
132,Afghanistan,2004,2004Afghanistan,10,5,5,83,5,0,108,13,8,6,118,5,0,150,258
133,Afghanistan,2004,2004Afghanistan,17,36,37,124,5,0,219,0,41,37,232,5,0,315,534
134,Afghanistan,2004,2004Afghanistan,22,39,34,74,5,0,174,17,42,36,75,16,0,186,360
135,Afghanistan,2004,2004Afghanistan,27,75,65,193,17,0,377,21,87,75,712,18,0,913,1290
136,Afghanistan,2004,2004Afghanistan,28,41,35,107,16,451,678,18,40,34,226,13,515,846,1524
137,Afghanistan,2004,2004Afghanistan,38,95,83,253,10,0,479,62,100,87,265,37,0,551,1030
138,Afghanistan,2004,2004Afghanistan,46,38,32,151,16,0,283,51,48,42,239,7,0,387,670
139,Afghanistan,2004,2004Afghanistan,57,226,196,570,29,0,1078,75,243,209,672,29,0,1228,5238
140,Afghanistan,2004,2004Afghanistan,148,808,693,3287,321,0,5257,187,876,750,2381,310,0,4504,9761
141,Afghanistan,2004,2004Afghanistan,31495,44526,139274,194180,11426,0,420901,33853,49405,153362,275828,19453,0,531901,952802
142,Afghanistan,2004,2004Afghanistan,78774,111502,95574,202345,20280,0,508475,76652,109350,93729,154047,17788,0,451566,1290408
143,Afghanistan,2005,2005Afghanistan,0,0,0,0,0,0,0,0,0,0,0,0,0,0,138623
144,Afghanistan,2005,2005Afghanistan,0,0,0,0,0,0,0,0,0,0,0,0,5,5,5
145,Afghanistan,2005,2005Afghanistan,0,0,0,0,0,0,0,0,0,0,5,0,0,5,5
146,Afghanistan,2005,2005Afghanistan,0,0,0,0,0,0,0,0,0,0,8,0,0,8,8
147,Afghanistan,2005,2005Afghanistan,0,0,0,0,0,0,0,0,0,0,9,0,0,9,9
148,Afghanistan,2005,2005Afghanistan,0,0,0,0,0,0,0,0,0,0,40,0,0,40,40
149,Afghanistan,2005,2005Afghanistan,0,0,0,0,0,0,0,0,5,0,0,0,0,5,5
150,Afghanistan,2005,2005Afghanistan,0,0,0,0,0,0,0,0,7,0,0,0,0,7,7
151,Afghanistan,2005,2005Afghanistan,0,0,0,0,0,0,0,5,0,0,8,0,0,13,13
152,Afghanistan,2005,2005Afghanistan,0,0,0,0,0,5,5,0,0,0,0,0,51,51,56
153,Afghanistan,2005,2005Afghanistan,0,0,0,0,0,535,535,0,0,0,0,0,693,693,1228
154,Afghanistan,2005,2005Afghanistan,0,0,0,0,0,604,604,0,0,0,0,0,402,402,1006
155,Afghanistan,2005,2005Afghanistan,0,0,0,0,0,531262,531262,0,0,0,0,0,552946,552946,1084208
156,Afghanistan,2005,2005Afghanistan,0,0,0,5,0,0,5,0,0,0,0,0,0,0,5
157,Afghanistan,2005,2005Afghanistan,0,0,0,5,0,0,5,0,9,0,0,0,0,9,153
158,Afghanistan,2005,2005Afghanistan,0,0,0,5,0,0,5,5,0,0,6,0,0,11,16
159,Afghanistan,2005,2005Afghanistan,0,0,0,7,0,0,7,0,0,0,0,0,0,0,7
160,Afghanistan,2005,2005Afghanistan,0,0,0,7,0,0,7,0,6,0,0,0,0,6,280
161,Afghanistan,2005,2005Afghanistan,0,0,5,0,0,0,5,0,0,0,8,0,0,8,13
162,Afghanistan,2005,2005Afghanistan,0,0,5,8,0,0,13,0,0,0,18,0,0,18,124
163,Afghanistan,2005,2005Afghanistan,0,0,8,12,0,0,20,0,6,5,20,0,0,31,51
164,Afghanistan,2005,2005Afghanistan,0,13,5,16,0,0,34,0,5,12,25,0,0,42,76
165,Afghanistan,2005,2005Afghanistan,5,0,0,0,0,0,5,5,0,0,21,0,0,26,31
166,Afghanistan,2005,2005Afghanistan,5,7,6,18,0,0,36,0,8,7,39,0,0,54,90
167,Afghanistan,2005,2005Afghanistan,7,19,17,63,5,0,111,0,23,20,91,6,0,140,251
168,Afghanistan,2005,2005Afghanistan,9,7,6,9,5,0,36,8,6,6,17,5,0,42,78
169,Afghanistan,2005,2005Afghanistan,12,23,20,53,5,0,113,9,25,21,48,13,0,116,229
170,Afghanistan,2005,2005Afghanistan,14,42,36,111,10,0,213,0,38,37,224,5,0,304,517
171,Afghanistan,2005,2005Afghanistan,14,75,64,198,20,0,371,12,77,66,667,20,0,842,1213
172,Afghanistan,2005,2005Afghanistan,28,46,40,131,17,436,698,19,48,41,277,16,496,897,1595
173,Afghanistan,2005,2005Afghanistan,31,180,156,479,20,0,866,53,184,159,516,27,0,939,4740
174,Afghanistan,2005,2005Afghanistan,41,75,67,164,17,0,364,45,63,55,203,19,0,385,749
175,Afghanistan,2005,2005Afghanistan,77,43,37,156,15,0,328,93,50,43,241,5,0,432,760
176,Afghanistan,2005,2005Afghanistan,162,739,633,3416,315,0,5265,186,825,708,2416,300,0,4435,9700
177,Afghanistan,2005,2005Afghanistan,18932,44332,138662,192197,9204,0,403327,19196,49071,152329,277920,18405,0,516921,920248
178,Afghanistan,2006,2006Afghanistan,0,0,0,0,0,0,0,0,0,0,0,0,0,0,131376
179,Afghanistan,2006,2006Afghanistan,0,0,0,0,0,0,0,0,0,0,0,0,5,5,10
180,Afghanistan,2006,2006Afghanistan,0,0,0,0,0,0,0,0,0,0,6,0,0,6,6
181,Afghanistan,2006,2006Afghanistan,0,0,0,0,0,0,0,0,0,0,40,0,0,40,40
182,Afghanistan,2006,2006Afghanistan,0,0,0,0,0,0,0,0,0,5,0,0,0,5,5
183,Afghanistan,2006,2006Afghanistan,0,0,0,0,0,0,0,0,0,7,0,0,0,7,7
184,Afghanistan,2006,2006Afghanistan,0,0,0,0,0,5,5,0,0,0,0,0,50,50,55
185,Afghanistan,2006,2006Afghanistan,0,0,0,0,0,83,83,0,0,0,0,0,143,143,226
186,Afghanistan,2006,2006Afghanistan,0,0,0,0,0,371,371,0,0,0,0,0,818,818,1189
187,Afghanistan,2006,2006Afghanistan,0,0,0,0,0,524,524,0,0,0,0,0,714,714,1238
188,Afghanistan,2006,2006Afghanistan,0,0,0,0,0,718,718,0,0,0,0,0,1008,1008,1726
189,Afghanistan,2006,2006Afghanistan,0,0,0,0,0,520112,520112,0,0,0,0,0,523872,523872,1043984
190,Afghanistan,2006,2006Afghanistan,0,0,0,5,0,0,5,0,0,0,0,0,0,0,10
191,Afghanistan,2006,2006Afghanistan,0,0,0,5,0,0,5,0,0,0,5,0,0,5,272
192,Afghanistan,2006,2006Afghanistan,0,0,0,5,0,0,5,5,0,0,7,0,0,12,17
193,Afghanistan,2006,2006Afghanistan,0,0,0,7,0,0,7,0,0,0,7,0,0,7,14
194,Afghanistan,2006,2006Afghanistan,0,0,5,0,0,0,5,0,0,0,7,0,0,7,12
195,Afghanistan,2006,2006Afghanistan,0,0,7,11,0,0,18,5,0,5,27,0,0,37,55
196,Afghanistan,2006,2006Afghanistan,0,0,10,15,0,425,450,0,9,0,6,5,447,467,917
197,Afghanistan,2006,2006Afghanistan,0,5,0,0,0,0,5,0,5,0,21,0,0,26,31
198,Afghanistan,2006,2006Afghanistan,0,9,0,7,0,0,16,0,10,17,22,0,0,49,65
199,Afghanistan,2006,2006Afghanistan,5,5,10,21,0,0,41,0,9,10,44,0,0,63,104
200,Afghanistan,2006,2006Afghanistan,6,10,24,69,5,0,114,0,12,31,93,6,0,142,256
201,Afghanistan,2006,2006Afghanistan,10,15,9,11,0,0,45,0,0,18,12,0,0,30,75
202,Afghanistan,2006,2006Afghanistan,11,51,30,111,5,0,208,6,36,21,215,5,0,283,491
203,Afghanistan,2006,2006Afghanistan,14,26,28,71,8,0,147,11,32,22,71,16,0,152,299
204,Afghanistan,2006,2006Afghanistan,36,74,61,159,16,0,346,35,63,59,188,19,0,364,710
205,Afghanistan,2006,2006Afghanistan,41,0,72,143,0,0,256,41,0,64,227,0,0,332,588
206,Afghanistan,2006,2006Afghanistan,199,408,927,3338,300,0,5172,220,524,948,2333,275,0,4300,9472
207,Afghanistan,2006,2006Afghanistan,32349,111685,8060,202036,11888,0,366018,34535,121070,89819,282660,20158,0,548242,914260
208,Afghanistan,2007,2007Afghanistan,0,0,0,0,0,0,0,0,0,0,0,0,0,0,100554
209,Afghanistan,2007,2007Afghanistan,0,0,0,0,0,0,0,0,0,0,5,0,0,5,10
210,Afghanistan,2007,2007Afghanistan,0,0,0,0,0,0,0,0,0,0,6,0,0,6,6
211,Afghanistan,2007,2007Afghanistan,0,0,0,0,0,0,0,0,0,0,9,0,0,9,9
212,Afghanistan,2007,2007Afghanistan,0,0,0,0,0,0,0,0,0,0,40,0,0,40,40
213,Afghanistan,2007,2007Afghanistan,0,0,0,0,0,0,0,0,0,5,0,0,0,5,5
214,Afghanistan,2007,2007Afghanistan,0,0,0,0,0,0,0,0,0,7,0,0,0,7,7
215,Afghanistan,2007,2007Afghanistan,0,0,0,0,0,0,0,0,5,0,0,0,0,5,5
216,Afghanistan,2007,2007Afghanistan,0,0,0,0,0,0,0,0,5,0,23,0,0,28,28
217,Afghanistan,2007,2007Afghanistan,0,0,0,0,0,5,5,0,0,0,0,0,11,11,97
218,Afghanistan,2007,2007Afghanistan,0,0,0,0,0,21,21,0,0,0,0,0,35,35,56
219,Afghanistan,2007,2007Afghanistan,0,0,0,0,0,44,44,0,0,0,0,0,107,107,151
220,Afghanistan,2007,2007Afghanistan,0,0,0,0,0,369,369,0,0,0,0,0,802,802,1171
221,Afghanistan,2007,2007Afghanistan,0,0,0,0,0,521,521,0,0,0,0,0,752,752,1273
222,Afghanistan,2007,2007Afghanistan,0,0,0,0,0,397133,397133,0,0,0,0,0,508938,508938,906071
223,Afghanistan,2007,2007Afghanistan,0,0,0,5,0,0,5,0,0,0,0,0,0,0,10
224,Afghanistan,2007,2007Afghanistan,0,0,0,5,0,0,5,5,0,0,7,0,0,12,17
225,Afghanistan,2007,2007Afghanistan,0,0,0,7,0,0,7,0,0,0,7,0,0,7,14
226,Afghanistan,2007,2007Afghanistan,0,0,5,0,0,0,5,0,0,0,7,0,0,7,12
227,Afghanistan,2007,2007Afghanistan,0,0,7,14,0,0,21,0,8,0,9,0,0,17,1126
228,Afghanistan,2007,2007Afghanistan,0,5,0,13,0,0,18,5,5,6,34,0,0,50,68
229,Afghanistan,2007,2007Afghanistan,0,6,0,7,0,0,13,0,8,5,23,0,0,36,49
230,Afghanistan,2007,2007Afghanistan,0,9,0,21,0,0,30,0,0,9,25,5,0,39,74
231,Afghanistan,2007,2007Afghanistan,0,16,37,40,0,0,93,5,12,49,53,0,0,119,212
232,Afghanistan,2007,2007Afghanistan,5,6,10,25,0,0,46,5,7,5,45,0,0,62,108
233,Afghanistan,2007,2007Afghanistan,5,10,7,20,0,0,42,7,10,7,19,0,0,43,85
234,Afghanistan,2007,2007Afghanistan,5,13,22,58,8,0,106,5,16,24,62,13,0,120,226
235,Afghanistan,2007,2007Afghanistan,9,7,14,84,5,0,119,0,10,17,125,6,0,158,277
236,Afghanistan,2007,2007Afghanistan,9,44,23,97,5,0,178,6,38,27,200,5,0,276,454
237,Afghanistan,2007,2007Afghanistan,28,24,20,82,10,0,164,24,0,48,168,0,0,240,404
238,Afghanistan,2007,2007Afghanistan,31,59,46,141,23,387,687,21,55,56,322,16,452,922,1609
239,Afghanistan,2007,2007Afghanistan,212,389,845,3183,304,0,4933,228,517,854,2221,258,0,4078,9011
240,Afghanistan,2007,2007Afghanistan,39470,110048,65010,184393,10725,0,409646,41540,117812,78713,217420,21535,0,477020,2034416
241,Afghanistan,2008,2008Afghanistan,0,0,0,0,0,0,0,0,0,0,0,0,0,0,99408
242,Afghanistan,2008,2008Afghanistan,0,0,0,0,0,0,0,0,0,0,5,0,0,5,5
243,Afghanistan,2008,2008Afghanistan,0,0,0,0,0,0,0,0,0,0,6,0,0,6,6
244,Afghanistan,2008,2008Afghanistan,0,0,0,0,0,0,0,0,0,0,8,0,0,8,8
245,Afghanistan,2008,2008Afghanistan,0,0,0,0,0,0,0,0,0,5,0,0,0,5,5
246,Afghanistan,2008,2008Afghanistan,0,0,0,0,0,0,0,0,5,0,23,0,0,28,28
247,Afghanistan,2008,2008Afghanistan,0,0,0,0,0,0,0,0,9,0,9,0,0,18,76
248,Afghanistan,2008,2008Afghanistan,0,0,0,0,0,21,21,0,0,0,0,0,35,35,56
249,Afghanistan,2008,2008Afghanistan,0,0,0,0,0,53,53,0,0,0,0,0,143,143,196
250,Afghanistan,2008,2008Afghanistan,0,0,0,0,0,535,535,0,0,0,0,0,810,810,1345
251,Afghanistan,2008,2008Afghanistan,0,0,0,5,0,0,5,0,0,0,0,0,0,0,5
252,Afghanistan,2008,2008Afghanistan,0,0,0,9,0,0,9,0,0,0,7,0,0,7,16
253,Afghanistan,2008,2008Afghanistan,0,0,5,0,0,0,5,0,0,0,5,0,0,5,10
254,Afghanistan,2008,2008Afghanistan,0,0,5,10,0,0,15,5,0,0,6,0,0,11,1790
255,Afghanistan,2008,2008Afghanistan,0,0,7,0,0,0,7,0,5,0,17,0,0,22,29
256,Afghanistan,2008,2008Afghanistan,0,0,7,12,0,0,19,5,5,5,28,0,0,43,62
257,Afghanistan,2008,2008Afghanistan,0,0,7,13,0,0,20,0,6,0,20,0,0,26,46
258,Afghanistan,2008,2008Afghanistan,0,5,5,25,0,0,35,0,0,7,32,0,0,39,79
259,Afghanistan,2008,2008Afghanistan,5,0,120,188,13,0,326,5,0,127,676,22,0,830,1156
260,Afghanistan,2008,2008Afghanistan,5,13,17,83,5,0,123,0,15,15,109,5,0,144,267
261,Afghanistan,2008,2008Afghanistan,5,39,43,66,0,0,153,10,26,51,107,0,0,194,347
262,Afghanistan,2008,2008Afghanistan,6,43,28,87,8,0,172,9,20,31,199,5,0,264,436
263,Afghanistan,2008,2008Afghanistan,8,7,8,29,0,0,52,5,9,8,51,0,0,73,125
264,Afghanistan,2008,2008Afghanistan,16,28,52,126,10,0,232,21,43,57,147,17,0,285,517
265,Afghanistan,2008,2008Afghanistan,26,86,25,223,11,0,371,30,58,80,260,10,0,438,809
266,Afghanistan,2008,2008Afghanistan,26,77229,90474,246387,14388,0,428504,26,86010,96634,301487,22934,0,507091,935595
267,Afghanistan,2008,2008Afghanistan,28,0,52,104,5,0,189,37,0,59,203,5,0,304,493
268,Afghanistan,2008,2008Afghanistan,29,52,52,135,23,380,671,19,62,61,346,18,433,939,1610
269,Afghanistan,2008,2008Afghanistan,226,362,724,3010,302,0,4624,242,445,794,2078,258,0,3817,8441
270,Afghanistan,2008,2008Afghanistan,33020,96060,57501,159375,9411,0,355367,34631,102122,68555,185469,18791,0,409568,1780150
271,Afghanistan,2009,2009Afghanistan,0,0,0,0,0,0,0,0,0,0,0,0,0,0,73363
272,Afghanistan,2009,2009Afghanistan,0,0,0,0,0,0,0,0,0,0,5,0,0,5,20
273,Afghanistan,2009,2009Afghanistan,0,0,0,0,0,0,0,0,0,0,6,0,0,6,6
274,Afghanistan,2009,2009Afghanistan,0,0,0,0,0,0,0,0,0,0,8,0,0,8,8
275,Afghanistan,2009,2009Afghanistan,0,0,0,0,0,0,0,0,0,0,9,0,0,9,9
276,Afghanistan,2009,2009Afghanistan,0,0,0,0,0,0,0,0,0,5,0,0,0,5,100
277,Afghanistan,2009,2009Afghanistan,0,0,0,0,0,0,0,0,0,7,0,0,0,7,7
278,Afghanistan,2009,2009Afghanistan,0,0,0,0,0,0,0,5,0,0,0,0,0,5,5
279,Afghanistan,2009,2009Afghanistan,0,0,0,0,0,18,18,0,0,0,0,0,39,39,57
280,Afghanistan,2009,2009Afghanistan,0,0,0,0,0,72,72,0,0,0,0,0,199,199,271
281,Afghanistan,2009,2009Afghanistan,0,0,0,5,0,0,5,0,0,0,7,0,0,7,12
282,Afghanistan,2009,2009Afghanistan,0,0,0,9,0,0,9,0,0,0,8,0,0,8,17
283,Afghanistan,2009,2009Afghanistan,0,0,6,6,0,0,12,0,0,0,17,0,0,17,29
284,Afghanistan,2009,2009Afghanistan,0,0,11,35,0,0,46,0,6,8,40,5,0,59,105
285,Afghanistan,2009,2009Afghanistan,0,7,0,10,0,0,17,0,6,0,8,0,0,14,2673
286,Afghanistan,2009,2009Afghanistan,5,5,11,21,0,0,42,0,19,269,1554,23,0,1865,1907
287,Afghanistan,2009,2009Afghanistan,5,14,20,98,5,0,142,5,8,14,148,6,0,181,323
288,Afghanistan,2009,2009Afghanistan,5,16,40,121,5,0,187,5,14,30,187,6,0,242,429
289,Afghanistan,2009,2009Afghanistan,6,7,7,25,0,0,45,5,11,48,106,5,0,175,220
290,Afghanistan,2009,2009Afghanistan,6,10,10,39,0,0,65,6,14,7,57,0,0,84,149
291,Afghanistan,2009,2009Afghanistan,7,43,29,76,8,0,163,9,19,25,187,5,0,245,408
292,Afghanistan,2009,2009Afghanistan,10,6,145,204,13,0,378,6,5,144,684,22,0,861,1239
293,Afghanistan,2009,2009Afghanistan,13,19,17,63,0,0,112,13,15,19,84,5,0,136,248
294,Afghanistan,2009,2009Afghanistan,20,82928,100414,269263,15718,0,468343,20,88548,111047,329475,25061,0,554151,1022494
295,Afghanistan,2009,2009Afghanistan,24,31,47,144,6,0,252,26,28,39,191,10,0,294,546
296,Afghanistan,2009,2009Afghanistan,30,83,88,239,16,0,456,33,82,109,260,23,0,507,963
297,Afghanistan,2009,2009Afghanistan,35,64,60,153,20,373,705,34,60,68,391,18,407,978,1683
298,Afghanistan,2009,2009Afghanistan,47,65,99,263,7,0,481,36,76,122,319,6,0,559,1040
299,Afghanistan,2009,2009Afghanistan,236,388,635,3047,307,0,4613,255,457,758,2180,265,0,3915,8528
300,Afghanistan,2009,2009Afghanistan,277,1253,1831,8511,2237,0,14109,282,1333,2138,10907,1551,0,16211,30320
301,Afghanistan,2009,2009Afghanistan,22251,99856,56422,163878,9456,0,351863,23687,105475,66314,192329,18948,0,406753,1739935
302,Afghanistan,2010,2010Afghanistan,0,0,0,0,0,0,0,0,0,0,0,0,0,0,1100450
303,Afghanistan,2010,2010Afghanistan,0,0,0,0,0,0,0,0,0,0,5,0,0,5,5
304,Afghanistan,2010,2010Afghanistan,0,0,0,0,0,0,0,0,0,0,6,0,0,6,6
305,Afghanistan,2010,2010Afghanistan,0,0,0,0,0,0,0,0,0,0,7,0,0,7,7
306,Afghanistan,2010,2010Afghanistan,0,0,0,0,0,0,0,0,0,0,8,0,0,8,8
307,Afghanistan,2010,2010Afghanistan,0,0,0,0,0,0,0,0,0,0,9,0,0,9,9
308,Afghanistan,2010,2010Afghanistan,0,0,0,0,0,0,0,0,0,0,12,0,0,12,12
309,Afghanistan,2010,2010Afghanistan,0,0,0,0,0,0,0,0,0,5,0,0,0,5,10
310,Afghanistan,2010,2010Afghanistan,0,0,0,0,0,0,0,0,0,7,0,0,0,7,7
311,Afghanistan,2010,2010Afghanistan,0,0,0,0,0,0,0,0,0,7,15,0,0,22,22
312,Afghanistan,2010,2010Afghanistan,0,0,0,0,0,0,0,5,0,0,0,0,0,5,5
313,Afghanistan,2010,2010Afghanistan,0,0,0,0,0,19,19,0,0,0,0,0,35,35,54
314,Afghanistan,2010,2010Afghanistan,0,0,0,0,0,144,144,0,0,0,0,0,357,357,501
315,Afghanistan,2010,2010Afghanistan,0,0,0,0,0,388,388,0,0,0,0,0,951,951,1339
316,Afghanistan,2010,2010Afghanistan,0,0,0,0,0,609,609,0,0,0,0,0,1181,1181,1790
317,Afghanistan,2010,2010Afghanistan,0,0,0,5,0,0,5,0,0,0,8,0,0,8,13
318,Afghanistan,2010,2010Afghanistan,0,0,6,6,0,0,12,0,0,0,18,0,0,18,30
319,Afghanistan,2010,2010Afghanistan,0,0,12,37,0,0,49,5,5,5,45,5,0,65,114
320,Afghanistan,2010,2010Afghanistan,0,5,0,0,0,0,5,0,0,0,52,0,0,52,135
321,Afghanistan,2010,2010Afghanistan,0,5,0,5,0,0,10,0,0,0,5,0,0,5,15
322,Afghanistan,2010,2010Afghanistan,0,7,0,0,0,0,7,0,0,0,0,0,0,0,108
323,Afghanistan,2010,2010Afghanistan,0,8,10,12,0,0,30,0,8,0,10,0,0,18,3126
324,Afghanistan,2010,2010Afghanistan,7,0,0,0,0,0,7,0,5,0,7,0,0,12,19
325,Afghanistan,2010,2010Afghanistan,7,10,6,21,0,0,44,5,19,33,158,0,0,215,259
326,Afghanistan,2010,2010Afghanistan,8,33,37,76,8,0,162,18,20,24,188,5,0,255,417
327,Afghanistan,2010,2010Afghanistan,10,8,28,82,6,0,134,10,17,24,114,5,0,170,304
328,Afghanistan,2010,2010Afghanistan,11,40,21,87,7,0,166,12,25,24,182,6,0,249,415
329,Afghanistan,2010,2010Afghanistan,22,42,25,111,0,0,200,16,29,36,144,5,0,230,430
330,Afghanistan,2010,2010Afghanistan,31,45,31,128,11,0,246,37,42,42,341,10,0,472,718
331,Afghanistan,2010,2010Afghanistan,43,104,128,400,5,0,680,39,133,148,485,6,0,811,1491
332,Afghanistan,2010,2010Afghanistan,49,82,75,208,22,357,793,59,80,94,487,21,395,1136,1929
333,Afghanistan,2010,2010Afghanistan,81,122,148,378,29,0,758,89,147,180,403,0,34,853,1611
334,Afghanistan,2010,2010Afghanistan,260,536,713,2416,286,0,4211,273,470,572,3244,324,0,4883,9094
335,Afghanistan,2010,2010Afghanistan,326,1208,1660,8455,2353,0,14002,332,1296,2138,11031,1605,0,16402,30404
336,Afghanistan,2010,2010Afghanistan,121141,215640,136563,387758,22770,0,883872,127760,226483,159785,457242,44700,0,1015970,1899842
337,Afghanistan,2011,2011Afghanistan,0,0,0,0,0,0,0,0,0,0,0,0,0,0,902210
338,Afghanistan,2011,2011Afghanistan,0,0,0,0,0,0,0,0,0,0,5,0,0,5,10
339,Afghanistan,2011,2011Afghanistan,0,0,0,0,0,0,0,0,0,0,6,0,0,6,6
340,Afghanistan,2011,2011Afghanistan,0,0,0,0,0,0,0,0,0,0,7,0,0,7,14
341,Afghanistan,2011,2011Afghanistan,0,0,0,0,0,0,0,0,0,0,8,0,0,8,8
342,Afghanistan,2011,2011Afghanistan,0,0,0,0,0,0,0,0,0,0,9,0,0,9,9
343,Afghanistan,2011,2011Afghanistan,0,0,0,0,0,0,0,0,0,0,13,0,0,13,13
344,Afghanistan,2011,2011Afghanistan,0,0,0,0,0,0,0,0,0,5,11,0,0,16,114
345,Afghanistan,2011,2011Afghanistan,0,0,0,0,0,0,0,0,0,8,16,0,0,24,24
346,Afghanistan,2011,2011Afghanistan,0,0,0,0,0,14,14,0,0,0,0,0,26,26,40
347,Afghanistan,2011,2011Afghanistan,0,0,0,0,0,239,239,0,0,0,0,0,546,546,785
348,Afghanistan,2011,2011Afghanistan,0,0,0,0,0,636,636,0,0,0,0,0,1484,1484,2120
349,Afghanistan,2011,2011Afghanistan,0,0,0,5,0,0,5,0,0,0,0,0,0,0,5
350,Afghanistan,2011,2011Afghanistan,0,0,0,5,0,0,5,0,0,0,16,0,0,16,21
351,Afghanistan,2011,2011Afghanistan,0,0,6,6,0,0,12,0,0,0,19,0,0,19,31
352,Afghanistan,2011,2011Afghanistan,0,0,9,19,0,0,28,0,5,5,35,0,0,45,1457
353,Afghanistan,2011,2011Afghanistan,0,0,10,35,5,0,50,0,7,6,45,6,0,64,114
354,Afghanistan,2011,2011Afghanistan,0,10,0,0,0,0,10,0,0,0,5,0,0,5,15
355,Afghanistan,2011,2011Afghanistan,5,0,0,0,0,0,5,0,0,5,6,0,0,11,16
356,Afghanistan,2011,2011Afghanistan,5,0,0,5,0,0,10,0,0,0,8,0,0,8,18
357,Afghanistan,2011,2011Afghanistan,5,9,9,19,0,0,42,5,8,5,15,0,0,33,3270
358,Afghanistan,2011,2011Afghanistan,5,14,5,26,0,0,50,0,15,78,333,0,0,426,476
359,Afghanistan,2011,2011Afghanistan,6,5,0,5,0,0,16,5,0,0,69,0,0,74,175
360,Afghanistan,2011,2011Afghanistan,7,0,0,0,0,0,7,0,5,0,7,0,0,12,26
361,Afghanistan,2011,2011Afghanistan,9,9,14,55,5,0,92,6,8,21,79,5,0,119,211
362,Afghanistan,2011,2011Afghanistan,9,35,35,80,9,0,168,16,27,21,187,5,0,256,424
363,Afghanistan,2011,2011Afghanistan,11,45,26,90,5,0,177,18,23,32,163,5,0,241,418
364,Afghanistan,2011,2011Afghanistan,14,36,21,89,0,0,160,14,18,24,120,5,0,181,341
365,Afghanistan,2011,2011Afghanistan,23,49,32,127,10,0,241,38,38,38,342,9,0,465,706
366,Afghanistan,2011,2011Afghanistan,28,38,40,151,0,0,257,31,46,24,192,6,0,299,556
367,Afghanistan,2011,2011Afghanistan,61,89,76,236,23,332,817,51,99,109,652,20,379,1310,2127
368,Afghanistan,2011,2011Afghanistan,67,132,165,484,47,0,895,59,132,169,648,24,0,1032,2659
369,Afghanistan,2011,2011Afghanistan,86,141,166,450,27,0,870,82,167,179,451,42,0,921,1791
370,Afghanistan,2011,2011Afghanistan,87,228,228,653,5,0,1201,92,254,313,803,19,0,1481,2682
371,Afghanistan,2011,2011Afghanistan,251,487,512,3295,331,0,4876,249,537,667,2527,305,0,4285,9161
372,Afghanistan,2011,2011Afghanistan,339,1197,1564,8404,2355,0,13859,347,1292,2078,11173,1676,0,16566,30425
373,Afghanistan,2011,2011Afghanistan,133307,185475,126590,335856,21225,0,802453,141589,196307,149297,370846,41453,0,899492,1701945
374,Afghanistan,2012,2012Afghanistan,0,0,0,0,0,0,0,0,0,0,0,0,0,0,61047
375,Afghanistan,2012,2012Afghanistan,0,0,0,0,0,0,0,0,0,0,5,0,0,5,10
376,Afghanistan,2012,2012Afghanistan,0,0,0,0,0,0,0,0,0,0,6,0,0,6,6
377,Afghanistan,2012,2012Afghanistan,0,0,0,0,0,0,0,0,0,0,7,0,0,7,14
378,Afghanistan,2012,2012Afghanistan,0,0,0,0,0,0,0,0,0,0,10,0,0,10,10
379,Afghanistan,2012,2012Afghanistan,0,0,0,0,0,0,0,0,0,0,12,0,0,12,12
380,Afghanistan,2012,2012Afghanistan,0,0,0,0,0,0,0,0,0,0,14,0,0,14,14
381,Afghanistan,2012,2012Afghanistan,0,0,0,0,0,0,0,0,0,0,24,0,0,24,125
382,Afghanistan,2012,2012Afghanistan,0,0,0,0,0,0,0,0,0,5,0,0,0,5,5
383,Afghanistan,2012,2012Afghanistan,0,0,0,0,0,0,0,0,0,13,5,0,0,18,18
384,Afghanistan,2012,2012Afghanistan,0,0,0,0,0,12,12,0,0,0,0,0,22,22,34
385,Afghanistan,2012,2012Afghanistan,0,0,0,0,0,110,110,0,0,0,0,0,131,131,241
386,Afghanistan,2012,2012Afghanistan,0,0,0,0,0,346,346,0,0,0,0,0,921,921,1267
387,Afghanistan,2012,2012Afghanistan,0,0,0,0,0,430,430,0,0,0,0,0,1050,1050,1480
388,Afghanistan,2012,2012Afghanistan,0,0,0,0,0,673,673,0,0,0,0,0,1917,1917,2590
389,Afghanistan,2012,2012Afghanistan,0,0,0,5,0,0,5,0,0,0,9,0,0,9,14
390,Afghanistan,2012,2012Afghanistan,0,0,0,5,0,0,5,0,0,9,14,0,0,23,28
391,Afghanistan,2012,2012Afghanistan,0,0,0,8,0,0,8,0,0,0,5,0,0,5,13
392,Afghanistan,2012,2012Afghanistan,0,0,0,10,0,0,10,0,0,0,9,0,0,9,19
393,Afghanistan,2012,2012Afghanistan,0,0,5,0,0,0,5,0,0,0,0,0,0,0,5
394,Afghanistan,2012,2012Afghanistan,0,0,7,38,5,0,50,0,8,5,44,6,0,63,113
395,Afghanistan,2012,2012Afghanistan,0,5,0,0,0,0,5,0,0,0,7,0,0,7,12
396,Afghanistan,2012,2012Afghanistan,0,5,0,0,0,0,5,0,0,5,9,0,0,14,19
397,Afghanistan,2012,2012Afghanistan,0,9,11,11,0,0,31,0,5,7,10,0,2143,2165,2196
398,Afghanistan,2012,2012Afghanistan,5,5,0,6,0,0,16,5,0,0,68,0,0,73,209
399,Afghanistan,2012,2012Afghanistan,5,9,11,47,5,0,77,5,5,11,66,9,0,96,173
400,Afghanistan,2012,2012Afghanistan,5,40,22,93,5,0,165,11,19,29,148,5,0,212,377
401,Afghanistan,2012,2012Afghanistan,7,0,0,0,0,0,7,0,5,0,9,0,0,14,28
402,Afghanistan,2012,2012Afghanistan,8,5,35,10,0,0,58,5,99,690,17,21,0,832,890
403,Afghanistan,2012,2012Afghanistan,8,32,37,75,9,0,161,14,28,21,180,5,0,248,409
404,Afghanistan,2012,2012Afghanistan,10,0,0,5,0,0,15,0,0,6,23,0,0,29,136
405,Afghanistan,2012,2012Afghanistan,12,23,13,73,6,0,127,19,21,24,105,6,0,175,2609
406,Afghanistan,2012,2012Afghanistan,13,30,25,85,5,0,158,13,21,23,129,5,0,191,349
407,Afghanistan,2012,2012Afghanistan,24,32,28,96,10,0,190,28,30,28,289,11,0,386,576
408,Afghanistan,2012,2012Afghanistan,27,36,33,146,5,0,247,24,38,29,181,6,0,278,525
409,Afghanistan,2012,2012Afghanistan,57,91,66,249,16,320,799,50,102,106,641,22,379,1300,2099
410,Afghanistan,2012,2012Afghanistan,74,138,141,480,27,0,860,75,149,149,456,48,0,877,1737
411,Afghanistan,2012,2012Afghanistan,118,291,312,872,10,0,1603,124,334,388,1048,20,0,1914,3517
412,Afghanistan,2012,2012Afghanistan,212,562,473,3513,373,0,5133,250,581,600,2742,327,0,4500,9633
413,Afghanistan,2012,2012Afghanistan,382,1240,1501,8583,2455,0,14161,432,1320,1960,12102,1771,0,17585,31746
414,Afghanistan,2012,2012Afghanistan,1853,2523,2707,6129,609,0,13821,1931,2495,2880,6294,842,0,14442,824087
415,Afghanistan,2012,2012Afghanistan,100102,183165,123261,341175,20961,0,768664,105902,192107,143552,386622,40893,0,869076,1637740
416,Afghanistan,2013,2013Afghanistan,0,0,0,0,0,0,0,0,0,0,0,0,0,0,67995
417,Afghanistan,2013,2013Afghanistan,0,0,0,0,0,0,0,0,0,0,5,0,0,5,25
418,Afghanistan,2013,2013Afghanistan,0,0,0,0,0,0,0,0,0,0,7,0,0,7,14
419,Afghanistan,2013,2013Afghanistan,0,0,0,0,0,0,0,0,0,0,10,0,0,10,20
420,Afghanistan,2013,2013Afghanistan,0,0,0,0,0,0,0,0,0,0,15,0,0,15,15
421,Afghanistan,2013,2013Afghanistan,0,0,0,0,0,0,0,0,0,5,0,0,0,5,5
422,Afghanistan,2013,2013Afghanistan,0,0,0,0,0,0,0,0,0,15,7,0,0,22,22
423,Afghanistan,2013,2013Afghanistan,0,0,0,0,0,5,5,0,0,0,0,0,18,18,106
424,Afghanistan,2013,2013Afghanistan,0,0,0,0,0,10,10,0,0,0,0,0,24,24,34
425,Afghanistan,2013,2013Afghanistan,0,0,0,0,0,438,438,0,0,0,0,0,1198,1198,4328
426,Afghanistan,2013,2013Afghanistan,0,0,0,0,0,760,760,0,0,0,0,0,2453,2453,3213
427,Afghanistan,2013,2013Afghanistan,0,0,0,5,0,0,5,0,0,0,11,0,0,11,16
428,Afghanistan,2013,2013Afghanistan,0,0,0,8,0,0,8,0,0,0,0,0,0,0,8
429,Afghanistan,2013,2013Afghanistan,0,0,0,10,0,0,10,0,0,0,9,0,0,9,19
430,Afghanistan,2013,2013Afghanistan,0,0,0,10,0,0,10,0,0,0,31,0,0,31,41
431,Afghanistan,2013,2013Afghanistan,0,0,7,38,5,0,50,0,7,5,42,8,0,62,112
432,Afghanistan,2013,2013Afghanistan,0,5,0,0,0,0,5,0,0,0,0,0,0,0,5
433,Afghanistan,2013,2013Afghanistan,0,5,0,0,0,0,5,0,0,5,10,0,0,15,20
434,Afghanistan,2013,2013Afghanistan,0,5,0,6,0,0,11,0,5,0,113,0,0,118,129
435,Afghanistan,2013,2013Afghanistan,0,5,7,38,0,0,50,0,14,8,31,0,0,53,2004
436,Afghanistan,2013,2013Afghanistan,5,8,0,0,0,0,13,0,5,0,10,0,0,15,154
437,Afghanistan,2013,2013Afghanistan,5,8,8,34,5,0,60,6,5,8,48,6,0,73,138
438,Afghanistan,2013,2013Afghanistan,5,10,26,50,0,0,91,15,11,175,808,28,0,1037,1128
439,Afghanistan,2013,2013Afghanistan,5,14,15,40,0,0,74,6,9,12,86,0,0,113,187
440,Afghanistan,2013,2013Afghanistan,7,0,0,0,0,0,7,0,5,0,9,0,0,14,28
441,Afghanistan,2013,2013Afghanistan,8,25,43,71,7,0,154,18,25,28,175,5,0,251,405
442,Afghanistan,2013,2013Afghanistan,14,33,38,102,5,0,192,27,23,22,141,0,0,213,405
443,Afghanistan,2013,2013Afghanistan,15,35,28,109,0,0,187,12,35,18,134,5,0,204,2700
444,Afghanistan,2013,2013Afghanistan,20,35,34,151,5,0,245,21,38,40,184,9,0,292,537
445,Afghanistan,2013,2013Afghanistan,21,36,27,112,7,0,203,25,34,26,304,11,0,400,603
446,Afghanistan,2013,2013Afghanistan,40,86,99,312,17,0,554,32,107,79,337,32,0,587,1141
447,Afghanistan,2013,2013Afghanistan,75,130,81,335,18,325,964,77,132,123,870,21,391,1614,2578
448,Afghanistan,2013,2013Afghanistan,114,319,326,1000,20,0,1779,124,366,384,1237,36,0,2147,3926
449,Afghanistan,2013,2013Afghanistan,193,622,505,3733,421,0,5474,212,664,646,2970,362,0,4854,10328
450,Afghanistan,2013,2013Afghanistan,453,960,1044,6174,1784,0,10415,491,1113,1479,9403,1302,0,13788,24203
451,Afghanistan,2013,2013Afghanistan,1799,2450,2680,6089,538,0,13556,1906,2467,2891,6240,821,0,14325,814015
452,Afghanistan,2013,2013Afghanistan,67222,187222,136386,345468,20909,0,757207,70831,195963,156567,394259,41049,0,858669,1615876
453,Afghanistan,2014,2014Afghanistan,0,0,0,0,0,0,0,0,0,0,0,0,0,0,80399
454,Afghanistan,2014,2014Afghanistan,0,0,0,0,0,0,0,0,0,0,5,0,0,5,35
455,Afghanistan,2014,2014Afghanistan,0,0,0,0,0,0,0,0,0,0,7,0,0,7,7
456,Afghanistan,2014,2014Afghanistan,0,0,0,0,0,0,0,0,0,0,8,0,0,8,16
457,Afghanistan,2014,2014Afghanistan,0,0,0,0,0,0,0,0,0,0,15,0,0,15,15
458,Afghanistan,2014,2014Afghanistan,0,0,0,0,0,0,0,0,0,5,0,0,0,5,5
459,Afghanistan,2014,2014Afghanistan,0,0,0,0,0,0,0,0,0,5,11,0,0,16,16
460,Afghanistan,2014,2014Afghanistan,0,0,0,0,0,0,0,0,0,15,8,0,0,23,23
461,Afghanistan,2014,2014Afghanistan,0,0,0,0,0,0,0,0,5,0,0,0,0,5,5
462,Afghanistan,2014,2014Afghanistan,0,0,0,0,0,5,5,0,0,0,0,0,5,5,10
463,Afghanistan,2014,2014Afghanistan,0,0,0,0,0,11,11,0,0,0,0,0,23,23,34
464,Afghanistan,2014,2014Afghanistan,0,0,0,0,0,13,13,0,0,0,0,0,22,22,35
465,Afghanistan,2014,2014Afghanistan,0,0,0,0,0,868,868,0,0,0,0,0,2970,2970,3838
466,Afghanistan,2014,2014Afghanistan,0,0,0,5,0,0,5,5,0,0,8,0,0,13,18
467,Afghanistan,2014,2014Afghanistan,0,0,0,6,0,0,6,0,0,0,0,0,0,0,6
468,Afghanistan,2014,2014Afghanistan,0,0,0,7,0,0,7,0,0,0,0,0,0,0,7
469,Afghanistan,2014,2014Afghanistan,0,0,0,7,0,0,7,0,0,5,40,0,0,45,52
470,Afghanistan,2014,2014Afghanistan,0,0,0,10,0,0,10,0,0,0,9,0,0,9,19
471,Afghanistan,2014,2014Afghanistan,0,5,0,0,0,0,5,0,0,0,0,0,0,0,5
472,Afghanistan,2014,2014Afghanistan,0,5,0,0,0,0,5,0,0,5,11,0,0,16,21
473,Afghanistan,2014,2014Afghanistan,0,6,0,0,0,0,6,0,5,5,0,0,0,10,16
474,Afghanistan,2014,2014Afghanistan,0,8,0,36,5,0,49,0,5,7,55,7,0,74,123
475,Afghanistan,2014,2014Afghanistan,5,0,0,7,0,0,12,0,0,0,7,0,0,7,19
476,Afghanistan,2014,2014Afghanistan,5,0,7,6,0,0,18,0,0,8,8,0,0,16,34
477,Afghanistan,2014,2014Afghanistan,6,0,0,0,0,0,6,0,0,5,17,0,0,22,186
478,Afghanistan,2014,2014Afghanistan,7,0,0,0,0,0,7,0,5,0,16,0,0,21,28
479,Afghanistan,2014,2014Afghanistan,7,0,6,8,0,0,21,0,5,9,85,0,0,99,120
480,Afghanistan,2014,2014Afghanistan,7,12,15,43,0,0,77,11,10,11,75,0,0,107,184
481,Afghanistan,2014,2014Afghanistan,8,25,40,76,7,0,156,17,23,26,177,0,0,243,399
482,Afghanistan,2014,2014Afghanistan,9,49,53,81,0,0,192,9,32,52,74,0,0,167,1975
483,Afghanistan,2014,2014Afghanistan,10,15,13,95,5,0,138,11,14,19,206,8,0,258,2704
484,Afghanistan,2014,2014Afghanistan,21,35,26,118,8,0,208,24,33,27,315,11,0,410,618
485,Afghanistan,2014,2014Afghanistan,22,21,27,96,5,0,171,13,30,188,1253,26,0,1510,1681
486,Afghanistan,2014,2014Afghanistan,22,35,37,160,11,0,265,25,38,38,198,14,0,313,578
487,Afghanistan,2014,2014Afghanistan,23,28,38,79,6,0,174,24,26,37,125,0,0,212,386
488,Afghanistan,2014,2014Afghanistan,51,178,285,82,5,0,601,43,170,291,103,6,0,613,1214
489,Afghanistan,2014,2014Afghanistan,114,327,317,1116,20,0,1894,123,344,423,1362,42,0,2294,4188
490,Afghanistan,2014,2014Afghanistan,124,212,121,524,31,405,1417,128,229,209,1617,35,484,2702,4119
491,Afghanistan,2014,2014Afghanistan,146,630,519,3762,462,0,5519,183,657,623,3040,373,0,4876,10395
492,Afghanistan,2014,2014Afghanistan,509,1202,1125,6764,1870,0,11470,594,1348,1537,11484,1381,0,16344,27814
493,Afghanistan,2014,2014Afghanistan,1905,2499,2758,6537,555,0,14254,2004,2525,2951,6619,835,0,14934,950000
494,Afghanistan,2014,2014Afghanistan,47535,173084,133321,335907,17977,0,707824,50449,182043,148213,379350,37033,0,797088,1504912
495,Afghanistan,2015,2015Afghanistan,0,0,0,0,0,0,0,0,0,0,0,0,0,0,86575
496,Afghanistan,2015,2015Afghanistan,0,0,0,0,0,0,0,0,0,0,5,0,0,5,30
497,Afghanistan,2015,2015Afghanistan,0,0,0,0,0,0,0,0,0,0,7,0,0,7,7
498,Afghanistan,2015,2015Afghanistan,0,0,0,0,0,0,0,0,0,0,8,0,0,8,8
499,Afghanistan,2015,2015Afghanistan,0,0,0,0,0,0,0,0,0,0,10,0,0,10,16
500,Afghanistan,2015,2015Afghanistan,0,0,0,0,0,0,0,0,0,0,14,0,0,14,14
501,Afghanistan,2015,2015Afghanistan,0,0,0,0,0,0,0,0,0,0,22,0,0,22,22
502,Afghanistan,2015,2015Afghanistan,0,0,0,0,0,0,0,0,0,5,0,0,0,5,5
503,Afghanistan,2015,2015Afghanistan,0,0,0,0,0,0,0,0,5,0,0,0,0,5,5
504,Afghanistan,2015,2015Afghanistan,0,0,0,0,0,0,0,0,6,0,0,0,0,6,6
505,Afghanistan,2015,2015Afghanistan,0,0,0,0,0,5,5,0,0,0,0,0,14,14,942
506,Afghanistan,2015,2015Afghanistan,0,0,0,0,0,13,13,0,0,0,0,0,24,24,37
507,Afghanistan,2015,2015Afghanistan,0,0,0,0,0,461,461,0,0,0,0,0,1059,1059,1520
508,Afghanistan,2015,2015Afghanistan,0,0,0,0,0,858,858,0,0,0,0,0,1092,1092,1950
509,Afghanistan,2015,2015Afghanistan,0,0,0,0,0,960,960,0,0,0,0,0,3437,3437,4397
510,Afghanistan,2015,2015Afghanistan,0,0,0,0,0,978,978,0,0,0,0,0,1956,1956,2934
511,Afghanistan,2015,2015Afghanistan,0,0,0,5,0,0,5,0,5,0,6,0,0,11,16
512,Afghanistan,2015,2015Afghanistan,0,0,0,5,0,0,5,6,0,0,6,0,0,12,17
513,Afghanistan,2015,2015Afghanistan,0,0,0,7,0,0,7,0,0,0,0,0,0,0,7
514,Afghanistan,2015,2015Afghanistan,0,0,0,9,0,0,9,0,0,0,0,0,0,0,9
515,Afghanistan,2015,2015Afghanistan,0,0,0,9,0,0,9,0,0,0,9,0,0,9,18
516,Afghanistan,2015,2015Afghanistan,0,0,5,7,0,0,12,0,0,0,165,5,0,170,182
517,Afghanistan,2015,2015Afghanistan,0,0,11,29,5,0,45,0,9,7,31,7,0,54,112
518,Afghanistan,2015,2015Afghanistan,0,5,0,0,0,0,5,0,0,0,0,0,0,0,5
519,Afghanistan,2015,2015Afghanistan,0,5,0,7,0,0,12,0,0,0,8,0,0,8,20
520,Afghanistan,2015,2015Afghanistan,0,5,0,16,0,0,21,0,5,0,50,0,0,55,76
521,Afghanistan,2015,2015Afghanistan,0,7,5,0,0,0,12,0,6,0,14,0,0,20,32
522,Afghanistan,2015,2015Afghanistan,0,7,6,23,5,0,41,5,5,15,34,6,0,65,106
523,Afghanistan,2015,2015Afghanistan,0,15,6,22,0,0,43,5,11,10,55,0,0,81,124
524,Afghanistan,2015,2015Afghanistan,0,17,0,0,0,0,17,0,0,10,33,0,0,43,199
525,Afghanistan,2015,2015Afghanistan,5,0,0,0,0,0,5,0,0,5,12,0,0,17,22
526,Afghanistan,2015,2015Afghanistan,6,5,5,10,0,0,26,0,5,10,100,0,0,115,141
527,Afghanistan,2015,2015Afghanistan,6,7,0,19,0,0,32,5,8,5,19,0,0,37,69
528,Afghanistan,2015,2015Afghanistan,6,9,12,36,5,0,68,9,14,9,73,0,0,105,173
529,Afghanistan,2015,2015Afghanistan,9,25,41,76,6,0,157,19,23,26,178,0,0,246,403
530,Afghanistan,2015,2015Afghanistan,14,17,26,61,0,0,118,16,16,9,99,0,0,140,258
531,Afghanistan,2015,2015Afghanistan,21,36,39,165,8,0,269,27,49,30,257,12,0,375,644
532,Afghanistan,2015,2015Afghanistan,22,33,28,112,6,0,201,32,33,24,301,11,0,401,602
533,Afghanistan,2015,2015Afghanistan,42,58,21,185,6,0,312,49,51,161,2299,18,0,2578,2890
534,Afghanistan,2015,2015Afghanistan,55,93,89,348,17,0,602,48,98,79,349,37,0,611,1213
535,Afghanistan,2015,2015Afghanistan,92,330,287,1003,10,0,1722,108,353,414,1204,45,0,2124,3846
536,Afghanistan,2015,2015Afghanistan,113,218,131,553,36,599,1650,134,248,276,1800,41,492,2991,4686
537,Afghanistan,2015,2015Afghanistan,117,594,540,3766,474,0,5491,142,623,612,2934,394,0,4705,10196
538,Afghanistan,2015,2015Afghanistan,524,1309,1142,7081,2002,0,12058,585,1540,1508,12892,1443,0,17968,30026
539,Afghanistan,2015,2015Afghanistan,1807,2463,2692,6149,586,0,13697,1921,2473,2874,6135,862,0,14265,951142
540,Afghanistan,2015,2015Afghanistan,53930,178779,140572,340967,18741,0,732989,58377,189436,153477,388708,37605,0,827603,1560592
541,Afghanistan,2016,2016Afghanistan,0,0,0,0,0,0,0,0,0,0,0,0,0,0,107560
542,Afghanistan,2016,2016Afghanistan,0,0,0,0,0,0,0,0,0,0,5,0,0,5,5
543,Afghanistan,2016,2016Afghanistan,0,0,0,0,0,0,0,0,0,0,6,0,0,6,3449
544,Afghanistan,2016,2016Afghanistan,0,0,0,0,0,0,0,0,0,0,8,0,0,8,16
545,Afghanistan,2016,2016Afghanistan,0,0,0,0,0,0,0,0,0,5,0,0,0,5,5
546,Afghanistan,2016,2016Afghanistan,0,0,0,0,0,0,0,0,5,0,0,0,0,5,5
547,Afghanistan,2016,2016Afghanistan,0,0,0,0,0,0,0,0,6,0,0,0,0,6,6
548,Afghanistan,2016,2016Afghanistan,0,0,0,0,0,0,0,0,8,0,0,0,0,8,8
549,Afghanistan,2016,2016Afghanistan,0,0,0,0,0,15,15,0,0,0,0,0,28,28,43
550,Afghanistan,2016,2016Afghanistan,0,0,0,0,0,466,466,0,0,0,0,0,1031,1031,1497
551,Afghanistan,2016,2016Afghanistan,0,0,0,0,0,990,990,0,0,0,0,0,2211,2211,3201
552,Afghanistan,2016,2016Afghanistan,0,0,0,0,0,1226,1226,0,0,0,0,0,6459,6459,7685
553,Afghanistan,2016,2016Afghanistan,0,0,0,5,0,0,5,0,0,0,0,0,0,0,10
554,Afghanistan,2016,2016Afghanistan,0,0,0,5,0,0,5,0,5,0,9,0,0,14,19
555,Afghanistan,2016,2016Afghanistan,0,0,0,7,0,0,7,0,0,0,0,0,0,0,7
556,Afghanistan,2016,2016Afghanistan,0,0,0,8,0,0,8,0,0,0,6,0,0,6,14
557,Afghanistan,2016,2016Afghanistan,0,0,0,9,0,0,9,0,0,0,10,0,0,10,19
558,Afghanistan,2016,2016Afghanistan,0,0,0,9,0,0,9,0,0,0,17,0,0,17,26
559,Afghanistan,2016,2016Afghanistan,0,0,5,0,0,0,5,0,0,0,0,0,0,0,5
560,Afghanistan,2016,2016Afghanistan,0,0,5,10,0,0,15,0,0,6,196,5,0,207,222
561,Afghanistan,2016,2016Afghanistan,0,5,0,0,0,0,5,0,0,0,0,0,0,0,5
562,Afghanistan,2016,2016Afghanistan,0,5,0,0,0,0,5,0,0,0,5,0,0,5,10
563,Afghanistan,2016,2016Afghanistan,0,5,0,7,0,0,12,0,5,0,5,0,0,10,22
564,Afghanistan,2016,2016Afghanistan,0,5,0,7,0,0,12,0,5,0,28,0,0,33,45
565,Afghanistan,2016,2016Afghanistan,0,5,6,12,0,0,23,0,0,10,96,0,0,106,129
566,Afghanistan,2016,2016Afghanistan,0,5,6,16,0,0,27,0,7,19,22,0,0,48,75
567,Afghanistan,2016,2016Afghanistan,0,5,14,48,11,0,78,5,9,5,125,5,0,149,227
568,Afghanistan,2016,2016Afghanistan,0,6,0,0,0,0,6,0,0,0,5,0,0,5,11
569,Afghanistan,2016,2016Afghanistan,0,6,0,0,0,0,6,0,0,0,6,0,0,6,12
570,Afghanistan,2016,2016Afghanistan,0,6,0,0,0,0,6,0,5,7,18,0,0,30,36
571,Afghanistan,2016,2016Afghanistan,0,6,0,21,0,0,27,0,6,0,65,0,0,71,98
572,Afghanistan,2016,2016Afghanistan,0,7,0,6,0,0,13,5,0,5,16,0,0,26,39
573,Afghanistan,2016,2016Afghanistan,0,7,5,0,0,0,12,0,6,0,15,0,0,21,33
574,Afghanistan,2016,2016Afghanistan,0,8,0,0,0,0,8,0,0,0,0,0,0,0,8
575,Afghanistan,2016,2016Afghanistan,5,0,6,17,0,0,28,5,9,0,17,0,0,31,59
576,Afghanistan,2016,2016Afghanistan,5,6,0,9,0,0,20,5,0,7,22,0,0,34,54
577,Afghanistan,2016,2016Afghanistan,10,17,16,89,0,0,132,13,17,16,64,0,0,110,242
578,Afghanistan,2016,2016Afghanistan,16,49,15,161,7,0,248,20,50,24,248,10,0,352,3177
579,Afghanistan,2016,2016Afghanistan,19,30,40,181,7,0,277,28,47,36,198,13,0,322,599
580,Afghanistan,2016,2016Afghanistan,21,24,35,106,6,0,192,25,34,26,270,15,0,370,562
581,Afghanistan,2016,2016Afghanistan,34,11,8,54,0,0,107,46,5,13,81,0,0,145,252
582,Afghanistan,2016,2016Afghanistan,54,82,79,349,20,0,584,54,93,81,332,42,0,602,1186
583,Afghanistan,2016,2016Afghanistan,59,108,55,329,16,0,567,78,109,130,3480,15,0,3812,4379
584,Afghanistan,2016,2016Afghanistan,109,304,268,941,20,0,1642,102,301,360,981,37,0,1781,3423
585,Afghanistan,2016,2016Afghanistan,133,241,170,622,44,539,1749,140,283,726,2056,43,678,3926,5675
586,Afghanistan,2016,2016Afghanistan,148,459,470,2632,311,0,4020,166,507,510,2210,280,0,3673,7693
587,Afghanistan,2016,2016Afghanistan,1511,2786,2046,10435,2205,0,18983,1640,3248,2872,17898,1651,0,27309,46292
588,Afghanistan,2016,2016Afghanistan,1807,2463,2692,6149,586,0,13697,1921,2473,2874,6135,862,0,14265,951142
589,Afghanistan,2016,2016Afghanistan,75289,136768,109143,282595,24361,0,628156,80328,145907,118291,338108,41370,0,724004,1352160
590,Afghanistan,2017,2017Afghanistan,0,0,0,0,0,0,0,0,0,0,0,0,0,0,125486
591,Afghanistan,2017,2017Afghanistan,0,0,0,0,0,0,0,0,0,0,0,0,2516,2516,2516
592,Afghanistan,2017,2017Afghanistan,0,0,0,0,0,0,0,0,0,0,5,0,0,5,25
593,Afghanistan,2017,2017Afghanistan,0,0,0,0,0,0,0,0,0,0,8,0,0,8,16
594,Afghanistan,2017,2017Afghanistan,0,0,0,0,0,0,0,0,0,0,13,0,0,13,13
595,Afghanistan,2017,2017Afghanistan,0,0,0,0,0,0,0,0,0,5,0,0,0,5,5
596,Afghanistan,2017,2017Afghanistan,0,0,0,0,0,0,0,0,5,0,0,0,0,5,5
597,Afghanistan,2017,2017Afghanistan,0,0,0,0,0,0,0,0,8,0,0,0,0,8,8
598,Afghanistan,2017,2017Afghanistan,0,0,0,0,0,438,438,0,0,0,0,0,972,972,1410
599,Afghanistan,2017,2017Afghanistan,0,0,0,0,0,1577,1577,0,0,0,0,0,11848,11848,13425
600,Afghanistan,2017,2017Afghanistan,0,0,0,5,0,0,5,0,5,0,8,0,0,13,18
601,Afghanistan,2017,2017Afghanistan,0,0,0,6,0,0,6,0,0,0,8,0,0,8,14
602,Afghanistan,2017,2017Afghanistan,0,0,0,7,0,0,7,0,0,0,0,0,0,0,2189
603,Afghanistan,2017,2017Afghanistan,0,0,0,7,0,0,7,0,0,0,13,0,0,13,20
604,Afghanistan,2017,2017Afghanistan,0,0,0,9,0,0,9,0,13,0,0,0,0,13,22
605,Afghanistan,2017,2017Afghanistan,0,0,0,12,0,0,12,0,0,6,207,5,0,218,230
606,Afghanistan,2017,2017Afghanistan,0,0,5,0,0,0,5,0,0,0,0,0,0,0,5
607,Afghanistan,2017,2017Afghanistan,0,5,0,0,0,0,5,0,0,0,0,0,0,0,10
608,Afghanistan,2017,2017Afghanistan,0,5,0,0,0,0,5,0,0,0,6,0,0,6,11
609,Afghanistan,2017,2017Afghanistan,0,5,0,7,0,0,12,0,5,0,28,0,0,33,45
610,Afghanistan,2017,2017Afghanistan,0,5,0,36,5,0,46,0,0,8,35,5,0,48,94
611,Afghanistan,2017,2017Afghanistan,0,6,0,0,0,0,6,0,5,10,20,0,0,35,41
612,Afghanistan,2017,2017Afghanistan,0,7,5,0,0,0,12,0,5,5,15,0,0,25,37
613,Afghanistan,2017,2017Afghanistan,0,9,0,7,0,0,16,5,0,5,19,0,0,29,45
614,Afghanistan,2017,2017Afghanistan,5,0,6,16,0,0,27,5,7,0,18,0,0,30,57
615,Afghanistan,2017,2017Afghanistan,5,5,5,15,0,0,30,5,5,15,97,0,0,122,152
616,Afghanistan,2017,2017Afghanistan,5,7,5,15,0,0,32,5,5,9,37,0,0,56,88
617,Afghanistan,2017,2017Afghanistan,7,7,5,27,0,0,46,6,12,6,63,0,0,87,133
618,Afghanistan,2017,2017Afghanistan,8,0,0,0,0,0,8,0,0,0,0,0,0,0,8
619,Afghanistan,2017,2017Afghanistan,9,0,0,0,0,0,9,0,0,0,8,0,0,8,17
620,Afghanistan,2017,2017Afghanistan,14,13,11,64,0,0,102,15,17,14,88,0,0,134,236
621,Afghanistan,2017,2017Afghanistan,18,34,35,168,11,0,266,22,47,45,170,11,0,295,561
622,Afghanistan,2017,2017Afghanistan,19,32,17,106,5,0,179,18,39,21,127,5,0,210,389
623,Afghanistan,2017,2017Afghanistan,26,24,29,121,8,0,208,26,40,27,271,15,0,379,587
624,Afghanistan,2017,2017Afghanistan,60,80,82,356,21,0,599,57,94,85,338,48,0,622,1221
625,Afghanistan,2017,2017Afghanistan,106,152,106,501,25,0,890,140,167,217,4032,31,0,4587,5477
626,Afghanistan,2017,2017Afghanistan,194,301,236,860,58,898,2547,206,353,880,3414,66,685,5604,8151
627,Afghanistan,2017,2017Afghanistan,200,500,490,2562,260,0,4012,242,536,546,2160,262,0,3746,7758
628,Afghanistan,2017,2017Afghanistan,226,469,464,1522,64,0,2745,227,544,548,1472,67,0,2858,5603
629,Afghanistan,2017,2017Afghanistan,1787,2476,2714,6150,605,0,13732,1902,2494,2830,6143,879,0,14248,951142
630,Afghanistan,2017,2017Afghanistan,5025,7452,5172,23051,3034,0,43734,5340,8418,8939,35477,2477,0,60651,104385
631,Afghanistan,2017,2017Afghanistan,94088,139099,103744,285690,23853,0,646474,99127,148633,111824,345812,40740,0,746136,1392610
632,Afghanistan,2018,2018Afghanistan,0,0,0,0,0,0,0,0,0,0,0,0,0,0,141920
633,Afghanistan,2018,2018Afghanistan,0,0,0,0,0,0,0,0,0,0,5,0,0,5,20
634,Afghanistan,2018,2018Afghanistan,0,0,0,0,0,0,0,0,0,0,8,0,0,8,8
635,Afghanistan,2018,2018Afghanistan,0,0,0,0,0,0,0,0,0,0,9,0,0,9,9
636,Afghanistan,2018,2018Afghanistan,0,0,0,0,0,0,0,0,0,0,14,0,0,14,14
637,Afghanistan,2018,2018Afghanistan,0,0,0,0,0,0,0,0,0,5,0,0,0,5,10
638,Afghanistan,2018,2018Afghanistan,0,0,0,0,0,0,0,0,0,8,0,0,0,8,8
639,Afghanistan,2018,2018Afghanistan,0,0,0,0,0,1895,1895,0,0,0,0,0,16639,16639,18534
640,Afghanistan,2018,2018Afghanistan,0,0,0,5,0,0,5,0,5,0,0,7,0,12,17
641,Afghanistan,2018,2018Afghanistan,0,0,0,5,0,0,5,0,5,0,8,0,0,13,18
642,Afghanistan,2018,2018Afghanistan,0,0,0,6,0,0,6,0,0,0,7,0,0,7,13
643,Afghanistan,2018,2018Afghanistan,0,0,0,7,0,0,7,0,0,0,7,0,0,7,14
644,Afghanistan,2018,2018Afghanistan,0,0,0,13,0,0,13,0,0,7,269,0,0,276,289
645,Afghanistan,2018,2018Afghanistan,0,0,5,0,0,0,5,0,0,0,0,0,0,0,5
646,Afghanistan,2018,2018Afghanistan,0,0,6,16,0,0,22,0,0,6,25,0,0,31,53
647,Afghanistan,2018,2018Afghanistan,0,0,9,16,0,0,25,5,5,15,105,0,0,130,155
648,Afghanistan,2018,2018Afghanistan,0,0,12,0,0,0,12,0,5,5,16,0,0,26,38
649,Afghanistan,2018,2018Afghanistan,0,5,0,0,0,0,5,0,0,0,0,0,0,0,5
650,Afghanistan,2018,2018Afghanistan,0,5,0,0,0,0,5,0,0,0,5,0,0,5,10
651,Afghanistan,2018,2018Afghanistan,0,5,0,6,0,0,11,0,0,0,9,0,0,9,20
652,Afghanistan,2018,2018Afghanistan,0,5,0,7,0,0,12,0,0,5,25,0,0,30,42
653,Afghanistan,2018,2018Afghanistan,0,5,6,15,0,0,26,0,6,6,17,0,0,29,55
654,Afghanistan,2018,2018Afghanistan,0,6,0,0,0,0,6,0,0,0,6,0,0,6,12
655,Afghanistan,2018,2018Afghanistan,0,6,0,0,0,0,6,0,5,10,20,0,0,35,48
656,Afghanistan,2018,2018Afghanistan,0,7,0,19,0,0,26,0,0,8,15,5,0,28,141
657,Afghanistan,2018,2018Afghanistan,8,7,12,31,0,0,58,7,21,0,60,0,0,88,146
658,Afghanistan,2018,2018Afghanistan,11,10,8,24,0,0,53,7,5,17,54,0,0,83,136
659,Afghanistan,2018,2018Afghanistan,12,11,11,60,5,0,99,16,15,17,76,0,0,124,223
660,Afghanistan,2018,2018Afghanistan,18,29,39,164,11,0,261,16,47,35,165,14,0,277,538
661,Afghanistan,2018,2018Afghanistan,26,31,29,140,5,0,231,29,47,29,285,15,0,405,636
662,Afghanistan,2018,2018Afghanistan,40,52,24,187,6,0,309,28,60,53,191,6,0,338,647
663,Afghanistan,2018,2018Afghanistan,57,67,88,363,25,0,600,60,83,89,344,53,0,629,1229
664,Afghanistan,2018,2018Afghanistan,120,270,250,1120,89,0,1849,131,280,247,1017,79,0,1754,3603
665,Afghanistan,2018,2018Afghanistan,173,218,132,666,31,0,1220,217,230,210,4181,40,0,4878,6098
666,Afghanistan,2018,2018Afghanistan,185,457,471,2202,220,0,3535,207,523,503,1975,241,0,3449,6984
667,Afghanistan,2018,2018Afghanistan,287,509,520,1871,53,0,3240,300,573,623,1784,86,0,3366,6606
668,Afghanistan,2018,2018Afghanistan,321,463,348,1352,83,972,3539,357,528,772,5742,87,1257,8743,12282
669,Afghanistan,2018,2018Afghanistan,1811,2504,2750,6195,626,0,13886,1920,2524,2865,6794,897,0,15000,951142
670,Afghanistan,2018,2018Afghanistan,5834,9268,6266,27840,3342,0,52550,6168,10450,9287,44747,2816,0,73468,126018
671,Afghanistan,2018,2018Afghanistan,79321,145957,102855,298172,24715,0,651020,83570,156092,109075,361376,42388,0,752501,1403521
672,Afghanistan,2019,2019Afghanistan,0,0,0,0,0,0,0,0,0,0,0,0,0,0,1107343
673,Afghanistan,2019,2019Afghanistan,0,0,0,0,0,0,0,0,0,0,5,0,0,5,20
674,Afghanistan,2019,2019Afghanistan,0,0,0,0,0,0,0,0,0,0,8,0,0,8,8
675,Afghanistan,2019,2019Afghanistan,0,0,0,0,0,0,0,0,0,0,9,0,0,9,9
676,Afghanistan,2019,2019Afghanistan,0,0,0,0,0,0,0,0,0,0,10,0,0,10,10
677,Afghanistan,2019,2019Afghanistan,0,0,0,0,0,0,0,0,0,0,14,0,0,14,14
678,Afghanistan,2019,2019Afghanistan,0,0,0,0,0,0,0,0,0,0,25,0,0,25,25
679,Afghanistan,2019,2019Afghanistan,0,0,0,0,0,0,0,0,0,0,43,0,0,43,43
680,Afghanistan,2019,2019Afghanistan,0,0,0,0,0,0,0,0,5,0,0,0,0,5,5
681,Afghanistan,2019,2019Afghanistan,0,0,0,0,0,150,150,0,0,0,0,0,150,150,3783
682,Afghanistan,2019,2019Afghanistan,0,0,0,0,0,250,250,0,0,0,0,0,570,570,820
683,Afghanistan,2019,2019Afghanistan,0,0,0,0,0,2263,2263,0,0,0,0,0,22030,22030,24293
684,Afghanistan,2019,2019Afghanistan,0,0,0,5,0,0,5,0,0,0,7,0,0,7,12
685,Afghanistan,2019,2019Afghanistan,0,0,0,5,0,0,5,0,5,0,0,8,0,13,18
686,Afghanistan,2019,2019Afghanistan,0,0,0,6,0,0,6,0,0,0,5,0,0,5,11
687,Afghanistan,2019,2019Afghanistan,0,0,0,6,0,0,6,0,0,0,7,0,0,7,13
688,Afghanistan,2019,2019Afghanistan,0,0,0,6,0,0,6,0,8,0,10,0,0,18,24
689,Afghanistan,2019,2019Afghanistan,0,0,0,7,0,0,7,0,0,0,7,0,0,7,14
690,Afghanistan,2019,2019Afghanistan,0,0,5,0,0,0,5,0,0,0,0,0,0,0,5
691,Afghanistan,2019,2019Afghanistan,0,0,5,0,0,0,5,0,0,5,0,0,0,5,10
692,Afghanistan,2019,2019Afghanistan,0,0,5,5,0,0,10,0,5,0,21,0,0,26,36
693,Afghanistan,2019,2019Afghanistan,0,0,6,13,0,0,19,0,6,6,335,0,0,347,366
694,Afghanistan,2019,2019Afghanistan,0,5,0,0,0,0,5,0,0,0,0,0,0,0,10
695,Afghanistan,2019,2019Afghanistan,0,5,0,0,0,0,5,0,0,0,5,0,0,5,10
696,Afghanistan,2019,2019Afghanistan,0,5,0,0,0,0,5,0,0,0,6,0,0,6,11
697,Afghanistan,2019,2019Afghanistan,0,5,5,15,0,0,25,0,5,5,16,0,0,26,51
698,Afghanistan,2019,2019Afghanistan,0,5,5,16,0,0,26,0,7,12,103,0,0,122,148
699,Afghanistan,2019,2019Afghanistan,0,5,6,13,0,0,24,0,8,0,21,0,0,29,53
700,Afghanistan,2019,2019Afghanistan,0,6,0,8,0,0,14,6,0,0,8,0,0,14,28
701,Afghanistan,2019,2019Afghanistan,0,8,0,5,0,0,13,0,0,0,8,0,0,8,21
702,Afghanistan,2019,2019Afghanistan,0,13,12,37,0,0,62,8,17,12,61,0,0,98,160
703,Afghanistan,2019,2019Afghanistan,8,11,8,27,0,0,54,5,5,10,60,0,0,80,134
704,Afghanistan,2019,2019Afghanistan,14,14,10,62,5,0,105,12,22,15,73,0,0,122,227
705,Afghanistan,2019,2019Afghanistan,15,30,34,144,10,0,233,14,33,37,164,10,0,258,491
706,Afghanistan,2019,2019Afghanistan,26,34,25,136,6,0,227,29,49,31,277,14,0,400,627
707,Afghanistan,2019,2019Afghanistan,44,70,75,327,21,0,537,64,67,82,312,48,0,573,1110
708,Afghanistan,2019,2019Afghanistan,67,107,90,347,22,0,633,58,126,135,386,14,0,719,1352
709,Afghanistan,2019,2019Afghanistan,163,190,147,646,31,0,1177,192,207,191,4061,38,0,4689,5866
710,Afghanistan,2019,2019Afghanistan,172,490,535,2380,230,0,3807,210,591,549,2056,257,0,3663,7470
711,Afghanistan,2019,2019Afghanistan,307,510,372,1539,101,0,2829,355,542,738,6279,105,0,8019,13455
712,Afghanistan,2019,2019Afghanistan,6147,10479,6994,31271,3610,0,58501,6479,11693,9297,51262,3134,0,81865,140366
713,Afghanistan,2019,2019Afghanistan,63659,149878,105232,314305,24977,0,658051,67573,159642,111175,379460,43183,0,761033,1419084
714,Afghanistan,2020,2020Afghanistan,0,0,0,0,0,0,0,0,0,0,0,0,0,0,964269
715,Afghanistan,2020,2020Afghanistan,0,0,0,0,0,0,0,0,0,0,5,0,0,5,20
716,Afghanistan,2020,2020Afghanistan,0,0,0,0,0,0,0,0,0,0,8,0,0,8,8
717,Afghanistan,2020,2020Afghanistan,0,0,0,0,0,0,0,0,0,0,9,0,0,9,18
718,Afghanistan,2020,2020Afghanistan,0,0,0,0,0,0,0,0,0,0,10,0,0,10,10
719,Afghanistan,2020,2020Afghanistan,0,0,0,0,0,0,0,0,0,0,35,0,0,35,35
720,Afghanistan,2020,2020Afghanistan,0,0,0,0,0,0,0,0,5,0,0,0,0,5,5
721,Afghanistan,2020,2020Afghanistan,0,0,0,0,0,0,0,0,5,0,5,0,0,10,10
722,Afghanistan,2020,2020Afghanistan,0,0,0,0,0,11,11,0,0,0,0,0,31,31,42
723,Afghanistan,2020,2020Afghanistan,0,0,0,0,0,116,116,0,0,0,0,0,201,201,317
724,Afghanistan,2020,2020Afghanistan,0,0,0,0,0,254,254,0,0,0,0,0,568,568,822
725,Afghanistan,2020,2020Afghanistan,0,0,0,0,0,500,500,0,0,0,0,0,1003,1003,1503
726,Afghanistan,2020,2020Afghanistan,0,0,0,0,0,1518,1518,0,0,0,0,0,3171,3171,4689
727,Afghanistan,2020,2020Afghanistan,0,0,0,5,0,0,5,0,0,0,7,0,0,7,12
728,Afghanistan,2020,2020Afghanistan,0,0,0,5,0,0,5,0,0,0,8,0,0,8,13
729,Afghanistan,2020,2020Afghanistan,0,0,0,5,0,0,5,0,0,0,24,0,0,24,29
730,Afghanistan,2020,2020Afghanistan,0,0,0,6,0,0,6,0,0,0,5,0,0,5,11
731,Afghanistan,2020,2020Afghanistan,0,0,0,6,0,0,6,0,0,0,7,0,0,7,13
732,Afghanistan,2020,2020Afghanistan,0,0,0,6,0,0,6,0,8,0,10,0,0,18,24
733,Afghanistan,2020,2020Afghanistan,0,0,0,7,0,0,7,0,0,0,7,0,0,7,14
734,Afghanistan,2020,2020Afghanistan,0,0,0,8,0,0,8,0,0,0,0,0,0,0,8
735,Afghanistan,2020,2020Afghanistan,0,0,0,8,0,0,8,0,0,5,15,0,0,20,28
736,Afghanistan,2020,2020Afghanistan,0,0,0,30,0,43,73,5,0,0,110,0,38,153,2261
737,Afghanistan,2020,2020Afghanistan,0,0,5,0,0,0,5,0,0,0,0,0,0,0,5
738,Afghanistan,2020,2020Afghanistan,0,0,5,0,0,0,5,0,0,6,0,0,0,6,11
739,Afghanistan,2020,2020Afghanistan,0,0,6,16,0,0,22,0,6,5,387,0,0,398,420
740,Afghanistan,2020,2020Afghanistan,0,5,0,0,0,0,5,0,0,0,5,0,0,5,10
741,Afghanistan,2020,2020Afghanistan,0,5,0,0,0,0,5,0,0,0,6,0,0,6,11
742,Afghanistan,2020,2020Afghanistan,0,5,0,8,0,0,13,5,0,8,8,0,0,21,34
743,Afghanistan,2020,2020Afghanistan,0,5,5,54,6,0,70,0,7,8,54,7,0,76,146
744,Afghanistan,2020,2020Afghanistan,0,5,6,13,0,0,24,0,8,0,22,0,0,30,54
745,Afghanistan,2020,2020Afghanistan,0,6,0,0,0,0,6,0,0,0,0,0,0,0,6
746,Afghanistan,2020,2020Afghanistan,0,6,0,5,0,0,11,0,0,0,9,0,0,9,20
747,Afghanistan,2020,2020Afghanistan,0,7,19,25,0,0,51,11,14,5,61,0,0,91,142
748,Afghanistan,2020,2020Afghanistan,0,9,0,16,0,0,25,0,5,5,17,0,0,27,52
749,Afghanistan,2020,2020Afghanistan,7,0,5,18,0,0,30,5,8,16,111,0,0,140,170
750,Afghanistan,2020,2020Afghanistan,12,11,11,33,0,0,67,9,8,12,64,0,0,93,160
751,Afghanistan,2020,2020Afghanistan,15,25,29,127,10,0,206,14,27,37,104,20,0,202,408
752,Afghanistan,2020,2020Afghanistan,17,11,11,63,0,0,102,11,23,13,65,5,0,117,219
753,Afghanistan,2020,2020Afghanistan,41,63,69,337,21,0,531,53,67,86,319,51,0,576,1107
754,Afghanistan,2020,2020Afghanistan,56,54,40,261,8,0,419,51,65,65,467,20,0,668,1087
755,Afghanistan,2020,2020Afghanistan,58,124,95,407,24,0,708,54,145,128,460,22,0,809,1517
756,Afghanistan,2020,2020Afghanistan,158,536,578,2665,273,0,4210,206,623,633,2324,279,0,4065,8275
757,Afghanistan,2020,2020Afghanistan,164,198,146,663,33,0,1204,176,221,187,4034,41,0,4659,5863
758,Afghanistan,2020,2020Afghanistan,336,549,391,1701,118,0,3095,364,579,852,6583,112,0,8490,14523
759,Afghanistan,2020,2020Afghanistan,5979,10969,7703,33195,3833,0,61679,6325,12021,9587,54962,3278,9,86182,147994
760,Afghanistan,2020,2020Afghanistan,49878,147686,110534,332525,26595,0,667218,53559,156817,117680,397836,45322,0,771214,1438432
761,Afghanistan,2021,2021Afghanistan,0,0,0,0,0,0,0,0,0,0,0,0,0,0,231518
762,Afghanistan,2021,2021Afghanistan,0,0,0,0,0,0,0,0,0,0,5,0,0,5,25
763,Afghanistan,2021,2021Afghanistan,0,0,0,0,0,0,0,0,0,0,8,0,0,8,8
764,Afghanistan,2021,2021Afghanistan,0,0,0,0,0,0,0,0,0,0,9,0,0,9,18
765,Afghanistan,2021,2021Afghanistan,0,0,0,0,0,0,0,0,0,0,30,0,0,30,30
766,Afghanistan,2021,2021Afghanistan,0,0,0,0,0,0,0,0,0,7,5,0,0,12,12
767,Afghanistan,2021,2021Afghanistan,0,0,0,0,0,0,0,0,0,8,0,0,0,8,8
768,Afghanistan,2021,2021Afghanistan,0,0,0,0,0,0,0,0,5,0,7,0,0,12,12
769,Afghanistan,2021,2021Afghanistan,0,0,0,0,0,0,0,6,0,0,5,0,0,11,11
770,Afghanistan,2021,2021Afghanistan,0,0,0,0,0,296,296,0,0,0,0,0,594,594,890
771,Afghanistan,2021,2021Afghanistan,0,0,0,5,0,0,5,0,0,0,5,0,0,5,10
772,Afghanistan,2021,2021Afghanistan,0,0,0,5,0,0,5,0,0,0,7,0,0,7,12
773,Afghanistan,2021,2021Afghanistan,0,0,0,5,0,0,5,0,0,0,12,0,0,12,17
774,Afghanistan,2021,2021Afghanistan,0,0,0,5,0,0,5,0,0,0,23,0,0,23,28
775,Afghanistan,2021,2021Afghanistan,0,0,0,5,0,0,5,5,0,0,6,8,0,19,24
776,Afghanistan,2021,2021Afghanistan,0,0,0,6,0,0,6,0,0,0,6,0,0,6,13032
777,Afghanistan,2021,2021Afghanistan,0,0,0,6,0,0,6,0,0,0,14,0,0,14,20
778,Afghanistan,2021,2021Afghanistan,0,0,0,8,0,0,8,0,0,0,0,0,0,0,8
779,Afghanistan,2021,2021Afghanistan,0,0,0,8,0,0,8,0,0,5,0,0,0,5,13
780,Afghanistan,2021,2021Afghanistan,0,0,0,14,0,71,85,0,0,0,0,0,65,65,150
781,Afghanistan,2021,2021Afghanistan,0,0,5,0,0,0,5,0,0,0,0,0,0,0,5
782,Afghanistan,2021,2021Afghanistan,0,0,5,0,0,0,5,0,0,0,6,0,0,6,11
783,Afghanistan,2021,2021Afghanistan,0,0,5,9,0,0,14,0,0,0,6,0,0,6,20
784,Afghanistan,2021,2021Afghanistan,0,5,0,0,0,0,5,0,0,0,0,0,0,0,5
785,Afghanistan,2021,2021Afghanistan,0,5,0,0,0,0,5,0,0,0,5,0,0,5,10
786,Afghanistan,2021,2021Afghanistan,0,5,0,0,0,0,5,0,0,0,7,0,0,7,12
787,Afghanistan,2021,2021Afghanistan,0,5,5,52,8,0,70,0,5,9,55,8,0,77,147
788,Afghanistan,2021,2021Afghanistan,0,5,6,13,0,17,41,0,8,0,22,0,22,52,93
789,Afghanistan,2021,2021Afghanistan,0,5,8,24,5,0,42,5,13,12,47,8,0,85,127
790,Afghanistan,2021,2021Afghanistan,0,7,0,10,0,0,17,0,0,17,9,0,0,26,43
791,Afghanistan,2021,2021Afghanistan,0,7,0,16,0,0,23,0,7,13,506,0,0,526,549
792,Afghanistan,2021,2021Afghanistan,0,9,0,16,0,0,25,0,5,5,17,0,0,27,52
793,Afghanistan,2021,2021Afghanistan,0,18,0,5,0,0,23,0,7,0,0,0,0,7,30
794,Afghanistan,2021,2021Afghanistan,5,5,5,26,0,0,41,10,11,5,46,0,0,72,113
795,Afghanistan,2021,2021Afghanistan,8,33,12,121,26,43,243,15,18,10,277,18,39,377,2263
796,Afghanistan,2021,2021Afghanistan,12,11,9,37,0,0,69,9,9,13,68,0,0,99,168
797,Afghanistan,2021,2021Afghanistan,13,13,12,56,5,0,99,16,20,11,62,5,0,114,213
798,Afghanistan,2021,2021Afghanistan,15,15,22,104,10,0,166,9,16,27,99,10,0,161,327
799,Afghanistan,2021,2021Afghanistan,17,12,13,70,0,0,112,11,13,29,167,0,0,220,332
800,Afghanistan,2021,2021Afghanistan,40,65,71,334,23,0,533,49,74,78,332,53,0,586,1119
801,Afghanistan,2021,2021Afghanistan,41,129,97,453,26,0,746,51,132,143,506,26,0,858,1604
802,Afghanistan,2021,2021Afghanistan,55,65,48,290,8,0,466,48,85,67,497,26,0,723,1189
803,Afghanistan,2021,2021Afghanistan,160,199,141,666,36,0,1202,174,224,182,4000,46,0,4626,5828
804,Afghanistan,2021,2021Afghanistan,190,580,708,3082,337,0,4897,218,720,770,2746,327,0,4781,9678
805,Afghanistan,2021,2021Afghanistan,279,566,425,1739,131,0,3140,287,640,1136,6139,122,0,8324,15060
806,Afghanistan,2021,2021Afghanistan,4816,12524,8493,35743,4068,0,65644,5240,13518,10409,60222,3535,21,92945,159409
807,Afghanistan,2021,2021Afghanistan,48430,60438,37927,205450,18273,0,370518,50707,63513,40463,228475,24378,0,407536,778054
808,Afghanistan,2021,2021Afghanistan,115419,154993,91232,284474,20654,10616,677388,122145,162676,97102,304532,29293,97426,813174,1490562
809,Albania,2001,2001Albania,0,0,0,0,0,0,0,0,0,0,0,0,0,0,6514
810,Albania,2001,2001Albania,0,0,0,0,0,55,55,0,0,0,0,0,60,60,115
811,Albania,2001,2001Albania,0,0,0,0,0,76,76,0,0,0,0,0,99,99,175
812,Albania,2001,2001Albania,0,0,0,0,0,305,305,0,0,0,0,0,494,494,799
813,Albania,2001,2001Albania,0,0,0,5,0,0,5,0,0,0,0,0,0,0,5
814,Albania,2001,2001Albania,0,0,0,5,0,0,5,0,0,0,9,0,0,9,14
815,Albania,2001,2001Albania,0,5,0,0,0,0,5,0,0,0,0,0,0,0,5
816,Albania,2002,2002Albania,0,0,0,0,0,0,0,0,0,0,0,0,0,0,9743
817,Albania,2002,2002Albania,0,0,0,0,0,0,0,0,0,5,5,0,0,10,10
818,Albania,2002,2002Albania,0,0,0,0,0,30,30,0,0,0,0,0,29,29,131
819,Albania,2002,2002Albania,0,0,0,0,0,349,349,0,0,0,0,0,520,520,869
820,Albania,2002,2002Albania,0,0,0,5,0,0,5,0,0,0,0,0,0,0,5
821,Albania,2003,2003Albania,0,0,0,0,0,0,0,0,0,0,0,0,0,0,9413
822,Albania,2003,2003Albania,0,0,0,0,0,0,0,0,0,0,5,0,0,5,5
823,Albania,2003,2003Albania,0,0,0,0,0,26,26,0,0,0,0,0,26,26,124
824,Albania,2003,2003Albania,0,0,0,0,0,380,380,0,0,0,0,0,455,455,835
825,Albania,2003,2003Albania,0,0,0,5,0,0,5,0,0,0,0,0,0,0,5
826,Albania,2004,2004Albania,0,0,0,0,0,0,0,0,0,0,0,0,0,0,10342
827,Albania,2004,2004Albania,0,0,0,5,0,0,5,0,0,0,0,0,0,0,5
828,Albania,2004,2004Albania,0,0,0,5,0,0,5,0,0,0,8,0,0,8,13
829,Albania,2004,2004Albania,0,5,6,10,5,25,51,5,7,6,16,0,29,63,114
830,Albania,2005,2005Albania,0,0,0,0,0,0,0,0,0,0,0,0,0,0,11459
831,Albania,2005,2005Albania,0,0,0,0,0,532,532,0,0,0,0,0,591,591,1123
832,Albania,2005,2005Albania,0,0,0,5,0,0,5,0,0,0,0,0,0,0,5
833,Albania,2005,2005Albania,0,0,0,9,0,0,9,0,0,0,8,0,0,8,17
834,Albania,2005,2005Albania,0,6,6,10,5,23,50,5,6,6,18,0,29,64,114
835,Albania,2006,2006Albania,0,0,0,0,0,0,0,0,0,0,0,0,0,0,12564
836,Albania,2006,2006Albania,0,0,0,0,0,40,40,0,0,0,0,0,52,52,92
837,Albania,2006,2006Albania,0,0,0,0,0,64,64,0,0,0,0,0,101,101,165
838,Albania,2006,2006Albania,0,0,0,0,0,586,586,0,0,0,0,0,653,653,1239
839,Albania,2006,2006Albania,0,0,0,5,0,0,5,0,0,0,0,0,0,0,5
840,Albania,2006,2006Albania,0,0,0,8,0,0,8,0,0,0,6,0,0,6,14
841,Albania,2007,2007Albania,0,0,0,0,0,0,0,0,0,0,0,0,0,0,13783
842,Albania,2007,2007Albania,0,0,0,0,0,0,0,0,0,0,5,0,0,5,5
843,Albania,2007,2007Albania,0,0,0,0,0,55,55,0,0,0,0,0,101,101,156
844,Albania,2007,2007Albania,0,0,0,0,0,623,623,0,0,0,0,0,675,675,1298
845,Albania,2007,2007Albania,0,0,0,8,0,0,8,0,0,0,5,0,0,5,13
846,Albania,2007,2007Albania,0,0,6,0,0,0,6,0,0,0,0,0,0,0,6
847,Albania,2007,2007Albania,0,0,6,10,0,19,35,0,7,6,8,0,18,39,74
848,Albania,2008,2008Albania,0,0,0,0,0,0,0,0,0,0,0,0,0,0,13368
849,Albania,2008,2008Albania,0,0,0,0,0,0,0,0,0,0,5,0,0,5,5
850,Albania,2008,2008Albania,0,0,0,0,0,67,67,0,0,0,0,0,114,114,181
851,Albania,2008,2008Albania,0,0,0,0,0,658,658,0,0,0,0,0,716,716,1374
852,Albania,2008,2008Albania,0,0,6,0,0,0,6,0,0,0,0,0,0,0,6
853,Albania,2008,2008Albania,0,0,6,6,5,19,36,0,6,5,8,0,18,37,73
854,Albania,2009,2009Albania,0,0,0,0,0,0,0,0,0,0,0,0,0,0,13108
855,Albania,2009,2009Albania,0,0,0,0,0,0,0,0,0,0,5,0,0,5,5
856,Albania,2009,2009Albania,0,0,0,0,0,71,71,0,0,0,0,0,124,124,195
857,Albania,2009,2009Albania,0,0,6,0,0,0,6,0,0,0,0,0,0,0,6
858,Albania,2009,2009Albania,0,0,6,10,0,19,35,0,5,6,7,0,18,36,71
859,Albania,2009,2009Albania,0,0,7,0,0,0,7,0,0,0,0,0,0,0,12
860,Albania,2009,2009Albania,5,35,100,699,60,0,899,16,49,81,1211,54,0,1411,2310
861,Albania,2010,2010Albania,0,0,0,0,0,0,0,0,0,0,0,0,0,0,10651
862,Albania,2010,2010Albania,0,0,0,0,0,0,0,0,0,0,5,0,0,5,5
863,Albania,2010,2010Albania,0,0,0,0,0,80,80,0,0,0,0,0,136,136,216
864,Albania,2010,2010Albania,0,0,0,0,0,740,740,0,0,0,0,0,816,816,1556
865,Albania,2010,2010Albania,0,0,0,6,0,0,6,0,0,0,0,0,0,0,6
866,Albania,2010,2010Albania,0,0,0,9,0,19,28,0,0,8,7,0,19,34,62
867,Albania,2010,2010Albania,6,40,84,701,62,0,893,10,43,80,1185,64,0,1382,2275
868,Albania,2011,2011Albania,0,0,0,0,0,0,0,0,0,0,0,0,0,0,7458
869,Albania,2011,2011Albania,0,0,0,0,0,0,0,0,0,0,5,0,0,5,5
870,Albania,2011,2011Albania,0,0,0,0,0,77,77,0,0,0,0,0,151,151,228
871,Albania,2011,2011Albania,0,0,0,0,0,780,780,0,0,0,0,0,886,886,1666
872,Albania,2011,2011Albania,0,0,0,6,0,0,6,0,0,0,0,0,0,0,6
873,Albania,2011,2011Albania,0,0,0,8,0,13,21,0,0,6,7,0,15,28,49
874,Albania,2011,2011Albania,0,0,0,9,0,0,9,0,0,0,0,0,0,0,28
875,Albania,2011,2011Albania,0,0,5,0,0,0,5,0,0,0,0,0,0,0,5
876,Albania,2011,2011Albania,0,9,5,68,5,0,87,0,5,15,92,5,0,117,1900
877,Albania,2011,2011Albania,5,34,71,684,70,0,864,5,36,79,1153,70,0,1343,2207
878,Albania,2012,2012Albania,0,0,0,0,0,0,0,0,0,0,0,0,0,0,6419
879,Albania,2012,2012Albania,0,0,0,0,0,6,6,0,0,0,0,0,11,11,17
880,Albania,2012,2012Albania,0,0,0,0,0,121,121,0,0,0,0,0,197,197,318
881,Albania,2012,2012Albania,0,0,0,0,0,846,846,0,0,0,0,0,916,916,1762
882,Albania,2012,2012Albania,0,0,0,5,0,0,5,0,0,0,5,0,0,5,28
883,Albania,2012,2012Albania,0,0,0,6,0,0,6,0,0,0,0,0,0,0,6
884,Albania,2012,2012Albania,0,0,0,10,0,13,23,0,0,6,7,0,13,26,49
885,Albania,2012,2012Albania,0,0,5,0,0,0,5,0,0,0,0,0,0,0,5
886,Albania,2012,2012Albania,0,0,5,20,0,0,25,0,0,5,33,0,0,38,1764
887,Albania,2012,2012Albania,6,32,56,697,81,0,872,5,35,71,1142,76,0,1329,2201
888,Albania,2013,2013Albania,0,0,0,0,0,0,0,0,0,0,0,0,0,0,5631
889,Albania,2013,2013Albania,0,0,0,0,0,0,0,0,0,0,5,0,0,5,5
890,Albania,2013,2013Albania,0,0,0,0,0,135,135,0,0,0,0,0,220,220,398
891,Albania,2013,2013Albania,0,0,0,0,0,923,923,0,0,0,0,0,1002,1002,1925
892,Albania,2013,2013Albania,0,0,0,6,0,0,6,0,0,0,0,0,0,0,6
893,Albania,2013,2013Albania,0,0,0,9,0,12,21,0,0,0,7,0,14,21,42
894,Albania,2013,2013Albania,0,0,0,12,5,0,17,0,0,0,8,0,0,8,25
895,Albania,2013,2013Albania,0,0,7,17,0,0,24,0,0,7,39,0,0,46,70
896,Albania,2013,2013Albania,0,5,8,40,0,0,53,0,0,7,61,0,0,68,1706
897,Albania,2013,2013Albania,5,9,11,96,11,0,132,6,11,19,115,13,0,164,296
898,Albania,2014,2014Albania,0,0,0,0,0,0,0,0,0,0,0,0,0,0,5603
899,Albania,2014,2014Albania,0,0,0,0,0,0,0,0,0,0,5,0,0,5,5
900,Albania,2014,2014Albania,0,0,0,0,0,25,25,0,0,0,0,0,33,33,58
901,Albania,2014,2014Albania,0,0,0,0,0,1235,1235,0,0,0,0,0,1287,1287,2522
902,Albania,2014,2014Albania,0,0,0,10,0,12,22,5,0,0,7,0,13,25,47
903,Albania,2014,2014Albania,0,0,0,12,5,0,17,0,0,0,8,0,0,8,25
904,Albania,2014,2014Albania,6,0,0,55,0,0,61,5,0,6,73,0,0,84,1530
905,Albania,2014,2014Albania,8,18,16,127,12,0,181,9,15,21,127,13,0,185,366
906,Albania,2015,2015Albania,0,0,0,0,0,0,0,0,0,0,0,0,0,0,6297
907,Albania,2015,2015Albania,0,0,0,0,0,35,35,0,0,0,0,0,40,40,75
908,Albania,2015,2015Albania,0,0,0,0,0,209,209,0,0,0,0,0,275,275,484
909,Albania,2015,2015Albania,0,0,0,0,0,1446,1446,0,0,0,0,0,1465,1465,2911
910,Albania,2015,2015Albania,0,0,0,6,0,0,6,0,0,0,0,0,0,0,6
911,Albania,2015,2015Albania,0,0,0,7,5,0,12,0,0,0,8,0,0,8,20
912,Albania,2015,2015Albania,0,0,7,17,0,0,24,0,0,8,43,0,0,51,75
913,Albania,2015,2015Albania,0,6,0,14,0,14,34,5,0,5,8,0,12,30,64
914,Albania,2015,2015Albania,13,22,17,165,14,0,231,13,23,23,165,17,0,241,472
915,Albania,2016,2016Albania,0,0,0,0,0,0,0,0,0,0,0,0,0,0,5155
916,Albania,2016,2016Albania,0,0,0,0,0,38,38,0,0,0,0,0,44,44,82
917,Albania,2016,2016Albania,0,0,0,0,0,245,245,0,0,0,0,0,289,289,534
918,Albania,2016,2016Albania,0,0,0,0,0,1799,1799,0,0,0,0,0,1769,1769,3568
919,Albania,2016,2016Albania,0,0,0,5,5,0,10,0,0,0,8,0,0,8,18
920,Albania,2016,2016Albania,0,0,5,17,0,0,22,0,0,5,33,0,0,38,863
921,Albania,2016,2016Albania,0,0,5,21,0,0,26,0,0,6,42,0,0,48,74
922,Albania,2016,2016Albania,0,0,6,15,0,12,33,5,0,6,9,0,14,34,67
923,Albania,2016,2016Albania,27,38,36,241,16,0,358,22,42,43,212,22,0,341,699
924,Albania,2017,2017Albania,0,0,0,0,0,0,0,0,0,0,0,0,0,0,6648
925,Albania,2017,2017Albania,0,0,0,0,0,2231,2231,0,0,0,0,0,2118,2118,4349
926,Albania,2017,2017Albania,0,0,0,5,5,0,10,0,0,0,8,0,0,8,18
927,Albania,2017,2017Albania,0,0,0,6,0,0,6,0,0,0,0,0,0,0,6
928,Albania,2017,2017Albania,0,0,5,21,0,0,26,0,0,6,46,0,0,52,78
929,Albania,2017,2017Albania,0,8,0,20,0,16,44,6,0,6,14,0,16,42,86
930,Albania,2017,2017Albania,37,59,54,348,21,0,519,33,62,71,271,27,0,464,983
931,Albania,2018,2018Albania,0,0,0,0,0,0,0,0,0,0,0,0,0,0,6111
932,Albania,2018,2018Albania,0,0,0,0,0,2645,2645,0,0,0,0,0,2474,2474,5119
933,Albania,2018,2018Albania,0,0,0,5,5,0,10,0,0,0,8,0,0,8,18
934,Albania,2018,2018Albania,0,7,0,51,0,0,58,0,13,7,63,0,0,83,911
935,Albania,2018,2018Albania,0,8,0,26,0,0,34,0,5,6,46,0,0,57,91
936,Albania,2018,2018Albania,5,6,0,20,0,18,49,0,6,6,16,0,15,43,92
937,Albania,2018,2018Albania,37,68,80,418,27,0,630,42,77,78,313,30,0,540,1170
938,Albania,2019,2019Albania,0,0,0,0,0,0,0,0,0,0,0,0,0,0,7651
939,Albania,2019,2019Albania,0,0,0,0,0,3061,3061,0,0,0,0,0,2768,2768,5829
940,Albania,2019,2019Albania,0,0,0,5,5,0,10,0,0,0,8,0,0,8,18
941,Albania,2019,2019Albania,0,8,6,27,0,0,41,5,5,5,19,0,0,34,106
942,Albania,2019,2019Albania,6,7,0,47,0,0,60,8,6,6,60,5,0,85,145
943,Albania,2019,2019Albania,32,82,88,467,28,0,697,45,85,84,334,33,0,581,1278
944,Albania,2020,2020Albania,0,0,0,0,0,0,0,0,0,0,0,0,0,0,12483
945,Albania,2020,2020Albania,0,0,0,0,0,0,0,0,0,0,0,0,5,5,5
946,Albania,2020,2020Albania,0,0,0,0,0,8,8,7,0,0,21,0,22,50,729
947,Albania,2020,2020Albania,0,0,0,0,0,17,17,0,0,0,0,0,21,21,38
948,Albania,2020,2020Albania,0,0,0,0,0,342,342,0,0,0,0,0,327,327,669
949,Albania,2020,2020Albania,0,0,0,5,5,0,10,0,0,0,8,0,0,8,18
950,Albania,2020,2020Albania,0,0,0,6,0,0,6,0,0,0,0,0,0,0,6
951,Albania,2020,2020Albania,0,9,6,30,0,0,45,5,9,5,21,0,0,40,113
952,Albania,2020,2020Albania,11,8,5,53,5,0,82,11,8,5,79,5,0,108,190
953,Albania,2020,2020Albania,29,77,89,474,28,0,697,39,87,88,326,35,0,575,1272
954,Albania,2021,2021Albania,0,0,0,0,0,0,0,0,0,0,0,0,0,0,17472
955,Albania,2021,2021Albania,0,0,0,5,5,0,10,0,0,0,8,0,0,8,18
956,Albania,2021,2021Albania,0,0,0,6,0,0,6,0,0,0,0,0,0,0,6
957,Albania,2021,2021Albania,0,0,0,8,0,0,8,0,0,0,0,0,0,0,8
958,Albania,2021,2021Albania,0,9,5,29,0,0,43,0,12,5,26,0,0,43,114
959,Albania,2021,2021Albania,5,5,5,26,0,8,49,10,0,5,82,0,22,119,749
960,Albania,2021,2021Albania,11,9,8,50,5,0,83,6,13,7,92,5,0,123,206
961,Albania,2021,2021Albania,16,86,92,465,29,0,688,24,107,81,340,34,0,586,1274
962,Algeria,2001,2001Algeria,0,0,0,0,0,0,0,0,0,0,0,0,0,0,7369
963,Algeria,2001,2001Algeria,0,0,0,0,0,0,0,0,0,0,5,0,0,5,10
964,Algeria,2001,2001Algeria,0,0,0,0,0,0,0,0,0,0,7,0,0,7,7
965,Algeria,2001,2001Algeria,0,0,0,0,0,0,0,0,0,0,9,0,0,9,9
966,Algeria,2001,2001Algeria,0,0,0,0,0,0,0,0,0,5,7,0,0,12,12
967,Algeria,2001,2001Algeria,0,0,0,0,0,0,0,0,5,0,0,0,0,5,5
968,Algeria,2001,2001Algeria,0,0,0,0,0,63,63,0,0,0,0,0,103,103,166
969,Algeria,2001,2001Algeria,0,0,0,0,0,83,83,0,0,0,0,0,134,134,217
970,Algeria,2001,2001Algeria,0,0,0,0,0,158,158,0,0,0,0,0,319,319,477
971,Algeria,2001,2001Algeria,0,0,0,5,0,0,5,0,0,0,33,0,0,33,38
972,Algeria,2001,2001Algeria,0,0,5,13,0,0,18,0,6,0,14,0,0,20,38
973,Algeria,2001,2001Algeria,9,0,9,5,0,0,23,10,0,5,13,0,0,28,51
974,Algeria,2002,2002Algeria,0,0,0,0,0,0,0,0,0,0,0,0,0,0,11127
975,Algeria,2002,2002Algeria,0,0,0,0,0,0,0,0,0,0,5,0,0,5,10
976,Algeria,2002,2002Algeria,0,0,0,0,0,0,0,0,0,0,7,0,0,7,7
977,Algeria,2002,2002Algeria,0,0,0,0,0,0,0,0,0,0,9,0,0,9,9
978,Algeria,2002,2002Algeria,0,0,0,0,0,0,0,0,5,0,0,0,0,5,5
979,Algeria,2002,2002Algeria,0,0,0,0,0,43,43,0,0,0,0,0,74,74,226
980,Algeria,2002,2002Algeria,0,0,0,0,0,198,198,0,0,0,0,0,406,406,604
981,Algeria,2002,2002Algeria,0,0,0,5,0,0,5,5,0,0,7,0,0,12,17
982,Algeria,2002,2002Algeria,0,0,0,7,0,0,7,5,0,0,24,0,0,29,36
983,Algeria,2002,2002Algeria,0,5,0,15,0,0,20,9,0,0,18,0,0,27,47
984,Algeria,2003,2003Algeria,0,0,0,0,0,0,0,0,0,0,0,0,0,0,10535
985,Algeria,2003,2003Algeria,0,0,0,0,0,0,0,0,0,0,7,0,0,7,7
986,Algeria,2003,2003Algeria,0,0,0,0,0,0,0,0,0,0,9,0,0,9,18
987,Algeria,2003,2003Algeria,0,0,0,0,0,0,0,0,5,0,0,0,0,5,5
988,Algeria,2003,2003Algeria,0,0,0,0,0,56,56,0,0,0,0,0,89,89,254
989,Algeria,2003,2003Algeria,0,0,0,0,0,243,243,0,0,0,0,0,483,483,726
990,Algeria,2003,2003Algeria,0,0,0,7,0,0,7,5,0,0,15,0,0,20,27
991,Algeria,2003,2003Algeria,0,0,9,0,0,0,9,9,7,0,5,0,0,21,30
992,Algeria,2003,2003Algeria,0,5,0,13,0,0,18,6,0,0,15,0,0,21,39
993,Algeria,2003,2003Algeria,5,0,0,0,0,0,5,0,0,0,0,0,0,0,10
994,Algeria,2004,2004Algeria,0,0,0,0,0,0,0,0,0,0,0,0,0,0,10208
995,Algeria,2004,2004Algeria,0,0,0,0,0,0,0,0,0,0,5,0,0,5,5
996,Algeria,2004,2004Algeria,0,0,0,0,0,0,0,0,0,0,7,0,0,7,14
997,Algeria,2004,2004Algeria,0,0,0,0,0,0,0,0,0,0,9,0,0,9,9
998,Algeria,2004,2004Algeria,0,0,0,0,0,0,0,0,5,0,0,0,0,5,5
999,Algeria,2004,2004Algeria,0,0,0,5,0,0,5,5,0,0,11,0,0,16,21
1000,Algeria,2004,2004Algeria,0,0,5,5,0,0,10,0,0,0,47,0,0,47,57
1001,Algeria,2004,2004Algeria,0,5,0,11,0,0,16,6,0,0,15,0,0,21,37
1002,Algeria,2004,2004Algeria,5,0,0,0,0,0,5,0,0,0,0,0,0,0,10
1003,Algeria,2004,2004Algeria,8,13,12,34,0,57,124,10,10,8,40,0,92,160,284
1004,Algeria,2005,2005Algeria,0,0,0,0,0,0,0,0,0,0,0,0,0,0,10490
1005,Algeria,2005,2005Algeria,0,0,0,0,0,0,0,0,0,0,5,0,0,5,5
1006,Algeria,2005,2005Algeria,0,0,0,0,0,0,0,0,0,0,7,0,0,7,21
1007,Algeria,2005,2005Algeria,0,0,0,0,0,0,0,0,0,0,9,0,0,9,9
1008,Algeria,2005,2005Algeria,0,0,0,0,0,0,0,0,0,0,11,0,0,11,11
1009,Algeria,2005,2005Algeria,0,0,0,0,0,0,0,0,5,0,0,0,0,5,5
1010,Algeria,2005,2005Algeria,0,0,0,0,0,0,0,0,6,0,0,0,0,6,6
1011,Algeria,2005,2005Algeria,0,0,0,0,0,5,5,0,0,0,0,0,0,0,5
1012,Algeria,2005,2005Algeria,0,0,0,0,0,359,359,0,0,0,0,0,685,685,1044
1013,Algeria,2005,2005Algeria,0,0,5,10,0,0,15,0,0,5,17,0,0,22,37
1014,Algeria,2005,2005Algeria,0,0,8,0,0,0,8,0,9,8,5,0,0,22,30
1015,Algeria,2005,2005Algeria,0,5,0,0,0,0,5,0,0,0,0,0,0,0,5
1016,Algeria,2005,2005Algeria,0,7,6,0,0,0,13,0,0,0,46,0,0,46,59
1017,Algeria,2005,2005Algeria,8,15,13,34,0,64,134,6,11,10,36,0,100,163,297
1018,Algeria,2006,2006Algeria,0,0,0,0,0,0,0,0,0,0,0,0,0,0,6674
1019,Algeria,2006,2006Algeria,0,0,0,0,0,0,0,0,0,0,0,0,5,5,5
1020,Algeria,2006,2006Algeria,0,0,0,0,0,0,0,0,0,0,5,0,0,5,10
1021,Algeria,2006,2006Algeria,0,0,0,0,0,0,0,0,0,0,6,0,0,6,6
1022,Algeria,2006,2006Algeria,0,0,0,0,0,0,0,0,0,0,7,0,0,7,7
1023,Algeria,2006,2006Algeria,0,0,0,0,0,0,0,0,0,0,9,0,0,9,9
1024,Algeria,2006,2006Algeria,0,0,0,0,0,0,0,0,5,0,0,0,0,5,5
1025,Algeria,2006,2006Algeria,0,0,0,0,0,5,5,0,0,0,0,0,0,0,5
1026,Algeria,2006,2006Algeria,0,0,0,0,0,16,16,0,0,0,0,0,38,38,54
1027,Algeria,2006,2006Algeria,0,0,0,0,0,109,109,0,0,0,0,0,156,156,265
1028,Algeria,2006,2006Algeria,0,0,0,0,0,415,415,0,0,0,0,0,751,751,1166
1029,Algeria,2006,2006Algeria,0,0,0,12,0,0,12,0,0,0,46,0,0,46,58
1030,Algeria,2006,2006Algeria,0,0,5,0,0,0,5,0,0,0,0,0,0,0,5
1031,Algeria,2006,2006Algeria,0,0,5,8,0,0,13,0,5,0,15,0,0,20,33
1032,Algeria,2006,2006Algeria,0,0,6,0,0,0,6,0,0,0,0,0,0,0,6
1033,Algeria,2006,2006Algeria,0,0,7,0,9,0,16,0,0,8,0,0,0,8,30
1034,Algeria,2007,2007Algeria,0,0,0,0,0,0,0,0,0,0,0,0,0,0,8924
1035,Algeria,2007,2007Algeria,0,0,0,0,0,0,0,0,0,0,5,0,0,5,15
1036,Algeria,2007,2007Algeria,0,0,0,0,0,0,0,0,0,0,7,0,0,7,7
1037,Algeria,2007,2007Algeria,0,0,0,0,0,0,0,0,0,0,9,0,0,9,9
1038,Algeria,2007,2007Algeria,0,0,0,0,0,0,0,0,0,5,0,0,0,5,5
1039,Algeria,2007,2007Algeria,0,0,0,0,0,0,0,0,5,0,0,0,0,5,5
1040,Algeria,2007,2007Algeria,0,0,0,0,0,19,19,0,0,0,0,0,35,35,54
1041,Algeria,2007,2007Algeria,0,0,0,0,0,446,446,0,0,0,0,0,794,794,1240
1042,Algeria,2007,2007Algeria,0,0,0,5,0,0,5,0,0,0,0,0,0,0,5
1043,Algeria,2007,2007Algeria,0,0,0,12,0,0,12,0,0,0,46,0,0,46,58
1044,Algeria,2007,2007Algeria,0,0,5,7,0,0,12,0,5,0,12,0,0,17,29
1045,Algeria,2007,2007Algeria,0,6,0,0,0,0,6,0,0,0,0,0,0,0,6
1046,Algeria,2007,2007Algeria,5,13,0,29,0,52,99,5,8,8,31,0,91,143,242
1047,Algeria,2008,2008Algeria,0,0,0,0,0,0,0,0,0,0,0,0,0,0,7405
1048,Algeria,2008,2008Algeria,0,0,0,0,0,0,0,0,0,0,5,0,0,5,15
1049,Algeria,2008,2008Algeria,0,0,0,0,0,0,0,0,0,0,6,0,0,6,6
1050,Algeria,2008,2008Algeria,0,0,0,0,0,0,0,0,0,0,9,0,0,9,9
1051,Algeria,2008,2008Algeria,0,0,0,0,0,0,0,0,0,5,0,0,0,5,10
1052,Algeria,2008,2008Algeria,0,0,0,0,0,12,12,0,0,0,0,0,29,29,41
1053,Algeria,2008,2008Algeria,0,0,0,0,0,471,471,0,0,0,0,0,797,797,1268
1054,Algeria,2008,2008Algeria,0,0,0,5,0,0,5,0,0,0,0,0,0,0,5
1055,Algeria,2008,2008Algeria,0,0,5,7,0,0,12,0,5,0,12,0,0,17,29
1056,Algeria,2008,2008Algeria,0,0,8,0,0,0,8,0,0,0,0,0,0,0,8
1057,Algeria,2008,2008Algeria,0,0,11,0,9,0,20,0,0,11,0,0,0,11,31
1058,Algeria,2008,2008Algeria,5,9,0,23,0,54,91,5,6,7,30,0,78,126,217
1059,Algeria,2009,2009Algeria,0,0,0,0,0,0,0,0,0,0,0,0,0,0,5503
1060,Algeria,2009,2009Algeria,0,0,0,0,0,0,0,0,0,0,5,0,0,5,15
1061,Algeria,2009,2009Algeria,0,0,0,0,0,0,0,0,0,0,7,0,0,7,7
1062,Algeria,2009,2009Algeria,0,0,0,0,0,0,0,0,0,0,9,0,0,9,9
1063,Algeria,2009,2009Algeria,0,0,0,0,0,0,0,0,0,5,0,0,0,5,5
1064,Algeria,2009,2009Algeria,0,0,0,0,0,8,8,0,0,0,0,0,28,28,36
1065,Algeria,2009,2009Algeria,0,0,0,5,0,0,5,0,0,0,0,0,0,0,5
1066,Algeria,2009,2009Algeria,0,0,0,6,0,0,6,0,0,0,0,0,0,0,6
1067,Algeria,2009,2009Algeria,0,5,0,6,0,0,11,0,5,0,9,0,0,14,25
1068,Algeria,2009,2009Algeria,0,5,7,0,0,0,12,0,8,9,0,0,0,17,29
1069,Algeria,2009,2009Algeria,5,10,5,24,0,48,92,5,9,9,29,0,67,119,211
1070,Algeria,2009,2009Algeria,26,68,129,441,13,0,677,26,85,113,1399,17,0,1640,2317
1071,Algeria,2010,2010Algeria,0,0,0,0,0,0,0,0,0,0,0,0,0,0,2856
1072,Algeria,2010,2010Algeria,0,0,0,0,0,0,0,0,0,0,5,0,0,5,10
1073,Algeria,2010,2010Algeria,0,0,0,0,0,0,0,0,0,0,7,0,0,7,7
1074,Algeria,2010,2010Algeria,0,0,0,0,0,0,0,0,0,0,9,0,0,9,9
1075,Algeria,2010,2010Algeria,0,0,0,0,0,7,7,0,0,0,0,0,28,28,35
1076,Algeria,2010,2010Algeria,0,0,0,0,0,469,469,0,0,0,0,0,720,720,1189
1077,Algeria,2010,2010Algeria,0,0,0,5,0,0,5,0,0,0,0,0,0,0,10
1078,Algeria,2010,2010Algeria,0,0,0,6,0,0,6,0,0,0,0,0,0,0,6
1079,Algeria,2010,2010Algeria,0,0,0,8,0,0,8,0,5,0,8,0,0,13,21
1080,Algeria,2010,2010Algeria,0,5,6,5,0,0,16,0,8,6,5,0,0,19,35
1081,Algeria,2010,2010Algeria,0,11,8,25,0,42,86,5,9,11,34,0,59,118,204
1082,Algeria,2010,2010Algeria,17,69,121,458,13,0,678,20,82,102,1373,28,0,1605,2283
1083,Algeria,2011,2011Algeria,0,0,0,0,0,0,0,0,0,0,0,0,0,0,1759
1084,Algeria,2011,2011Algeria,0,0,0,0,0,0,0,0,0,0,5,0,0,5,5
1085,Algeria,2011,2011Algeria,0,0,0,0,0,0,0,0,0,0,7,0,0,7,7
1086,Algeria,2011,2011Algeria,0,0,0,0,0,0,0,0,0,0,9,0,0,9,9
1087,Algeria,2011,2011Algeria,0,0,0,0,0,0,0,0,0,7,0,0,0,7,7
1088,Algeria,2011,2011Algeria,0,0,0,0,0,6,6,0,0,0,0,0,24,24,37
1089,Algeria,2011,2011Algeria,0,0,0,0,0,490,490,0,0,0,0,0,735,735,1225
1090,Algeria,2011,2011Algeria,0,0,0,5,0,0,5,0,0,0,0,0,0,0,5
1091,Algeria,2011,2011Algeria,0,0,0,6,0,0,6,0,0,0,0,0,0,0,6
1092,Algeria,2011,2011Algeria,0,0,0,8,0,0,8,0,5,0,0,0,0,5,13
1093,Algeria,2011,2011Algeria,0,0,7,5,0,0,12,0,0,7,5,0,0,12,24
1094,Algeria,2011,2011Algeria,0,5,5,35,0,0,45,0,5,5,28,0,0,38,628
1095,Algeria,2011,2011Algeria,0,13,7,23,0,45,88,5,8,9,34,0,59,115,203
1096,Algeria,2011,2011Algeria,12,70,93,436,12,0,623,13,75,92,1327,35,0,1542,2165
1097,Algeria,2012,2012Algeria,0,0,0,0,0,0,0,0,0,0,0,0,0,0,1361
1098,Algeria,2012,2012Algeria,0,0,0,0,0,0,0,0,0,0,5,0,0,5,10
1099,Algeria,2012,2012Algeria,0,0,0,0,0,0,0,0,0,0,7,0,0,7,7
1100,Algeria,2012,2012Algeria,0,0,0,0,0,0,0,0,0,0,9,0,0,9,9
1101,Algeria,2012,2012Algeria,0,0,0,0,0,0,0,0,0,7,0,0,0,7,7
1102,Algeria,2012,2012Algeria,0,0,0,0,0,7,7,0,0,0,0,0,26,26,33
1103,Algeria,2012,2012Algeria,0,0,0,0,0,518,518,0,0,0,0,0,746,746,1264
1104,Algeria,2012,2012Algeria,0,0,0,6,0,0,6,0,0,0,0,0,0,0,6
1105,Algeria,2012,2012Algeria,0,0,0,7,0,0,7,0,0,5,8,0,0,13,20
1106,Algeria,2012,2012Algeria,0,0,0,9,0,0,9,0,0,0,8,0,0,8,17
1107,Algeria,2012,2012Algeria,0,7,0,0,0,0,7,0,0,5,5,0,0,10,17
1108,Algeria,2012,2012Algeria,0,8,0,21,0,0,29,0,0,8,20,0,0,28,513
1109,Algeria,2012,2012Algeria,5,9,5,21,0,44,84,0,6,13,39,0,53,111,195
1110,Algeria,2012,2012Algeria,15,65,85,474,10,0,649,17,69,94,1327,42,0,1549,2198
1111,Algeria,2013,2013Algeria,0,0,0,0,0,0,0,0,0,0,0,0,0,0,1032
1112,Algeria,2013,2013Algeria,0,0,0,0,0,0,0,0,0,0,5,0,0,5,10
1113,Algeria,2013,2013Algeria,0,0,0,0,0,0,0,0,0,0,7,0,0,7,7
1114,Algeria,2013,2013Algeria,0,0,0,0,0,0,0,0,0,0,9,0,0,9,9
1115,Algeria,2013,2013Algeria,0,0,0,0,0,0,0,0,0,8,0,0,0,8,8
1116,Algeria,2013,2013Algeria,0,0,0,0,0,6,6,0,0,0,0,0,16,16,28
1117,Algeria,2013,2013Algeria,0,0,0,0,0,555,555,0,0,0,0,0,778,778,1333
1118,Algeria,2013,2013Algeria,0,0,0,5,0,0,5,0,0,0,26,10,0,36,41
1119,Algeria,2013,2013Algeria,0,0,0,6,0,0,6,0,0,0,0,0,0,0,6
1120,Algeria,2013,2013Algeria,0,0,0,7,0,0,7,0,0,5,8,0,0,13,20
1121,Algeria,2013,2013Algeria,0,0,0,9,0,0,9,0,0,0,0,0,0,0,9
1122,Algeria,2013,2013Algeria,0,0,5,26,0,0,31,0,0,5,158,0,0,163,194
1123,Algeria,2013,2013Algeria,0,0,8,0,0,0,8,0,0,9,0,0,0,9,17
1124,Algeria,2013,2013Algeria,0,5,0,27,0,0,32,0,9,0,28,0,0,37,443
1125,Algeria,2013,2013Algeria,0,10,5,22,0,38,75,0,6,15,35,0,48,104,179
1126,Algeria,2013,2013Algeria,6,13,14,85,0,0,118,5,5,7,166,6,0,189,307
1127,Algeria,2014,2014Algeria,0,0,0,0,0,0,0,0,0,0,0,0,0,0,1208
1128,Algeria,2014,2014Algeria,0,0,0,0,0,0,0,0,0,0,5,0,0,5,10
1129,Algeria,2014,2014Algeria,0,0,0,0,0,0,0,0,0,0,7,0,0,7,7
1130,Algeria,2014,2014Algeria,0,0,0,0,0,0,0,0,0,0,9,0,0,9,9
1131,Algeria,2014,2014Algeria,0,0,0,0,0,0,0,0,0,7,0,0,0,7,7
1132,Algeria,2014,2014Algeria,0,0,0,0,0,5,5,0,0,0,0,0,0,0,5
1133,Algeria,2014,2014Algeria,0,0,0,0,0,571,571,0,0,0,0,0,782,782,1353
1134,Algeria,2014,2014Algeria,0,0,0,5,0,0,5,0,0,0,0,0,0,0,5
1135,Algeria,2014,2014Algeria,0,0,0,5,0,0,5,0,0,0,10,0,0,10,15
1136,Algeria,2014,2014Algeria,0,0,0,5,0,0,5,0,0,0,26,10,0,36,41
1137,Algeria,2014,2014Algeria,0,0,0,8,0,0,8,0,0,0,9,0,0,9,17
1138,Algeria,2014,2014Algeria,0,0,5,0,0,0,5,0,0,0,0,0,0,0,10
1139,Algeria,2014,2014Algeria,0,0,9,0,0,0,9,0,0,0,0,0,0,0,9
1140,Algeria,2014,2014Algeria,0,6,5,18,0,35,64,0,6,8,40,0,48,102,166
1141,Algeria,2014,2014Algeria,0,8,0,26,0,0,34,5,0,0,22,0,0,27,346
1142,Algeria,2014,2014Algeria,5,8,12,83,0,0,108,5,9,8,161,10,0,193,301
1143,Algeria,2015,2015Algeria,0,0,0,0,0,0,0,0,0,0,0,0,0,0,1291
1144,Algeria,2015,2015Algeria,0,0,0,0,0,0,0,0,0,0,5,0,0,5,10
1145,Algeria,2015,2015Algeria,0,0,0,0,0,0,0,0,0,0,7,0,0,7,7
1146,Algeria,2015,2015Algeria,0,0,0,0,0,0,0,0,0,0,9,0,0,9,9
1147,Algeria,2015,2015Algeria,0,0,0,0,0,0,0,0,0,0,25,9,0,34,34
1148,Algeria,2015,2015Algeria,0,0,0,0,0,19,19,0,0,0,0,0,28,28,47
1149,Algeria,2015,2015Algeria,0,0,0,0,0,593,593,0,0,0,0,0,791,791,1384
1150,Algeria,2015,2015Algeria,0,0,0,5,0,0,5,0,0,0,0,0,0,0,5
1151,Algeria,2015,2015Algeria,0,0,0,5,0,0,5,0,0,0,8,0,0,8,13
1152,Algeria,2015,2015Algeria,0,0,0,8,0,0,8,0,0,0,0,0,0,0,8
1153,Algeria,2015,2015Algeria,0,0,0,31,0,0,31,0,0,5,152,0,0,157,188
1154,Algeria,2015,2015Algeria,0,0,8,18,0,48,74,0,0,9,38,0,32,79,158
1155,Algeria,2015,2015Algeria,0,9,0,0,0,0,9,0,0,7,6,0,0,13,22
1156,Algeria,2015,2015Algeria,5,0,0,0,0,0,5,0,0,0,0,0,0,0,5
1157,Algeria,2015,2015Algeria,5,7,7,76,5,0,100,5,7,11,154,12,0,189,289
1158,Algeria,2016,2016Algeria,0,0,0,0,0,0,0,0,0,0,0,0,0,0,931
1159,Algeria,2016,2016Algeria,0,0,0,0,0,0,0,0,0,0,5,0,0,5,20
1160,Algeria,2016,2016Algeria,0,0,0,0,0,0,0,0,0,0,7,0,0,7,14
1161,Algeria,2016,2016Algeria,0,0,0,0,0,0,0,0,0,0,9,0,0,9,9
1162,Algeria,2016,2016Algeria,0,0,0,0,0,0,0,0,0,0,25,6,0,31,31
1163,Algeria,2016,2016Algeria,0,0,0,0,0,19,19,0,0,0,0,0,27,27,46
1164,Algeria,2016,2016Algeria,0,0,0,0,0,676,676,0,0,0,0,0,858,858,1534
1165,Algeria,2016,2016Algeria,0,0,0,5,0,0,5,0,0,0,0,0,0,0,5
1166,Algeria,2016,2016Algeria,0,0,0,6,0,0,6,0,0,0,0,0,0,0,6
1167,Algeria,2016,2016Algeria,0,0,0,7,0,0,7,0,0,0,9,0,0,9,360
1168,Algeria,2016,2016Algeria,0,0,0,29,0,0,29,0,0,0,152,0,5,157,186
1169,Algeria,2016,2016Algeria,0,0,6,18,0,28,52,0,5,11,38,0,43,97,149
1170,Algeria,2016,2016Algeria,0,0,7,0,0,0,7,0,0,5,5,0,0,10,17
1171,Algeria,2016,2016Algeria,11,15,11,113,7,0,157,15,15,12,182,16,0,240,397
1172,Algeria,2017,2017Algeria,0,0,0,0,0,0,0,0,0,0,0,0,0,0,1396
1173,Algeria,2017,2017Algeria,0,0,0,0,0,0,0,0,0,0,5,0,0,5,15
1174,Algeria,2017,2017Algeria,0,0,0,0,0,0,0,0,0,0,7,0,0,7,7
1175,Algeria,2017,2017Algeria,0,0,0,0,0,0,0,0,0,0,9,0,0,9,9
1176,Algeria,2017,2017Algeria,0,0,0,0,0,0,0,0,0,0,25,5,0,30,30
1177,Algeria,2017,2017Algeria,0,0,0,0,0,739,739,0,0,0,0,0,915,915,1654
1178,Algeria,2017,2017Algeria,0,0,0,5,0,0,5,0,0,0,0,0,0,0,15
1179,Algeria,2017,2017Algeria,0,0,0,8,0,0,8,0,0,0,9,0,0,9,17
1180,Algeria,2017,2017Algeria,0,0,0,30,0,0,30,0,5,0,149,0,0,154,189
1181,Algeria,2017,2017Algeria,0,0,5,0,0,0,5,0,0,0,0,0,0,0,5
1182,Algeria,2017,2017Algeria,0,0,7,20,0,43,70,5,5,8,40,0,32,90,160
1183,Algeria,2017,2017Algeria,26,24,16,169,8,0,243,24,31,16,187,23,0,281,524
1184,Algeria,2018,2018Algeria,0,0,0,0,0,0,0,0,0,0,0,0,0,0,1057
1185,Algeria,2018,2018Algeria,0,0,0,0,0,0,0,0,0,0,5,0,0,5,5
1186,Algeria,2018,2018Algeria,0,0,0,0,0,0,0,0,0,0,6,0,0,6,6
1187,Algeria,2018,2018Algeria,0,0,0,0,0,0,0,0,0,0,8,0,0,8,8
1188,Algeria,2018,2018Algeria,0,0,0,0,0,0,0,0,0,0,25,5,0,30,30
1189,Algeria,2018,2018Algeria,0,0,0,0,0,818,818,0,0,0,0,0,972,972,1790
1190,Algeria,2018,2018Algeria,0,0,0,5,0,0,5,0,0,0,0,0,0,0,20
1191,Algeria,2018,2018Algeria,0,0,0,5,0,0,5,0,0,0,38,0,0,38,43
1192,Algeria,2018,2018Algeria,0,0,0,6,0,0,6,0,0,0,0,0,0,0,6
1193,Algeria,2018,2018Algeria,0,0,5,21,0,0,26,0,9,0,13,0,0,22,443
1194,Algeria,2018,2018Algeria,0,0,6,19,0,36,61,5,5,7,39,5,40,101,162
1195,Algeria,2018,2018Algeria,0,0,9,0,0,0,9,0,0,5,8,0,0,13,22
1196,Algeria,2018,2018Algeria,32,27,18,190,11,0,278,26,43,16,200,26,0,311,589
1197,Algeria,2019,2019Algeria,0,0,0,0,0,0,0,0,0,0,0,0,0,0,1613
1198,Algeria,2019,2019Algeria,0,0,0,0,0,0,0,0,0,0,9,0,0,9,9
1199,Algeria,2019,2019Algeria,0,0,0,0,0,0,0,0,0,0,25,5,0,30,30
1200,Algeria,2019,2019Algeria,0,0,0,0,0,917,917,0,0,0,0,0,1080,1080,1997
1201,Algeria,2019,2019Algeria,0,0,0,6,0,0,6,0,5,0,43,0,0,48,54
1202,Algeria,2019,2019Algeria,0,0,0,9,0,0,9,0,0,0,0,0,0,0,9
1203,Algeria,2019,2019Algeria,0,0,0,9,0,0,9,0,0,5,8,0,0,13,22
1204,Algeria,2019,2019Algeria,0,5,0,0,0,0,5,0,0,0,0,0,0,0,5
1205,Algeria,2019,2019Algeria,5,5,0,21,0,0,31,5,5,5,43,5,0,63,162
1206,Algeria,2019,2019Algeria,28,42,21,198,11,0,300,28,48,21,187,29,0,313,613
1207,Algeria,2020,2020Algeria,0,0,0,0,0,0,0,0,0,0,0,0,0,0,2961
1208,Algeria,2020,2020Algeria,0,0,0,0,0,0,0,0,0,0,0,0,6,6,6
1209,Algeria,2020,2020Algeria,0,0,0,0,0,0,0,0,0,0,25,5,0,30,30
1210,Algeria,2020,2020Algeria,0,0,0,0,0,5,5,0,0,0,0,0,9,9,14
1211,Algeria,2020,2020Algeria,0,0,0,0,0,29,29,0,0,0,0,0,41,41,70
1212,Algeria,2020,2020Algeria,0,0,0,5,0,0,5,0,0,0,0,0,0,0,5
1213,Algeria,2020,2020Algeria,0,0,0,6,0,0,6,0,0,0,0,0,0,0,6
1214,Algeria,2020,2020Algeria,0,0,0,9,0,0,9,0,0,0,0,0,0,0,18
1215,Algeria,2020,2020Algeria,0,0,0,9,0,0,9,0,0,0,8,5,0,13,22
1216,Algeria,2020,2020Algeria,0,0,0,9,0,0,9,6,0,0,49,0,0,55,64
1217,Algeria,2020,2020Algeria,0,0,0,36,0,34,70,0,0,0,55,0,37,92,592
1218,Algeria,2020,2020Algeria,0,5,0,0,0,0,5,0,0,0,0,0,0,0,5
1219,Algeria,2020,2020Algeria,5,6,0,20,5,0,36,5,5,9,47,5,0,71,178
1220,Algeria,2020,2020Algeria,21,47,22,188,13,0,291,28,45,23,182,31,0,309,600
1221,Algeria,2021,2021Algeria,0,0,0,0,0,0,0,0,0,0,0,0,0,0,4167
1222,Algeria,2021,2021Algeria,0,0,0,0,0,0,0,0,0,0,5,0,0,5,5
1223,Algeria,2021,2021Algeria,0,0,0,0,0,0,0,0,0,0,10,0,0,10,10
1224,Algeria,2021,2021Algeria,0,0,0,0,0,0,0,0,0,0,25,5,0,30,30
1225,Algeria,2021,2021Algeria,0,0,0,5,0,0,5,0,0,0,0,0,0,0,5
1226,Algeria,2021,2021Algeria,0,0,0,5,0,0,5,0,0,0,5,0,0,5,10
1227,Algeria,2021,2021Algeria,0,0,0,6,0,0,6,0,0,0,0,0,0,0,6
1228,Algeria,2021,2021Algeria,0,0,0,9,0,0,9,0,0,0,8,5,0,13,22
1229,Algeria,2021,2021Algeria,0,0,0,9,0,0,9,6,0,0,53,0,0,59,68
1230,Algeria,2021,2021Algeria,0,5,0,0,0,0,5,0,0,0,0,0,0,0,5
1231,Algeria,2021,2021Algeria,0,9,0,18,5,0,32,0,7,10,46,5,0,68,173
1232,Algeria,2021,2021Algeria,19,16,14,127,0,34,210,12,28,16,199,0,37,292,872
1233,Algeria,2021,2021Algeria,21,47,21,197,16,0,302,24,49,26,195,34,0,328,630
1234,Angola,2001,2001Angola,0,0,0,0,0,0,0,0,0,0,0,0,0,0,7134
1235,Angola,2001,2001Angola,0,0,0,0,0,0,0,0,0,0,5,0,0,5,10
1236,Angola,2001,2001Angola,0,0,0,0,0,0,0,0,0,0,9,0,0,9,9
1237,Angola,2001,2001Angola,0,0,0,0,0,140,140,0,0,0,0,0,169,169,309
1238,Angola,2001,2001Angola,0,0,0,0,0,603,603,0,0,0,0,0,1073,1073,1676
1239,Angola,2001,2001Angola,0,0,0,0,0,972,972,0,0,0,0,0,910,910,1882
1240,Angola,2001,2001Angola,0,0,0,5,0,0,5,0,0,0,0,0,0,0,5
1241,Angola,2001,2001Angola,0,0,0,6,0,0,6,0,0,0,0,0,0,0,6
1242,Angola,2001,2001Angola,0,0,5,0,0,0,5,0,0,0,0,0,0,0,5
1243,Angola,2001,2001Angola,0,0,7,0,0,0,7,0,0,0,29,0,0,29,36
1244,Angola,2001,2001Angola,0,5,0,0,0,0,5,0,0,0,9,0,0,9,14
1245,Angola,2001,2001Angola,0,5,0,9,6,9911,9931,0,8,0,12,5,12591,12616,218154
1246,Angola,2001,2001Angola,0,12,10,71,0,0,93,18,15,13,87,0,0,133,226
1247,Angola,2001,2001Angola,5,0,0,0,0,0,5,0,0,0,0,0,0,0,5
1248,Angola,2001,2001Angola,6,8,7,24,0,0,45,0,5,8,41,0,0,54,99
1249,Angola,2001,2001Angola,8,0,6,9,0,0,23,0,7,7,11,0,0,25,48
1250,Angola,2001,2001Angola,43,58,54,154,11,0,320,42,65,56,228,30,0,421,741
1251,Angola,2001,2001Angola,83,130,111,588,0,0,912,140,231,198,1105,0,0,1674,4752
1252,Angola,2001,2001Angola,317,259,232,820,63,0,1691,331,366,315,685,96,0,1793,17745
1253,Angola,2001,2001Angola,2234,1968,1682,3932,249,0,10065,2222,2214,1897,4264,223,0,10820,30881
1254,Angola,2001,2001Angola,9517,8980,7702,21758,1788,0,49745,8648,9167,7863,16477,1473,0,43628,186879
1255,Angola,2002,2002Angola,0,0,0,0,0,0,0,0,0,0,0,0,0,0,12959
1256,Angola,2002,2002Angola,0,0,0,0,0,0,0,0,0,0,5,0,0,5,10
1257,Angola,2002,2002Angola,0,0,0,0,0,0,0,0,0,0,9,0,0,9,9
1258,Angola,2002,2002Angola,0,0,0,0,0,15,15,0,0,0,0,0,23,23,2040
1259,Angola,2002,2002Angola,0,0,0,0,0,652,652,0,0,0,0,0,1125,1125,1777
1260,Angola,2002,2002Angola,0,0,5,0,0,0,5,0,0,0,0,0,0,0,5
1261,Angola,2002,2002Angola,0,0,5,0,0,0,5,0,0,0,9,0,0,9,14
1262,Angola,2002,2002Angola,0,0,7,0,0,0,7,0,0,0,30,0,0,30,37
1263,Angola,2002,2002Angola,0,5,0,0,0,0,5,0,0,0,0,0,0,0,5
1264,Angola,2002,2002Angola,0,6,11,32,5,0,54,0,6,11,37,16,0,70,124
1265,Angola,2002,2002Angola,0,12,10,71,0,0,93,18,15,13,91,0,0,137,230
1266,Angola,2002,2002Angola,6,5,5,9,0,0,25,0,6,5,12,0,0,23,48
1267,Angola,2002,2002Angola,6,6,7,25,0,0,44,0,8,0,41,0,0,49,93
1268,Angola,2002,2002Angola,24,75,64,291,0,0,454,32,108,92,458,0,0,690,5291
1269,Angola,2002,2002Angola,57,58,54,152,10,0,331,49,65,56,224,29,0,423,754
1270,Angola,2002,2002Angola,275,1892,1623,4776,709,0,9275,482,1547,1325,4974,143,0,8471,17746
1271,Angola,2002,2002Angola,1361,1810,1551,2816,254,0,7792,1320,2010,1723,2587,204,0,7844,21636
1272,Angola,2002,2002Angola,2145,2885,2472,4475,195,30,12202,2284,2844,2438,5432,345,29,13372,188436
1273,Angola,2002,2002Angola,9487,9121,7818,17835,1476,0,45737,10479,8967,7685,16583,1278,0,44992,184201
1274,Angola,2003,2003Angola,0,0,0,0,0,0,0,0,0,0,0,0,0,0,14710
1275,Angola,2003,2003Angola,0,0,0,0,0,0,0,0,0,0,5,0,0,5,10
1276,Angola,2003,2003Angola,0,0,0,0,0,11,11,0,0,0,0,0,26,26,2102
1277,Angola,2003,2003Angola,0,0,0,0,0,700,700,0,0,0,0,0,1136,1136,1836
1278,Angola,2003,2003Angola,0,0,5,0,0,0,5,0,0,0,0,0,0,0,5
1279,Angola,2003,2003Angola,0,0,5,0,0,0,5,0,0,0,8,0,0,8,13
1280,Angola,2003,2003Angola,0,0,7,0,0,0,7,0,0,0,26,0,0,26,33
1281,Angola,2003,2003Angola,0,5,6,11,0,0,22,0,6,6,16,0,0,28,50
1282,Angola,2003,2003Angola,0,6,5,39,5,0,55,0,11,5,44,17,0,77,132
1283,Angola,2003,2003Angola,5,0,0,0,0,0,5,0,0,0,0,0,0,0,5
1284,Angola,2003,2003Angola,6,6,7,25,0,0,44,0,0,9,42,0,0,51,95
1285,Angola,2003,2003Angola,9,18,16,76,0,0,119,15,30,25,317,0,0,387,506
1286,Angola,2003,2003Angola,24,75,64,291,0,0,454,32,108,92,458,0,0,690,5773
1287,Angola,2003,2003Angola,151,231,198,502,33,0,1115,172,267,228,609,38,0,1314,3881
1288,Angola,2003,2003Angola,1158,1323,1134,2020,143,0,5778,1123,1496,1282,2032,103,0,6036,17814
1289,Angola,2003,2003Angola,4069,4898,4198,9259,1019,0,23443,3990,5000,4284,7685,812,0,21771,123714
1290,Angola,2003,2003Angola,7470,7465,6398,13609,1820,0,36762,6721,7047,6041,13287,2036,0,35132,158894
1291,Angola,2004,2004Angola,0,0,0,0,0,0,0,0,0,0,0,0,0,0,20679
1292,Angola,2004,2004Angola,0,0,0,0,0,0,0,0,0,0,5,0,0,5,10
1293,Angola,2004,2004Angola,0,0,0,0,0,0,0,0,0,0,6,0,0,6,6
1294,Angola,2004,2004Angola,0,0,0,5,0,0,5,0,0,0,8,0,0,8,13
1295,Angola,2004,2004Angola,0,0,0,5,0,0,5,0,0,0,25,0,0,25,30
1296,Angola,2004,2004Angola,0,0,5,0,0,0,5,0,0,0,0,0,0,0,5
1297,Angola,2004,2004Angola,0,0,5,0,0,0,5,0,0,0,8,0,0,8,13
1298,Angola,2004,2004Angola,0,0,9,10,0,0,19,0,7,0,7,0,0,14,33
1299,Angola,2004,2004Angola,0,6,5,39,5,0,55,0,11,5,44,17,0,77,132
1300,Angola,2004,2004Angola,5,0,0,0,0,0,5,0,0,0,0,0,0,0,5
1301,Angola,2004,2004Angola,6,6,6,28,0,0,46,0,0,8,41,0,0,49,95
1302,Angola,2004,2004Angola,9,11,10,26,0,0,56,35,34,30,57,0,0,156,212
1303,Angola,2004,2004Angola,71,94,80,342,5,0,592,87,102,87,1132,5,0,1413,2005
1304,Angola,2004,2004Angola,177,204,175,535,6,10,1107,212,173,149,456,5,27,1022,2129
1305,Angola,2004,2004Angola,214,310,266,723,54,0,1567,304,420,362,927,52,0,2065,3632
1306,Angola,2004,2004Angola,628,685,587,1138,83,0,3121,586,762,652,1449,48,0,3497,12618
1307,Angola,2004,2004Angola,1831,2494,2134,4615,377,0,11451,1814,2564,2203,3093,258,0,9932,98383
1308,Angola,2004,2004Angola,4235,4389,3761,7057,929,24990,45361,4638,3530,3028,7245,1031,24009,43481,88842
1309,Angola,2005,2005Angola,0,0,0,0,0,0,0,0,0,0,0,0,0,0,24794
1310,Angola,2005,2005Angola,0,0,0,0,0,0,0,0,0,0,5,0,0,5,5
1311,Angola,2005,2005Angola,0,0,0,0,0,0,0,0,0,0,6,0,0,6,6
1312,Angola,2005,2005Angola,0,0,0,0,0,0,0,0,0,0,7,0,0,7,7
1313,Angola,2005,2005Angola,0,0,0,0,0,0,0,0,0,0,8,0,0,8,8
1314,Angola,2005,2005Angola,0,0,0,0,0,963,963,0,0,0,0,0,1507,1507,2470
1315,Angola,2005,2005Angola,0,0,0,5,0,0,5,0,0,0,0,0,0,0,5
1316,Angola,2005,2005Angola,0,0,0,5,0,0,5,0,0,0,8,0,0,8,13
1317,Angola,2005,2005Angola,0,0,0,5,0,0,5,0,0,0,24,0,0,24,29
1318,Angola,2005,2005Angola,0,0,5,0,0,0,5,0,0,0,0,0,0,0,5
1319,Angola,2005,2005Angola,0,0,9,15,0,0,24,0,7,0,7,0,0,14,38
1320,Angola,2005,2005Angola,6,6,6,28,0,0,46,0,0,8,41,0,0,49,95
1321,Angola,2005,2005Angola,7,6,0,9,0,0,22,6,0,5,13,7,0,31,53
1322,Angola,2005,2005Angola,53,70,60,152,16,0,351,52,71,60,295,18,0,496,847
1323,Angola,2005,2005Angola,158,250,217,724,26,0,1375,200,299,259,827,15,0,1600,2975
1324,Angola,2005,2005Angola,175,219,188,570,7,10,1169,199,188,162,471,5,27,1052,2221
1325,Angola,2005,2005Angola,2289,3095,2652,4212,720,0,12968,2661,2458,2101,5488,792,0,13500,75468
1326,Angola,2005,2005Angola,5084,5647,4838,15019,1911,0,32499,5094,5843,5015,11830,1491,0,29273,106772
1327,Angola,2006,2006Angola,0,0,0,0,0,0,0,0,0,0,0,0,0,0,17302
1328,Angola,2006,2006Angola,0,0,0,0,0,0,0,0,0,0,5,0,0,5,20
1329,Angola,2006,2006Angola,0,0,0,0,0,0,0,0,0,0,6,0,0,6,6
1330,Angola,2006,2006Angola,0,0,0,0,0,0,0,0,0,0,8,0,0,8,8
1331,Angola,2006,2006Angola,0,0,0,0,0,6,6,0,0,0,0,0,24,24,30
1332,Angola,2006,2006Angola,0,0,0,0,0,50,50,0,0,0,0,0,76,76,126
1333,Angola,2006,2006Angola,0,0,0,0,0,431,431,0,0,0,0,0,1243,1243,1674
1334,Angola,2006,2006Angola,0,0,0,0,0,1023,1023,0,0,0,0,0,1571,1571,2594
1335,Angola,2006,2006Angola,0,0,0,0,0,1140,1140,0,0,0,0,0,1020,1020,2160
1336,Angola,2006,2006Angola,0,0,0,5,0,0,5,0,0,0,10,0,0,10,15
1337,Angola,2006,2006Angola,0,0,0,6,0,0,6,0,0,0,7,0,0,7,13
1338,Angola,2006,2006Angola,0,0,5,0,0,0,5,0,0,0,0,0,0,0,5
1339,Angola,2006,2006Angola,0,6,6,12,5,0,29,0,8,0,14,9,0,31,60
1340,Angola,2006,2006Angola,6,5,7,28,0,0,46,0,0,8,41,0,0,49,95
1341,Angola,2006,2006Angola,122,183,271,671,25,0,1272,150,232,265,727,20,0,1394,2666
1342,Angola,2006,2006Angola,500,530,530,808,36,0,2404,493,537,538,737,29,0,2334,4738
1343,Angola,2006,2006Angola,2124,1410,2052,4298,705,0,10589,1508,1068,1564,3377,569,0,8086,42675
1344,Angola,2006,2006Angola,7701,18822,0,30505,4484,0,61512,7530,19710,0,24429,4114,0,55783,132295
1345,Angola,2007,2007Angola,0,0,0,0,0,0,0,0,0,0,0,0,0,0,129594
1346,Angola,2007,2007Angola,0,0,0,0,0,0,0,0,0,0,5,0,0,5,15
1347,Angola,2007,2007Angola,0,0,0,0,0,0,0,0,0,0,6,0,0,6,6
1348,Angola,2007,2007Angola,0,0,0,0,0,0,0,0,0,0,8,0,0,8,8
1349,Angola,2007,2007Angola,0,0,0,0,0,6,6,0,0,0,0,0,24,24,30
1350,Angola,2007,2007Angola,0,0,0,0,0,51,51,0,0,0,0,0,82,82,133
1351,Angola,2007,2007Angola,0,0,0,0,0,1088,1088,0,0,0,0,0,1634,1634,2722
1352,Angola,2007,2007Angola,0,0,0,5,0,0,5,0,0,0,10,0,0,10,15
1353,Angola,2007,2007Angola,0,0,0,8,0,0,8,0,8,0,0,0,0,8,16
1354,Angola,2007,2007Angola,0,0,5,0,0,0,5,0,0,0,0,0,0,0,10
1355,Angola,2007,2007Angola,0,6,8,12,5,0,31,0,0,7,17,9,0,33,64
1356,Angola,2007,2007Angola,0,54,60,489,5,0,608,0,49,111,896,5,0,1061,1669
1357,Angola,2007,2007Angola,6,5,7,28,0,0,46,0,0,8,41,0,0,49,95
1358,Angola,2007,2007Angola,11,0,0,0,0,0,11,0,5,0,10,0,0,15,26
1359,Angola,2007,2007Angola,37,74,35,86,16,0,248,38,52,27,261,14,0,392,640
1360,Angola,2007,2007Angola,122,183,271,670,25,0,1271,150,232,265,727,20,0,1394,2665
1361,Angola,2007,2007Angola,140,227,126,530,6,11,1040,147,221,111,418,5,25,927,1967
1362,Angola,2007,2007Angola,442,621,484,1147,46,0,2740,429,629,506,1349,52,0,2965,5705
1363,Angola,2007,2007Angola,2116,1422,2057,4306,705,0,10606,1489,1084,1621,3375,582,0,8151,40757
1364,Angola,2008,2008Angola,0,0,0,0,0,0,0,0,0,0,0,0,0,0,128467
1365,Angola,2008,2008Angola,0,0,0,0,0,0,0,0,0,0,5,0,0,5,15
1366,Angola,2008,2008Angola,0,0,0,0,0,0,0,0,0,0,8,0,0,8,8
1367,Angola,2008,2008Angola,0,0,0,0,0,50,50,0,0,0,0,0,78,78,128
1368,Angola,2008,2008Angola,0,0,0,0,0,1113,1113,0,0,0,0,0,1701,1701,2814
1369,Angola,2008,2008Angola,0,0,0,5,0,0,5,0,0,0,0,0,0,0,5
1370,Angola,2008,2008Angola,0,0,0,5,0,0,5,0,0,0,6,0,0,6,11
1371,Angola,2008,2008Angola,0,0,0,6,0,0,6,0,0,0,24,0,0,24,30
1372,Angola,2008,2008Angola,0,0,0,8,0,0,8,0,0,9,0,0,0,9,17
1373,Angola,2008,2008Angola,0,0,5,0,0,0,5,0,0,0,0,0,0,0,5
1374,Angola,2008,2008Angola,0,54,60,488,5,0,607,0,49,111,894,5,0,1059,1666
1375,Angola,2008,2008Angola,5,5,0,0,0,0,10,0,0,0,5,0,0,5,15
1376,Angola,2008,2008Angola,5,5,5,12,5,0,32,0,0,7,21,9,0,37,69
1377,Angola,2008,2008Angola,6,5,7,28,0,0,46,0,0,8,41,0,0,49,95
1378,Angola,2008,2008Angola,32,50,30,82,15,0,209,24,60,29,137,10,0,260,487
1379,Angola,2008,2008Angola,42,204,292,692,37,0,1267,85,244,275,745,36,0,1385,2652
1380,Angola,2008,2008Angola,126,205,130,505,8,9,983,125,216,108,382,5,24,860,1843
1381,Angola,2008,2008Angola,452,632,485,1221,50,0,2840,452,617,518,1435,54,0,3076,5916
1382,Angola,2008,2008Angola,2000,1883,1594,3633,400,0,9510,1917,1847,1512,3584,531,0,9391,27131
1383,Angola,2009,2009Angola,0,0,0,0,0,0,0,0,0,0,0,0,0,0,16918
1384,Angola,2009,2009Angola,0,0,0,0,0,0,0,0,0,0,5,0,0,5,10
1385,Angola,2009,2009Angola,0,0,0,0,0,0,0,0,0,0,7,0,0,7,7
1386,Angola,2009,2009Angola,0,0,0,0,0,0,0,0,0,0,8,0,0,8,8
1387,Angola,2009,2009Angola,0,0,0,0,0,0,0,5,0,0,0,0,0,5,15
1388,Angola,2009,2009Angola,0,0,0,0,0,41,41,0,0,0,0,0,68,68,109
1389,Angola,2009,2009Angola,0,0,0,5,0,0,5,0,0,0,0,0,0,0,5
1390,Angola,2009,2009Angola,0,0,0,5,0,0,5,0,0,0,6,0,0,6,11
1391,Angola,2009,2009Angola,0,0,0,6,0,0,6,0,0,0,24,0,0,24,30
1392,Angola,2009,2009Angola,0,0,0,9,0,0,9,0,0,9,0,0,0,9,18
1393,Angola,2009,2009Angola,0,0,6,0,0,0,6,0,0,0,0,0,0,0,6
1394,Angola,2009,2009Angola,0,54,60,495,5,0,614,0,49,111,904,5,0,1069,1683
1395,Angola,2009,2009Angola,5,5,5,12,5,0,32,0,0,7,24,9,0,40,72
1396,Angola,2009,2009Angola,6,5,7,28,0,0,46,0,0,8,41,0,0,49,95
1397,Angola,2009,2009Angola,26,64,109,176,15,0,390,22,75,86,221,19,0,423,813
1398,Angola,2009,2009Angola,34,57,31,93,13,0,228,33,53,38,138,12,0,274,502
1399,Angola,2009,2009Angola,42,243,221,1057,15,0,1578,61,230,221,1333,10,0,1855,3433
1400,Angola,2009,2009Angola,104,171,120,456,11,9,871,103,204,98,344,0,24,773,1644
1401,Angola,2009,2009Angola,440,597,497,1248,50,0,2832,454,594,516,1471,57,0,3092,5924
1402,Angola,2009,2009Angola,1834,2002,1155,3248,349,0,8588,1725,1475,1555,3257,500,0,8512,25329
1403,Angola,2009,2009Angola,5470,6143,5844,24162,3825,0,45444,5241,6511,6307,19879,992,0,38930,84374
1404,Angola,2010,2010Angola,0,0,0,0,0,0,0,0,0,0,0,0,0,0,13396
1405,Angola,2010,2010Angola,0,0,0,0,0,0,0,0,0,0,5,0,0,5,10
1406,Angola,2010,2010Angola,0,0,0,0,0,0,0,0,0,0,7,0,0,7,7
1407,Angola,2010,2010Angola,0,0,0,0,0,0,0,0,5,0,0,0,0,5,5
1408,Angola,2010,2010Angola,0,0,0,0,0,0,0,5,0,0,0,0,0,5,5
1409,Angola,2010,2010Angola,0,0,0,0,0,6,6,0,0,0,0,0,25,25,31
1410,Angola,2010,2010Angola,0,0,0,0,0,46,46,0,0,0,0,0,71,71,117
1411,Angola,2010,2010Angola,0,0,0,0,0,1261,1261,0,0,0,0,0,1836,1836,3097
1412,Angola,2010,2010Angola,0,0,0,5,0,0,5,0,0,0,0,0,0,0,5
1413,Angola,2010,2010Angola,0,0,0,5,0,0,5,0,0,0,6,0,0,6,11
1414,Angola,2010,2010Angola,0,0,0,9,0,0,9,0,0,5,5,0,0,10,19
1415,Angola,2010,2010Angola,0,0,6,0,0,0,6,0,0,0,0,0,0,0,6
1416,Angola,2010,2010Angola,0,5,0,0,0,0,5,0,0,0,0,0,0,0,5
1417,Angola,2010,2010Angola,0,6,7,11,6,0,30,0,0,5,27,9,0,41,71
1418,Angola,2010,2010Angola,0,14,30,402,5,0,451,0,11,37,1173,14,0,1235,1686
1419,Angola,2010,2010Angola,5,0,0,0,0,0,5,0,0,0,0,0,0,0,5
1420,Angola,2010,2010Angola,38,65,40,223,23,0,389,54,88,59,215,23,0,439,828
1421,Angola,2010,2010Angola,39,214,215,1006,19,0,1493,60,198,232,1323,15,0,1828,3321
1422,Angola,2010,2010Angola,80,145,114,403,14,10,766,84,165,96,299,5,25,674,1440
1423,Angola,2010,2010Angola,465,585,496,1229,48,0,2823,473,590,509,1453,56,0,3081,5904
1424,Angola,2010,2010Angola,2123,2798,2002,4942,610,0,12475,2001,2845,1823,5245,876,0,12790,25265
1425,Angola,2010,2010Angola,4529,8492,5329,19672,3263,0,41285,4594,8582,5868,16527,2761,0,38332,79617
1426,Angola,2011,2011Angola,0,0,0,0,0,0,0,0,0,0,0,0,0,0,10861
1427,Angola,2011,2011Angola,0,0,0,0,0,0,0,0,0,0,5,0,0,5,41
1428,Angola,2011,2011Angola,0,0,0,0,0,0,0,0,0,0,7,0,0,7,7
1429,Angola,2011,2011Angola,0,0,0,0,0,0,0,0,5,0,0,0,0,5,5
1430,Angola,2011,2011Angola,0,0,0,0,0,0,0,5,0,0,0,0,0,5,5
1431,Angola,2011,2011Angola,0,0,0,0,0,42,42,0,0,0,0,0,73,73,120
1432,Angola,2011,2011Angola,0,0,0,0,0,1296,1296,0,0,0,0,0,1866,1866,3162
1433,Angola,2011,2011Angola,0,0,0,5,0,0,5,0,0,0,0,0,0,0,10
1434,Angola,2011,2011Angola,0,0,0,6,0,0,6,0,6,0,0,0,0,6,12
1435,Angola,2011,2011Angola,0,0,0,8,0,0,8,0,0,0,8,0,0,8,893
1436,Angola,2011,2011Angola,0,0,6,0,0,0,6,0,0,0,0,0,0,0,6
1437,Angola,2011,2011Angola,0,5,0,0,0,0,5,0,0,0,0,0,0,0,5
1438,Angola,2011,2011Angola,0,7,7,12,7,0,33,0,0,7,21,9,0,37,70
1439,Angola,2011,2011Angola,0,9,32,402,5,0,448,0,6,38,1180,14,0,1238,1686
1440,Angola,2011,2011Angola,7,0,0,0,0,0,7,0,0,0,0,0,0,0,7
1441,Angola,2011,2011Angola,27,190,216,949,19,0,1401,51,204,226,1220,16,0,1717,3118
1442,Angola,2011,2011Angola,28,48,30,84,18,0,208,30,55,38,156,10,0,289,497
1443,Angola,2011,2011Angola,40,72,55,249,21,0,437,39,102,71,245,24,0,481,918
1444,Angola,2011,2011Angola,76,123,98,367,14,10,688,71,130,83,265,5,26,580,1268
1445,Angola,2011,2011Angola,300,458,366,966,41,0,2131,323,462,399,947,60,0,2191,4322
1446,Angola,2011,2011Angola,1796,2728,1925,4560,564,0,11573,1714,2750,1756,4874,833,0,11927,23500
1447,Angola,2011,2011Angola,4381,8323,5225,19352,3221,0,40502,4460,8405,5791,16254,2732,0,37642,78144
1448,Angola,2012,2012Angola,0,0,0,0,0,0,0,0,0,0,0,0,0,0,8721
1449,Angola,2012,2012Angola,0,0,0,0,0,0,0,0,0,0,5,0,0,5,5
1450,Angola,2012,2012Angola,0,0,0,0,0,0,0,0,0,0,7,0,0,7,7
1451,Angola,2012,2012Angola,0,0,0,0,0,0,0,0,0,5,0,0,0,5,5
1452,Angola,2012,2012Angola,0,0,0,0,0,0,0,5,0,0,0,0,0,5,5
1453,Angola,2012,2012Angola,0,0,0,0,0,6,6,0,0,0,0,0,23,23,29
1454,Angola,2012,2012Angola,0,0,0,0,0,7,7,0,0,0,0,0,16,16,23
1455,Angola,2012,2012Angola,0,0,0,0,0,38,38,0,0,0,0,0,63,63,101
1456,Angola,2012,2012Angola,0,0,0,0,0,1336,1336,0,0,0,0,0,1922,1922,3258
1457,Angola,2012,2012Angola,0,0,0,5,0,0,5,0,0,0,0,0,0,0,15
1458,Angola,2012,2012Angola,0,0,0,5,0,0,5,0,0,0,5,0,0,5,753
1459,Angola,2012,2012Angola,0,0,0,5,0,0,5,0,0,0,7,0,0,7,12
1460,Angola,2012,2012Angola,0,0,0,6,0,0,6,0,6,0,0,0,0,6,12
1461,Angola,2012,2012Angola,0,5,0,0,0,0,5,0,0,0,0,0,0,0,5
1462,Angola,2012,2012Angola,0,6,5,15,7,0,33,0,0,7,21,9,0,37,70
1463,Angola,2012,2012Angola,0,9,32,403,5,0,449,0,6,38,1177,14,0,1235,1684
1464,Angola,2012,2012Angola,9,0,0,0,0,0,9,0,0,0,0,0,0,0,9
1465,Angola,2012,2012Angola,12,35,13,72,10,0,142,10,41,33,79,17,0,180,322
1466,Angola,2012,2012Angola,23,165,201,952,23,0,1364,30,186,237,1198,26,0,1677,3041
1467,Angola,2012,2012Angola,61,111,86,341,16,18,633,64,114,77,249,5,34,543,1176
1468,Angola,2013,2013Angola,0,0,0,0,0,0,0,0,0,0,0,0,0,0,1950
1469,Angola,2013,2013Angola,0,0,0,0,0,0,0,0,0,0,5,0,0,5,5
1470,Angola,2013,2013Angola,0,0,0,0,0,0,0,0,0,0,13,0,0,13,13
1471,Angola,2013,2013Angola,0,0,0,0,0,0,0,0,0,5,0,0,0,5,5
1472,Angola,2013,2013Angola,0,0,0,0,0,0,0,0,5,0,0,0,0,5,10
1473,Angola,2013,2013Angola,0,0,0,0,0,25,25,0,0,0,0,0,42,42,67
1474,Angola,2013,2013Angola,0,0,0,0,0,1398,1398,0,0,0,0,0,1951,1951,3349
1475,Angola,2013,2013Angola,0,0,0,5,0,0,5,0,0,0,0,0,0,0,15
1476,Angola,2013,2013Angola,0,0,0,5,0,0,5,0,0,0,7,0,0,7,12
1477,Angola,2013,2013Angola,0,0,0,7,0,0,7,0,0,0,0,0,0,0,650
1478,Angola,2013,2013Angola,0,0,0,7,0,0,7,0,0,0,5,0,0,5,12
1479,Angola,2013,2013Angola,0,0,9,16,6,0,31,0,5,0,26,8,0,39,70
1480,Angola,2013,2013Angola,0,5,15,89,0,0,109,0,5,11,135,5,0,156,265
1481,Angola,2013,2013Angola,0,15,31,323,5,0,374,0,6,40,628,14,0,688,1062
1482,Angola,2013,2013Angola,9,68,66,284,19,0,446,11,65,65,250,13,0,404,850
1483,Angola,2013,2013Angola,11,34,16,72,10,0,143,5,38,36,85,19,0,183,326
1484,Angola,2013,2013Angola,37,43,45,115,8,0,248,39,54,51,141,25,0,310,558
1485,Angola,2013,2013Angola,49,101,88,312,14,10,574,53,96,73,230,5,24,481,1055
1486,Angola,2014,2014Angola,0,0,0,0,0,0,0,0,0,0,0,0,0,0,1723
1487,Angola,2014,2014Angola,0,0,0,0,0,0,0,0,0,0,5,0,0,5,5
1488,Angola,2014,2014Angola,0,0,0,0,0,0,0,0,0,0,6,0,0,6,445
1489,Angola,2014,2014Angola,0,0,0,0,0,0,0,0,0,0,8,0,0,8,8
1490,Angola,2014,2014Angola,0,0,0,0,0,0,0,0,0,0,13,0,0,13,13
1491,Angola,2014,2014Angola,0,0,0,0,0,0,0,0,0,5,0,0,0,5,5
1492,Angola,2014,2014Angola,0,0,0,0,0,6,6,0,0,0,0,0,7,7,13
1493,Angola,2014,2014Angola,0,0,0,0,0,1410,1410,0,0,0,0,0,1928,1928,3338
1494,Angola,2014,2014Angola,0,0,0,5,0,0,5,0,0,0,0,0,0,0,10
1495,Angola,2014,2014Angola,0,0,0,6,0,0,6,0,0,0,0,0,0,0,6
1496,Angola,2014,2014Angola,0,0,0,7,0,0,7,0,0,0,5,0,0,5,12
1497,Angola,2014,2014Angola,0,0,6,0,0,0,6,0,0,0,9,0,0,9,15
1498,Angola,2014,2014Angola,0,0,9,213,0,0,222,0,5,5,838,0,0,848,1070
1499,Angola,2014,2014Angola,5,0,0,0,0,0,5,0,0,0,0,0,0,0,5
1500,Angola,2014,2014Angola,5,44,28,122,15,0,214,0,47,53,133,20,0,253,467
1501,Angola,2014,2014Angola,10,58,70,267,18,0,423,7,55,73,222,20,0,377,800
1502,Angola,2014,2014Angola,36,45,45,115,8,0,249,39,54,51,140,25,0,309,558
1503,Angola,2014,2014Angola,43,94,70,299,13,10,529,46,89,71,210,5,25,446,975
1504,Angola,2015,2015Angola,0,0,0,0,0,0,0,0,0,0,0,0,0,0,4377
1505,Angola,2015,2015Angola,0,0,0,0,0,0,0,0,0,0,9,0,0,9,9
1506,Angola,2015,2015Angola,0,0,0,0,0,0,0,0,0,5,0,0,0,5,5
1507,Angola,2015,2015Angola,0,0,0,0,0,6,6,0,0,0,0,0,9,9,15
1508,Angola,2015,2015Angola,0,0,0,0,0,6,6,0,0,0,0,0,23,23,29
1509,Angola,2015,2015Angola,0,0,0,0,0,41,41,0,0,0,0,0,59,59,100
1510,Angola,2015,2015Angola,0,0,0,0,0,1424,1424,0,0,0,0,0,1925,1925,3349
1511,Angola,2015,2015Angola,0,0,0,5,0,0,5,0,0,0,0,0,0,0,15
1512,Angola,2015,2015Angola,0,0,0,5,0,0,5,0,0,0,9,0,0,9,14
1513,Angola,2015,2015Angola,0,5,0,7,0,0,12,0,0,0,0,0,0,0,12
1514,Angola,2015,2015Angola,0,5,8,88,0,0,101,0,0,8,135,5,0,148,249
1515,Angola,2015,2015Angola,0,6,0,0,0,0,6,0,0,0,9,0,0,9,15
1516,Angola,2015,2015Angola,0,91,24,184,5,0,304,0,18,23,733,5,0,779,1083
1517,Angola,2015,2015Angola,5,0,0,0,0,0,5,0,0,0,0,0,0,0,5
1518,Angola,2015,2015Angola,5,31,13,81,7,0,137,7,22,35,90,12,0,166,303
1519,Angola,2015,2015Angola,8,48,66,279,18,0,419,5,62,59,226,25,0,377,796
1520,Angola,2015,2015Angola,27,40,45,119,14,0,245,31,56,51,148,30,0,316,561
1521,Angola,2015,2015Angola,37,91,56,281,12,22,499,39,81,67,205,7,10,409,918
1522,Angola,2016,2016Angola,0,0,0,0,0,0,0,0,0,0,0,0,0,0,954
1523,Angola,2016,2016Angola,0,0,0,0,0,0,0,0,0,0,9,0,0,9,84
1524,Angola,2016,2016Angola,0,0,0,0,0,0,0,0,0,5,0,0,0,5,5
1525,Angola,2016,2016Angola,0,0,0,0,0,6,6,0,0,0,0,0,9,9,15
1526,Angola,2016,2016Angola,0,0,0,0,0,6,6,0,0,0,0,0,21,21,27
1527,Angola,2016,2016Angola,0,0,0,0,0,36,36,0,0,0,0,0,55,55,91
1528,Angola,2016,2016Angola,0,0,0,0,0,1465,1465,0,0,0,0,0,1943,1943,3408
1529,Angola,2016,2016Angola,0,0,0,5,0,0,5,0,0,0,0,0,0,0,5
1530,Angola,2016,2016Angola,0,0,0,5,0,0,5,0,0,0,6,0,0,6,11
1531,Angola,2016,2016Angola,0,0,0,5,0,0,5,0,0,0,9,0,0,9,14
1532,Angola,2016,2016Angola,0,0,9,87,0,0,96,0,0,6,130,5,0,141,237
1533,Angola,2016,2016Angola,0,5,0,0,0,0,5,0,0,0,0,0,0,0,10
1534,Angola,2016,2016Angola,0,5,0,0,0,0,5,0,0,0,8,0,0,8,13
1535,Angola,2016,2016Angola,0,94,27,190,5,0,316,0,21,26,741,5,0,793,1109
1536,Angola,2016,2016Angola,5,24,24,80,12,0,145,7,23,37,91,14,0,172,317
1537,Angola,2016,2016Angola,9,40,68,253,18,0,388,5,53,50,224,28,0,360,748
1538,Angola,2016,2016Angola,38,40,40,99,11,0,228,26,45,37,113,45,0,266,494
1539,Angola,2016,2016Angola,39,79,51,259,14,11,453,35,72,62,191,10,23,393,846
1540,Angola,2017,2017Angola,0,0,0,0,0,0,0,0,0,0,0,0,0,0,1012
1541,Angola,2017,2017Angola,0,0,0,0,0,0,0,0,0,0,5,0,0,5,10
1542,Angola,2017,2017Angola,0,0,0,0,0,0,0,0,0,5,0,0,0,5,5
1543,Angola,2017,2017Angola,0,0,0,0,0,0,0,5,0,0,0,0,0,5,1112
1544,Angola,2017,2017Angola,0,0,0,0,0,6,6,0,0,0,0,0,20,20,26
1545,Angola,2017,2017Angola,0,0,0,0,0,11,11,0,0,0,0,0,14,14,25
1546,Angola,2017,2017Angola,0,0,0,0,0,1481,1481,0,0,0,0,0,1947,1947,3428
1547,Angola,2017,2017Angola,0,0,0,5,0,0,5,0,0,0,0,0,0,0,5
1548,Angola,2017,2017Angola,0,0,0,5,0,0,5,0,0,0,6,0,0,6,11
1549,Angola,2017,2017Angola,0,0,0,5,0,0,5,0,0,0,9,0,0,9,14
1550,Angola,2017,2017Angola,0,5,0,0,0,0,5,0,0,0,0,0,0,0,5
1551,Angola,2017,2017Angola,0,5,0,0,0,0,5,0,0,0,9,0,0,9,14
1552,Angola,2017,2017Angola,0,8,0,88,0,0,96,0,0,6,129,5,0,140,236
1553,Angola,2017,2017Angola,7,26,21,77,13,0,144,5,28,34,89,18,0,174,318
1554,Angola,2017,2017Angola,9,45,59,284,20,0,417,10,52,58,229,37,0,386,803
1555,Angola,2017,2017Angola,35,63,42,242,16,24,422,32,65,54,179,11,11,352,774
1556,Angola,2017,2017Angola,38,40,40,99,11,0,228,26,45,37,113,45,0,266,494
1557,Angola,2018,2018Angola,0,0,0,0,0,0,0,0,0,0,0,0,0,0,2036
1558,Angola,2018,2018Angola,0,0,0,0,0,0,0,0,0,0,5,0,0,5,5
1559,Angola,2018,2018Angola,0,0,0,0,0,0,0,0,0,5,0,0,0,5,5
1560,Angola,2018,2018Angola,0,0,0,0,0,0,0,0,9,0,0,0,0,9,9
1561,Angola,2018,2018Angola,0,0,0,0,0,1551,1551,0,0,0,0,0,1990,1990,3541
1562,Angola,2018,2018Angola,0,0,0,5,0,0,5,0,0,0,0,0,0,0,5
1563,Angola,2018,2018Angola,0,0,0,5,0,0,5,0,0,0,6,0,0,6,11
1564,Angola,2018,2018Angola,0,0,0,5,0,0,5,0,0,0,9,0,0,9,14
1565,Angola,2018,2018Angola,0,0,0,8,0,0,8,0,0,0,0,0,0,0,8
1566,Angola,2018,2018Angola,0,5,0,0,0,0,5,0,0,0,0,0,0,0,5
1567,Angola,2018,2018Angola,0,5,0,0,0,0,5,0,0,0,9,0,0,9,14
1568,Angola,2018,2018Angola,0,6,0,14,0,0,20,0,5,0,25,0,0,30,50
1569,Angola,2018,2018Angola,0,7,0,7,0,0,14,0,0,0,9,0,0,9,132
1570,Angola,2018,2018Angola,5,0,0,0,0,0,5,0,0,0,0,0,0,0,5
1571,Angola,2018,2018Angola,5,21,22,85,15,0,148,0,22,33,91,23,0,169,317
1572,Angola,2018,2018Angola,12,47,57,295,26,0,437,17,51,62,235,44,0,409,846
1573,Angola,2018,2018Angola,34,63,35,243,13,11,399,29,57,45,177,20,23,351,750
1574,Angola,2018,2018Angola,38,39,41,98,10,0,226,26,48,35,110,45,0,264,490
1575,Angola,2019,2019Angola,0,0,0,0,0,0,0,0,0,0,0,0,0,0,2262
1576,Angola,2019,2019Angola,0,0,0,0,0,0,0,0,0,0,0,0,24,24,24
1577,Angola,2019,2019Angola,0,0,0,0,0,0,0,0,0,0,0,5,0,5,5
1578,Angola,2019,2019Angola,0,0,0,0,0,1649,1649,0,0,0,0,0,2029,2029,3678
1579,Angola,2019,2019Angola,0,0,0,5,0,0,5,0,0,0,0,0,0,0,5
1580,Angola,2019,2019Angola,0,0,0,5,0,0,5,0,0,0,9,0,0,9,14
1581,Angola,2019,2019Angola,0,0,0,8,0,0,8,0,0,0,0,0,0,0,8
1582,Angola,2019,2019Angola,0,0,5,0,0,0,5,0,0,0,8,0,0,8,13
1583,Angola,2019,2019Angola,0,0,6,8,0,0,14,0,0,0,0,0,0,0,14
1584,Angola,2019,2019Angola,0,5,0,0,0,0,5,0,0,0,0,0,0,0,5
1585,Angola,2019,2019Angola,0,5,0,15,0,0,20,0,0,0,30,0,0,30,50
1586,Angola,2019,2019Angola,0,6,0,0,0,0,6,0,0,0,0,0,0,0,6
1587,Angola,2019,2019Angola,0,6,0,0,0,0,6,0,0,0,7,0,0,7,13
1588,Angola,2019,2019Angola,0,7,0,0,0,0,7,0,7,0,0,0,0,7,14
1589,Angola,2019,2019Angola,16,43,28,108,15,0,210,33,48,38,107,54,0,280,490
1590,Angola,2019,2019Angola,16,55,52,298,29,0,450,26,43,69,231,43,0,412,862
1591,Angola,2019,2019Angola,26,57,40,233,16,0,372,23,57,37,170,20,0,307,713
1592,Angola,2020,2020Angola,0,0,0,0,0,0,0,0,0,0,0,0,0,0,5614
1593,Angola,2020,2020Angola,0,0,0,0,0,0,0,0,0,0,0,0,5,5,5
1594,Angola,2020,2020Angola,0,0,0,0,0,0,0,0,0,0,0,0,9,9,9
1595,Angola,2020,2020Angola,0,0,0,0,0,0,0,0,0,0,0,0,24,24,24
1596,Angola,2020,2020Angola,0,0,0,0,0,0,0,0,0,0,5,0,0,5,5
1597,Angola,2020,2020Angola,0,0,0,0,0,5,5,0,0,0,0,0,0,0,5
1598,Angola,2020,2020Angola,0,0,0,0,0,34,34,0,0,0,0,0,54,54,88
1599,Angola,2020,2020Angola,0,0,0,5,0,0,5,0,0,0,0,0,0,0,5
1600,Angola,2020,2020Angola,0,0,0,5,0,0,5,0,0,0,9,0,0,9,14
1601,Angola,2020,2020Angola,0,0,0,9,0,0,9,0,0,0,0,0,0,0,9
1602,Angola,2020,2020Angola,0,0,0,11,0,0,11,0,0,0,13,0,0,13,24
1603,Angola,2020,2020Angola,0,0,0,27,0,20,47,0,0,0,22,0,27,49,314
1604,Angola,2020,2020Angola,0,0,6,0,0,0,6,0,0,0,7,0,0,7,13
1605,Angola,2020,2020Angola,0,0,6,7,0,0,13,0,0,0,0,0,0,0,13
1606,Angola,2020,2020Angola,0,5,0,0,0,0,5,0,0,0,0,0,0,0,10
1607,Angola,2020,2020Angola,0,6,0,0,0,0,6,0,0,0,7,0,0,7,13
1608,Angola,2020,2020Angola,0,6,0,17,0,0,23,0,5,0,25,0,0,30,53
1609,Angola,2020,2020Angola,0,7,0,0,0,0,7,0,0,0,0,0,0,0,7
1610,Angola,2020,2020Angola,0,7,0,0,0,0,7,0,0,7,0,0,0,7,14
1611,Angola,2020,2020Angola,16,27,26,98,12,0,179,18,26,35,102,54,0,235,414
1612,Angola,2020,2020Angola,17,42,54,287,31,0,431,18,51,63,210,49,0,391,822
1613,Angola,2020,2020Angola,25,51,43,232,21,0,372,24,55,45,168,23,0,315,721
1614,Angola,2021,2021Angola,0,0,0,0,0,0,0,0,0,0,0,0,0,0,8641
1615,Angola,2021,2021Angola,0,0,0,0,0,0,0,0,0,0,0,0,24,24,24
1616,Angola,2021,2021Angola,0,0,0,0,0,0,0,0,0,0,5,0,0,5,10
1617,Angola,2021,2021Angola,0,0,0,5,0,0,5,0,0,0,5,0,0,5,10
1618,Angola,2021,2021Angola,0,0,0,5,0,0,5,0,0,0,9,0,0,9,14
1619,Angola,2021,2021Angola,0,0,0,7,0,0,7,0,0,0,0,0,0,0,7
1620,Angola,2021,2021Angola,0,0,0,9,0,0,9,0,0,0,0,0,0,0,9
1621,Angola,2021,2021Angola,0,0,0,11,0,0,11,0,0,0,13,0,0,13,24
1622,Angola,2021,2021Angola,0,0,5,0,0,0,5,0,0,0,0,0,0,0,10
1623,Angola,2021,2021Angola,0,0,5,0,0,0,5,0,0,0,7,0,0,7,12
1624,Angola,2021,2021Angola,0,0,5,18,0,0,23,0,0,0,29,0,0,29,52
1625,Angola,2021,2021Angola,0,0,7,0,0,0,7,0,0,0,0,0,0,0,7
1626,Angola,2021,2021Angola,0,6,0,0,0,0,6,0,0,0,6,0,0,6,12
1627,Angola,2021,2021Angola,0,7,0,0,0,0,7,0,7,0,0,0,0,7,14
1628,Angola,2021,2021Angola,0,8,0,0,0,0,8,0,0,0,0,0,0,0,8
1629,Angola,2021,2021Angola,7,28,16,111,0,20,182,20,30,15,110,0,27,202,594
1630,Angola,2021,2021Angola,16,27,26,100,12,0,181,18,24,36,104,54,0,236,417
1631,Angola,2021,2021Angola,17,38,50,304,35,0,444,14,54,70,208,45,0,391,835
1632,Angola,2021,2021Angola,22,46,47,222,23,0,360,25,49,44,164,25,0,307,703
1633,Armenia,2001,2001Armenia,0,0,0,0,0,0,0,0,0,0,0,0,0,0,6455
1634,Armenia,2001,2001Armenia,0,0,0,0,0,0,0,0,5,0,0,0,0,5,5
1635,Armenia,2001,2001Armenia,0,0,0,0,0,14,14,0,0,0,0,0,19,19,33
1636,Armenia,2001,2001Armenia,0,0,0,0,0,19,19,0,0,0,0,0,21,21,40
1637,Armenia,2001,2001Armenia,0,0,0,0,0,224,224,0,0,0,0,0,204,204,428
1638,Armenia,2001,2001Armenia,13,22,18,68,0,0,121,11,18,21,69,5,0,124,245
1639,Armenia,2002,2002Armenia,0,0,0,0,0,0,0,0,0,0,0,0,0,0,12454
1640,Armenia,2002,2002Armenia,0,0,0,0,0,6,6,0,0,0,0,0,0,0,65
1641,Armenia,2002,2002Armenia,0,0,0,0,0,250,250,0,0,0,0,0,231,231,481
1642,Armenia,2002,2002Armenia,12,22,18,69,0,0,121,11,23,15,69,5,0,123,244
1643,Armenia,2003,2003Armenia,0,0,0,0,0,0,0,0,0,0,0,0,0,0,12270
1644,Armenia,2003,2003Armenia,0,0,0,0,0,7,7,0,0,0,0,0,0,0,75
1645,Armenia,2003,2003Armenia,0,0,0,0,0,287,287,0,0,0,0,0,284,284,571
1646,Armenia,2003,2003Armenia,13,22,18,68,0,0,121,9,19,17,71,5,0,121,242
1647,Armenia,2004,2004Armenia,0,0,0,0,0,0,0,0,0,0,0,0,0,0,13031
1648,Armenia,2004,2004Armenia,0,0,0,0,0,0,0,0,0,0,5,0,0,5,10
1649,Armenia,2004,2004Armenia,0,0,0,0,0,0,0,0,5,0,0,0,0,5,5
1650,Armenia,2004,2004Armenia,0,6,0,11,5,0,22,0,0,9,32,0,0,41,63
1651,Armenia,2004,2004Armenia,0,8,7,29,0,5,49,5,10,8,17,0,5,45,94
1652,Armenia,2004,2004Armenia,9,17,15,58,0,0,99,7,15,12,68,5,0,107,206
1653,Armenia,2005,2005Armenia,0,0,0,0,0,0,0,0,0,0,0,0,0,0,12270
1654,Armenia,2005,2005Armenia,0,0,0,0,0,0,0,0,0,0,5,0,0,5,5
1655,Armenia,2005,2005Armenia,0,0,0,0,0,8,8,0,0,0,0,0,0,0,8
1656,Armenia,2005,2005Armenia,0,0,0,0,0,645,645,0,0,0,0,0,622,622,1267
1657,Armenia,2005,2005Armenia,0,0,0,5,0,0,5,0,0,0,0,0,0,0,5
1658,Armenia,2005,2005Armenia,0,6,0,24,5,0,35,0,9,0,43,0,0,52,87
1659,Armenia,2005,2005Armenia,0,10,8,35,0,5,58,0,11,10,23,0,6,50,108
1660,Armenia,2005,2005Armenia,5,20,17,58,0,0,100,5,18,16,71,5,0,115,215
1661,Armenia,2006,2006Armenia,0,0,0,0,0,0,0,0,0,0,0,0,0,0,12971
1662,Armenia,2006,2006Armenia,0,0,0,0,0,0,0,0,0,0,0,0,5,5,5
1663,Armenia,2006,2006Armenia,0,0,0,0,0,8,8,0,0,0,0,0,0,0,8
1664,Armenia,2006,2006Armenia,0,0,0,0,0,20,20,0,0,0,0,0,20,20,40
1665,Armenia,2006,2006Armenia,0,0,0,0,0,52,52,0,0,0,0,0,53,53,105
1666,Armenia,2006,2006Armenia,0,0,0,0,0,98,98,0,0,0,0,0,110,110,208
1667,Armenia,2006,2006Armenia,0,0,0,0,0,735,735,0,0,0,0,0,729,729,1464
1668,Armenia,2006,2006Armenia,0,0,0,5,0,0,5,0,0,0,0,0,0,0,5
1669,Armenia,2006,2006Armenia,0,0,0,9,0,0,9,0,0,5,9,0,0,14,23
1670,Armenia,2006,2006Armenia,0,0,5,24,5,0,34,0,0,7,43,0,0,50,84
1671,Armenia,2007,2007Armenia,0,0,0,0,0,0,0,0,0,0,0,0,0,0,13255
1672,Armenia,2007,2007Armenia,0,0,0,0,0,0,0,0,0,0,5,0,0,5,5
1673,Armenia,2007,2007Armenia,0,0,0,0,0,22,22,0,0,0,0,0,23,23,45
1674,Armenia,2007,2007Armenia,0,0,0,0,0,97,97,0,0,0,0,0,108,108,205
1675,Armenia,2007,2007Armenia,0,0,0,0,0,875,875,0,0,0,0,0,841,841,1716
1676,Armenia,2007,2007Armenia,0,0,0,5,0,0,5,0,0,0,0,0,0,0,10
1677,Armenia,2007,2007Armenia,0,0,5,8,0,0,13,0,0,5,8,0,0,13,26
1678,Armenia,2007,2007Armenia,0,0,5,24,5,0,34,0,0,7,43,0,0,50,84
1679,Armenia,2007,2007Armenia,0,6,5,29,0,5,45,0,8,5,25,0,6,44,89
1680,Armenia,2008,2008Armenia,0,0,0,0,0,0,0,0,0,0,0,0,0,0,13782
1681,Armenia,2008,2008Armenia,0,0,0,0,0,0,0,0,0,0,5,0,0,5,5
1682,Armenia,2008,2008Armenia,0,0,0,0,0,14,14,0,0,0,0,0,21,21,35
1683,Armenia,2008,2008Armenia,0,0,0,0,0,1095,1095,0,0,0,0,0,1092,1092,2187
1684,Armenia,2008,2008Armenia,0,0,0,5,0,0,5,0,0,0,0,0,0,0,5
1685,Armenia,2008,2008Armenia,0,0,0,9,5,0,14,0,0,0,13,0,0,13,27
1686,Armenia,2008,2008Armenia,0,0,5,0,0,0,5,0,0,0,0,0,0,0,5
1687,Armenia,2008,2008Armenia,0,0,39,57,0,0,96,0,0,34,60,5,0,99,195
1688,Armenia,2008,2008Armenia,0,5,5,29,0,5,44,0,10,5,27,0,6,48,92
1689,Armenia,2009,2009Armenia,0,0,0,0,0,0,0,0,0,0,0,0,0,0,13942
1690,Armenia,2009,2009Armenia,0,0,0,0,0,0,0,0,0,0,5,0,0,5,10
1691,Armenia,2009,2009Armenia,0,0,0,0,0,26,26,0,0,0,0,0,29,29,55
1692,Armenia,2009,2009Armenia,0,0,0,5,0,0,5,0,0,0,0,0,0,0,10
1693,Armenia,2009,2009Armenia,0,0,0,6,5,0,11,0,0,0,10,0,0,10,21
1694,Armenia,2009,2009Armenia,0,0,5,0,0,0,5,0,0,0,0,0,0,0,5
1695,Armenia,2009,2009Armenia,0,0,6,19,5,0,30,0,9,5,23,0,7,44,74
1696,Armenia,2009,2009Armenia,0,0,39,56,0,0,95,0,0,33,63,5,0,101,196
1697,Armenia,2009,2009Armenia,32,161,249,1282,135,0,1859,28,134,242,1332,96,0,1832,3691
1698,Armenia,2010,2010Armenia,0,0,0,0,0,0,0,0,0,0,0,0,0,0,10176
1699,Armenia,2010,2010Armenia,0,0,0,0,0,0,0,0,0,0,5,0,0,5,10
1700,Armenia,2010,2010Armenia,0,0,0,0,0,29,29,0,0,0,0,0,32,32,61
1701,Armenia,2010,2010Armenia,0,0,0,0,0,96,96,0,0,0,0,0,102,102,198
1702,Armenia,2010,2010Armenia,0,0,0,0,0,1531,1531,0,0,0,0,0,1542,1542,3073
1703,Armenia,2010,2010Armenia,0,0,0,5,0,0,5,0,0,0,0,0,0,0,10
1704,Armenia,2010,2010Armenia,0,0,0,13,0,0,13,0,0,0,13,0,0,13,26
1705,Armenia,2010,2010Armenia,0,7,0,21,5,5,38,0,7,7,22,0,7,43,81
1706,Armenia,2010,2010Armenia,23,158,251,1391,164,0,1987,23,140,237,1417,114,0,1931,3918
1707,Armenia,2011,2011Armenia,0,0,0,0,0,0,0,0,0,0,0,0,0,0,8666
1708,Armenia,2011,2011Armenia,0,0,0,0,0,0,0,0,0,0,5,0,0,5,10
1709,Armenia,2011,2011Armenia,0,0,0,0,0,0,0,0,0,0,8,0,0,8,8
1710,Armenia,2011,2011Armenia,0,0,0,0,0,30,30,0,0,0,0,0,34,34,64
1711,Armenia,2011,2011Armenia,0,0,0,0,0,1675,1675,0,0,0,0,0,1675,1675,3350
1712,Armenia,2011,2011Armenia,0,0,0,5,0,0,5,0,0,0,0,0,0,0,5
1713,Armenia,2011,2011Armenia,0,0,0,12,0,0,12,0,0,0,11,0,0,11,23
1714,Armenia,2011,2011Armenia,0,0,0,14,5,0,19,0,5,0,10,0,0,15,192
1715,Armenia,2011,2011Armenia,0,0,5,0,0,0,5,0,0,0,0,0,0,0,5
1716,Armenia,2011,2011Armenia,0,0,5,35,6,0,46,0,0,0,53,0,0,53,122
1717,Armenia,2011,2011Armenia,0,5,0,25,0,5,35,0,7,7,20,5,9,48,83
1718,Armenia,2011,2011Armenia,21,125,242,1405,183,0,1976,28,144,240,1459,116,0,1987,3963
1719,Armenia,2012,2012Armenia,0,0,0,0,0,0,0,0,0,0,0,0,0,0,7072
1720,Armenia,2012,2012Armenia,0,0,0,0,0,0,0,0,0,0,5,0,0,5,5
1721,Armenia,2012,2012Armenia,0,0,0,0,0,0,0,0,5,0,0,0,0,5,5
1722,Armenia,2012,2012Armenia,0,0,0,0,0,32,32,0,0,0,0,0,32,32,64
1723,Armenia,2012,2012Armenia,0,0,0,0,0,48,48,0,0,0,0,0,51,51,99
1724,Armenia,2012,2012Armenia,0,0,0,0,0,96,96,0,0,0,0,0,104,104,200
1725,Armenia,2012,2012Armenia,0,0,0,0,0,1816,1816,0,0,0,0,0,1817,1817,3633
1726,Armenia,2012,2012Armenia,0,0,0,5,0,0,5,0,0,0,0,0,0,0,15
1727,Armenia,2012,2012Armenia,0,0,0,5,0,0,5,0,0,0,7,0,0,7,200
1728,Armenia,2012,2012Armenia,0,0,0,10,5,0,15,0,0,0,13,0,0,13,28
1729,Armenia,2012,2012Armenia,0,0,0,17,5,5,27,0,0,8,22,0,9,39,66
1730,Armenia,2012,2012Armenia,0,0,5,0,0,0,5,0,0,0,0,0,0,0,5
1731,Armenia,2012,2012Armenia,0,0,5,32,8,0,45,0,0,0,47,5,0,52,126
1732,Armenia,2012,2012Armenia,23,126,261,1569,229,0,2208,34,141,266,1618,152,0,2211,4419
1733,Armenia,2013,2013Armenia,0,0,0,0,0,0,0,0,0,0,0,0,0,0,6460
1734,Armenia,2013,2013Armenia,0,0,0,0,0,0,0,0,0,0,5,0,0,5,5
1735,Armenia,2013,2013Armenia,0,0,0,0,0,0,0,0,5,0,0,0,0,5,5
1736,Armenia,2013,2013Armenia,0,0,0,0,0,45,45,0,0,0,0,0,45,45,129
1737,Armenia,2013,2013Armenia,0,0,0,0,0,1983,1983,0,0,0,0,0,1936,1936,3919
1738,Armenia,2013,2013Armenia,0,0,0,5,0,0,5,0,0,0,0,0,0,0,10
1739,Armenia,2013,2013Armenia,0,0,0,8,0,0,8,0,0,0,0,0,0,0,190
1740,Armenia,2013,2013Armenia,0,0,0,13,0,0,13,0,0,0,15,0,0,15,28
1741,Armenia,2013,2013Armenia,0,0,5,44,10,0,59,0,0,0,58,5,0,63,122
1742,Armenia,2013,2013Armenia,0,0,8,0,0,0,8,0,0,0,14,0,0,14,22
1743,Armenia,2013,2013Armenia,0,7,0,22,5,5,39,0,0,9,21,5,9,44,83
1744,Armenia,2013,2013Armenia,9,23,33,341,98,0,504,11,32,38,374,63,0,518,1022
1745,Armenia,2014,2014Armenia,0,0,0,0,0,0,0,0,0,0,0,0,0,0,6190
1746,Armenia,2014,2014Armenia,0,0,0,0,0,0,0,0,0,0,5,0,0,5,5
1747,Armenia,2014,2014Armenia,0,0,0,0,0,0,0,0,6,0,0,0,0,6,6
1748,Armenia,2014,2014Armenia,0,0,0,0,0,2059,2059,0,0,0,0,0,2004,2004,4063
1749,Armenia,2014,2014Armenia,0,0,0,5,0,0,5,0,0,0,7,0,0,7,189
1750,Armenia,2014,2014Armenia,0,0,0,12,0,0,12,0,0,0,12,0,0,12,24
1751,Armenia,2014,2014Armenia,0,0,5,0,0,0,5,0,0,0,0,0,0,0,5
1752,Armenia,2014,2014Armenia,0,0,5,44,10,0,59,0,0,0,58,5,0,63,122
1753,Armenia,2014,2014Armenia,5,7,0,29,5,5,51,0,8,7,28,5,9,57,108
1754,Armenia,2014,2014Armenia,5,22,33,376,116,0,552,10,35,39,416,75,0,575,1127
1755,Armenia,2015,2015Armenia,0,0,0,0,0,0,0,0,0,0,0,0,0,0,5411
1756,Armenia,2015,2015Armenia,0,0,0,0,0,0,0,0,0,0,5,0,0,5,5
1757,Armenia,2015,2015Armenia,0,0,0,0,0,58,58,0,0,0,0,0,68,68,126
1758,Armenia,2015,2015Armenia,0,0,0,0,0,102,102,0,0,0,0,0,98,98,200
1759,Armenia,2015,2015Armenia,0,0,0,0,0,2053,2053,0,0,0,0,0,1981,1981,4034
1760,Armenia,2015,2015Armenia,0,0,0,5,0,0,5,0,0,0,0,0,0,0,10
1761,Armenia,2015,2015Armenia,0,0,0,9,0,0,9,0,0,0,11,0,0,11,20
1762,Armenia,2015,2015Armenia,0,0,0,28,10,0,38,0,0,0,36,5,0,41,79
1763,Armenia,2015,2015Armenia,0,0,5,0,0,0,5,0,0,0,0,0,0,0,5
1764,Armenia,2015,2015Armenia,0,0,5,0,0,0,5,0,0,0,5,0,0,5,10
1765,Armenia,2015,2015Armenia,5,9,5,32,6,7,64,5,6,6,29,5,5,56,120
1766,Armenia,2015,2015Armenia,7,23,29,393,120,0,572,13,33,42,446,85,0,619,1191
1767,Armenia,2016,2016Armenia,0,0,0,0,0,0,0,0,0,0,0,0,0,0,4603
1768,Armenia,2016,2016Armenia,0,0,0,0,0,0,0,0,0,0,0,0,6,6,6
1769,Armenia,2016,2016Armenia,0,0,0,0,0,0,0,0,0,0,5,0,0,5,5
1770,Armenia,2016,2016Armenia,0,0,0,0,0,0,0,0,0,5,0,0,0,5,88
1771,Armenia,2016,2016Armenia,0,0,0,0,0,0,0,0,5,0,0,0,0,5,5
1772,Armenia,2016,2016Armenia,0,0,0,0,0,56,56,0,0,0,0,0,71,71,127
1773,Armenia,2016,2016Armenia,0,0,0,0,0,95,95,0,0,0,0,0,99,99,194
1774,Armenia,2016,2016Armenia,0,0,0,0,0,2101,2101,0,0,0,0,0,2016,2016,4117
1775,Armenia,2016,2016Armenia,0,0,0,8,0,0,8,0,0,0,11,0,0,11,19
1776,Armenia,2016,2016Armenia,0,0,0,28,10,0,38,0,0,0,35,6,0,41,79
1777,Armenia,2016,2016Armenia,0,0,5,0,0,0,5,0,0,0,6,0,0,6,11
1778,Armenia,2016,2016Armenia,5,5,5,33,6,5,59,5,8,6,26,5,8,58,117
1779,Armenia,2016,2016Armenia,9,33,36,433,143,0,654,15,42,48,468,109,0,682,1336
1780,Armenia,2017,2017Armenia,0,0,0,0,0,0,0,0,0,0,0,0,0,0,4198
1781,Armenia,2017,2017Armenia,0,0,0,0,0,0,0,0,5,0,0,0,0,5,5
1782,Armenia,2017,2017Armenia,0,0,0,0,0,95,95,0,0,0,0,0,97,97,192
1783,Armenia,2017,2017Armenia,0,0,0,0,0,2096,2096,0,0,0,0,0,2017,2017,4113
1784,Armenia,2017,2017Armenia,0,0,0,8,0,0,8,0,0,0,11,0,0,11,19
1785,Armenia,2017,2017Armenia,0,0,0,28,10,0,38,0,0,0,34,6,0,40,78
1786,Armenia,2017,2017Armenia,0,0,5,0,0,0,5,0,0,0,6,0,0,6,11
1787,Armenia,2017,2017Armenia,0,10,7,38,8,7,70,8,6,7,31,5,5,62,132
1788,Armenia,2017,2017Armenia,48,68,72,651,186,0,1025,60,97,80,642,134,0,1013,2038
1789,Armenia,2018,2018Armenia,0,0,0,0,0,0,0,0,0,0,0,0,0,0,4024
1790,Armenia,2018,2018Armenia,0,0,0,0,0,0,0,0,0,0,9,0,0,9,9
1791,Armenia,2018,2018Armenia,0,0,0,0,0,0,0,0,5,0,0,0,0,5,5
1792,Armenia,2018,2018Armenia,0,0,0,0,0,2137,2137,0,0,0,0,0,2060,2060,4197
1793,Armenia,2018,2018Armenia,0,0,0,5,0,0,5,0,0,0,0,0,0,0,83
1794,Armenia,2018,2018Armenia,0,0,0,8,0,0,8,0,0,0,11,0,0,11,19
1795,Armenia,2018,2018Armenia,0,0,0,24,14,0,38,0,0,0,34,5,0,39,77
1796,Armenia,2018,2018Armenia,5,8,6,46,8,5,78,6,10,11,37,5,5,74,152
1797,Armenia,2018,2018Armenia,70,90,92,757,223,0,1232,70,138,103,758,173,0,1242,2474
1798,Armenia,2019,2019Armenia,0,0,0,0,0,0,0,0,0,0,0,0,0,0,3757
1799,Armenia,2019,2019Armenia,0,0,0,0,0,0,0,0,5,0,0,0,0,5,5
1800,Armenia,2019,2019Armenia,0,0,0,0,0,6,6,0,0,0,0,0,41,41,47
1801,Armenia,2019,2019Armenia,0,0,0,0,0,2159,2159,0,0,0,0,0,2092,2092,4251
1802,Armenia,2019,2019Armenia,0,0,0,6,0,0,6,0,0,0,8,0,0,8,14
1803,Armenia,2019,2019Armenia,0,0,0,6,0,0,6,0,0,0,10,0,0,10,16
1804,Armenia,2019,2019Armenia,0,0,0,23,15,0,38,0,0,0,33,6,0,39,77
1805,Armenia,2019,2019Armenia,5,7,8,43,7,0,70,5,8,9,41,5,0,68,150
1806,Armenia,2019,2019Armenia,69,107,83,795,252,0,1306,67,146,110,829,187,0,1339,2645
1807,Armenia,2020,2020Armenia,0,0,0,0,0,0,0,0,0,0,0,0,0,0,7143
1808,Armenia,2020,2020Armenia,0,0,0,0,0,0,0,0,0,0,0,0,5,5,5
1809,Armenia,2020,2020Armenia,0,0,0,0,0,0,0,0,0,5,0,0,0,5,5
1810,Armenia,2020,2020Armenia,0,0,0,0,0,6,6,0,0,0,0,0,40,40,46
1811,Armenia,2020,2020Armenia,0,0,0,0,0,21,21,0,0,0,0,0,22,22,43
1812,Armenia,2020,2020Armenia,0,0,0,0,0,63,63,0,0,0,0,0,81,81,144
1813,Armenia,2020,2020Armenia,0,0,0,5,0,0,5,0,0,0,10,0,0,10,15
1814,Armenia,2020,2020Armenia,0,0,0,6,0,0,6,0,0,0,8,0,0,8,14
1815,Armenia,2020,2020Armenia,0,0,0,21,17,0,38,0,0,0,31,8,0,39,77
1816,Armenia,2020,2020Armenia,5,6,10,49,8,0,78,5,8,11,42,5,0,71,161
1817,Armenia,2020,2020Armenia,59,116,89,786,255,0,1305,57,147,124,860,188,0,1376,2681
1818,Armenia,2021,2021Armenia,0,0,0,0,0,0,0,0,0,0,0,0,0,0,9136
1819,Armenia,2021,2021Armenia,0,0,0,0,0,0,0,0,0,0,5,0,0,5,32
1820,Armenia,2021,2021Armenia,0,0,0,0,0,8,8,0,0,0,0,0,44,44,52
1821,Armenia,2021,2021Armenia,0,0,0,0,0,11,11,0,0,0,0,0,10,10,21
1822,Armenia,2021,2021Armenia,0,0,0,5,0,0,5,0,0,0,6,0,0,6,11
1823,Armenia,2021,2021Armenia,0,0,0,6,0,0,6,0,0,0,8,0,0,8,14
1824,Armenia,2021,2021Armenia,0,0,0,21,17,0,38,0,0,0,31,8,0,39,77
1825,Armenia,2021,2021Armenia,0,5,0,0,0,0,5,0,0,0,0,0,0,0,5
1826,Armenia,2021,2021Armenia,5,5,11,47,10,0,78,5,10,8,46,5,0,74,163
1827,Armenia,2021,2021Armenia,42,137,99,809,259,0,1346,44,152,143,861,198,0,1398,2744
1828,Azerbaijan,2001,2001Azerbaijan,0,0,0,0,0,0,0,0,0,0,0,0,0,0,3905
1829,Azerbaijan,2001,2001Azerbaijan,0,0,0,0,0,50,50,0,0,0,0,0,45,45,95
1830,Azerbaijan,2001,2001Azerbaijan,0,0,0,0,0,81,81,0,0,0,0,0,79,79,160
1831,Azerbaijan,2001,2001Azerbaijan,0,0,0,8,0,0,8,0,0,0,5,0,0,5,13
1832,Azerbaijan,2001,2001Azerbaijan,0,0,5,0,0,0,5,0,0,0,0,0,0,0,5
1833,Azerbaijan,2001,2001Azerbaijan,0,19,19,40,10,0,88,0,22,20,98,5,0,145,233
1834,Azerbaijan,2001,2001Azerbaijan,6,0,5,0,0,0,11,0,0,6,0,0,0,6,17
1835,Azerbaijan,2001,2001Azerbaijan,3719,5417,4643,63481,66030,0,143290,4011,5240,4488,55163,52135,0,121037,264327
1836,Azerbaijan,2002,2002Azerbaijan,0,0,0,0,0,0,0,0,0,0,0,0,0,0,11999
1837,Azerbaijan,2002,2002Azerbaijan,0,0,0,0,0,0,0,0,0,0,0,0,5,5,5
1838,Azerbaijan,2002,2002Azerbaijan,0,0,0,0,0,125,125,0,0,0,0,0,128,128,253
1839,Azerbaijan,2002,2002Azerbaijan,0,0,0,0,0,103697,103697,0,0,0,0,0,88336,88336,247538
1840,Azerbaijan,2002,2002Azerbaijan,0,0,0,0,5,0,5,0,0,0,0,0,0,0,5
1841,Azerbaijan,2002,2002Azerbaijan,0,0,0,8,0,0,8,0,0,0,5,0,0,5,13
1842,Azerbaijan,2002,2002Azerbaijan,0,0,5,0,0,0,5,0,0,0,0,0,0,0,5
1843,Azerbaijan,2002,2002Azerbaijan,0,20,19,37,10,0,86,0,21,19,101,5,0,146,232
1844,Azerbaijan,2002,2002Azerbaijan,5,0,5,0,0,0,10,0,0,11,0,0,0,11,21
1845,Azerbaijan,2002,2002Azerbaijan,5,12,10,45,9,0,81,0,10,10,39,6,0,65,146
1846,Azerbaijan,2003,2003Azerbaijan,0,0,0,0,0,0,0,0,0,0,0,0,0,0,13125
1847,Azerbaijan,2003,2003Azerbaijan,0,0,0,0,0,238,238,0,0,0,0,0,222,222,460
1848,Azerbaijan,2003,2003Azerbaijan,0,0,0,0,0,100601,100601,0,0,0,0,0,85695,85695,239250
1849,Azerbaijan,2003,2003Azerbaijan,0,0,0,0,6,0,6,0,0,0,0,0,0,0,6
1850,Azerbaijan,2003,2003Azerbaijan,0,0,0,6,0,0,6,0,0,0,5,0,0,5,11
1851,Azerbaijan,2003,2003Azerbaijan,5,0,0,10,0,0,15,0,6,0,6,0,0,12,27
1852,Azerbaijan,2003,2003Azerbaijan,5,11,9,43,6,0,74,0,9,9,35,5,0,58,132
1853,Azerbaijan,2003,2003Azerbaijan,5,17,15,40,10,0,87,5,19,16,103,7,0,150,237
1854,Azerbaijan,2004,2004Azerbaijan,0,0,0,0,0,0,0,0,0,0,0,0,0,0,15101
1855,Azerbaijan,2004,2004Azerbaijan,0,0,0,0,0,99213,99213,0,0,0,0,0,84511,84511,235101
1856,Azerbaijan,2004,2004Azerbaijan,0,0,0,0,7,0,7,0,0,0,0,0,0,0,7
1857,Azerbaijan,2004,2004Azerbaijan,0,0,0,5,0,7,12,0,0,0,0,0,10,10,22
1858,Azerbaijan,2004,2004Azerbaijan,0,5,0,10,0,0,15,0,5,0,7,0,0,12,27
1859,Azerbaijan,2004,2004Azerbaijan,0,14,13,34,11,0,72,0,12,11,96,6,0,125,197
1860,Azerbaijan,2004,2004Azerbaijan,5,11,10,41,6,0,73,0,9,9,33,5,0,56,129
1861,Azerbaijan,2005,2005Azerbaijan,0,0,0,0,0,0,0,0,0,0,0,0,0,0,12984
1862,Azerbaijan,2005,2005Azerbaijan,0,0,0,0,0,546,546,0,0,0,0,0,522,522,1068
1863,Azerbaijan,2005,2005Azerbaijan,0,0,0,0,7,0,7,0,0,0,0,0,0,0,14
1864,Azerbaijan,2005,2005Azerbaijan,0,0,0,5,0,0,5,0,0,0,0,0,0,0,5
1865,Azerbaijan,2005,2005Azerbaijan,0,0,0,5,0,11,16,0,0,0,0,0,13,13,29
1866,Azerbaijan,2005,2005Azerbaijan,0,0,0,5,11,0,16,0,0,0,14,0,0,14,30
1867,Azerbaijan,2005,2005Azerbaijan,0,0,0,96,18,124866,124980,0,0,0,111,39,94194,94344,219324
1868,Azerbaijan,2005,2005Azerbaijan,0,10,0,6,0,0,16,0,5,0,8,0,0,13,29
1869,Azerbaijan,2005,2005Azerbaijan,0,14,13,43,7,0,77,0,11,10,91,6,0,118,195
1870,Azerbaijan,2006,2006Azerbaijan,0,0,0,0,0,0,0,0,0,0,0,0,0,0,11293
1871,Azerbaijan,2006,2006Azerbaijan,0,0,0,0,0,0,0,0,0,0,5,0,0,5,5
1872,Azerbaijan,2006,2006Azerbaijan,0,0,0,0,0,0,0,0,0,5,0,0,0,5,5
1873,Azerbaijan,2006,2006Azerbaijan,0,0,0,0,0,19,19,0,0,0,0,0,26,26,45
1874,Azerbaijan,2006,2006Azerbaijan,0,0,0,0,0,25,25,0,0,0,0,0,19,19,44
1875,Azerbaijan,2006,2006Azerbaijan,0,0,0,0,0,74,74,0,0,0,0,0,106,106,180
1876,Azerbaijan,2006,2006Azerbaijan,0,0,0,0,0,625,625,0,0,0,0,0,585,585,1210
1877,Azerbaijan,2006,2006Azerbaijan,0,0,0,0,5,0,5,0,0,0,0,0,0,0,5
1878,Azerbaijan,2006,2006Azerbaijan,0,0,0,8,5,0,13,0,0,0,15,0,0,15,28
1879,Azerbaijan,2006,2006Azerbaijan,0,0,8,618,174,56969,57769,0,0,16,605,96,54738,55455,113224
1880,Azerbaijan,2006,2006Azerbaijan,0,10,0,6,0,0,16,0,0,0,13,0,0,13,29
1881,Azerbaijan,2007,2007Azerbaijan,0,0,0,0,0,0,0,0,0,0,0,0,0,0,10321
1882,Azerbaijan,2007,2007Azerbaijan,0,0,0,0,0,0,0,0,0,5,0,0,0,5,5
1883,Azerbaijan,2007,2007Azerbaijan,0,0,0,0,0,0,0,0,5,0,0,0,0,5,5
1884,Azerbaijan,2007,2007Azerbaijan,0,0,0,0,0,14,14,0,0,0,0,0,24,24,38
1885,Azerbaijan,2007,2007Azerbaijan,0,0,0,0,0,76,76,0,0,0,0,0,108,108,184
1886,Azerbaijan,2007,2007Azerbaijan,0,0,0,0,0,748,748,0,0,0,0,0,691,691,1439
1887,Azerbaijan,2007,2007Azerbaijan,0,0,0,0,5,0,5,0,0,0,0,0,0,0,5
1888,Azerbaijan,2007,2007Azerbaijan,0,0,0,5,0,0,5,0,0,0,0,0,0,0,5
1889,Azerbaijan,2007,2007Azerbaijan,0,0,0,11,5,0,16,0,0,0,12,0,0,12,28
1890,Azerbaijan,2007,2007Azerbaijan,0,0,0,1436,642,0,2078,0,0,0,1458,279,0,1737,3815
1891,Azerbaijan,2007,2007Azerbaijan,0,5,0,6,0,0,11,0,0,0,17,0,0,17,28
1892,Azerbaijan,2007,2007Azerbaijan,0,5,0,7,0,16,28,0,0,5,0,0,16,21,49
1893,Azerbaijan,2008,2008Azerbaijan,0,0,0,0,0,0,0,0,0,0,0,0,0,0,11153
1894,Azerbaijan,2008,2008Azerbaijan,0,0,0,0,0,0,0,0,5,0,0,0,0,5,5
1895,Azerbaijan,2008,2008Azerbaijan,0,0,0,0,0,12,12,0,0,0,0,0,15,15,27
1896,Azerbaijan,2008,2008Azerbaijan,0,0,0,0,0,922,922,0,0,0,0,0,823,823,1745
1897,Azerbaijan,2008,2008Azerbaijan,0,0,0,0,5,0,5,0,0,0,0,0,0,0,10
1898,Azerbaijan,2008,2008Azerbaijan,0,0,0,8,0,0,8,0,0,0,0,0,0,0,8
1899,Azerbaijan,2008,2008Azerbaijan,0,0,0,15,0,0,15,0,0,5,5,0,0,10,25
1900,Azerbaijan,2008,2008Azerbaijan,0,0,0,1152,499,0,1651,0,0,0,1176,255,0,1431,3082
1901,Azerbaijan,2008,2008Azerbaijan,0,0,5,6,0,0,11,0,0,0,17,0,0,17,28
1902,Azerbaijan,2008,2008Azerbaijan,0,0,24,50,6,0,80,0,0,21,76,5,0,102,182
1903,Azerbaijan,2008,2008Azerbaijan,0,5,0,11,0,17,33,0,0,5,5,0,13,23,56
1904,Azerbaijan,2009,2009Azerbaijan,0,0,0,0,0,0,0,0,0,0,0,0,0,0,7859
1905,Azerbaijan,2009,2009Azerbaijan,0,0,0,0,0,0,0,0,0,0,9,0,0,9,9
1906,Azerbaijan,2009,2009Azerbaijan,0,0,0,0,0,0,0,0,5,0,0,0,0,5,5
1907,Azerbaijan,2009,2009Azerbaijan,0,0,0,0,0,11,11,0,0,0,0,0,16,16,27
1908,Azerbaijan,2009,2009Azerbaijan,0,0,0,0,5,0,5,0,0,0,0,0,0,0,5
1909,Azerbaijan,2009,2009Azerbaijan,0,0,0,6,7,0,13,0,0,0,10,0,0,10,23
1910,Azerbaijan,2009,2009Azerbaijan,0,0,0,921,458,0,1379,0,0,0,1053,249,0,1302,2681
1911,Azerbaijan,2009,2009Azerbaijan,0,0,21,50,6,0,77,0,0,21,76,5,0,102,179
1912,Azerbaijan,2009,2009Azerbaijan,0,5,0,9,0,0,14,0,0,0,12,0,0,12,26
1913,Azerbaijan,2009,2009Azerbaijan,0,5,0,13,0,19,37,0,0,6,7,0,18,31,68
1914,Azerbaijan,2009,2009Azerbaijan,58,266,330,2007,432,0,3093,87,273,339,1988,283,0,2970,6063
1915,Azerbaijan,2010,2010Azerbaijan,0,0,0,0,0,0,0,0,0,0,0,0,0,0,5510
1916,Azerbaijan,2010,2010Azerbaijan,0,0,0,0,0,0,0,0,5,0,0,0,0,5,5
1917,Azerbaijan,2010,2010Azerbaijan,0,0,0,0,0,12,12,0,0,0,0,0,14,14,26
1918,Azerbaijan,2010,2010Azerbaijan,0,0,0,0,0,77,77,0,0,0,0,0,98,98,175
1919,Azerbaijan,2010,2010Azerbaijan,0,0,0,0,0,1174,1174,0,0,0,0,0,1065,1065,2239
1920,Azerbaijan,2010,2010Azerbaijan,0,0,0,0,5,0,5,0,0,0,0,0,0,0,5
1921,Azerbaijan,2010,2010Azerbaijan,0,0,0,5,0,0,5,0,0,0,5,0,0,5,10
1922,Azerbaijan,2010,2010Azerbaijan,0,0,0,14,0,0,14,0,0,0,10,0,0,10,24
1923,Azerbaijan,2010,2010Azerbaijan,0,0,0,795,439,0,1234,0,0,0,874,239,0,1113,2347
1924,Azerbaijan,2010,2010Azerbaijan,0,5,0,9,0,0,14,0,0,0,11,0,0,11,25
1925,Azerbaijan,2010,2010Azerbaijan,0,5,0,12,0,16,33,0,0,5,8,0,18,31,64
1926,Azerbaijan,2010,2010Azerbaijan,53,241,334,2111,489,0,3228,71,262,341,2092,332,0,3098,6326
1927,Azerbaijan,2011,2011Azerbaijan,0,0,0,0,0,0,0,0,0,0,0,0,0,0,4408
1928,Azerbaijan,2011,2011Azerbaijan,0,0,0,0,0,0,0,0,5,0,0,0,0,5,5
1929,Azerbaijan,2011,2011Azerbaijan,0,0,0,0,0,12,12,0,0,0,0,0,17,17,29
1930,Azerbaijan,2011,2011Azerbaijan,0,0,0,0,0,1271,1271,0,0,0,0,0,1174,1174,2445
1931,Azerbaijan,2011,2011Azerbaijan,0,0,0,0,5,0,5,0,0,0,0,0,0,0,5
1932,Azerbaijan,2011,2011Azerbaijan,0,0,0,5,0,0,5,0,0,0,0,0,0,0,172
1933,Azerbaijan,2011,2011Azerbaijan,0,0,0,5,0,0,5,0,0,0,5,0,0,5,10
1934,Azerbaijan,2011,2011Azerbaijan,0,0,0,6,5,0,11,0,0,0,13,0,0,13,683
1935,Azerbaijan,2011,2011Azerbaijan,0,0,0,13,0,0,13,0,0,0,10,0,0,10,23
1936,Azerbaijan,2011,2011Azerbaijan,0,0,0,644,363,0,1007,0,0,0,707,214,0,921,1928
1937,Azerbaijan,2011,2011Azerbaijan,0,0,5,9,0,0,14,0,0,0,11,0,0,11,25
1938,Azerbaijan,2011,2011Azerbaijan,0,5,0,12,0,17,34,0,0,5,8,0,20,33,67
1939,Azerbaijan,2011,2011Azerbaijan,48,219,339,2123,531,0,3260,65,251,315,2102,375,0,3108,6368
1940,Azerbaijan,2012,2012Azerbaijan,0,0,0,0,0,0,0,0,0,0,0,0,0,0,3729
1941,Azerbaijan,2012,2012Azerbaijan,0,0,0,0,0,0,0,0,5,0,0,0,0,5,10
1942,Azerbaijan,2012,2012Azerbaijan,0,0,0,0,0,8,8,0,0,0,0,0,12,12,20
1943,Azerbaijan,2012,2012Azerbaijan,0,0,0,0,0,9,9,0,0,0,0,0,14,14,23
1944,Azerbaijan,2012,2012Azerbaijan,0,0,0,0,0,82,82,0,0,0,0,0,99,99,181
1945,Azerbaijan,2012,2012Azerbaijan,0,0,0,0,0,1360,1360,0,0,0,0,0,1207,1207,2567
1946,Azerbaijan,2012,2012Azerbaijan,0,0,0,0,5,0,5,0,0,0,0,0,0,0,5
1947,Azerbaijan,2012,2012Azerbaijan,0,0,0,5,0,0,5,0,0,0,5,0,0,5,10
1948,Azerbaijan,2012,2012Azerbaijan,0,0,0,5,0,0,5,0,5,0,8,0,0,13,18
1949,Azerbaijan,2012,2012Azerbaijan,0,0,0,6,6,0,12,0,0,0,10,0,0,10,22
1950,Azerbaijan,2012,2012Azerbaijan,0,0,0,7,0,0,7,0,0,0,7,0,0,7,598
1951,Azerbaijan,2012,2012Azerbaijan,0,0,0,579,335,0,914,0,0,0,604,198,0,802,1716
1952,Azerbaijan,2012,2012Azerbaijan,0,5,0,5,5,19,34,0,0,0,6,0,27,33,67
1953,Azerbaijan,2012,2012Azerbaijan,36,218,323,2199,585,0,3361,55,257,321,2172,409,0,3214,6575
1954,Azerbaijan,2013,2013Azerbaijan,0,0,0,0,0,0,0,0,0,0,0,0,0,0,3684
1955,Azerbaijan,2013,2013Azerbaijan,0,0,0,0,0,0,0,0,0,0,5,0,0,5,5
1956,Azerbaijan,2013,2013Azerbaijan,0,0,0,0,0,0,0,0,0,0,9,0,0,9,9
1957,Azerbaijan,2013,2013Azerbaijan,0,0,0,0,0,0,0,0,5,0,0,0,0,5,5
1958,Azerbaijan,2013,2013Azerbaijan,0,0,0,0,0,19,19,0,0,0,0,0,17,17,36
1959,Azerbaijan,2013,2013Azerbaijan,0,0,0,0,0,1426,1426,0,0,0,0,0,1283,1283,2709
1960,Azerbaijan,2013,2013Azerbaijan,0,0,0,5,0,0,5,0,0,0,11,0,0,11,16
1961,Azerbaijan,2013,2013Azerbaijan,0,0,0,6,5,0,11,0,0,0,10,0,0,10,21
1962,Azerbaijan,2013,2013Azerbaijan,0,0,0,7,0,0,7,0,0,0,12,0,0,12,19
1963,Azerbaijan,2013,2013Azerbaijan,0,0,0,9,0,0,9,0,0,0,10,0,0,10,550
1964,Azerbaijan,2013,2013Azerbaijan,0,0,0,549,322,0,871,0,0,0,542,194,0,736,1607
1965,Azerbaijan,2013,2013Azerbaijan,0,5,0,10,0,17,32,0,0,5,6,0,22,33,65
1966,Azerbaijan,2013,2013Azerbaijan,22,74,70,758,134,0,1058,19,94,89,728,94,0,1024,2082
1967,Azerbaijan,2014,2014Azerbaijan,0,0,0,0,0,0,0,0,0,0,0,0,0,0,3424
1968,Azerbaijan,2014,2014Azerbaijan,0,0,0,0,0,0,0,0,0,0,9,0,0,9,9
1969,Azerbaijan,2014,2014Azerbaijan,0,0,0,0,0,0,0,0,5,0,0,0,0,5,10
1970,Azerbaijan,2014,2014Azerbaijan,0,0,0,0,0,6,6,0,0,0,0,0,8,8,14
1971,Azerbaijan,2014,2014Azerbaijan,0,0,0,0,0,1459,1459,0,0,0,0,0,1312,1312,2771
1972,Azerbaijan,2014,2014Azerbaijan,0,0,0,5,0,0,5,0,0,0,10,0,0,10,15
1973,Azerbaijan,2014,2014Azerbaijan,0,0,0,5,5,0,10,0,0,0,5,0,0,5,15
1974,Azerbaijan,2014,2014Azerbaijan,0,0,0,8,0,0,8,0,0,0,0,0,0,0,455
1975,Azerbaijan,2014,2014Azerbaijan,0,0,0,530,316,0,846,0,0,0,522,186,0,708,1554
1976,Azerbaijan,2014,2014Azerbaijan,5,0,0,13,0,19,37,5,0,0,7,0,25,37,74
1977,Azerbaijan,2014,2014Azerbaijan,24,70,70,781,146,0,1091,27,96,85,767,101,0,1076,2167
1978,Azerbaijan,2015,2015Azerbaijan,0,0,0,0,0,0,0,0,0,0,0,0,0,0,2830
1979,Azerbaijan,2015,2015Azerbaijan,0,0,0,0,0,0,0,0,0,0,14,0,0,14,14
1980,Azerbaijan,2015,2015Azerbaijan,0,0,0,0,0,0,0,0,5,0,0,0,0,5,10
1981,Azerbaijan,2015,2015Azerbaijan,0,0,0,0,0,6,6,0,0,0,0,0,8,8,14
1982,Azerbaijan,2015,2015Azerbaijan,0,0,0,0,0,45,45,0,0,0,0,0,31,31,76
1983,Azerbaijan,2015,2015Azerbaijan,0,0,0,0,0,72,72,0,0,0,0,0,97,97,169
1984,Azerbaijan,2015,2015Azerbaijan,0,0,0,0,0,1469,1469,0,0,0,0,0,1347,1347,2816
1985,Azerbaijan,2015,2015Azerbaijan,0,0,0,0,6,0,6,0,0,0,0,0,0,0,6
1986,Azerbaijan,2015,2015Azerbaijan,0,0,0,0,7,0,7,0,0,0,0,0,0,0,7
1987,Azerbaijan,2015,2015Azerbaijan,0,0,0,6,0,0,6,0,0,0,8,0,0,8,14
1988,Azerbaijan,2015,2015Azerbaijan,0,0,0,515,310,0,825,0,0,0,498,178,0,676,1501
1989,Azerbaijan,2015,2015Azerbaijan,5,0,0,8,0,28,41,0,0,0,7,0,24,31,79
1990,Azerbaijan,2015,2015Azerbaijan,22,74,65,778,157,0,1096,18,103,75,770,109,0,1075,2171
1991,Azerbaijan,2016,2016Azerbaijan,0,0,0,0,0,0,0,0,0,0,0,0,0,0,2296
1992,Azerbaijan,2016,2016Azerbaijan,0,0,0,0,0,0,0,0,0,0,0,5,0,5,5
1993,Azerbaijan,2016,2016Azerbaijan,0,0,0,0,0,0,0,0,0,0,5,0,0,5,5
1994,Azerbaijan,2016,2016Azerbaijan,0,0,0,0,0,0,0,0,5,0,0,0,0,5,10
1995,Azerbaijan,2016,2016Azerbaijan,0,0,0,0,0,7,7,0,0,0,0,0,8,8,15
1996,Azerbaijan,2016,2016Azerbaijan,0,0,0,0,0,42,42,0,0,0,0,0,33,33,75
1997,Azerbaijan,2016,2016Azerbaijan,0,0,0,0,0,50,50,0,0,0,0,0,107,107,157
1998,Azerbaijan,2016,2016Azerbaijan,0,0,0,0,0,1518,1518,0,0,0,0,0,1408,1408,2926
1999,Azerbaijan,2016,2016Azerbaijan,0,0,0,0,7,0,7,0,0,0,0,0,0,0,7
2000,Azerbaijan,2016,2016Azerbaijan,0,0,0,7,0,0,7,0,0,0,8,0,0,8,15
2001,Azerbaijan,2016,2016Azerbaijan,0,0,0,10,0,0,10,0,0,0,34,0,0,34,164
2002,Azerbaijan,2016,2016Azerbaijan,0,0,0,369,221,0,590,0,0,0,348,124,0,472,2046
2003,Azerbaijan,2016,2016Azerbaijan,5,0,0,7,0,29,41,0,0,0,9,0,35,44,85
2004,Azerbaijan,2016,2016Azerbaijan,32,87,67,816,173,0,1175,29,118,78,793,119,0,1137,2312
2005,Azerbaijan,2017,2017Azerbaijan,0,0,0,0,0,0,0,0,0,0,0,0,0,0,2352
2006,Azerbaijan,2017,2017Azerbaijan,0,0,0,0,0,0,0,0,0,0,5,0,0,5,10
2007,Azerbaijan,2017,2017Azerbaijan,0,0,0,0,0,0,0,0,0,5,0,0,0,5,5
2008,Azerbaijan,2017,2017Azerbaijan,0,0,0,0,0,0,0,0,5,0,0,0,0,5,5
2009,Azerbaijan,2017,2017Azerbaijan,0,0,0,0,0,58,58,0,0,0,0,0,91,91,149
2010,Azerbaijan,2017,2017Azerbaijan,0,0,0,0,0,1505,1505,0,0,0,0,0,1411,1411,2916
2011,Azerbaijan,2017,2017Azerbaijan,0,0,0,0,8,0,8,0,0,0,0,0,0,0,8
2012,Azerbaijan,2017,2017Azerbaijan,0,0,0,7,0,0,7,0,0,0,8,0,0,8,15
2013,Azerbaijan,2017,2017Azerbaijan,0,0,0,367,217,0,584,0,0,0,342,123,0,465,2034
2014,Azerbaijan,2017,2017Azerbaijan,0,0,5,5,0,33,43,0,0,0,8,0,29,37,80
2015,Azerbaijan,2017,2017Azerbaijan,0,0,6,0,0,0,6,0,0,0,0,0,0,0,6
2016,Azerbaijan,2017,2017Azerbaijan,104,174,104,1073,203,0,1658,126,199,150,1051,129,0,1655,3313
2017,Azerbaijan,2018,2018Azerbaijan,0,0,0,0,0,0,0,0,0,0,0,0,0,0,2194
2018,Azerbaijan,2018,2018Azerbaijan,0,0,0,0,0,0,0,0,0,0,5,0,0,5,10
2019,Azerbaijan,2018,2018Azerbaijan,0,0,0,0,0,0,0,0,0,0,6,0,0,6,6
2020,Azerbaijan,2018,2018Azerbaijan,0,0,0,0,0,0,0,0,0,5,0,0,0,5,5
2021,Azerbaijan,2018,2018Azerbaijan,0,0,0,0,0,0,0,0,5,0,0,0,0,5,5
2022,Azerbaijan,2018,2018Azerbaijan,0,0,0,0,0,1487,1487,0,0,0,0,0,1399,1399,2886
2023,Azerbaijan,2018,2018Azerbaijan,0,0,0,0,7,0,7,0,0,0,0,0,0,0,7
2024,Azerbaijan,2018,2018Azerbaijan,0,0,0,484,286,0,770,0,0,0,448,170,0,618,1961
2025,Azerbaijan,2018,2018Azerbaijan,0,0,6,0,0,0,6,0,0,0,0,0,0,0,6
2026,Azerbaijan,2018,2018Azerbaijan,0,5,0,7,0,32,44,0,5,0,6,0,41,52,96
2027,Azerbaijan,2018,2018Azerbaijan,5,11,0,29,0,0,45,0,17,0,55,0,0,72,427
2028,Azerbaijan,2018,2018Azerbaijan,111,203,119,1170,231,0,1834,136,235,172,1105,161,0,1809,3643
2029,Azerbaijan,2019,2019Azerbaijan,0,0,0,0,0,0,0,0,0,0,0,0,0,0,2790
2030,Azerbaijan,2019,2019Azerbaijan,0,0,0,0,0,0,0,0,0,0,5,0,0,5,15
2031,Azerbaijan,2019,2019Azerbaijan,0,0,0,0,0,0,0,0,5,0,0,0,0,5,5
2032,Azerbaijan,2019,2019Azerbaijan,0,0,0,0,0,21,21,0,0,0,0,0,51,51,72
2033,Azerbaijan,2019,2019Azerbaijan,0,0,0,0,0,1510,1510,0,0,0,0,0,1432,1432,2942
2034,Azerbaijan,2019,2019Azerbaijan,0,0,0,0,7,0,7,0,0,0,0,0,0,0,7
2035,Azerbaijan,2019,2019Azerbaijan,0,0,0,469,269,0,738,0,0,0,410,167,0,577,1888
2036,Azerbaijan,2019,2019Azerbaijan,0,0,5,0,0,0,5,0,0,0,0,0,0,0,5
2037,Azerbaijan,2019,2019Azerbaijan,0,8,0,9,0,0,17,0,7,0,10,0,0,17,118
2038,Azerbaijan,2019,2019Azerbaijan,110,223,139,1189,252,0,1913,131,256,190,1123,171,0,1871,3784
2039,Azerbaijan,2020,2020Azerbaijan,0,0,0,0,0,0,0,0,0,0,0,0,0,0,4802
2040,Azerbaijan,2020,2020Azerbaijan,0,0,0,0,0,0,0,0,0,0,5,0,0,5,15
2041,Azerbaijan,2020,2020Azerbaijan,0,0,0,0,0,0,0,0,0,5,0,0,0,5,5
2042,Azerbaijan,2020,2020Azerbaijan,0,0,0,0,0,0,0,0,5,0,0,0,0,5,5
2043,Azerbaijan,2020,2020Azerbaijan,0,0,0,0,0,0,0,6,0,0,0,0,0,6,21
2044,Azerbaijan,2020,2020Azerbaijan,0,0,0,0,0,6,6,0,0,0,0,0,7,7,13
2045,Azerbaijan,2020,2020Azerbaijan,0,0,0,0,0,7,7,0,0,0,0,0,6,6,13
2046,Azerbaijan,2020,2020Azerbaijan,0,0,0,0,0,20,20,0,0,0,0,0,50,50,70
2047,Azerbaijan,2020,2020Azerbaijan,0,0,0,0,0,45,45,0,0,0,0,0,40,40,85
2048,Azerbaijan,2020,2020Azerbaijan,0,0,0,0,6,0,6,0,0,0,0,0,0,0,6
2049,Azerbaijan,2020,2020Azerbaijan,0,0,0,5,0,0,5,0,0,0,0,0,0,0,5
2050,Azerbaijan,2020,2020Azerbaijan,0,0,0,20,0,20,40,0,0,0,26,0,23,49,622
2051,Azerbaijan,2020,2020Azerbaijan,0,5,6,7,5,0,23,0,5,5,12,0,0,22,190
2052,Azerbaijan,2020,2020Azerbaijan,101,225,160,1194,255,0,1935,118,279,204,1128,186,0,1915,3850
2053,Azerbaijan,2020,2020Azerbaijan,5374,5261,5208,34686,10283,159,60971,5613,5707,5631,7986,5172,113,30222,91766
2054,Azerbaijan,2021,2021Azerbaijan,0,0,0,0,0,0,0,0,0,0,0,0,0,0,6610
2055,Azerbaijan,2021,2021Azerbaijan,0,0,0,0,0,0,0,0,0,0,5,0,0,5,10
2056,Azerbaijan,2021,2021Azerbaijan,0,0,0,0,0,0,0,0,0,5,0,0,0,5,5
2057,Azerbaijan,2021,2021Azerbaijan,0,0,0,0,0,0,0,0,5,0,0,0,0,5,5
2058,Azerbaijan,2021,2021Azerbaijan,0,0,0,0,0,12,12,0,0,0,0,0,14,14,26
2059,Azerbaijan,2021,2021Azerbaijan,0,0,0,0,0,21,21,0,0,0,0,0,49,49,70
2060,Azerbaijan,2021,2021Azerbaijan,0,0,0,0,6,0,6,0,0,0,0,0,0,0,6
2061,Azerbaijan,2021,2021Azerbaijan,0,0,0,5,0,0,5,0,0,0,0,0,0,0,5
2062,Azerbaijan,2021,2021Azerbaijan,0,0,0,432,233,0,665,0,0,0,368,146,24,538,27933
2063,Azerbaijan,2021,2021Azerbaijan,0,6,7,8,5,0,26,0,5,5,13,0,0,23,207
2064,Azerbaijan,2021,2021Azerbaijan,5,6,0,54,5,20,90,5,5,5,76,0,23,114,723
2065,Azerbaijan,2021,2021Azerbaijan,88,224,172,1180,270,0,1934,97,289,225,1132,201,0,1944,3878
2066,Bangladesh,2001,2001Bangladesh,0,0,0,0,0,0,0,0,0,0,0,0,0,0,4806
2067,Bangladesh,2001,2001Bangladesh,0,0,0,0,0,0,0,0,7,0,0,0,0,7,7
2068,Bangladesh,2001,2001Bangladesh,0,0,0,0,0,5,5,0,0,0,0,0,15,15,20
2069,Bangladesh,2001,2001Bangladesh,0,0,0,0,0,72,72,0,0,0,0,0,639,639,711
2070,Bangladesh,2002,2002Bangladesh,0,0,0,0,0,0,0,0,0,0,0,0,0,0,4969
2071,Bangladesh,2002,2002Bangladesh,0,0,0,0,0,0,0,0,0,0,0,0,7,7,26
2072,Bangladesh,2002,2002Bangladesh,0,0,0,0,0,0,0,0,0,0,5,0,0,5,5
2073,Bangladesh,2002,2002Bangladesh,0,0,0,0,0,0,0,0,7,0,0,0,0,7,7
2074,Bangladesh,2002,2002Bangladesh,0,0,0,0,0,98,98,0,0,0,0,0,699,699,797
2075,Bangladesh,2003,2003Bangladesh,0,0,0,0,0,0,0,0,0,0,0,0,0,0,4690
2076,Bangladesh,2003,2003Bangladesh,0,0,0,0,0,0,0,0,0,0,0,0,5,5,24
2077,Bangladesh,2003,2003Bangladesh,0,0,0,0,0,0,0,0,7,0,0,0,0,7,7
2078,Bangladesh,2003,2003Bangladesh,0,0,0,0,0,0,0,5,0,0,0,0,0,5,5
2079,Bangladesh,2003,2003Bangladesh,0,0,0,0,0,113,113,0,0,0,0,0,724,724,837
2080,Bangladesh,2004,2004Bangladesh,0,0,0,0,0,0,0,0,0,0,0,0,0,0,5670
2081,Bangladesh,2004,2004Bangladesh,0,0,0,0,0,0,0,0,0,0,8,0,0,8,8
2082,Bangladesh,2004,2004Bangladesh,0,0,0,0,0,0,0,0,0,0,12,0,0,12,12
2083,Bangladesh,2004,2004Bangladesh,0,0,0,0,0,0,0,5,0,0,0,0,0,5,5
2084,Bangladesh,2004,2004Bangladesh,0,0,0,6,0,0,6,0,0,0,0,0,0,0,6
2085,Bangladesh,2004,2004Bangladesh,0,0,0,6,0,0,6,0,5,5,11,0,5,26,32
2086,Bangladesh,2005,2005Bangladesh,0,0,0,0,0,0,0,0,0,0,0,0,0,0,6044
2087,Bangladesh,2005,2005Bangladesh,0,0,0,0,0,0,0,0,0,0,5,0,0,5,5
2088,Bangladesh,2005,2005Bangladesh,0,0,0,0,0,0,0,0,0,0,9,0,0,9,9
2089,Bangladesh,2005,2005Bangladesh,0,0,0,0,0,0,0,0,0,0,12,0,0,12,12
2090,Bangladesh,2005,2005Bangladesh,0,0,0,0,0,147,147,0,0,0,0,0,1057,1057,1204
2091,Bangladesh,2005,2005Bangladesh,0,0,0,7,0,0,7,0,8,0,9,0,5,22,29
2092,Bangladesh,2006,2006Bangladesh,0,0,0,0,0,0,0,0,0,0,0,0,0,0,6431
2093,Bangladesh,2006,2006Bangladesh,0,0,0,0,0,0,0,0,0,0,5,0,0,5,5
2094,Bangladesh,2006,2006Bangladesh,0,0,0,0,0,0,0,0,0,0,7,0,0,7,7
2095,Bangladesh,2006,2006Bangladesh,0,0,0,0,0,0,0,0,0,0,13,0,0,13,13
2096,Bangladesh,2006,2006Bangladesh,0,0,0,0,0,5,5,0,0,0,0,0,0,0,5
2097,Bangladesh,2006,2006Bangladesh,0,0,0,0,0,12,12,0,0,0,0,0,26,26,38
2098,Bangladesh,2006,2006Bangladesh,0,0,0,0,0,163,163,0,0,0,0,0,1134,1134,1297
2099,Bangladesh,2007,2007Bangladesh,0,0,0,0,0,0,0,0,0,0,0,0,0,0,8662
2100,Bangladesh,2007,2007Bangladesh,0,0,0,0,0,0,0,0,0,0,0,0,8,8,8
2101,Bangladesh,2007,2007Bangladesh,0,0,0,0,0,0,0,0,0,0,5,0,0,5,5
2102,Bangladesh,2007,2007Bangladesh,0,0,0,0,0,0,0,0,0,0,7,0,0,7,7
2103,Bangladesh,2007,2007Bangladesh,0,0,0,0,0,179,179,0,0,0,0,0,1316,1316,1495
2104,Bangladesh,2007,2007Bangladesh,0,0,0,5,0,0,5,0,0,0,0,0,0,0,5
2105,Bangladesh,2007,2007Bangladesh,0,0,0,6,0,0,6,0,0,0,12,0,0,12,18
2106,Bangladesh,2007,2007Bangladesh,0,6,0,5,0,0,11,0,7,0,12,0,5,24,35
2107,Bangladesh,2008,2008Bangladesh,0,0,0,0,0,0,0,0,0,0,0,0,0,0,8287
2108,Bangladesh,2008,2008Bangladesh,0,0,0,0,0,0,0,0,0,0,0,0,8,8,8
2109,Bangladesh,2008,2008Bangladesh,0,0,0,0,0,0,0,0,0,0,5,0,0,5,15
2110,Bangladesh,2008,2008Bangladesh,0,0,0,0,0,0,0,5,0,0,0,0,0,5,5
2111,Bangladesh,2008,2008Bangladesh,0,0,0,0,0,194,194,0,0,0,0,0,1523,1523,1717
2112,Bangladesh,2008,2008Bangladesh,0,0,0,7,0,0,7,0,0,0,12,0,0,12,19
2113,Bangladesh,2008,2008Bangladesh,0,7,0,6,0,5,18,0,5,5,13,0,5,28,46
2114,Bangladesh,2009,2009Bangladesh,0,0,0,0,0,0,0,0,0,0,0,0,0,0,9364
2115,Bangladesh,2009,2009Bangladesh,0,0,0,0,0,0,0,0,0,0,5,0,0,5,15
2116,Bangladesh,2009,2009Bangladesh,0,0,0,0,0,0,0,0,0,0,6,0,0,6,6
2117,Bangladesh,2009,2009Bangladesh,0,0,0,0,0,0,0,5,0,0,0,0,0,5,5
2118,Bangladesh,2009,2009Bangladesh,0,0,0,0,0,5,5,0,0,0,0,0,5,5,10
2119,Bangladesh,2009,2009Bangladesh,0,0,0,12,0,0,12,5,0,0,23,0,0,28,40
2120,Bangladesh,2009,2009Bangladesh,0,0,8,6,0,5,19,0,8,0,14,0,5,27,46
2121,Bangladesh,2009,2009Bangladesh,7,10,15,103,5,0,140,7,21,8,757,9,0,802,942
2122,Bangladesh,2010,2010Bangladesh,0,0,0,0,0,0,0,0,0,0,0,0,0,0,6688
2123,Bangladesh,2010,2010Bangladesh,0,0,0,0,0,0,0,0,0,0,0,0,8,8,8
2124,Bangladesh,2010,2010Bangladesh,0,0,0,0,0,0,0,0,0,0,0,0,12,12,12
2125,Bangladesh,2010,2010Bangladesh,0,0,0,0,0,0,0,0,0,0,5,0,0,5,5
2126,Bangladesh,2010,2010Bangladesh,0,0,0,0,0,0,0,0,0,0,8,0,0,8,13
2127,Bangladesh,2010,2010Bangladesh,0,0,0,0,0,5,5,0,0,0,0,0,5,5,10
2128,Bangladesh,2010,2010Bangladesh,0,0,0,0,0,252,252,0,0,0,0,0,2016,2016,2268
2129,Bangladesh,2010,2010Bangladesh,0,0,0,16,0,0,16,5,0,0,27,0,0,32,48
2130,Bangladesh,2010,2010Bangladesh,0,0,8,9,0,6,23,0,7,6,13,0,5,31,54
2131,Bangladesh,2010,2010Bangladesh,0,5,0,0,0,0,5,0,0,0,0,0,0,0,5
2132,Bangladesh,2010,2010Bangladesh,5,9,14,103,7,0,138,5,18,13,746,15,0,797,935
2133,Bangladesh,2011,2011Bangladesh,0,0,0,0,0,0,0,0,0,0,0,0,0,0,4432
2134,Bangladesh,2011,2011Bangladesh,0,0,0,0,0,0,0,0,0,0,0,0,12,12,12
2135,Bangladesh,2011,2011Bangladesh,0,0,0,0,0,0,0,0,0,0,5,0,0,5,5
2136,Bangladesh,2011,2011Bangladesh,0,0,0,0,0,0,0,0,0,0,8,0,0,8,13
2137,Bangladesh,2011,2011Bangladesh,0,0,0,0,0,0,0,0,0,0,9,0,0,9,9
2138,Bangladesh,2011,2011Bangladesh,0,0,0,0,0,0,0,5,0,0,0,0,0,5,5
2139,Bangladesh,2011,2011Bangladesh,0,0,0,0,0,9,9,0,0,0,0,0,0,0,9
2140,Bangladesh,2011,2011Bangladesh,0,0,0,0,0,272,272,0,0,0,0,0,2201,2201,2473
2141,Bangladesh,2011,2011Bangladesh,0,0,9,11,0,6,26,0,8,5,16,0,7,36,62
2142,Bangladesh,2011,2011Bangladesh,0,0,9,30,0,0,39,0,9,0,38,5,0,52,2076
2143,Bangladesh,2011,2011Bangladesh,0,5,0,0,0,0,5,0,0,0,0,0,0,0,5
2144,Bangladesh,2011,2011Bangladesh,0,14,11,101,7,0,133,5,13,13,711,21,0,763,896
2145,Bangladesh,2011,2011Bangladesh,5,0,0,12,0,0,17,5,0,0,28,0,0,33,50
2146,Bangladesh,2012,2012Bangladesh,0,0,0,0,0,0,0,0,0,0,0,0,0,0,4298
2147,Bangladesh,2012,2012Bangladesh,0,0,0,0,0,0,0,0,0,0,0,0,8,8,8
2148,Bangladesh,2012,2012Bangladesh,0,0,0,0,0,0,0,0,0,0,5,0,0,5,10
2149,Bangladesh,2012,2012Bangladesh,0,0,0,0,0,0,0,0,0,0,6,0,0,6,6
2150,Bangladesh,2012,2012Bangladesh,0,0,0,0,0,0,0,0,5,0,0,0,0,5,5
2151,Bangladesh,2012,2012Bangladesh,0,0,0,0,0,5,5,0,0,0,0,0,10,10,15
2152,Bangladesh,2012,2012Bangladesh,0,0,0,0,0,9,9,0,0,0,0,0,0,0,9
2153,Bangladesh,2012,2012Bangladesh,0,0,0,0,0,312,312,0,0,0,0,0,2522,2522,2834
2154,Bangladesh,2012,2012Bangladesh,0,0,0,5,0,0,5,0,0,0,6,0,0,6,16
2155,Bangladesh,2012,2012Bangladesh,0,0,5,8,0,0,13,0,0,0,17,0,0,17,1917
2156,Bangladesh,2012,2012Bangladesh,0,0,8,11,0,7,26,0,6,5,14,0,7,32,58
2157,Bangladesh,2012,2012Bangladesh,0,5,0,0,0,0,5,0,0,0,0,0,0,0,5
2158,Bangladesh,2012,2012Bangladesh,5,0,0,16,0,0,21,6,0,0,38,0,0,44,65
2159,Bangladesh,2012,2012Bangladesh,5,11,10,104,7,0,137,5,14,14,713,30,0,776,913
2160,Bangladesh,2013,2013Bangladesh,0,0,0,0,0,0,0,0,0,0,0,0,0,0,4306
2161,Bangladesh,2013,2013Bangladesh,0,0,0,0,0,0,0,0,0,0,5,0,0,5,15
2162,Bangladesh,2013,2013Bangladesh,0,0,0,0,0,0,0,0,0,0,6,0,0,6,6
2163,Bangladesh,2013,2013Bangladesh,0,0,0,0,0,0,0,0,5,0,0,0,0,5,5
2164,Bangladesh,2013,2013Bangladesh,0,0,0,0,0,0,0,5,0,0,0,0,0,5,5
2165,Bangladesh,2013,2013Bangladesh,0,0,0,0,0,5,5,0,0,0,0,0,7,7,12
2166,Bangladesh,2013,2013Bangladesh,0,0,0,0,0,5,5,0,0,0,0,0,10,10,15
2167,Bangladesh,2013,2013Bangladesh,0,0,0,0,0,387,387,0,0,0,0,0,2949,2949,3336
2168,Bangladesh,2013,2013Bangladesh,0,0,0,5,0,0,5,0,0,0,6,0,0,6,16
2169,Bangladesh,2013,2013Bangladesh,0,5,0,11,0,5,21,0,8,0,11,0,8,27,48
2170,Bangladesh,2013,2013Bangladesh,0,5,0,14,0,0,19,0,5,5,84,5,0,99,118
2171,Bangladesh,2013,2013Bangladesh,0,8,0,15,5,0,28,0,0,7,19,0,0,26,1764
2172,Bangladesh,2013,2013Bangladesh,7,0,0,18,0,0,25,7,0,0,42,0,0,49,74
2173,Bangladesh,2014,2014Bangladesh,0,0,0,0,0,0,0,0,0,0,0,0,0,0,4476
2174,Bangladesh,2014,2014Bangladesh,0,0,0,0,0,0,0,0,0,0,5,0,0,5,10
2175,Bangladesh,2014,2014Bangladesh,0,0,0,0,0,0,0,0,0,0,8,0,0,8,8
2176,Bangladesh,2014,2014Bangladesh,0,0,0,0,0,0,0,0,0,0,12,0,0,12,12
2177,Bangladesh,2014,2014Bangladesh,0,0,0,0,0,0,0,0,5,0,0,0,0,5,5
2178,Bangladesh,2014,2014Bangladesh,0,0,0,0,0,0,0,5,0,0,8,0,0,13,13
2179,Bangladesh,2014,2014Bangladesh,0,0,0,0,0,5,5,0,0,0,0,0,10,10,15
2180,Bangladesh,2014,2014Bangladesh,0,0,0,0,0,20,20,0,0,0,0,0,829,829,849
2181,Bangladesh,2014,2014Bangladesh,0,0,0,0,0,440,440,0,0,0,0,0,3277,3277,3717
2182,Bangladesh,2014,2014Bangladesh,0,5,0,10,0,7,22,0,6,0,14,0,12,32,54
2183,Bangladesh,2014,2014Bangladesh,0,5,0,15,0,0,20,0,5,5,117,6,0,133,153
2184,Bangladesh,2014,2014Bangladesh,7,12,7,69,0,0,95,11,12,7,102,8,0,140,1483
2185,Bangladesh,2014,2014Bangladesh,9,0,0,16,0,0,25,7,0,0,41,0,0,48,73
2186,Bangladesh,2015,2015Bangladesh,0,0,0,0,0,0,0,0,0,0,0,0,0,0,7792
2187,Bangladesh,2015,2015Bangladesh,0,0,0,0,0,0,0,0,0,0,5,0,0,5,15
2188,Bangladesh,2015,2015Bangladesh,0,0,0,0,0,0,0,0,0,0,10,0,0,10,10
2189,Bangladesh,2015,2015Bangladesh,0,0,0,0,0,0,0,0,0,0,13,0,0,13,13
2190,Bangladesh,2015,2015Bangladesh,0,0,0,0,0,0,0,0,5,0,0,0,0,5,5
2191,Bangladesh,2015,2015Bangladesh,0,0,0,0,0,0,0,5,0,0,10,0,0,15,15
2192,Bangladesh,2015,2015Bangladesh,0,0,0,0,0,5,5,0,0,0,0,0,14,14,19
2193,Bangladesh,2015,2015Bangladesh,0,0,0,0,0,493,493,0,0,0,0,0,3467,3467,3960
2194,Bangladesh,2015,2015Bangladesh,0,5,0,22,0,0,27,0,9,0,145,5,0,159,186
2195,Bangladesh,2015,2015Bangladesh,0,6,0,9,0,0,15,0,8,0,33,0,0,41,56
2196,Bangladesh,2015,2015Bangladesh,6,5,0,23,0,0,34,8,0,0,41,0,0,49,83
2197,Bangladesh,2016,2016Bangladesh,0,0,0,0,0,0,0,0,0,0,0,0,0,0,7549
2198,Bangladesh,2016,2016Bangladesh,0,0,0,0,0,0,0,0,0,0,0,0,18,18,18
2199,Bangladesh,2016,2016Bangladesh,0,0,0,0,0,0,0,0,0,0,5,0,0,5,10
2200,Bangladesh,2016,2016Bangladesh,0,0,0,0,0,0,0,0,0,0,8,0,0,8,8
2201,Bangladesh,2016,2016Bangladesh,0,0,0,0,0,0,0,0,0,0,10,0,0,10,10
2202,Bangladesh,2016,2016Bangladesh,0,0,0,0,0,0,0,5,5,0,0,0,0,10,10
2203,Bangladesh,2016,2016Bangladesh,0,0,0,0,0,0,0,6,0,0,0,0,0,6,6
2204,Bangladesh,2016,2016Bangladesh,0,0,0,0,0,5,5,0,0,0,0,0,323,323,328
2205,Bangladesh,2016,2016Bangladesh,0,0,0,0,0,630,630,0,0,0,0,0,3981,3981,4611
2206,Bangladesh,2016,2016Bangladesh,0,0,0,5,0,0,5,0,0,0,7,0,0,7,12
2207,Bangladesh,2016,2016Bangladesh,0,0,0,5,0,0,5,5,0,0,5,0,0,10,20
2208,Bangladesh,2016,2016Bangladesh,0,0,0,6,0,0,6,0,0,0,19,0,0,19,25
2209,Bangladesh,2016,2016Bangladesh,0,0,0,22,0,0,22,0,0,0,48,6,0,54,799
2210,Bangladesh,2016,2016Bangladesh,0,5,0,9,0,9,23,0,0,8,18,0,13,39,62
2211,Bangladesh,2016,2016Bangladesh,5,7,0,32,0,0,44,0,7,5,221,7,0,240,284
2212,Bangladesh,2016,2016Bangladesh,10,5,0,22,0,0,37,6,5,0,42,0,0,53,90
2213,Bangladesh,2017,2017Bangladesh,0,0,0,0,0,0,0,0,0,0,0,0,0,0,10457
2214,Bangladesh,2017,2017Bangladesh,0,0,0,0,0,0,0,0,0,0,5,0,0,5,10
2215,Bangladesh,2017,2017Bangladesh,0,0,0,0,0,0,0,0,0,0,10,0,0,10,10
2216,Bangladesh,2017,2017Bangladesh,0,0,0,0,0,0,0,0,0,6,0,0,0,6,6
2217,Bangladesh,2017,2017Bangladesh,0,0,0,0,0,6,6,0,0,0,0,0,313,313,319
2218,Bangladesh,2017,2017Bangladesh,0,0,0,0,0,757,757,0,0,0,0,0,4403,4403,5160
2219,Bangladesh,2017,2017Bangladesh,0,0,0,5,0,0,5,0,0,0,7,0,0,7,12
2220,Bangladesh,2017,2017Bangladesh,0,0,0,7,0,0,7,0,0,0,23,0,0,23,30
2221,Bangladesh,2017,2017Bangladesh,0,5,0,0,0,0,5,0,5,0,6,0,0,11,27
2222,Bangladesh,2017,2017Bangladesh,0,5,0,7,0,15,27,0,0,6,13,5,11,35,62
2223,Bangladesh,2017,2017Bangladesh,11,11,5,61,5,0,93,11,13,8,456,8,0,496,589
2224,Bangladesh,2017,2017Bangladesh,18,5,0,24,0,0,47,5,5,0,41,0,0,51,98
2225,Bangladesh,2018,2018Bangladesh,0,0,0,0,0,0,0,0,0,0,0,0,0,0,13396
2226,Bangladesh,2018,2018Bangladesh,0,0,0,0,0,0,0,0,0,0,0,0,5,5,5
2227,Bangladesh,2018,2018Bangladesh,0,0,0,0,0,0,0,0,0,0,5,0,0,5,10
2228,Bangladesh,2018,2018Bangladesh,0,0,0,0,0,0,0,0,0,6,0,0,0,6,6
2229,Bangladesh,2018,2018Bangladesh,0,0,0,0,0,870,870,0,0,0,0,0,4761,4761,5631
2230,Bangladesh,2018,2018Bangladesh,0,0,0,5,0,0,5,0,0,0,5,0,0,5,10
2231,Bangladesh,2018,2018Bangladesh,0,0,0,9,0,0,9,0,0,0,25,0,0,25,34
2232,Bangladesh,2018,2018Bangladesh,0,0,5,0,0,0,5,0,0,0,0,0,0,0,5
2233,Bangladesh,2018,2018Bangladesh,0,5,0,0,0,0,5,0,5,0,21,0,0,26,31
2234,Bangladesh,2018,2018Bangladesh,0,5,0,7,0,11,23,0,0,7,15,0,15,37,60
2235,Bangladesh,2018,2018Bangladesh,6,32,23,102,0,0,163,5,30,14,90,7,0,146,1020
2236,Bangladesh,2018,2018Bangladesh,15,14,6,74,5,0,114,12,18,12,539,11,0,592,706
2237,Bangladesh,2018,2018Bangladesh,19,9,0,21,0,0,49,5,6,0,48,0,0,59,108
2238,Bangladesh,2019,2019Bangladesh,0,0,0,0,0,0,0,0,0,0,0,0,0,0,15628
2239,Bangladesh,2019,2019Bangladesh,0,0,0,0,0,0,0,0,0,0,0,0,5,5,5
2240,Bangladesh,2019,2019Bangladesh,0,0,0,0,0,0,0,0,0,0,5,0,0,5,15
2241,Bangladesh,2019,2019Bangladesh,0,0,0,0,0,0,0,0,0,0,6,0,0,6,12
2242,Bangladesh,2019,2019Bangladesh,0,0,0,0,0,0,0,0,0,0,14,0,0,14,28
2243,Bangladesh,2019,2019Bangladesh,0,0,0,0,0,0,0,0,0,6,0,0,0,6,6
2244,Bangladesh,2019,2019Bangladesh,0,0,0,0,0,989,989,0,0,0,0,0,5167,5167,6156
2245,Bangladesh,2019,2019Bangladesh,0,0,0,5,0,0,5,0,5,0,29,0,0,34,39
2246,Bangladesh,2019,2019Bangladesh,0,0,0,10,0,0,10,0,0,6,13,0,0,19,54
2247,Bangladesh,2019,2019Bangladesh,5,0,0,12,0,0,17,5,0,0,35,0,0,40,57
2248,Bangladesh,2019,2019Bangladesh,16,16,8,81,5,0,126,15,20,15,577,13,0,640,766
2249,Bangladesh,2020,2020Bangladesh,0,0,0,0,0,0,0,0,0,0,0,0,0,0,16225
2250,Bangladesh,2020,2020Bangladesh,0,0,0,0,0,0,0,0,0,0,0,0,5,5,5
2251,Bangladesh,2020,2020Bangladesh,0,0,0,0,0,0,0,0,0,0,5,0,0,5,15
2252,Bangladesh,2020,2020Bangladesh,0,0,0,0,0,0,0,0,0,0,7,0,0,7,14
2253,Bangladesh,2020,2020Bangladesh,0,0,0,0,0,0,0,0,0,0,12,0,0,12,12
2254,Bangladesh,2020,2020Bangladesh,0,0,0,0,0,0,0,0,0,0,15,0,0,15,15
2255,Bangladesh,2020,2020Bangladesh,0,0,0,0,0,0,0,0,6,0,0,0,0,6,6
2256,Bangladesh,2020,2020Bangladesh,0,0,0,0,0,5,5,0,0,0,0,0,6,6,11
2257,Bangladesh,2020,2020Bangladesh,0,0,0,0,0,5,5,0,0,0,0,0,16,16,21
2258,Bangladesh,2020,2020Bangladesh,0,0,0,0,0,57,57,0,0,0,0,0,71,71,128
2259,Bangladesh,2020,2020Bangladesh,0,0,0,5,0,0,5,0,5,0,28,0,0,33,38
2260,Bangladesh,2020,2020Bangladesh,0,0,0,7,0,0,7,0,0,0,195,0,0,195,202
2261,Bangladesh,2020,2020Bangladesh,0,0,0,8,0,0,8,0,0,0,0,0,0,0,8
2262,Bangladesh,2020,2020Bangladesh,0,0,0,9,0,0,9,0,0,5,9,5,0,19,49
2263,Bangladesh,2020,2020Bangladesh,0,0,0,35,0,28,63,0,0,0,44,0,47,91,1288
2264,Bangladesh,2020,2020Bangladesh,0,5,0,0,0,0,5,0,0,0,14,0,0,14,19
2265,Bangladesh,2020,2020Bangladesh,5,5,0,19,0,0,29,6,0,0,61,0,0,67,96
2266,Bangladesh,2020,2020Bangladesh,16,20,9,85,5,0,135,18,19,17,596,11,0,661,796
2267,Bangladesh,2021,2021Bangladesh,0,0,0,0,0,0,0,0,0,0,0,0,0,0,19523
2268,Bangladesh,2021,2021Bangladesh,0,0,0,0,0,0,0,0,0,0,0,0,5,5,5
2269,Bangladesh,2021,2021Bangladesh,0,0,0,0,0,0,0,0,0,0,5,0,0,5,15
2270,Bangladesh,2021,2021Bangladesh,0,0,0,0,0,0,0,0,0,0,7,0,0,7,7
2271,Bangladesh,2021,2021Bangladesh,0,0,0,0,0,0,0,0,0,0,15,0,0,15,15
2272,Bangladesh,2021,2021Bangladesh,0,0,0,0,0,0,0,0,6,0,0,0,0,6,6
2273,Bangladesh,2021,2021Bangladesh,0,0,0,5,0,0,5,0,0,0,5,0,0,5,10
2274,Bangladesh,2021,2021Bangladesh,0,0,0,5,0,0,5,0,0,0,6,0,0,6,11
2275,Bangladesh,2021,2021Bangladesh,0,0,0,5,0,0,5,0,0,0,8,0,0,8,13
2276,Bangladesh,2021,2021Bangladesh,0,0,0,5,0,0,5,0,5,0,22,5,0,32,37
2277,Bangladesh,2021,2021Bangladesh,0,0,0,7,0,0,7,0,0,0,193,0,0,193,200
2278,Bangladesh,2021,2021Bangladesh,0,0,0,7,0,0,7,0,0,5,7,5,0,17,43
2279,Bangladesh,2021,2021Bangladesh,0,0,0,8,0,0,8,0,0,0,0,0,0,0,8
2280,Bangladesh,2021,2021Bangladesh,0,5,0,0,0,0,5,0,0,0,0,0,0,0,5
2281,Bangladesh,2021,2021Bangladesh,0,5,0,0,0,0,5,0,0,0,12,0,0,12,17
2282,Bangladesh,2021,2021Bangladesh,5,7,0,19,0,0,31,0,6,0,64,0,0,70,101
2283,Bangladesh,2021,2021Bangladesh,5,38,20,193,11,28,295,10,34,30,325,11,47,457,1840
2284,Bangladesh,2021,2021Bangladesh,17,21,12,93,0,0,143,15,24,19,601,14,0,673,816
2285,Belarus,2001,2001Belarus,0,0,0,0,0,0,0,0,0,0,0,0,0,0,3611
2286,Belarus,2001,2001Belarus,0,0,0,0,0,0,0,0,0,0,0,0,9,9,9
2287,Belarus,2001,2001Belarus,0,0,0,0,0,30,30,0,0,0,0,0,36,36,66
2288,Belarus,2001,2001Belarus,0,5,0,0,0,0,5,0,0,0,0,0,0,0,5
2289,Belarus,2002,2002Belarus,0,0,0,0,0,0,0,0,0,0,0,0,0,0,6271
2290,Belarus,2002,2002Belarus,0,0,0,0,0,5,5,0,0,0,0,0,0,0,5
2291,Belarus,2002,2002Belarus,0,0,0,0,0,36,36,0,0,0,0,0,49,49,85
2292,Belarus,2002,2002Belarus,0,5,0,0,0,0,5,0,0,0,0,0,0,0,5
2293,Belarus,2003,2003Belarus,0,0,0,0,0,0,0,0,0,0,0,0,0,0,7586
2294,Belarus,2003,2003Belarus,0,0,0,0,0,5,5,0,0,0,0,0,0,0,5
2295,Belarus,2003,2003Belarus,0,0,0,0,0,67,67,0,0,0,0,0,85,85,152
2296,Belarus,2003,2003Belarus,0,0,0,5,0,0,5,0,0,0,0,0,9,9,69
2297,Belarus,2003,2003Belarus,0,5,0,0,0,0,5,0,0,0,0,0,0,0,5
2298,Belarus,2004,2004Belarus,0,0,0,0,0,0,0,0,0,0,0,0,0,0,8216
2299,Belarus,2004,2004Belarus,0,0,0,0,0,0,0,0,0,0,5,0,0,5,5
2300,Belarus,2004,2004Belarus,0,5,0,0,0,0,5,0,0,0,0,0,0,0,5
2301,Belarus,2005,2005Belarus,0,0,0,0,0,0,0,0,0,0,0,0,0,0,8531
2302,Belarus,2005,2005Belarus,0,0,0,0,0,0,0,0,0,0,9,0,0,9,9
2303,Belarus,2005,2005Belarus,0,0,0,0,0,141,141,0,0,0,0,0,163,163,304
2304,Belarus,2005,2005Belarus,0,5,0,0,0,0,5,0,0,0,0,0,0,0,5
2305,Belarus,2006,2006Belarus,0,0,0,0,0,0,0,0,0,0,0,0,0,0,8819
2306,Belarus,2006,2006Belarus,0,0,0,0,0,0,0,0,0,0,5,0,0,5,5
2307,Belarus,2006,2006Belarus,0,0,0,0,0,6,6,0,0,0,0,0,9,9,15
2308,Belarus,2006,2006Belarus,0,0,0,0,0,72,72,0,0,0,0,0,98,98,170
2309,Belarus,2006,2006Belarus,0,0,0,0,0,164,164,0,0,0,0,0,190,190,354
2310,Belarus,2006,2006Belarus,0,0,5,0,0,0,5,0,0,0,0,0,0,0,5
2311,Belarus,2007,2007Belarus,0,0,0,0,0,0,0,0,0,0,0,0,0,0,4374
2312,Belarus,2007,2007Belarus,0,0,0,0,0,0,0,0,0,0,8,0,0,8,8
2313,Belarus,2007,2007Belarus,0,0,0,0,0,61,61,0,0,0,0,0,98,98,159
2314,Belarus,2007,2007Belarus,0,0,0,0,0,179,179,0,0,0,0,0,212,212,391
2315,Belarus,2007,2007Belarus,0,0,5,0,0,0,5,0,0,0,0,0,0,0,5
2316,Belarus,2007,2007Belarus,0,5,0,5,0,0,10,0,0,7,7,0,0,14,24
2317,Belarus,2008,2008Belarus,0,0,0,0,0,0,0,0,0,0,0,0,0,0,4793
2318,Belarus,2008,2008Belarus,0,0,0,0,0,0,0,0,0,0,8,0,0,8,16
2319,Belarus,2008,2008Belarus,0,0,0,0,0,52,52,0,0,0,0,0,72,72,124
2320,Belarus,2008,2008Belarus,0,0,0,0,0,185,185,0,0,0,0,0,228,228,413
2321,Belarus,2008,2008Belarus,0,0,5,0,0,0,5,0,0,0,0,0,0,0,5
2322,Belarus,2008,2008Belarus,0,5,0,5,0,0,10,0,5,0,5,0,5,15,25
2323,Belarus,2009,2009Belarus,0,0,0,0,0,0,0,0,0,0,0,0,0,0,3659
2324,Belarus,2009,2009Belarus,0,0,0,0,0,0,0,0,0,0,7,0,0,7,7
2325,Belarus,2009,2009Belarus,0,0,0,0,0,45,45,0,0,0,0,0,63,63,108
2326,Belarus,2009,2009Belarus,0,0,0,5,0,0,5,0,0,0,13,0,0,13,18
2327,Belarus,2009,2009Belarus,0,0,0,8,0,0,8,0,0,0,0,0,0,0,8
2328,Belarus,2009,2009Belarus,0,5,0,5,0,0,10,0,7,0,7,0,0,14,24
2329,Belarus,2009,2009Belarus,10,58,80,644,112,0,904,9,50,86,557,88,0,790,1694
2330,Belarus,2010,2010Belarus,0,0,0,0,0,0,0,0,0,0,0,0,0,0,3299
2331,Belarus,2010,2010Belarus,0,0,0,0,0,0,0,0,0,0,5,0,0,5,5
2332,Belarus,2010,2010Belarus,0,0,0,0,0,0,0,0,0,0,7,0,0,7,7
2333,Belarus,2010,2010Belarus,0,0,0,0,0,0,0,0,0,7,0,0,0,7,7
2334,Belarus,2010,2010Belarus,0,0,0,0,0,5,5,0,0,0,0,0,16,16,21
2335,Belarus,2010,2010Belarus,0,0,0,0,0,30,30,0,0,0,0,0,46,46,76
2336,Belarus,2010,2010Belarus,0,0,0,0,0,200,200,0,0,0,0,0,241,241,441
2337,Belarus,2010,2010Belarus,0,0,0,8,0,0,8,0,0,0,0,0,0,0,8
2338,Belarus,2010,2010Belarus,0,0,6,7,0,0,13,0,6,0,5,0,5,16,29
2339,Belarus,2010,2010Belarus,11,55,69,704,140,0,979,6,49,76,630,102,0,863,1842
2340,Belarus,2011,2011Belarus,0,0,0,0,0,0,0,0,0,0,0,0,0,0,3128
2341,Belarus,2011,2011Belarus,0,0,0,0,0,0,0,0,0,0,5,0,0,5,5
2342,Belarus,2011,2011Belarus,0,0,0,0,0,0,0,0,0,0,7,0,0,7,7
2343,Belarus,2011,2011Belarus,0,0,0,0,0,0,0,0,0,7,0,0,0,7,7
2344,Belarus,2011,2011Belarus,0,0,0,0,0,21,21,0,0,0,0,0,42,42,63
2345,Belarus,2011,2011Belarus,0,0,0,0,0,209,209,0,0,0,0,0,246,246,455
2346,Belarus,2011,2011Belarus,0,0,0,8,0,0,8,0,0,0,0,0,0,0,8
2347,Belarus,2011,2011Belarus,0,0,0,14,0,0,14,0,0,0,12,0,0,12,311
2348,Belarus,2011,2011Belarus,0,0,6,7,0,0,13,0,5,0,5,0,5,15,28
2349,Belarus,2011,2011Belarus,9,48,70,732,151,0,1010,5,43,81,651,114,0,894,1904
2350,Belarus,2012,2012Belarus,0,0,0,0,0,0,0,0,0,0,0,0,0,0,2968
2351,Belarus,2012,2012Belarus,0,0,0,0,0,0,0,0,0,0,6,0,0,6,6
2352,Belarus,2012,2012Belarus,0,0,0,0,0,0,0,0,0,0,7,0,0,7,7
2353,Belarus,2012,2012Belarus,0,0,0,0,0,0,0,0,0,0,8,0,0,8,300
2354,Belarus,2012,2012Belarus,0,0,0,0,0,0,0,0,0,7,0,0,0,7,7
2355,Belarus,2012,2012Belarus,0,0,0,0,0,0,0,5,0,0,7,0,0,12,27
2356,Belarus,2012,2012Belarus,0,0,0,0,0,5,5,0,0,0,0,0,16,16,21
2357,Belarus,2012,2012Belarus,0,0,0,0,0,13,13,0,0,0,0,0,32,32,45
2358,Belarus,2012,2012Belarus,0,0,0,0,0,110,110,0,0,0,0,0,192,192,302
2359,Belarus,2012,2012Belarus,0,0,0,0,0,217,217,0,0,0,0,0,254,254,471
2360,Belarus,2012,2012Belarus,0,0,0,8,0,0,8,0,0,0,0,0,0,0,8
2361,Belarus,2012,2012Belarus,0,0,6,7,0,0,13,0,5,0,6,0,6,17,30
2362,Belarus,2012,2012Belarus,8,43,75,757,165,0,1048,5,34,99,677,126,0,941,1989
2363,Belarus,2013,2013Belarus,0,0,0,0,0,0,0,0,0,0,0,0,0,0,3290
2364,Belarus,2013,2013Belarus,0,0,0,0,0,0,0,0,0,0,7,0,0,7,14
2365,Belarus,2013,2013Belarus,0,0,0,0,0,0,0,0,0,0,8,0,0,8,268
2366,Belarus,2013,2013Belarus,0,0,0,0,0,0,0,0,0,7,0,0,0,7,7
2367,Belarus,2013,2013Belarus,0,0,0,0,0,0,0,5,0,0,13,0,0,18,30
2368,Belarus,2013,2013Belarus,0,0,0,0,0,11,11,0,0,0,0,0,32,32,43
2369,Belarus,2013,2013Belarus,0,0,0,0,0,230,230,0,0,0,0,0,261,261,491
2370,Belarus,2013,2013Belarus,0,0,0,7,0,6,13,0,0,0,6,0,9,15,28
2371,Belarus,2013,2013Belarus,0,0,0,8,0,0,8,0,0,0,0,0,0,0,8
2372,Belarus,2013,2013Belarus,0,0,0,22,0,0,22,0,0,0,26,5,0,31,53
2373,Belarus,2013,2013Belarus,0,5,10,49,6,0,70,0,7,16,52,10,0,85,155
2374,Belarus,2014,2014Belarus,0,0,0,0,0,0,0,0,0,0,0,0,0,0,3543
2375,Belarus,2014,2014Belarus,0,0,0,0,0,0,0,0,0,0,0,0,6,6,6
2376,Belarus,2014,2014Belarus,0,0,0,0,0,0,0,0,0,0,7,0,0,7,14
2377,Belarus,2014,2014Belarus,0,0,0,0,0,0,0,0,0,7,0,0,0,7,7
2378,Belarus,2014,2014Belarus,0,0,0,0,0,235,235,0,0,0,0,0,267,267,502
2379,Belarus,2014,2014Belarus,0,0,5,5,0,5,15,0,0,0,6,0,12,18,33
2380,Belarus,2014,2014Belarus,0,6,13,50,7,0,76,5,5,12,48,9,0,79,155
2381,Belarus,2014,2014Belarus,5,0,0,0,0,0,5,0,0,0,0,0,0,0,5
2382,Belarus,2014,2014Belarus,5,0,0,0,0,0,5,0,0,0,7,0,0,7,31
2383,Belarus,2015,2015Belarus,0,0,0,0,0,0,0,0,0,0,0,0,0,0,3230
2384,Belarus,2015,2015Belarus,0,0,0,0,0,0,0,0,0,0,0,0,7,7,7
2385,Belarus,2015,2015Belarus,0,0,0,0,0,0,0,0,0,0,7,0,0,7,7
2386,Belarus,2015,2015Belarus,0,0,0,0,0,0,0,0,0,7,0,0,0,7,7
2387,Belarus,2015,2015Belarus,0,0,0,0,0,0,0,5,6,0,0,0,0,11,33
2388,Belarus,2015,2015Belarus,0,0,0,0,0,5,5,0,0,0,0,0,15,15,20
2389,Belarus,2015,2015Belarus,0,0,0,0,0,18,18,0,0,0,0,0,30,30,48
2390,Belarus,2015,2015Belarus,0,0,0,0,0,242,242,0,0,0,0,0,273,273,515
2391,Belarus,2015,2015Belarus,0,0,0,9,0,12,21,0,0,0,9,0,5,14,40
2392,Belarus,2015,2015Belarus,0,0,0,21,0,0,21,0,0,0,25,5,0,30,51
2393,Belarus,2015,2015Belarus,0,0,5,0,0,0,5,0,0,0,0,0,0,0,5
2394,Belarus,2015,2015Belarus,0,5,10,53,8,0,76,0,5,15,47,11,0,78,154
2395,Belarus,2016,2016Belarus,0,0,0,0,0,0,0,0,0,0,0,0,0,0,2884
2396,Belarus,2016,2016Belarus,0,0,0,0,0,0,0,0,0,0,0,0,7,7,7
2397,Belarus,2016,2016Belarus,0,0,0,0,0,0,0,0,0,7,0,0,0,7,7
2398,Belarus,2016,2016Belarus,0,0,0,0,0,5,5,0,0,0,0,0,20,20,25
2399,Belarus,2016,2016Belarus,0,0,0,0,0,15,15,0,0,0,0,0,26,26,41
2400,Belarus,2016,2016Belarus,0,0,0,0,0,249,249,0,0,0,0,0,275,275,524
2401,Belarus,2016,2016Belarus,0,0,0,5,0,0,5,0,0,0,0,0,0,0,99
2402,Belarus,2016,2016Belarus,0,0,0,11,0,7,18,0,7,0,7,0,11,25,43
2403,Belarus,2016,2016Belarus,0,0,0,18,0,0,18,0,0,0,26,0,0,26,44
2404,Belarus,2016,2016Belarus,0,5,6,58,8,0,77,5,0,9,49,12,0,75,152
2405,Belarus,2016,2016Belarus,5,0,0,0,0,0,5,0,0,0,0,0,0,0,5
2406,Belarus,2017,2017Belarus,0,0,0,0,0,0,0,0,0,0,0,0,0,0,2828
2407,Belarus,2017,2017Belarus,0,0,0,0,0,0,0,0,0,7,0,0,0,7,7
2408,Belarus,2017,2017Belarus,0,0,0,0,0,0,0,0,5,0,0,0,0,5,5
2409,Belarus,2017,2017Belarus,0,0,0,0,0,5,5,0,0,0,0,0,21,21,26
2410,Belarus,2017,2017Belarus,0,0,0,0,0,246,246,0,0,0,0,0,268,268,514
2411,Belarus,2017,2017Belarus,0,0,0,11,0,11,22,0,7,0,7,0,7,21,43
2412,Belarus,2017,2017Belarus,0,0,0,18,0,0,18,0,0,0,25,0,0,25,43
2413,Belarus,2017,2017Belarus,0,5,0,0,0,0,5,0,0,0,0,0,0,0,5
2414,Belarus,2017,2017Belarus,5,10,5,69,7,0,96,7,5,7,51,13,0,83,179
2415,Belarus,2018,2018Belarus,0,0,0,0,0,0,0,0,0,0,0,0,0,0,2659
2416,Belarus,2018,2018Belarus,0,0,0,0,0,245,245,0,0,0,0,0,264,264,509
2417,Belarus,2018,2018Belarus,0,0,0,9,0,0,9,0,0,0,13,0,0,13,22
2418,Belarus,2018,2018Belarus,0,0,5,0,0,0,5,0,0,0,0,0,0,0,5
2419,Belarus,2018,2018Belarus,0,5,0,8,0,7,20,0,7,0,8,0,11,26,46
2420,Belarus,2018,2018Belarus,0,14,5,69,9,0,97,7,8,0,61,13,0,89,186
2421,Belarus,2018,2018Belarus,5,0,0,0,0,0,5,0,0,0,0,0,0,0,5
2422,Belarus,2018,2018Belarus,6,0,0,11,0,0,17,0,7,0,0,0,0,7,94
2423,Belarus,2019,2019Belarus,0,0,0,0,0,0,0,0,0,0,0,0,0,0,2600
2424,Belarus,2019,2019Belarus,0,0,0,0,0,0,0,0,0,0,5,0,0,5,5
2425,Belarus,2019,2019Belarus,0,0,0,0,0,5,5,0,0,0,0,0,19,19,24
2426,Belarus,2019,2019Belarus,0,0,0,0,0,251,251,0,0,0,0,0,273,273,524
2427,Belarus,2019,2019Belarus,0,0,0,8,0,0,8,0,0,0,14,0,0,14,22
2428,Belarus,2019,2019Belarus,0,5,0,0,0,0,5,0,0,0,0,0,0,0,5
2429,Belarus,2019,2019Belarus,0,6,0,12,0,0,18,0,0,8,9,0,0,17,52
2430,Belarus,2019,2019Belarus,5,11,5,66,12,0,99,5,11,0,64,14,0,94,193
2431,Belarus,2020,2020Belarus,0,0,0,0,0,0,0,0,0,0,0,0,0,0,2802
2432,Belarus,2020,2020Belarus,0,0,0,0,0,0,0,0,0,0,5,0,0,5,5
2433,Belarus,2020,2020Belarus,0,0,0,0,0,5,5,0,0,0,0,0,21,21,26
2434,Belarus,2020,2020Belarus,0,0,0,0,0,15,15,0,0,0,0,0,26,26,41
2435,Belarus,2020,2020Belarus,0,0,0,7,0,0,7,0,0,0,12,0,0,12,19
2436,Belarus,2020,2020Belarus,0,5,0,0,0,0,5,0,0,0,0,0,0,0,5
2437,Belarus,2020,2020Belarus,0,6,0,12,0,0,18,0,0,8,10,0,0,18,54
2438,Belarus,2020,2020Belarus,0,14,6,66,11,0,97,0,11,5,59,15,0,90,187
2439,Belarus,2021,2021Belarus,0,0,0,0,0,0,0,0,0,0,0,0,0,0,4099
2440,Belarus,2021,2021Belarus,0,0,0,0,0,0,0,0,0,0,5,0,0,5,5
2441,Belarus,2021,2021Belarus,0,0,0,0,0,9,9,0,0,0,0,0,34,34,43
2442,Belarus,2021,2021Belarus,0,0,0,0,0,66,66,0,0,0,0,0,103,103,169
2443,Belarus,2021,2021Belarus,0,0,0,5,0,0,5,0,0,0,8,0,0,8,46
2444,Belarus,2021,2021Belarus,0,0,0,7,0,0,7,0,0,0,11,0,0,11,18
2445,Belarus,2021,2021Belarus,0,0,5,11,0,0,16,0,0,7,9,0,0,16,52
2446,Belarus,2021,2021Belarus,0,5,0,0,0,0,5,0,0,0,0,0,0,0,5
2447,Belarus,2021,2021Belarus,0,13,10,66,12,0,101,0,15,5,55,19,0,94,195
2448,Bhutan,2001,2001Bhutan,0,0,0,0,0,0,0,0,0,0,0,0,0,0,50
2449,Bhutan,2001,2001Bhutan,0,0,0,0,0,5,5,0,0,0,0,0,9,9,14
2450,Bhutan,2001,2001Bhutan,4480,9150,7842,25628,2231,5000,54331,4617,9393,8055,26355,3029,5000,56449,110780
2451,Bhutan,2002,2002Bhutan,0,0,0,0,0,0,0,0,0,0,0,0,0,0,245
2452,Bhutan,2002,2002Bhutan,0,0,0,0,0,5,5,0,0,0,0,0,11,11,16
2453,Bhutan,2002,2002Bhutan,4466,8996,7708,26626,2296,5000,55092,4812,9177,7867,27444,2871,5000,57171,112263
2454,Bhutan,2003,2003Bhutan,0,0,0,0,0,0,0,0,0,0,0,0,0,0,310
2455,Bhutan,2003,2003Bhutan,0,0,0,0,0,5,5,0,0,0,0,0,12,12,17
2456,Bhutan,2003,2003Bhutan,3805,8671,7433,23962,2456,4560,50887,4051,8896,7625,24634,2997,4560,52763,103650
2457,Bhutan,2004,2004Bhutan,0,0,0,0,0,0,0,0,0,0,0,0,0,0,344
2458,Bhutan,2004,2004Bhutan,4112,8546,7325,28596,2780,20,51379,4352,8771,7518,29448,3447,0,53536,104915
2459,Bhutan,2005,2005Bhutan,0,0,0,0,0,0,0,0,0,0,0,0,0,0,272
2460,Bhutan,2005,2005Bhutan,0,0,0,0,0,5,5,0,0,0,0,0,14,14,19
2461,Bhutan,2005,2005Bhutan,4813,8569,7344,28605,2695,0,52026,5126,8789,7534,29419,3354,0,54222,106248
2462,Bhutan,2006,2006Bhutan,0,0,0,0,0,0,0,0,0,0,0,0,0,0,246
2463,Bhutan,2006,2006Bhutan,0,0,0,0,0,5,5,0,0,0,0,0,15,15,20
2464,Bhutan,2006,2006Bhutan,3698,7369,7330,31151,3215,0,52763,4158,7883,7393,31822,3784,0,55040,107803
2465,Bhutan,2007,2007Bhutan,0,0,0,0,0,0,0,0,0,0,0,0,0,0,255
2466,Bhutan,2007,2007Bhutan,0,0,0,0,0,0,0,0,0,0,0,0,5,5,5
2467,Bhutan,2007,2007Bhutan,0,0,0,0,0,5,5,0,0,0,0,0,18,18,23
2468,Bhutan,2007,2007Bhutan,3992,6647,6742,31119,3393,1222,53115,4212,6949,6910,31471,3932,1221,54695,110310
2469,Bhutan,2008,2008Bhutan,0,0,0,0,0,0,0,0,0,0,0,0,0,0,337
2470,Bhutan,2008,2008Bhutan,0,0,0,0,0,0,0,0,0,0,5,0,0,5,5
2471,Bhutan,2008,2008Bhutan,0,0,0,0,0,7,7,0,0,0,0,0,24,24,31
2472,Bhutan,2008,2008Bhutan,3826,6004,6138,29786,3228,1220,50202,4065,6310,6237,30286,3767,1220,51885,104587
2473,Bhutan,2009,2009Bhutan,0,0,0,0,0,0,0,0,0,0,0,0,0,0,756
2474,Bhutan,2009,2009Bhutan,0,0,0,0,0,0,0,0,0,0,5,0,0,5,5
2475,Bhutan,2009,2009Bhutan,0,5,0,14,0,0,19,0,0,7,72,0,0,79,98
2476,Bhutan,2009,2009Bhutan,3403,5040,5548,24524,2626,1119,42260,3615,5284,5667,24874,3090,1118,43648,88205
2477,Bhutan,2010,2010Bhutan,0,0,0,0,0,0,0,0,0,0,0,0,0,0,379
2478,Bhutan,2010,2010Bhutan,0,0,0,0,0,0,0,0,0,0,5,0,0,5,5
2479,Bhutan,2010,2010Bhutan,0,0,0,0,0,0,0,0,0,0,7,0,0,7,7
2480,Bhutan,2010,2010Bhutan,0,0,0,0,0,8,8,0,0,0,0,0,44,44,52
2481,Bhutan,2010,2010Bhutan,0,5,0,12,0,0,17,0,0,5,61,0,0,66,83
2482,Bhutan,2010,2010Bhutan,2954,4024,4535,20537,2283,1112,35445,3142,4199,4754,20839,2752,1111,36797,74536
2483,Bhutan,2011,2011Bhutan,0,0,0,0,0,0,0,0,0,0,0,0,0,0,425
2484,Bhutan,2011,2011Bhutan,0,0,0,0,0,0,0,0,0,0,5,0,0,5,5
2485,Bhutan,2011,2011Bhutan,0,0,0,0,0,0,0,0,0,0,7,0,0,7,7
2486,Bhutan,2011,2011Bhutan,0,0,0,0,0,9,9,0,0,0,0,0,58,58,67
2487,Bhutan,2011,2011Bhutan,0,0,5,5,0,0,10,0,0,0,8,0,0,8,18
2488,Bhutan,2011,2011Bhutan,0,5,0,10,0,0,15,0,0,5,57,0,0,62,77
2489,Bhutan,2011,2011Bhutan,2252,3138,3378,15176,1818,1144,26906,2320,3329,3617,15430,2249,1144,28089,57381
2490,Bhutan,2012,2012Bhutan,0,0,0,0,0,0,0,0,0,0,0,0,0,0,433
2491,Bhutan,2012,2012Bhutan,0,0,0,0,0,0,0,0,0,0,5,0,0,5,5
2492,Bhutan,2012,2012Bhutan,0,0,0,0,0,11,11,0,0,0,0,0,68,68,79
2493,Bhutan,2012,2012Bhutan,0,0,0,5,0,0,5,0,0,0,15,0,0,15,20
2494,Bhutan,2012,2012Bhutan,0,0,0,14,0,0,14,0,0,5,55,0,0,60,74
2495,Bhutan,2012,2012Bhutan,1808,2547,2483,11484,1462,0,19784,1862,2717,2704,12050,1854,0,21187,40971
2496,Bhutan,2013,2013Bhutan,0,0,0,0,0,0,0,0,0,0,0,0,0,0,395
2497,Bhutan,2013,2013Bhutan,0,0,0,0,0,15,15,0,0,0,0,0,87,87,102
2498,Bhutan,2013,2013Bhutan,0,0,0,6,0,0,6,0,0,0,23,0,0,23,29
2499,Bhutan,2013,2013Bhutan,0,0,0,7,0,0,7,0,0,0,24,0,0,24,31
2500,Bhutan,2013,2013Bhutan,0,5,0,0,0,0,5,0,0,0,0,0,0,0,22
2501,Bhutan,2013,2013Bhutan,1487,1892,1701,8732,1126,0,14938,1474,1999,1900,9235,1431,0,16039,30977
2502,Bhutan,2014,2014Bhutan,0,0,0,0,0,0,0,0,0,0,0,0,0,0,403
2503,Bhutan,2014,2014Bhutan,0,0,0,0,0,0,0,0,0,0,0,0,5,5,5
2504,Bhutan,2014,2014Bhutan,0,0,0,0,0,16,16,0,0,0,0,0,93,93,109
2505,Bhutan,2014,2014Bhutan,0,0,0,5,0,0,5,0,0,0,23,0,0,23,28
2506,Bhutan,2014,2014Bhutan,0,0,0,6,0,0,6,0,0,0,23,0,0,23,29
2507,Bhutan,2014,2014Bhutan,1132,1480,1258,6390,791,0,11051,1126,1589,1382,6861,1050,0,12008,23059
2508,Bhutan,2015,2015Bhutan,0,0,0,0,0,0,0,0,0,0,0,0,0,0,394
2509,Bhutan,2015,2015Bhutan,0,0,0,0,0,0,0,0,0,0,0,0,6,6,6
2510,Bhutan,2015,2015Bhutan,0,0,0,0,0,17,17,0,0,0,0,0,96,96,113
2511,Bhutan,2015,2015Bhutan,0,0,0,5,0,0,5,0,0,0,22,0,0,22,27
2512,Bhutan,2015,2015Bhutan,0,0,0,6,0,0,6,0,0,0,0,0,0,0,6
2513,Bhutan,2015,2015Bhutan,0,0,0,7,0,0,7,0,0,0,22,0,0,22,29
2514,Bhutan,2015,2015Bhutan,824,1170,964,4645,565,0,8168,875,1219,1017,5075,780,0,8966,17134
2515,Bhutan,2016,2016Bhutan,0,0,0,0,0,0,0,0,0,0,0,0,0,0,366
2516,Bhutan,2016,2016Bhutan,0,0,0,0,0,0,0,0,0,0,0,0,5,5,5
2517,Bhutan,2016,2016Bhutan,0,0,0,0,0,0,0,0,0,0,9,0,0,9,9
2518,Bhutan,2016,2016Bhutan,0,0,0,0,0,0,0,0,0,0,23,0,0,23,23
2519,Bhutan,2016,2016Bhutan,0,0,0,0,0,17,17,0,0,0,0,0,94,94,111
2520,Bhutan,2016,2016Bhutan,0,0,0,7,0,0,7,0,0,0,23,0,0,23,30
2521,Bhutan,2016,2016Bhutan,476,793,676,2928,444,0,5317,509,853,651,3272,611,0,5896,11213
2522,Bhutan,2017,2017Bhutan,0,0,0,0,0,0,0,0,0,0,0,0,0,0,384
2523,Bhutan,2017,2017Bhutan,0,0,0,0,0,0,0,0,0,0,21,0,0,21,21
2524,Bhutan,2017,2017Bhutan,0,0,0,0,0,18,18,0,0,0,0,0,99,99,117
2525,Bhutan,2017,2017Bhutan,0,0,0,5,0,0,5,0,0,0,5,0,0,5,10
2526,Bhutan,2017,2017Bhutan,266,497,415,1893,345,0,3416,312,547,415,2254,478,0,4006,7422
2527,Bhutan,2018,2018Bhutan,0,0,0,0,0,0,0,0,0,0,0,0,0,0,314
2528,Bhutan,2018,2018Bhutan,0,0,0,0,0,0,0,0,0,0,10,0,0,10,10
2529,Bhutan,2018,2018Bhutan,0,0,0,0,0,21,21,0,0,0,0,0,102,102,123
2530,Bhutan,2018,2018Bhutan,0,0,0,5,0,0,5,0,0,0,0,0,0,0,5
2531,Bhutan,2018,2018Bhutan,0,0,0,5,0,0,5,0,0,0,17,0,0,17,22
2532,Bhutan,2018,2018Bhutan,241,435,381,1711,307,0,3075,257,456,404,1989,445,0,3551,6626
2533,Bhutan,2019,2019Bhutan,0,0,0,0,0,0,0,0,0,0,0,0,0,0,287
2534,Bhutan,2019,2019Bhutan,0,0,0,0,0,0,0,0,0,0,10,0,0,10,10
2535,Bhutan,2019,2019Bhutan,0,0,0,0,0,22,22,0,0,0,0,0,104,104,126
2536,Bhutan,2019,2019Bhutan,0,0,0,5,0,0,5,0,0,0,15,0,0,15,20
2537,Bhutan,2019,2019Bhutan,224,400,357,1674,320,0,2975,235,428,389,1916,453,0,3421,6396
2538,Bhutan,2020,2020Bhutan,0,0,0,0,0,0,0,0,0,0,0,0,0,0,340
2539,Bhutan,2020,2020Bhutan,0,0,0,0,0,0,0,0,0,0,11,0,0,11,11
2540,Bhutan,2020,2020Bhutan,0,0,0,0,0,0,0,0,0,0,15,5,0,20,20
2541,Bhutan,2020,2020Bhutan,0,0,0,0,0,5,5,0,0,0,0,0,0,0,5
2542,Bhutan,2020,2020Bhutan,175,393,350,1717,322,0,2957,180,411,424,1939,454,0,3408,6365
2543,Bhutan,2021,2021Bhutan,0,0,0,0,0,0,0,0,0,0,0,0,0,0,306
2544,Bhutan,2021,2021Bhutan,0,0,0,0,0,0,0,0,0,0,10,0,0,10,10
2545,Bhutan,2021,2021Bhutan,0,0,0,0,0,0,0,0,0,0,16,5,0,21,21
2546,Bhutan,2021,2021Bhutan,125,370,346,1764,352,0,2957,126,387,417,1950,528,0,3408,6365
2547,Bosnia and Herzegovina,2001,2001Bosnia and Herzegovina,0,0,0,0,0,0,0,0,0,0,0,0,0,0,271136
2548,Bosnia and Herzegovina,2001,2001Bosnia and Herzegovina,0,0,0,0,0,0,0,0,0,0,5,0,0,5,15
2549,Bosnia and Herzegovina,2001,2001Bosnia and Herzegovina,0,0,0,0,0,0,0,0,0,0,6,0,0,6,6
2550,Bosnia and Herzegovina,2001,2001Bosnia and Herzegovina,0,0,0,0,0,79,79,0,0,0,0,0,94,94,173
2551,Bosnia and Herzegovina,2001,2001Bosnia and Herzegovina,0,0,0,0,0,694,694,0,0,0,0,0,647,647,1341
2552,Bosnia and Herzegovina,2001,2001Bosnia and Herzegovina,0,0,0,0,0,4277,4277,0,0,0,0,0,3766,3766,8043
2553,Bosnia and Herzegovina,2001,2001Bosnia and Herzegovina,0,0,0,5,0,0,5,0,0,0,0,0,0,0,5
2554,Bosnia and Herzegovina,2001,2001Bosnia and Herzegovina,0,0,0,6,0,0,6,0,0,0,0,5,0,5,11
2555,Bosnia and Herzegovina,2001,2001Bosnia and Herzegovina,0,0,0,14,5,0,19,0,0,0,16,0,0,16,55
2556,Bosnia and Herzegovina,2001,2001Bosnia and Herzegovina,0,0,5,0,0,0,5,0,0,0,0,0,0,0,5
2557,Bosnia and Herzegovina,2001,2001Bosnia and Herzegovina,0,0,5,0,0,0,5,0,8,0,0,0,0,8,13
2558,Bosnia and Herzegovina,2001,2001Bosnia and Herzegovina,0,0,7,16,7,0,30,0,0,6,21,5,0,32,627
2559,Bosnia and Herzegovina,2001,2001Bosnia and Herzegovina,58,125,118,892,330,0,1523,45,112,102,475,124,0,858,2381
2560,Bosnia and Herzegovina,2001,2001Bosnia and Herzegovina,99,810,695,5887,4182,502,12175,90,905,777,3573,2451,450,8246,20421
2561,Bosnia and Herzegovina,2001,2001Bosnia and Herzegovina,1476,7208,6178,49807,14922,0,79591,1507,7502,6431,37490,10504,0,63434,143094
2562,Bosnia and Herzegovina,2002,2002Bosnia and Herzegovina,0,0,0,0,0,0,0,0,0,0,0,0,0,0,388590
2563,Bosnia and Herzegovina,2002,2002Bosnia and Herzegovina,0,0,0,0,0,0,0,0,0,0,5,0,0,5,15
2564,Bosnia and Herzegovina,2002,2002Bosnia and Herzegovina,0,0,0,0,0,0,0,0,0,0,6,0,0,6,6
2565,Bosnia and Herzegovina,2002,2002Bosnia and Herzegovina,0,0,0,0,0,67,67,0,0,0,0,0,62,62,353
2566,Bosnia and Herzegovina,2002,2002Bosnia and Herzegovina,0,0,0,0,0,762,762,0,0,0,0,0,751,751,1513
2567,Bosnia and Herzegovina,2002,2002Bosnia and Herzegovina,0,0,0,0,0,2586,2586,0,0,0,0,0,2511,2511,7654
2568,Bosnia and Herzegovina,2002,2002Bosnia and Herzegovina,0,0,0,6,0,0,6,0,0,0,0,5,0,5,11
2569,Bosnia and Herzegovina,2002,2002Bosnia and Herzegovina,0,0,0,11,5,0,16,0,0,0,14,0,0,14,50
2570,Bosnia and Herzegovina,2002,2002Bosnia and Herzegovina,0,0,5,0,0,0,5,0,0,0,0,0,0,0,5
2571,Bosnia and Herzegovina,2002,2002Bosnia and Herzegovina,0,0,5,0,0,0,5,0,8,0,0,0,0,8,13
2572,Bosnia and Herzegovina,2002,2002Bosnia and Herzegovina,16,32,27,154,20,0,249,19,57,50,172,27,0,325,574
2573,Bosnia and Herzegovina,2002,2002Bosnia and Herzegovina,42,288,247,2207,1777,0,4561,32,302,258,1492,1027,0,3111,7672
2574,Bosnia and Herzegovina,2003,2003Bosnia and Herzegovina,0,0,0,0,0,0,0,0,0,0,0,0,0,0,284959
2575,Bosnia and Herzegovina,2003,2003Bosnia and Herzegovina,0,0,0,0,0,0,0,0,0,0,5,0,0,5,10
2576,Bosnia and Herzegovina,2003,2003Bosnia and Herzegovina,0,0,0,0,0,0,0,0,0,0,6,0,0,6,6
2577,Bosnia and Herzegovina,2003,2003Bosnia and Herzegovina,0,0,0,0,0,786,786,0,0,0,0,0,837,837,1623
2578,Bosnia and Herzegovina,2003,2003Bosnia and Herzegovina,0,0,0,0,0,2326,2326,0,0,0,0,0,2241,2241,6945
2579,Bosnia and Herzegovina,2003,2003Bosnia and Herzegovina,0,0,0,5,0,0,5,0,0,0,6,0,0,6,11
2580,Bosnia and Herzegovina,2003,2003Bosnia and Herzegovina,0,0,0,5,0,0,5,0,0,8,0,0,0,8,13
2581,Bosnia and Herzegovina,2003,2003Bosnia and Herzegovina,0,0,0,9,0,0,9,0,0,0,6,0,0,6,15
2582,Bosnia and Herzegovina,2003,2003Bosnia and Herzegovina,0,0,5,0,0,0,5,0,0,0,0,0,0,0,5
2583,Bosnia and Herzegovina,2003,2003Bosnia and Herzegovina,14,28,24,130,18,0,214,16,51,43,147,23,0,280,494
2584,Bosnia and Herzegovina,2003,2003Bosnia and Herzegovina,14,140,121,1137,890,0,2302,6,149,128,843,502,0,1628,3930
2585,Bosnia and Herzegovina,2003,2003Bosnia and Herzegovina,21,78,66,495,322,9,991,25,90,80,502,308,5,1010,2001
2586,Bosnia and Herzegovina,2004,2004Bosnia and Herzegovina,0,0,0,0,0,0,0,0,0,0,0,0,0,0,218230
2587,Bosnia and Herzegovina,2004,2004Bosnia and Herzegovina,0,0,0,0,0,0,0,0,0,0,5,0,0,5,10
2588,Bosnia and Herzegovina,2004,2004Bosnia and Herzegovina,0,0,0,0,0,0,0,0,0,0,6,0,0,6,6
2589,Bosnia and Herzegovina,2004,2004Bosnia and Herzegovina,0,0,0,0,0,0,0,0,0,0,8,0,0,8,8
2590,Bosnia and Herzegovina,2004,2004Bosnia and Herzegovina,0,0,0,0,0,0,0,0,0,0,9,0,0,9,9
2591,Bosnia and Herzegovina,2004,2004Bosnia and Herzegovina,0,0,0,0,0,0,0,0,0,5,0,0,0,5,5
2592,Bosnia and Herzegovina,2004,2004Bosnia and Herzegovina,0,0,0,0,0,127,127,0,0,0,0,0,87,87,214
2593,Bosnia and Herzegovina,2004,2004Bosnia and Herzegovina,0,0,0,5,0,0,5,0,0,7,0,0,0,7,12
2594,Bosnia and Herzegovina,2004,2004Bosnia and Herzegovina,0,0,0,6,0,0,6,0,0,0,0,5,0,5,11
2595,Bosnia and Herzegovina,2004,2004Bosnia and Herzegovina,0,0,0,7,0,0,7,0,0,0,6,0,0,6,13
2596,Bosnia and Herzegovina,2004,2004Bosnia and Herzegovina,0,0,0,9,0,0,9,0,0,0,6,0,0,6,15
2597,Bosnia and Herzegovina,2004,2004Bosnia and Herzegovina,0,0,5,0,0,0,5,0,0,0,0,0,0,0,5
2598,Bosnia and Herzegovina,2004,2004Bosnia and Herzegovina,0,5,0,14,0,0,19,0,0,5,0,0,0,5,24
2599,Bosnia and Herzegovina,2004,2004Bosnia and Herzegovina,14,28,24,130,18,0,214,16,51,43,147,23,0,280,494
2600,Bosnia and Herzegovina,2004,2004Bosnia and Herzegovina,16,89,76,959,747,0,1887,15,102,87,719,394,0,1317,3204
2601,Bosnia and Herzegovina,2004,2004Bosnia and Herzegovina,61,192,164,755,135,2178,3485,70,205,176,478,68,2071,3068,6553
2602,Bosnia and Herzegovina,2005,2005Bosnia and Herzegovina,0,0,0,0,0,0,0,0,0,0,0,0,0,0,97613
2603,Bosnia and Herzegovina,2005,2005Bosnia and Herzegovina,0,0,0,0,0,0,0,0,0,0,5,0,0,5,10
2604,Bosnia and Herzegovina,2005,2005Bosnia and Herzegovina,0,0,0,0,0,0,0,0,0,0,6,0,0,6,6
2605,Bosnia and Herzegovina,2005,2005Bosnia and Herzegovina,0,0,0,0,0,0,0,0,0,0,8,0,0,8,8
2606,Bosnia and Herzegovina,2005,2005Bosnia and Herzegovina,0,0,0,0,0,9,9,0,0,0,0,0,6,6,15
2607,Bosnia and Herzegovina,2005,2005Bosnia and Herzegovina,0,0,0,0,0,80,80,0,0,0,0,0,57,57,137
2608,Bosnia and Herzegovina,2005,2005Bosnia and Herzegovina,0,0,0,0,0,1571,1571,0,0,0,0,0,1801,1801,3372
2609,Bosnia and Herzegovina,2005,2005Bosnia and Herzegovina,0,0,0,5,0,0,5,0,0,0,7,0,0,7,12
2610,Bosnia and Herzegovina,2005,2005Bosnia and Herzegovina,0,0,0,6,0,0,6,0,0,0,0,5,0,5,11
2611,Bosnia and Herzegovina,2005,2005Bosnia and Herzegovina,0,0,0,7,6,0,13,0,0,0,0,0,0,0,13
2612,Bosnia and Herzegovina,2005,2005Bosnia and Herzegovina,0,0,5,14,0,0,19,0,0,5,0,0,0,5,24
2613,Bosnia and Herzegovina,2005,2005Bosnia and Herzegovina,17,57,48,735,627,0,1484,13,73,63,593,319,0,1061,2545
2614,Bosnia and Herzegovina,2005,2005Bosnia and Herzegovina,51,176,150,710,123,2073,3283,59,192,164,463,67,1937,2882,6165
2615,Bosnia and Herzegovina,2006,2006Bosnia and Herzegovina,0,0,0,0,0,0,0,0,0,0,0,0,0,0,155877
2616,Bosnia and Herzegovina,2006,2006Bosnia and Herzegovina,0,0,0,0,0,0,0,0,0,0,5,0,0,5,10
2617,Bosnia and Herzegovina,2006,2006Bosnia and Herzegovina,0,0,0,0,0,0,0,0,0,0,6,0,0,6,6
2618,Bosnia and Herzegovina,2006,2006Bosnia and Herzegovina,0,0,0,0,0,0,0,0,0,0,8,0,0,8,8
2619,Bosnia and Herzegovina,2006,2006Bosnia and Herzegovina,0,0,0,0,0,5,5,0,0,0,0,0,0,0,5
2620,Bosnia and Herzegovina,2006,2006Bosnia and Herzegovina,0,0,0,0,0,9,9,0,0,0,0,0,6,6,15
2621,Bosnia and Herzegovina,2006,2006Bosnia and Herzegovina,0,0,0,0,0,60,60,0,0,0,0,0,85,85,145
2622,Bosnia and Herzegovina,2006,2006Bosnia and Herzegovina,0,0,0,0,0,1682,1682,0,0,0,0,0,1931,1931,3613
2623,Bosnia and Herzegovina,2006,2006Bosnia and Herzegovina,0,0,0,0,0,2957,2957,0,0,0,0,0,2591,2591,5548
2624,Bosnia and Herzegovina,2006,2006Bosnia and Herzegovina,0,0,0,5,0,0,5,0,0,0,0,0,0,0,5
2625,Bosnia and Herzegovina,2006,2006Bosnia and Herzegovina,0,0,0,5,0,0,5,0,0,0,7,0,0,7,12
2626,Bosnia and Herzegovina,2006,2006Bosnia and Herzegovina,0,0,0,6,0,0,6,0,0,0,0,5,0,5,11
2627,Bosnia and Herzegovina,2006,2006Bosnia and Herzegovina,0,0,0,7,6,0,13,0,0,0,0,0,0,0,13
2628,Bosnia and Herzegovina,2006,2006Bosnia and Herzegovina,0,0,0,16,0,0,16,0,0,5,0,0,0,5,21
2629,Bosnia and Herzegovina,2006,2006Bosnia and Herzegovina,0,0,5,57,12,0,74,0,0,5,31,17,0,53,137
2630,Bosnia and Herzegovina,2006,2006Bosnia and Herzegovina,5,17,50,613,536,0,1221,0,48,58,502,274,0,882,2103
2631,Bosnia and Herzegovina,2006,2006Bosnia and Herzegovina,15,108,225,1978,527,0,2853,21,128,244,1380,379,0,2152,5005
2632,Bosnia and Herzegovina,2006,2006Bosnia and Herzegovina,110,649,1010,8127,4804,18,14718,102,674,1086,8267,2545,22,12696,27414
2633,Bosnia and Herzegovina,2007,2007Bosnia and Herzegovina,0,0,0,0,0,0,0,0,0,0,0,0,0,0,34554
2634,Bosnia and Herzegovina,2007,2007Bosnia and Herzegovina,0,0,0,0,0,0,0,0,0,0,0,0,5,5,5
2635,Bosnia and Herzegovina,2007,2007Bosnia and Herzegovina,0,0,0,0,0,0,0,0,0,0,5,0,0,5,5
2636,Bosnia and Herzegovina,2007,2007Bosnia and Herzegovina,0,0,0,0,0,0,0,0,0,0,6,0,0,6,6
2637,Bosnia and Herzegovina,2007,2007Bosnia and Herzegovina,0,0,0,0,0,0,0,0,0,0,8,0,0,8,8
2638,Bosnia and Herzegovina,2007,2007Bosnia and Herzegovina,0,0,0,0,0,44,44,0,0,0,0,0,68,68,112
2639,Bosnia and Herzegovina,2007,2007Bosnia and Herzegovina,0,0,0,0,0,1776,1776,0,0,0,0,0,2004,2004,3780
2640,Bosnia and Herzegovina,2007,2007Bosnia and Herzegovina,0,0,0,5,0,0,5,0,0,0,0,0,0,0,10
2641,Bosnia and Herzegovina,2007,2007Bosnia and Herzegovina,0,0,0,5,0,0,5,0,0,0,7,0,0,7,12
2642,Bosnia and Herzegovina,2007,2007Bosnia and Herzegovina,0,0,0,6,0,0,6,0,0,0,0,5,0,5,11
2643,Bosnia and Herzegovina,2007,2007Bosnia and Herzegovina,0,0,0,7,6,0,13,0,0,0,0,0,0,0,13
2644,Bosnia and Herzegovina,2007,2007Bosnia and Herzegovina,0,0,0,16,0,0,16,0,0,5,0,0,0,5,21
2645,Bosnia and Herzegovina,2007,2007Bosnia and Herzegovina,5,9,31,371,384,0,800,5,22,29,268,212,0,536,1336
2646,Bosnia and Herzegovina,2007,2007Bosnia and Herzegovina,10,125,231,2347,800,0,3513,8,134,274,1687,550,0,2653,6166
2647,Bosnia and Herzegovina,2007,2007Bosnia and Herzegovina,37,101,118,577,86,1685,2604,44,112,138,387,38,1577,2296,4900
2648,Bosnia and Herzegovina,2007,2007Bosnia and Herzegovina,59,564,956,8114,4977,0,14670,47,605,994,8363,2649,0,12658,27328
2649,Bosnia and Herzegovina,2008,2008Bosnia and Herzegovina,0,0,0,0,0,0,0,0,0,0,0,0,0,0,31447
2650,Bosnia and Herzegovina,2008,2008Bosnia and Herzegovina,0,0,0,0,0,0,0,0,0,0,5,0,0,5,5
2651,Bosnia and Herzegovina,2008,2008Bosnia and Herzegovina,0,0,0,0,0,0,0,0,0,0,6,0,0,6,6
2652,Bosnia and Herzegovina,2008,2008Bosnia and Herzegovina,0,0,0,0,0,37,37,0,0,0,0,0,60,60,97
2653,Bosnia and Herzegovina,2008,2008Bosnia and Herzegovina,0,0,0,0,0,1799,1799,0,0,0,0,0,2035,2035,3834
2654,Bosnia and Herzegovina,2008,2008Bosnia and Herzegovina,0,0,0,5,0,0,5,0,0,0,0,0,0,0,10
2655,Bosnia and Herzegovina,2008,2008Bosnia and Herzegovina,0,0,0,5,0,0,5,0,0,0,7,0,0,7,12
2656,Bosnia and Herzegovina,2008,2008Bosnia and Herzegovina,0,0,0,6,0,0,6,0,0,0,0,5,0,5,11
2657,Bosnia and Herzegovina,2008,2008Bosnia and Herzegovina,5,20,33,304,275,0,637,5,20,33,235,145,0,438,1289
2658,Bosnia and Herzegovina,2008,2008Bosnia and Herzegovina,11,106,206,2328,851,0,3502,5,128,241,1692,600,0,2666,6168
2659,Bosnia and Herzegovina,2008,2008Bosnia and Herzegovina,26,499,870,8094,5100,0,14589,25,515,907,8413,2716,0,12576,27165
2660,Bosnia and Herzegovina,2008,2008Bosnia and Herzegovina,35,93,102,484,68,1511,2293,33,84,125,341,27,1411,2021,4314
2661,Bosnia and Herzegovina,2009,2009Bosnia and Herzegovina,0,0,0,0,0,0,0,0,0,0,0,0,0,0,10409
2662,Bosnia and Herzegovina,2009,2009Bosnia and Herzegovina,0,0,0,0,0,0,0,0,0,0,5,0,0,5,5
2663,Bosnia and Herzegovina,2009,2009Bosnia and Herzegovina,0,0,0,0,0,0,0,0,0,0,6,0,0,6,6
2664,Bosnia and Herzegovina,2009,2009Bosnia and Herzegovina,0,0,0,0,0,33,33,0,0,0,0,0,51,51,84
2665,Bosnia and Herzegovina,2009,2009Bosnia and Herzegovina,0,0,0,5,0,0,5,0,0,0,0,0,0,0,5
2666,Bosnia and Herzegovina,2009,2009Bosnia and Herzegovina,0,0,0,5,0,0,5,0,0,0,7,0,0,7,12
2667,Bosnia and Herzegovina,2009,2009Bosnia and Herzegovina,5,14,13,272,257,0,561,5,9,27,132,136,0,309,956
2668,Bosnia and Herzegovina,2009,2009Bosnia and Herzegovina,5,75,182,2079,825,0,3166,5,104,190,1582,589,0,2470,5636
2669,Bosnia and Herzegovina,2009,2009Bosnia and Herzegovina,22,74,80,416,69,1347,2008,22,62,94,325,21,1260,1784,3792
2670,Bosnia and Herzegovina,2009,2009Bosnia and Herzegovina,24,444,775,7199,4534,0,12976,22,457,806,7479,2414,0,11178,24154
2671,Bosnia and Herzegovina,2009,2009Bosnia and Herzegovina,73,496,1025,9864,1293,0,12751,88,535,990,9549,1034,0,12196,24947
2672,Bosnia and Herzegovina,2010,2010Bosnia and Herzegovina,0,0,0,0,0,0,0,0,0,0,0,0,0,0,5253
2673,Bosnia and Herzegovina,2010,2010Bosnia and Herzegovina,0,0,0,0,0,0,0,0,0,0,5,0,0,5,5
2674,Bosnia and Herzegovina,2010,2010Bosnia and Herzegovina,0,0,0,0,0,0,0,0,0,0,6,0,0,6,6
2675,Bosnia and Herzegovina,2010,2010Bosnia and Herzegovina,0,0,0,0,0,28,28,0,0,0,0,0,39,39,67
2676,Bosnia and Herzegovina,2010,2010Bosnia and Herzegovina,0,0,0,0,0,1927,1927,0,0,0,0,0,2156,2156,4083
2677,Bosnia and Herzegovina,2010,2010Bosnia and Herzegovina,0,0,0,5,0,0,5,0,0,0,0,0,0,0,5
2678,Bosnia and Herzegovina,2010,2010Bosnia and Herzegovina,0,0,0,5,0,0,5,0,0,0,7,0,0,7,12
2679,Bosnia and Herzegovina,2010,2010Bosnia and Herzegovina,0,10,10,164,129,0,313,0,5,20,151,106,0,282,668
2680,Bosnia and Herzegovina,2010,2010Bosnia and Herzegovina,0,199,542,6058,4616,0,11415,0,195,604,6339,2494,0,9632,21047
2681,Bosnia and Herzegovina,2010,2010Bosnia and Herzegovina,5,38,108,1489,514,0,2154,6,51,121,1176,350,0,1704,3858
2682,Bosnia and Herzegovina,2010,2010Bosnia and Herzegovina,15,54,63,332,53,1260,1777,13,56,59,261,16,1188,1593,3370
2683,Bosnia and Herzegovina,2010,2010Bosnia and Herzegovina,68,399,947,9732,1387,0,12533,64,458,938,9468,1161,0,12089,24622
2684,Bosnia and Herzegovina,2011,2011Bosnia and Herzegovina,0,0,0,0,0,0,0,0,0,0,0,0,0,0,6005
2685,Bosnia and Herzegovina,2011,2011Bosnia and Herzegovina,0,0,0,0,0,0,0,0,0,0,5,0,0,5,5
2686,Bosnia and Herzegovina,2011,2011Bosnia and Herzegovina,0,0,0,0,0,0,0,0,0,0,6,0,0,6,6
2687,Bosnia and Herzegovina,2011,2011Bosnia and Herzegovina,0,0,0,0,0,22,22,0,0,0,0,0,29,29,51
2688,Bosnia and Herzegovina,2011,2011Bosnia and Herzegovina,0,0,0,0,0,1931,1931,0,0,0,0,0,2177,2177,4108
2689,Bosnia and Herzegovina,2011,2011Bosnia and Herzegovina,0,0,0,5,0,0,5,0,0,0,0,0,0,0,5
2690,Bosnia and Herzegovina,2011,2011Bosnia and Herzegovina,0,0,0,8,0,0,8,0,0,0,7,0,0,7,93
2691,Bosnia and Herzegovina,2011,2011Bosnia and Herzegovina,0,0,5,0,0,0,5,0,0,0,7,0,0,7,12
2692,Bosnia and Herzegovina,2011,2011Bosnia and Herzegovina,0,7,6,123,146,21,303,0,6,12,101,73,18,210,555
2693,Bosnia and Herzegovina,2011,2011Bosnia and Herzegovina,0,167,446,5938,4686,0,11237,0,165,507,6199,2565,0,9436,20673
2694,Bosnia and Herzegovina,2011,2011Bosnia and Herzegovina,16,43,53,283,41,1159,1595,9,43,54,230,14,1098,1448,3043
2695,Bosnia and Herzegovina,2011,2011Bosnia and Herzegovina,52,314,837,9510,1475,0,12188,47,371,836,9307,1267,0,11828,24016
2696,Bosnia and Herzegovina,2012,2012Bosnia and Herzegovina,0,0,0,0,0,0,0,0,0,0,0,0,0,0,4402
2697,Bosnia and Herzegovina,2012,2012Bosnia and Herzegovina,0,0,0,0,0,0,0,0,0,0,5,0,0,5,5
2698,Bosnia and Herzegovina,2012,2012Bosnia and Herzegovina,0,0,0,0,0,0,0,0,0,0,6,0,0,6,6
2699,Bosnia and Herzegovina,2012,2012Bosnia and Herzegovina,0,0,0,0,0,0,0,0,0,5,5,0,0,10,10
2700,Bosnia and Herzegovina,2012,2012Bosnia and Herzegovina,0,0,0,0,0,5,5,0,0,0,0,0,6,6,11
2701,Bosnia and Herzegovina,2012,2012Bosnia and Herzegovina,0,0,0,0,0,18,18,0,0,0,0,0,28,28,46
2702,Bosnia and Herzegovina,2012,2012Bosnia and Herzegovina,0,0,0,0,0,1935,1935,0,0,0,0,0,2183,2183,4118
2703,Bosnia and Herzegovina,2012,2012Bosnia and Herzegovina,0,0,0,5,0,0,5,0,0,0,0,0,0,0,5
2704,Bosnia and Herzegovina,2012,2012Bosnia and Herzegovina,0,0,0,7,0,0,7,0,0,0,0,0,0,0,91
2705,Bosnia and Herzegovina,2012,2012Bosnia and Herzegovina,0,0,0,9,0,0,9,0,0,0,0,0,0,0,9
2706,Bosnia and Herzegovina,2012,2012Bosnia and Herzegovina,0,0,6,102,117,16,241,0,5,7,82,55,15,164,439
2707,Bosnia and Herzegovina,2012,2012Bosnia and Herzegovina,0,129,358,4717,3722,0,8926,0,127,406,4923,2036,0,7492,16418
2708,Bosnia and Herzegovina,2012,2012Bosnia and Herzegovina,14,40,36,254,32,1098,1474,12,28,36,206,11,1028,1321,2795
2709,Bosnia and Herzegovina,2012,2012Bosnia and Herzegovina,36,257,732,9246,1594,0,11865,49,308,796,9050,1392,0,11595,23460
2710,Bosnia and Herzegovina,2013,2013Bosnia and Herzegovina,0,0,0,0,0,0,0,0,0,0,0,0,0,0,2886
2711,Bosnia and Herzegovina,2013,2013Bosnia and Herzegovina,0,0,0,0,0,0,0,0,0,0,5,0,0,5,5
2712,Bosnia and Herzegovina,2013,2013Bosnia and Herzegovina,0,0,0,0,0,0,0,0,0,0,6,0,0,6,6
2713,Bosnia and Herzegovina,2013,2013Bosnia and Herzegovina,0,0,0,0,0,0,0,0,0,5,5,0,0,10,10
2714,Bosnia and Herzegovina,2013,2013Bosnia and Herzegovina,0,0,0,0,0,14,14,0,0,0,0,0,27,27,41
2715,Bosnia and Herzegovina,2013,2013Bosnia and Herzegovina,0,0,0,0,0,173,173,0,0,0,0,0,159,159,386
2716,Bosnia and Herzegovina,2013,2013Bosnia and Herzegovina,0,0,0,0,0,1984,1984,0,0,0,0,0,2190,2190,4174
2717,Bosnia and Herzegovina,2013,2013Bosnia and Herzegovina,0,0,0,0,6,0,6,0,0,0,0,0,0,0,6
2718,Bosnia and Herzegovina,2013,2013Bosnia and Herzegovina,0,0,0,5,0,0,5,0,0,0,0,0,0,0,5
2719,Bosnia and Herzegovina,2013,2013Bosnia and Herzegovina,0,0,0,7,0,0,7,0,0,0,7,0,0,7,14
2720,Bosnia and Herzegovina,2013,2013Bosnia and Herzegovina,0,0,0,11,0,0,11,0,0,0,0,0,0,0,11
2721,Bosnia and Herzegovina,2013,2013Bosnia and Herzegovina,0,119,316,4146,3274,0,7855,0,127,403,4889,2022,0,7441,15296
2722,Bosnia and Herzegovina,2013,2013Bosnia and Herzegovina,8,23,45,553,132,0,761,9,29,53,413,79,0,583,1344
2723,Bosnia and Herzegovina,2013,2013Bosnia and Herzegovina,11,45,39,233,31,1018,1377,12,26,29,186,12,961,1226,2603
2724,Bosnia and Herzegovina,2014,2014Bosnia and Herzegovina,0,0,0,0,0,0,0,0,0,0,0,0,0,0,1587
2725,Bosnia and Herzegovina,2014,2014Bosnia and Herzegovina,0,0,0,0,0,0,0,0,0,0,5,0,0,5,10
2726,Bosnia and Herzegovina,2014,2014Bosnia and Herzegovina,0,0,0,0,0,0,0,0,0,0,9,0,0,9,9
2727,Bosnia and Herzegovina,2014,2014Bosnia and Herzegovina,0,0,0,0,0,7,7,0,0,0,0,0,0,0,7
2728,Bosnia and Herzegovina,2014,2014Bosnia and Herzegovina,0,0,0,0,0,167,167,0,0,0,0,0,151,151,396
2729,Bosnia and Herzegovina,2014,2014Bosnia and Herzegovina,0,0,0,0,0,1954,1954,0,0,0,0,0,2124,2124,4078
2730,Bosnia and Herzegovina,2014,2014Bosnia and Herzegovina,0,0,0,0,5,0,5,0,0,0,0,0,0,0,5
2731,Bosnia and Herzegovina,2014,2014Bosnia and Herzegovina,0,0,0,0,6,0,6,0,0,0,0,0,0,0,6
2732,Bosnia and Herzegovina,2014,2014Bosnia and Herzegovina,0,0,0,6,0,0,6,0,5,0,0,0,0,5,11
2733,Bosnia and Herzegovina,2014,2014Bosnia and Herzegovina,0,9,5,225,102,0,341,0,5,5,186,71,0,267,608
2734,Bosnia and Herzegovina,2014,2014Bosnia and Herzegovina,0,83,234,3072,2426,0,5815,0,94,299,3620,1497,0,5510,11325
2735,Bosnia and Herzegovina,2014,2014Bosnia and Herzegovina,10,21,41,559,144,0,775,8,39,50,422,87,0,606,1381
2736,Bosnia and Herzegovina,2014,2014Bosnia and Herzegovina,15,39,31,222,29,957,1293,18,24,30,176,11,908,1167,2460
2737,Bosnia and Herzegovina,2015,2015Bosnia and Herzegovina,0,0,0,0,0,0,0,0,0,0,0,0,0,0,1360
2738,Bosnia and Herzegovina,2015,2015Bosnia and Herzegovina,0,0,0,0,0,0,0,0,0,0,5,0,0,5,10
2739,Bosnia and Herzegovina,2015,2015Bosnia and Herzegovina,0,0,0,0,0,0,0,0,0,0,8,0,0,8,8
2740,Bosnia and Herzegovina,2015,2015Bosnia and Herzegovina,0,0,0,0,0,0,0,0,0,0,9,0,0,9,9
2741,Bosnia and Herzegovina,2015,2015Bosnia and Herzegovina,0,0,0,0,0,7,7,0,0,0,0,0,0,0,7
2742,Bosnia and Herzegovina,2015,2015Bosnia and Herzegovina,0,0,0,0,0,20,20,0,0,0,0,0,32,32,52
2743,Bosnia and Herzegovina,2015,2015Bosnia and Herzegovina,0,0,0,0,0,74,74,0,0,0,0,0,66,66,155
2744,Bosnia and Herzegovina,2015,2015Bosnia and Herzegovina,0,0,0,0,0,1941,1941,0,0,0,0,0,2114,2114,4055
2745,Bosnia and Herzegovina,2015,2015Bosnia and Herzegovina,0,0,0,0,6,0,6,0,0,0,0,0,0,0,6
2746,Bosnia and Herzegovina,2015,2015Bosnia and Herzegovina,0,0,0,7,0,0,7,0,0,0,7,0,0,7,14
2747,Bosnia and Herzegovina,2015,2015Bosnia and Herzegovina,0,0,0,27,28,0,55,0,0,5,48,5,0,58,113
2748,Bosnia and Herzegovina,2015,2015Bosnia and Herzegovina,0,67,189,2570,2019,0,4845,0,75,240,2921,1207,0,4443,9288
2749,Bosnia and Herzegovina,2015,2015Bosnia and Herzegovina,8,14,39,581,153,0,795,10,35,42,438,92,0,617,1412
2750,Bosnia and Herzegovina,2015,2015Bosnia and Herzegovina,16,33,19,203,30,844,1145,16,19,25,157,15,886,1118,2274
2751,Bosnia and Herzegovina,2016,2016Bosnia and Herzegovina,0,0,0,0,0,0,0,0,0,0,0,0,0,0,1283
2752,Bosnia and Herzegovina,2016,2016Bosnia and Herzegovina,0,0,0,0,0,0,0,0,0,0,5,0,0,5,10
2753,Bosnia and Herzegovina,2016,2016Bosnia and Herzegovina,0,0,0,0,0,0,0,0,0,0,9,0,0,9,9
2754,Bosnia and Herzegovina,2016,2016Bosnia and Herzegovina,0,0,0,0,0,7,7,0,0,0,0,0,0,0,7
2755,Bosnia and Herzegovina,2016,2016Bosnia and Herzegovina,0,0,0,0,0,19,19,0,0,0,0,0,31,31,50
2756,Bosnia and Herzegovina,2016,2016Bosnia and Herzegovina,0,0,0,0,0,1949,1949,0,0,0,0,0,2116,2116,4065
2757,Bosnia and Herzegovina,2016,2016Bosnia and Herzegovina,0,0,0,6,0,0,6,0,0,0,0,0,0,0,6
2758,Bosnia and Herzegovina,2016,2016Bosnia and Herzegovina,0,0,0,9,0,5,14,0,0,0,0,0,0,0,14
2759,Bosnia and Herzegovina,2016,2016Bosnia and Herzegovina,0,0,0,16,5,0,21,0,0,0,11,6,0,17,38
2760,Bosnia and Herzegovina,2016,2016Bosnia and Herzegovina,0,8,0,0,0,0,8,0,0,0,0,0,0,0,8
2761,Bosnia and Herzegovina,2016,2016Bosnia and Herzegovina,0,67,184,2513,1972,0,4736,0,75,235,2857,1178,0,4345,9081
2762,Bosnia and Herzegovina,2016,2016Bosnia and Herzegovina,5,22,33,590,157,0,807,9,29,42,450,113,0,643,1450
2763,Bosnia and Herzegovina,2016,2016Bosnia and Herzegovina,14,31,22,192,31,857,1147,14,20,20,150,14,808,1026,2173
2764,Bosnia and Herzegovina,2017,2017Bosnia and Herzegovina,0,0,0,0,0,0,0,0,0,0,0,0,0,0,1264
2765,Bosnia and Herzegovina,2017,2017Bosnia and Herzegovina,0,0,0,0,0,0,0,0,0,0,5,0,0,5,5
2766,Bosnia and Herzegovina,2017,2017Bosnia and Herzegovina,0,0,0,0,0,1965,1965,0,0,0,0,0,2120,2120,4085
2767,Bosnia and Herzegovina,2017,2017Bosnia and Herzegovina,0,0,0,5,0,0,5,0,0,0,5,0,0,5,10
2768,Bosnia and Herzegovina,2017,2017Bosnia and Herzegovina,0,0,0,6,0,0,6,0,0,0,0,0,0,0,6
2769,Bosnia and Herzegovina,2017,2017Bosnia and Herzegovina,0,0,0,7,0,0,7,0,0,5,12,5,0,22,29
2770,Bosnia and Herzegovina,2017,2017Bosnia and Herzegovina,0,0,0,9,0,0,9,0,0,0,0,0,0,0,14
2771,Bosnia and Herzegovina,2017,2017Bosnia and Herzegovina,0,0,8,0,0,0,8,0,0,0,0,0,0,0,8
2772,Bosnia and Herzegovina,2017,2017Bosnia and Herzegovina,0,66,177,2425,1903,0,4571,0,73,226,2758,1137,0,4194,8765
2773,Bosnia and Herzegovina,2017,2017Bosnia and Herzegovina,9,26,31,593,162,0,821,8,35,38,454,122,0,657,1478
2774,Bosnia and Herzegovina,2017,2017Bosnia and Herzegovina,14,22,21,162,30,782,1031,12,19,12,129,14,809,995,2026
2775,Bosnia and Herzegovina,2018,2018Bosnia and Herzegovina,0,0,0,0,0,0,0,0,0,0,0,0,0,0,1182
2776,Bosnia and Herzegovina,2018,2018Bosnia and Herzegovina,0,0,0,0,0,0,0,0,0,0,9,0,0,9,9
2777,Bosnia and Herzegovina,2018,2018Bosnia and Herzegovina,0,0,0,0,0,1973,1973,0,0,0,0,0,2126,2126,4099
2778,Bosnia and Herzegovina,2018,2018Bosnia and Herzegovina,0,0,0,6,0,0,6,0,0,0,0,0,0,0,6
2779,Bosnia and Herzegovina,2018,2018Bosnia and Herzegovina,0,0,0,6,0,0,6,0,0,0,8,6,0,14,20
2780,Bosnia and Herzegovina,2018,2018Bosnia and Herzegovina,0,0,0,7,0,0,7,0,0,0,0,0,0,0,34
2781,Bosnia and Herzegovina,2018,2018Bosnia and Herzegovina,0,0,8,0,0,0,8,0,0,0,0,0,0,0,8
2782,Bosnia and Herzegovina,2018,2018Bosnia and Herzegovina,0,0,46,1567,3185,0,4798,0,0,61,1655,1757,0,3473,8271
2783,Bosnia and Herzegovina,2018,2018Bosnia and Herzegovina,9,21,18,141,36,742,967,10,22,9,111,17,718,887,1854
2784,Bosnia and Herzegovina,2018,2018Bosnia and Herzegovina,11,26,29,587,173,0,826,9,30,32,459,117,0,647,1473
2785,Bosnia and Herzegovina,2019,2019Bosnia and Herzegovina,0,0,0,0,0,0,0,0,0,0,0,0,0,0,9317
2786,Bosnia and Herzegovina,2019,2019Bosnia and Herzegovina,0,0,0,0,0,0,0,0,0,0,0,5,0,5,5
2787,Bosnia and Herzegovina,2019,2019Bosnia and Herzegovina,0,0,0,0,0,0,0,0,0,0,9,0,0,9,9
2788,Bosnia and Herzegovina,2019,2019Bosnia and Herzegovina,0,0,0,0,0,1986,1986,0,0,0,0,0,2130,2130,4116
2789,Bosnia and Herzegovina,2019,2019Bosnia and Herzegovina,0,0,0,6,0,0,6,0,0,0,0,0,0,0,6
2790,Bosnia and Herzegovina,2019,2019Bosnia and Herzegovina,0,0,0,8,0,0,8,0,0,0,0,0,0,0,8
2791,Bosnia and Herzegovina,2019,2019Bosnia and Herzegovina,0,0,0,8,0,0,8,0,0,0,8,0,0,8,16
2792,Bosnia and Herzegovina,2019,2019Bosnia and Herzegovina,7,17,16,126,33,0,199,8,21,10,97,19,0,155,1647
2793,Bosnia and Herzegovina,2019,2019Bosnia and Herzegovina,7,25,28,559,178,0,797,10,24,28,453,120,0,635,1432
2794,Bosnia and Herzegovina,2020,2020Bosnia and Herzegovina,0,0,0,0,0,0,0,0,0,0,0,0,0,0,12583
2795,Bosnia and Herzegovina,2020,2020Bosnia and Herzegovina,0,0,0,0,0,0,0,0,0,0,0,5,0,5,5
2796,Bosnia and Herzegovina,2020,2020Bosnia and Herzegovina,0,0,0,0,0,0,0,0,0,0,5,0,0,5,5
2797,Bosnia and Herzegovina,2020,2020Bosnia and Herzegovina,0,0,0,0,0,0,0,0,0,0,9,0,0,9,9
2798,Bosnia and Herzegovina,2020,2020Bosnia and Herzegovina,0,0,0,0,0,5,5,0,0,0,0,0,0,0,5
2799,Bosnia and Herzegovina,2020,2020Bosnia and Herzegovina,0,0,0,0,0,19,19,0,0,0,0,0,25,25,44
2800,Bosnia and Herzegovina,2020,2020Bosnia and Herzegovina,0,0,0,0,5,0,5,0,0,0,0,0,0,0,5
2801,Bosnia and Herzegovina,2020,2020Bosnia and Herzegovina,0,0,0,6,0,0,6,0,0,0,0,0,0,0,6
2802,Bosnia and Herzegovina,2020,2020Bosnia and Herzegovina,0,28,25,515,193,0,761,10,18,30,414,125,0,597,1358
2803,Bosnia and Herzegovina,2020,2020Bosnia and Herzegovina,6,15,19,117,37,0,194,9,16,14,87,19,0,145,1558
2804,Bosnia and Herzegovina,2021,2021Bosnia and Herzegovina,0,0,0,0,0,0,0,0,0,0,0,0,0,0,15360
2805,Bosnia and Herzegovina,2021,2021Bosnia and Herzegovina,0,0,0,0,0,0,0,0,0,0,0,5,0,5,5
2806,Bosnia and Herzegovina,2021,2021Bosnia and Herzegovina,0,0,0,0,0,0,0,0,0,0,5,0,0,5,5
2807,Bosnia and Herzegovina,2021,2021Bosnia and Herzegovina,0,0,0,0,0,0,0,0,0,0,9,0,0,9,9
2808,Bosnia and Herzegovina,2021,2021Bosnia and Herzegovina,0,0,0,6,0,0,6,0,0,0,0,0,0,0,6
2809,Bosnia and Herzegovina,2021,2021Bosnia and Herzegovina,0,5,0,0,0,0,5,0,0,0,0,0,0,0,5
2810,Bosnia and Herzegovina,2021,2021Bosnia and Herzegovina,5,11,16,106,38,0,176,7,18,11,82,19,0,137,1483
2811,Bosnia and Herzegovina,2021,2021Bosnia and Herzegovina,5,28,22,485,196,0,736,9,22,21,390,138,0,580,1316
2812,Burkina Faso,2001,2001Burkina Faso,0,0,0,0,0,0,0,0,0,0,0,0,0,0,44
2813,Burkina Faso,2001,2001Burkina Faso,0,0,0,0,0,0,0,0,0,0,8,0,0,8,8
2814,Burkina Faso,2001,2001Burkina Faso,0,0,0,0,0,5,5,0,0,0,0,0,0,0,5
2815,Burkina Faso,2001,2001Burkina Faso,0,0,0,0,0,8,8,0,0,0,0,0,25,25,33
2816,Burkina Faso,2002,2002Burkina Faso,0,0,0,0,0,0,0,0,0,0,0,0,0,0,934
2817,Burkina Faso,2002,2002Burkina Faso,0,0,0,0,0,0,0,0,0,0,8,0,0,8,8
2818,Burkina Faso,2002,2002Burkina Faso,0,0,0,0,0,6,6,0,0,0,0,0,22,22,28
2819,Burkina Faso,2003,2003Burkina Faso,0,0,0,0,0,0,0,0,0,0,0,0,0,0,820
2820,Burkina Faso,2003,2003Burkina Faso,0,0,0,0,0,0,0,0,0,0,7,0,0,7,7
2821,Burkina Faso,2003,2003Burkina Faso,0,0,0,0,0,6,6,0,0,0,0,0,19,19,25
2822,Burkina Faso,2004,2004Burkina Faso,0,0,0,0,0,0,0,0,0,0,0,0,0,0,560
2823,Burkina Faso,2004,2004Burkina Faso,0,0,0,0,0,0,0,0,0,0,6,0,0,6,6
2824,Burkina Faso,2004,2004Burkina Faso,0,0,0,0,0,0,0,0,0,0,9,0,0,9,9
2825,Burkina Faso,2005,2005Burkina Faso,0,0,0,0,0,0,0,0,0,0,0,0,0,0,556
2826,Burkina Faso,2005,2005Burkina Faso,0,0,0,0,0,0,0,0,0,0,6,0,0,6,6
2827,Burkina Faso,2005,2005Burkina Faso,0,0,0,0,0,0,0,0,0,0,8,0,0,8,8
2828,Burkina Faso,2005,2005Burkina Faso,0,0,0,0,0,6,6,0,0,0,0,0,26,26,32
2829,Burkina Faso,2006,2006Burkina Faso,0,0,0,0,0,0,0,0,0,0,0,0,0,0,325
2830,Burkina Faso,2006,2006Burkina Faso,0,0,0,0,0,0,0,0,0,0,0,0,5,5,5
2831,Burkina Faso,2006,2006Burkina Faso,0,0,0,0,0,6,6,0,0,0,0,0,29,29,35
2832,Burkina Faso,2006,2006Burkina Faso,0,0,0,0,0,8,8,0,0,0,0,0,0,0,8
2833,Burkina Faso,2007,2007Burkina Faso,0,0,0,0,0,0,0,0,0,0,0,0,0,0,491
2834,Burkina Faso,2007,2007Burkina Faso,0,0,0,0,0,0,0,0,0,0,5,0,0,5,5
2835,Burkina Faso,2007,2007Burkina Faso,0,0,0,0,0,0,0,0,5,0,0,0,0,5,5
2836,Burkina Faso,2007,2007Burkina Faso,0,0,0,0,0,8,8,0,0,0,0,0,32,32,40
2837,Burkina Faso,2007,2007Burkina Faso,0,0,0,0,0,11,11,0,0,0,0,0,0,0,11
2838,Burkina Faso,2007,2007Burkina Faso,5,0,0,0,0,0,5,0,0,0,0,0,0,0,5
2839,Burkina Faso,2008,2008Burkina Faso,0,0,0,0,0,0,0,0,0,0,0,0,0,0,645
2840,Burkina Faso,2008,2008Burkina Faso,0,0,0,0,0,0,0,0,0,0,0,0,7,7,7
2841,Burkina Faso,2008,2008Burkina Faso,0,0,0,0,0,0,0,0,0,0,5,0,0,5,5
2842,Burkina Faso,2008,2008Burkina Faso,0,0,0,0,0,0,0,0,5,0,0,0,0,5,5
2843,Burkina Faso,2008,2008Burkina Faso,0,0,0,0,0,7,7,0,0,0,0,0,6,6,13
2844,Burkina Faso,2008,2008Burkina Faso,0,0,0,0,0,11,11,0,0,0,0,0,33,33,44
2845,Burkina Faso,2009,2009Burkina Faso,0,0,0,0,0,0,0,0,0,0,0,0,0,0,752
2846,Burkina Faso,2009,2009Burkina Faso,0,0,0,0,0,0,0,0,0,0,5,0,0,5,5
2847,Burkina Faso,2009,2009Burkina Faso,0,0,0,0,0,0,0,0,5,0,0,0,0,5,5
2848,Burkina Faso,2009,2009Burkina Faso,0,0,0,0,0,12,12,0,0,0,0,0,9,9,21
2849,Burkina Faso,2009,2009Burkina Faso,0,0,5,0,0,0,5,0,0,0,0,0,6,6,11
2850,Burkina Faso,2009,2009Burkina Faso,0,7,7,35,0,0,49,7,8,0,125,0,0,140,189
2851,Burkina Faso,2010,2010Burkina Faso,0,0,0,0,0,0,0,0,0,0,0,0,0,0,826
2852,Burkina Faso,2010,2010Burkina Faso,0,0,0,0,0,0,0,0,5,0,0,0,0,5,5
2853,Burkina Faso,2010,2010Burkina Faso,0,0,0,0,0,13,13,0,0,0,0,0,11,11,24
2854,Burkina Faso,2010,2010Burkina Faso,0,0,0,0,0,25,25,0,0,0,0,0,38,38,63
2855,Burkina Faso,2010,2010Burkina Faso,0,0,5,0,0,0,5,0,0,0,0,0,5,5,10
2856,Burkina Faso,2010,2010Burkina Faso,0,10,6,39,0,0,55,5,8,5,135,0,0,153,208
2857,Burkina Faso,2010,2010Burkina Faso,5,0,0,0,0,0,5,0,0,0,0,0,0,0,5
2858,Burkina Faso,2011,2011Burkina Faso,0,0,0,0,0,0,0,0,0,0,0,0,0,0,806
2859,Burkina Faso,2011,2011Burkina Faso,0,0,0,0,0,17,17,0,0,0,0,0,10,10,27
2860,Burkina Faso,2011,2011Burkina Faso,0,0,0,0,0,32,32,0,0,0,0,0,42,42,74
2861,Burkina Faso,2011,2011Burkina Faso,0,0,0,5,0,0,5,0,0,0,0,0,6,6,11
2862,Burkina Faso,2011,2011Burkina Faso,0,0,0,10,0,0,10,0,0,0,9,0,0,9,149
2863,Burkina Faso,2011,2011Burkina Faso,0,6,5,40,0,0,51,0,12,6,126,0,0,144,195
2864,Burkina Faso,2012,2012Burkina Faso,0,0,0,0,0,0,0,0,0,0,0,0,0,0,971
2865,Burkina Faso,2012,2012Burkina Faso,0,0,0,0,0,0,0,0,0,0,5,0,0,5,5
2866,Burkina Faso,2012,2012Burkina Faso,0,0,0,0,0,29,29,0,0,0,0,0,19,19,48
2867,Burkina Faso,2012,2012Burkina Faso,0,0,0,0,0,42,42,0,0,0,0,0,44,44,86
2868,Burkina Faso,2012,2012Burkina Faso,0,0,0,5,0,0,5,0,0,0,0,0,5,5,10
2869,Burkina Faso,2012,2012Burkina Faso,0,0,0,8,0,0,8,0,0,0,0,0,0,0,141
2870,Burkina Faso,2012,2012Burkina Faso,5,5,5,38,0,0,53,0,11,8,120,5,0,144,197
2871,Burkina Faso,2013,2013Burkina Faso,0,0,0,0,0,0,0,0,0,0,0,0,0,0,1229
2872,Burkina Faso,2013,2013Burkina Faso,0,0,0,0,0,0,0,0,0,0,5,0,0,5,5
2873,Burkina Faso,2013,2013Burkina Faso,0,0,0,0,0,26,26,0,0,0,0,0,18,18,52
2874,Burkina Faso,2013,2013Burkina Faso,0,0,0,0,0,46,46,0,0,0,0,0,51,51,97
2875,Burkina Faso,2013,2013Burkina Faso,0,0,0,6,0,0,6,0,0,0,0,0,5,5,11
2876,Burkina Faso,2013,2013Burkina Faso,0,0,0,9,0,0,9,0,0,0,8,0,0,8,146
2877,Burkina Faso,2013,2013Burkina Faso,0,0,0,12,0,0,12,0,5,0,21,0,0,26,38
2878,Burkina Faso,2014,2014Burkina Faso,0,0,0,0,0,0,0,0,0,0,0,0,0,0,1548
2879,Burkina Faso,2014,2014Burkina Faso,0,0,0,0,0,0,0,0,0,0,5,0,0,5,5
2880,Burkina Faso,2014,2014Burkina Faso,0,0,0,0,0,0,0,0,0,0,7,0,0,7,7
2881,Burkina Faso,2014,2014Burkina Faso,0,0,0,0,0,0,0,0,0,0,9,0,0,9,136
2882,Burkina Faso,2014,2014Burkina Faso,0,0,0,0,0,0,0,0,0,6,0,0,0,6,6
2883,Burkina Faso,2014,2014Burkina Faso,0,0,0,0,0,56,56,0,0,0,0,0,51,51,107
2884,Burkina Faso,2014,2014Burkina Faso,0,0,0,7,0,0,7,0,0,0,0,0,0,0,7
2885,Burkina Faso,2014,2014Burkina Faso,0,0,0,9,0,0,9,0,5,0,23,0,0,28,37
2886,Burkina Faso,2015,2015Burkina Faso,0,0,0,0,0,0,0,0,0,0,0,0,0,0,1881
2887,Burkina Faso,2015,2015Burkina Faso,0,0,0,0,0,0,0,0,0,0,5,0,0,5,15
2888,Burkina Faso,2015,2015Burkina Faso,0,0,0,0,0,0,0,0,0,7,0,0,0,7,7
2889,Burkina Faso,2015,2015Burkina Faso,0,0,0,0,0,44,44,0,0,0,0,0,28,28,72
2890,Burkina Faso,2015,2015Burkina Faso,0,0,0,0,0,58,58,0,0,0,0,0,56,56,114
2891,Burkina Faso,2015,2015Burkina Faso,0,0,0,5,0,0,5,0,0,0,0,0,0,0,5
2892,Burkina Faso,2015,2015Burkina Faso,0,0,0,7,0,0,7,0,0,0,5,0,5,10,17
2893,Burkina Faso,2015,2015Burkina Faso,0,0,0,9,0,0,9,0,0,0,27,0,0,27,36
2894,Burkina Faso,2016,2016Burkina Faso,0,0,0,0,0,0,0,0,0,0,0,0,0,0,1984
2895,Burkina Faso,2016,2016Burkina Faso,0,0,0,0,0,0,0,0,0,0,5,0,0,5,5
2896,Burkina Faso,2016,2016Burkina Faso,0,0,0,0,0,44,44,0,0,0,0,0,32,32,76
2897,Burkina Faso,2016,2016Burkina Faso,0,0,0,0,0,74,74,0,0,0,0,0,64,64,138
2898,Burkina Faso,2016,2016Burkina Faso,0,0,0,10,0,0,10,0,5,0,26,0,0,31,41
2899,Burkina Faso,2016,2016Burkina Faso,0,5,0,0,0,5,10,0,0,0,6,0,0,6,16
2900,Burkina Faso,2016,2016Burkina Faso,0,5,0,7,0,0,12,0,0,0,9,0,0,9,92
2901,Burkina Faso,2017,2017Burkina Faso,0,0,0,0,0,0,0,0,0,0,0,0,0,0,2410
2902,Burkina Faso,2017,2017Burkina Faso,0,0,0,0,0,113,113,0,0,0,0,0,80,80,193
2903,Burkina Faso,2017,2017Burkina Faso,0,0,0,8,0,0,8,6,0,0,0,0,5,11,19
2904,Burkina Faso,2017,2017Burkina Faso,7,0,0,22,0,0,29,0,0,5,38,0,0,43,72
2905,Burkina Faso,2018,2018Burkina Faso,0,0,0,0,0,0,0,0,0,0,0,0,0,0,2557
2906,Burkina Faso,2018,2018Burkina Faso,0,0,0,0,0,145,145,0,0,0,0,0,91,91,236
2907,Burkina Faso,2018,2018Burkina Faso,0,0,0,9,0,5,14,0,0,6,0,0,0,6,20
2908,Burkina Faso,2018,2018Burkina Faso,0,10,0,14,0,0,24,0,0,5,10,0,0,15,95
2909,Burkina Faso,2018,2018Burkina Faso,9,0,0,28,0,0,37,7,0,0,38,0,0,45,82
2910,Burkina Faso,2018,2018Burkina Faso,919,1134,457,1834,86,0,4430,921,1175,447,1301,183,0,4027,8457
2911,Burkina Faso,2019,2019Burkina Faso,0,0,0,0,0,0,0,0,0,0,0,0,0,0,2882
2912,Burkina Faso,2019,2019Burkina Faso,0,0,0,0,0,173,173,0,0,0,0,0,110,110,283
2913,Burkina Faso,2019,2019Burkina Faso,7,8,0,34,0,0,49,7,0,0,37,0,0,44,93
2914,Burkina Faso,2019,2019Burkina Faso,8,0,0,0,0,0,8,0,0,0,5,0,0,5,18
2915,Burkina Faso,2019,2019Burkina Faso,763,1224,485,1860,93,0,4425,747,1264,503,1326,192,0,4032,8457
2916,Burkina Faso,2020,2020Burkina Faso,0,0,0,0,0,0,0,0,0,0,0,0,0,0,2560
2917,Burkina Faso,2020,2020Burkina Faso,0,0,0,0,0,56,56,0,0,0,0,0,50,50,106
2918,Burkina Faso,2020,2020Burkina Faso,0,0,0,7,0,0,7,0,0,0,7,0,0,7,19
2919,Burkina Faso,2020,2020Burkina Faso,0,0,0,7,0,0,7,0,8,0,0,0,0,8,15
2920,Burkina Faso,2020,2020Burkina Faso,9,10,0,37,0,0,56,8,0,0,40,0,0,48,104
2921,Burkina Faso,2020,2020Burkina Faso,1200,1601,690,3545,266,0,7302,1151,1517,673,1941,306,0,5588,12890
2922,Burkina Faso,2021,2021Burkina Faso,0,0,0,0,0,0,0,0,0,0,0,0,0,0,2861
2923,Burkina Faso,2021,2021Burkina Faso,0,0,0,0,0,0,0,0,0,0,5,0,0,5,5
2924,Burkina Faso,2021,2021Burkina Faso,0,0,0,0,0,0,0,0,0,0,9,0,0,9,9
2925,Burkina Faso,2021,2021Burkina Faso,0,0,0,0,0,0,0,0,0,0,11,0,0,11,11
2926,Burkina Faso,2021,2021Burkina Faso,0,0,0,0,0,0,0,0,0,0,14,0,0,14,14
2927,Burkina Faso,2021,2021Burkina Faso,0,0,0,8,0,0,8,0,0,0,9,0,0,9,22
2928,Burkina Faso,2021,2021Burkina Faso,0,0,0,20,0,0,20,0,0,0,20,0,0,20,116
2929,Burkina Faso,2021,2021Burkina Faso,8,0,0,0,0,0,8,0,5,0,5,0,0,10,18
2930,Burkina Faso,2021,2021Burkina Faso,11,11,0,41,0,0,63,0,8,0,35,0,0,43,106
2931,Burkina Faso,2021,2021Burkina Faso,18,23,14,30,5,0,90,19,34,8,33,5,0,99,189
2932,Burkina Faso,2021,2021Burkina Faso,185,291,126,441,58,0,1101,187,331,149,325,34,0,1026,2127
2933,Burkina Faso,2021,2021Burkina Faso,1356,1869,808,3931,298,0,8262,1296,1763,748,2307,355,0,6469,14731
2934,Burundi,2001,2001Burundi,0,0,0,0,0,0,0,0,0,0,0,0,0,0,3767
2935,Burundi,2001,2001Burundi,0,0,0,0,0,0,0,0,0,0,5,0,0,5,5
2936,Burundi,2001,2001Burundi,0,0,0,0,0,0,0,0,0,0,7,0,0,7,7
2937,Burundi,2001,2001Burundi,0,0,0,0,0,0,0,0,0,0,8,0,0,8,8
2938,Burundi,2001,2001Burundi,0,0,0,0,0,0,0,0,0,0,10,0,0,10,10
2939,Burundi,2001,2001Burundi,0,0,0,0,0,0,0,0,0,0,24,0,0,24,24
2940,Burundi,2001,2001Burundi,0,0,0,0,0,0,0,0,0,7,0,0,0,7,7
2941,Burundi,2001,2001Burundi,0,0,0,0,0,89,89,0,0,0,0,0,79,79,168
2942,Burundi,2001,2001Burundi,0,0,0,0,0,114,114,0,0,0,0,0,103,103,217
2943,Burundi,2001,2001Burundi,0,0,0,0,0,326,326,0,0,0,0,0,295,295,621
2944,Burundi,2001,2001Burundi,0,0,0,10,0,0,10,6,0,0,14,0,0,20,30
2945,Burundi,2001,2001Burundi,0,0,0,16,0,0,16,0,0,0,35,0,0,35,51
2946,Burundi,2001,2001Burundi,0,0,5,0,0,0,5,0,0,0,13,0,0,13,18
2947,Burundi,2001,2001Burundi,0,0,5,19,0,0,24,0,0,6,44,0,0,50,74
2948,Burundi,2001,2001Burundi,0,5,0,7,0,8,20,5,0,0,9,0,20,34,130
2949,Burundi,2001,2001Burundi,0,7,7,26,0,0,40,0,6,5,48,0,0,59,99
2950,Burundi,2001,2001Burundi,5,0,0,0,0,0,5,0,0,0,10,0,0,10,15
2951,Burundi,2001,2001Burundi,5,6,6,20,0,0,37,0,5,5,15,0,0,25,62
2952,Burundi,2001,2001Burundi,5,10,8,26,0,0,49,7,7,7,62,0,0,83,132
2953,Burundi,2001,2001Burundi,5,10,10,30,0,0,55,5,11,15,66,0,0,97,152
2954,Burundi,2001,2001Burundi,8,10,5,33,0,0,56,6,8,8,16,0,0,38,94
2955,Burundi,2001,2001Burundi,9,0,0,0,0,0,9,0,0,0,7,0,0,7,16
2956,Burundi,2001,2001Burundi,12,23,20,138,5,0,198,16,24,21,311,5,0,377,2417
2957,Burundi,2001,2001Burundi,16,33,30,122,0,0,201,21,50,41,169,5,0,286,487
2958,Burundi,2001,2001Burundi,28,58,50,211,0,0,347,18,98,84,892,0,0,1092,1439
2959,Burundi,2001,2001Burundi,31,15,14,176,0,0,236,43,111,95,367,0,0,616,852
2960,Burundi,2001,2001Burundi,40,45,39,129,0,0,253,61,64,54,188,5,0,372,19485
2961,Burundi,2001,2001Burundi,94,55,47,161,0,0,357,118,67,58,150,0,0,393,750
2962,Burundi,2001,2001Burundi,102,170,145,271,19,0,707,106,174,150,520,13,0,963,1670
2963,Burundi,2001,2001Burundi,35876,33069,28344,71861,3507,94583,267240,36115,33971,29117,74442,3536,76759,253940,521180
2964,Burundi,2002,2002Burundi,0,0,0,0,0,0,0,0,0,0,0,0,0,0,6762
2965,Burundi,2002,2002Burundi,0,0,0,0,0,0,0,0,0,0,5,0,0,5,15
2966,Burundi,2002,2002Burundi,0,0,0,0,0,0,0,0,0,0,8,0,0,8,8
2967,Burundi,2002,2002Burundi,0,0,0,0,0,0,0,0,0,0,10,0,0,10,10
2968,Burundi,2002,2002Burundi,0,0,0,0,0,0,0,0,0,7,0,0,0,7,7
2969,Burundi,2002,2002Burundi,0,0,0,0,0,0,0,5,0,0,11,0,0,16,16
2970,Burundi,2002,2002Burundi,0,0,0,0,0,117,117,0,0,0,0,0,102,102,219
2971,Burundi,2002,2002Burundi,0,0,0,0,0,313,313,0,0,0,0,0,300,300,1583
2972,Burundi,2002,2002Burundi,0,0,0,9,0,0,9,5,0,0,11,0,0,16,25
2973,Burundi,2002,2002Burundi,0,0,0,16,0,0,16,0,0,0,40,0,0,40,56
2974,Burundi,2002,2002Burundi,0,0,5,0,0,0,5,0,0,0,0,0,0,0,21
2975,Burundi,2002,2002Burundi,0,0,5,0,0,0,5,0,0,0,13,0,0,13,18
2976,Burundi,2002,2002Burundi,0,0,5,19,0,0,24,0,0,6,44,0,0,50,74
2977,Burundi,2002,2002Burundi,0,0,7,12,0,0,19,0,0,6,15,0,0,21,40
2978,Burundi,2002,2002Burundi,0,5,0,0,0,0,5,0,5,0,34,0,0,39,44
2979,Burundi,2002,2002Burundi,0,5,0,5,0,0,10,7,0,0,6,0,0,13,23
2980,Burundi,2002,2002Burundi,0,6,7,33,0,0,46,0,5,5,41,0,0,51,97
2981,Burundi,2002,2002Burundi,0,7,0,14,0,0,21,0,0,7,11,0,0,18,39
2982,Burundi,2002,2002Burundi,0,20,5,23,0,0,48,14,0,0,23,8,0,45,93
2983,Burundi,2002,2002Burundi,5,6,6,21,0,0,38,0,5,5,15,0,0,25,63
2984,Burundi,2002,2002Burundi,5,10,8,30,0,0,53,7,7,7,60,0,0,81,134
2985,Burundi,2002,2002Burundi,8,15,12,22,0,0,57,5,7,14,62,0,0,88,145
2986,Burundi,2002,2002Burundi,15,29,27,98,0,0,169,19,40,34,135,5,0,233,402
2987,Burundi,2002,2002Burundi,22,22,15,50,0,0,109,25,17,15,79,0,0,136,245
2988,Burundi,2002,2002Burundi,31,15,14,182,0,0,242,46,111,95,415,0,0,667,909
2989,Burundi,2002,2002Burundi,51,66,57,201,0,0,375,56,53,45,359,0,0,513,1715
2990,Burundi,2002,2002Burundi,61,72,61,174,10,0,378,86,89,77,233,10,0,495,19374
2991,Burundi,2002,2002Burundi,94,150,129,257,17,0,647,101,161,138,494,13,0,907,1554
2992,Burundi,2002,2002Burundi,37981,34901,29916,75838,3698,94596,276930,37843,35711,30612,78950,4045,76770,263931,540861
2993,Burundi,2003,2003Burundi,0,0,0,0,0,0,0,0,0,0,0,0,0,0,8538
2994,Burundi,2003,2003Burundi,0,0,0,0,0,0,0,0,0,0,5,0,0,5,10
2995,Burundi,2003,2003Burundi,0,0,0,0,0,0,0,0,0,0,8,0,0,8,8
2996,Burundi,2003,2003Burundi,0,0,0,0,0,0,0,0,0,0,10,0,0,10,10
2997,Burundi,2003,2003Burundi,0,0,0,0,0,0,0,6,0,0,12,0,0,18,18
2998,Burundi,2003,2003Burundi,0,0,0,0,0,46,46,0,0,0,0,0,49,49,188
2999,Burundi,2003,2003Burundi,0,0,0,0,0,120,120,0,0,0,0,0,103,103,223
3000,Burundi,2003,2003Burundi,0,0,0,5,0,0,5,0,0,0,5,0,0,5,10
3001,Burundi,2003,2003Burundi,0,0,5,9,0,0,14,0,0,0,33,0,0,33,47
3002,Burundi,2003,2003Burundi,0,0,5,18,0,0,23,0,0,6,43,0,0,49,72
3003,Burundi,2003,2003Burundi,0,0,8,12,0,0,20,8,0,0,15,0,0,23,43
3004,Burundi,2003,2003Burundi,0,0,8,18,0,0,26,0,8,0,11,0,0,19,45
3005,Burundi,2003,2003Burundi,0,7,7,34,0,0,48,0,6,6,41,0,0,53,101
3006,Burundi,2003,2003Burundi,0,12,5,18,0,0,35,6,0,0,18,9,0,33,76
3007,Burundi,2003,2003Burundi,5,0,0,5,0,0,10,8,0,0,17,0,0,25,35
3008,Burundi,2003,2003Burundi,5,6,6,21,0,0,38,5,6,0,14,0,0,25,63
3009,Burundi,2003,2003Burundi,5,9,7,31,0,0,52,8,7,7,58,0,0,80,132
3010,Burundi,2003,2003Burundi,13,15,13,22,0,0,63,5,9,8,70,0,0,92,155
3011,Burundi,2003,2003Burundi,14,29,27,99,0,0,169,13,41,35,141,5,0,235,404
3012,Burundi,2003,2003Burundi,30,27,18,58,0,0,133,36,32,34,82,0,0,184,317
3013,Burundi,2003,2003Burundi,51,66,57,201,0,0,375,56,53,45,359,0,0,513,1986
3014,Burundi,2003,2003Burundi,69,60,52,282,0,0,463,88,145,125,663,0,0,1021,1484
3015,Burundi,2003,2003Burundi,70,77,67,235,10,0,459,90,88,72,323,20,0,593,19552
3016,Burundi,2003,2003Burundi,136,186,160,382,16,0,880,122,178,154,486,21,0,961,1841
3017,Burundi,2003,2003Burundi,219,83,64,288,11,0,665,171,80,69,731,14,0,1065,2059
3018,Burundi,2003,2003Burundi,40302,29574,25348,61907,3146,0,160277,40208,30325,26000,63824,3575,0,163932,494209
3019,Burundi,2004,2004Burundi,0,0,0,0,0,0,0,0,0,0,0,0,0,0,12516
3020,Burundi,2004,2004Burundi,0,0,0,0,0,0,0,0,0,0,5,0,0,5,26
3021,Burundi,2004,2004Burundi,0,0,0,0,0,0,0,0,0,0,7,0,0,7,7
3022,Burundi,2004,2004Burundi,0,0,0,0,0,0,0,0,0,0,9,0,0,9,9
3023,Burundi,2004,2004Burundi,0,0,0,0,0,0,0,0,0,0,12,0,0,12,12
3024,Burundi,2004,2004Burundi,0,0,0,0,0,0,0,0,0,5,0,0,0,5,5
3025,Burundi,2004,2004Burundi,0,0,5,7,0,0,12,0,0,0,44,0,0,44,56
3026,Burundi,2004,2004Burundi,0,0,5,14,0,0,19,0,0,5,41,0,0,46,65
3027,Burundi,2004,2004Burundi,0,0,7,33,0,45,85,5,0,0,38,0,48,91,176
3028,Burundi,2004,2004Burundi,0,0,9,18,0,0,27,0,8,0,10,0,0,18,45
3029,Burundi,2004,2004Burundi,0,5,0,0,0,0,5,0,0,0,8,0,0,8,13
3030,Burundi,2004,2004Burundi,0,5,0,14,0,0,19,0,0,5,5,0,21,31,50
3031,Burundi,2004,2004Burundi,0,7,0,26,0,0,33,9,9,8,36,0,0,62,95
3032,Burundi,2004,2004Burundi,0,9,0,14,0,0,23,9,0,0,17,0,0,26,49
3033,Burundi,2004,2004Burundi,0,9,9,28,0,0,46,9,5,6,52,0,0,72,118
3034,Burundi,2004,2004Burundi,5,0,0,0,0,0,5,0,0,0,0,0,0,0,5
3035,Burundi,2004,2004Burundi,5,0,0,0,0,0,5,0,0,0,16,0,0,16,21
3036,Burundi,2004,2004Burundi,5,6,6,21,0,0,38,5,6,0,13,0,0,24,62
3037,Burundi,2004,2004Burundi,8,0,0,7,0,0,15,5,0,5,18,0,0,28,43
3038,Burundi,2004,2004Burundi,9,5,0,27,0,0,41,5,5,0,17,0,0,27,68
3039,Burundi,2004,2004Burundi,13,15,13,23,0,0,64,5,9,8,69,0,0,91,155
3040,Burundi,2004,2004Burundi,19,31,28,120,0,0,198,83,142,123,502,0,0,850,1048
3041,Burundi,2004,2004Burundi,71,66,57,220,10,0,424,99,84,67,311,19,0,580,19400
3042,Burundi,2004,2004Burundi,78,58,46,126,0,0,308,89,64,54,148,0,0,355,663
3043,Burundi,2004,2004Burundi,92,113,98,161,0,0,464,21,74,63,160,0,0,318,782
3044,Burundi,2004,2004Burundi,150,75,58,259,17,204,763,91,85,69,552,10,196,1003,1839
3045,Burundi,2004,2004Burundi,360,463,398,1025,54,0,2300,386,484,415,995,26,0,2306,4719
3046,Burundi,2004,2004Burundi,26232,22538,19316,52176,1785,0,122047,26216,22891,19620,52512,2189,0,123428,443706
3047,Burundi,2005,2005Burundi,0,0,0,0,0,0,0,0,0,0,0,0,0,0,15491
3048,Burundi,2005,2005Burundi,0,0,0,0,0,0,0,0,0,0,5,0,0,5,15
3049,Burundi,2005,2005Burundi,0,0,0,0,0,0,0,0,0,0,6,0,0,6,6
3050,Burundi,2005,2005Burundi,0,0,0,0,0,0,0,0,0,0,7,0,0,7,14
3051,Burundi,2005,2005Burundi,0,0,0,0,0,0,0,0,5,0,0,0,0,5,5
3052,Burundi,2005,2005Burundi,0,0,0,0,0,0,0,5,0,0,0,0,0,5,5
3053,Burundi,2005,2005Burundi,0,0,0,0,0,140,140,0,0,0,0,0,120,120,260
3054,Burundi,2005,2005Burundi,0,0,0,0,0,199,199,0,0,0,0,0,243,243,442
3055,Burundi,2005,2005Burundi,0,0,0,5,0,0,5,0,0,0,0,0,0,0,24
3056,Burundi,2005,2005Burundi,0,0,0,5,0,0,5,0,0,0,5,0,0,5,10
3057,Burundi,2005,2005Burundi,0,0,0,6,0,0,6,0,0,0,0,0,0,0,6
3058,Burundi,2005,2005Burundi,0,0,0,16,0,0,16,6,0,0,9,0,0,15,31
3059,Burundi,2005,2005Burundi,0,0,5,11,0,0,16,0,0,0,43,0,0,43,59
3060,Burundi,2005,2005Burundi,0,0,5,14,0,0,19,0,0,5,38,0,0,43,62
3061,Burundi,2005,2005Burundi,0,0,5,34,0,41,80,0,5,0,40,0,41,86,166
3062,Burundi,2005,2005Burundi,0,0,10,28,0,0,38,0,5,0,20,0,0,25,63
3063,Burundi,2005,2005Burundi,0,7,0,20,0,0,27,6,6,6,39,0,0,57,84
3064,Burundi,2005,2005Burundi,0,7,7,9,0,0,23,6,0,5,61,0,0,72,95
3065,Burundi,2005,2005Burundi,0,9,0,14,0,0,23,9,0,0,18,0,0,27,50
3066,Burundi,2005,2005Burundi,0,9,10,5,0,0,24,0,0,5,7,0,0,12,36
3067,Burundi,2005,2005Burundi,5,5,5,15,0,0,30,0,8,6,14,0,0,28,58
3068,Burundi,2005,2005Burundi,5,6,6,21,0,0,38,5,6,0,11,0,0,22,60
3069,Burundi,2005,2005Burundi,5,8,6,27,0,0,46,8,5,5,46,0,0,64,110
3070,Burundi,2005,2005Burundi,8,0,0,7,0,0,15,5,0,5,21,0,0,31,46
3071,Burundi,2005,2005Burundi,16,15,13,25,0,0,69,15,10,8,72,0,0,105,174
3072,Burundi,2005,2005Burundi,48,50,42,183,5,0,328,65,60,52,209,12,0,398,19032
3073,Burundi,2005,2005Burundi,79,69,59,399,0,0,606,16,69,59,438,0,0,582,1188
3074,Burundi,2005,2005Burundi,188,103,87,313,16,0,707,121,126,109,626,0,0,982,2089
3075,Burundi,2005,2005Burundi,215,161,131,309,11,0,827,215,140,120,339,19,0,833,1660
3076,Burundi,2005,2005Burundi,390,307,264,883,25,0,1869,406,264,227,947,30,0,1874,3743
3077,Burundi,2005,2005Burundi,20613,18489,15848,40431,1869,0,97250,22280,17920,15357,40265,2311,0,98133,393611
3078,Burundi,2006,2006Burundi,0,0,0,0,0,0,0,0,0,0,0,0,0,0,15918
3079,Burundi,2006,2006Burundi,0,0,0,0,0,0,0,0,0,0,5,0,0,5,20
3080,Burundi,2006,2006Burundi,0,0,0,0,0,0,0,0,0,0,6,0,0,6,6
3081,Burundi,2006,2006Burundi,0,0,0,0,0,0,0,0,0,0,7,0,0,7,7
3082,Burundi,2006,2006Burundi,0,0,0,0,0,0,0,0,0,0,10,0,0,10,10
3083,Burundi,2006,2006Burundi,0,0,0,0,0,0,0,0,5,0,0,0,0,5,5
3084,Burundi,2006,2006Burundi,0,0,0,0,0,0,0,5,0,0,0,0,0,5,5
3085,Burundi,2006,2006Burundi,0,0,0,0,0,5,5,0,0,0,0,0,28,28,33
3086,Burundi,2006,2006Burundi,0,0,0,0,0,75,75,0,0,0,0,0,73,73,148
3087,Burundi,2006,2006Burundi,0,0,0,0,0,142,142,0,0,0,0,0,124,124,266
3088,Burundi,2006,2006Burundi,0,0,0,0,0,145,145,0,0,0,0,0,149,149,294
3089,Burundi,2006,2006Burundi,0,0,0,0,0,221,221,0,0,0,0,0,272,272,493
3090,Burundi,2006,2006Burundi,0,0,0,6,0,0,6,0,0,0,0,0,0,0,6
3091,Burundi,2006,2006Burundi,0,0,0,6,0,0,6,0,0,0,35,0,0,35,41
3092,Burundi,2006,2006Burundi,0,0,5,13,0,0,18,0,0,0,38,0,0,38,56
3093,Burundi,2006,2006Burundi,0,0,7,22,0,0,29,0,9,0,24,0,0,33,62
3094,Burundi,2006,2006Burundi,0,5,0,0,0,0,5,0,0,5,36,0,0,41,68
3095,Burundi,2006,2006Burundi,0,5,0,25,0,0,30,0,0,0,17,0,0,17,47
3096,Burundi,2006,2006Burundi,0,5,6,31,0,0,42,0,5,6,39,0,0,50,92
3097,Burundi,2006,2006Burundi,0,5,8,8,0,0,21,0,18,0,11,0,0,29,50
3098,Burundi,2006,2006Burundi,0,9,0,11,0,0,20,8,0,0,18,0,0,26,46
3099,Burundi,2006,2006Burundi,0,9,0,14,0,0,23,0,9,0,18,0,0,27,50
3100,Burundi,2006,2006Burundi,0,9,10,9,0,0,28,0,0,5,8,0,0,13,41
3101,Burundi,2006,2006Burundi,5,5,7,20,0,0,37,0,0,9,11,0,0,20,57
3102,Burundi,2006,2006Burundi,5,10,23,75,0,0,113,6,14,12,124,0,0,156,269
3103,Burundi,2006,2006Burundi,8,0,0,7,0,0,15,5,0,5,16,0,0,26,41
3104,Burundi,2006,2006Burundi,14,16,14,25,0,0,69,15,8,10,71,0,0,104,173
3105,Burundi,2006,2006Burundi,26,35,81,245,8,0,395,36,42,80,443,5,0,606,1401
3106,Burundi,2006,2006Burundi,50,90,30,113,0,0,283,49,81,26,166,0,0,322,605
3107,Burundi,2006,2006Burundi,84,79,46,405,0,0,614,15,65,63,438,0,0,581,1195
3108,Burundi,2006,2006Burundi,117,117,102,203,5,0,544,121,120,88,251,5,0,585,1741
3109,Burundi,2006,2006Burundi,259,293,227,637,30,0,1446,275,320,244,560,25,0,1424,2870
3110,Burundi,2006,2006Burundi,514,896,0,1448,101,0,2959,460,856,0,1003,84,0,2403,17777
3111,Burundi,2006,2006Burundi,23100,24466,34323,77408,2568,0,161865,26022,28192,45824,87752,2985,0,190775,352640
3112,Burundi,2007,2007Burundi,0,0,0,0,0,0,0,0,0,0,0,0,0,0,28609
3113,Burundi,2007,2007Burundi,0,0,0,0,0,0,0,0,0,0,0,0,7,7,7
3114,Burundi,2007,2007Burundi,0,0,0,0,0,0,0,0,0,0,5,0,0,5,20
3115,Burundi,2007,2007Burundi,0,0,0,0,0,0,0,0,0,0,6,0,0,6,6
3116,Burundi,2007,2007Burundi,0,0,0,0,0,0,0,0,5,0,0,0,0,5,5
3117,Burundi,2007,2007Burundi,0,0,0,0,0,0,0,5,0,0,0,0,0,5,5
3118,Burundi,2007,2007Burundi,0,0,0,0,0,124,124,0,0,0,0,0,134,134,258
3119,Burundi,2007,2007Burundi,0,0,0,0,0,155,155,0,0,0,0,0,133,133,288
3120,Burundi,2007,2007Burundi,0,0,0,5,0,0,5,0,0,5,24,0,0,29,34
3121,Burundi,2007,2007Burundi,0,0,0,7,0,0,7,0,0,0,0,0,0,0,7
3122,Burundi,2007,2007Burundi,0,0,0,9,0,0,9,0,0,0,31,0,0,31,40
3123,Burundi,2007,2007Burundi,0,0,5,12,0,0,17,0,0,0,34,0,0,34,51
3124,Burundi,2007,2007Burundi,0,5,0,7,0,0,12,0,5,7,14,0,0,26,38
3125,Burundi,2007,2007Burundi,0,5,0,25,0,0,30,0,0,0,25,0,0,25,55
3126,Burundi,2007,2007Burundi,0,6,0,8,0,0,14,7,0,0,16,0,0,23,37
3127,Burundi,2007,2007Burundi,0,6,12,16,0,0,34,0,10,16,31,0,0,57,91
3128,Burundi,2007,2007Burundi,0,9,0,15,0,0,24,0,9,0,18,0,0,27,51
3129,Burundi,2007,2007Burundi,0,9,10,9,0,0,28,0,5,0,8,0,0,13,41
3130,Burundi,2007,2007Burundi,5,0,5,29,0,29,68,0,0,0,27,0,35,62,130
3131,Burundi,2007,2007Burundi,5,5,7,20,0,0,37,0,0,9,11,0,0,20,57
3132,Burundi,2007,2007Burundi,7,0,0,20,0,0,27,0,8,0,22,0,0,30,57
3133,Burundi,2007,2007Burundi,8,0,0,6,0,0,14,5,0,5,17,0,0,27,41
3134,Burundi,2007,2007Burundi,9,7,20,74,0,0,110,6,13,13,119,5,0,156,266
3135,Burundi,2007,2007Burundi,10,8,5,22,0,0,45,9,11,6,38,0,0,64,109
3136,Burundi,2007,2007Burundi,16,15,13,25,0,0,69,15,8,10,71,0,0,104,173
3137,Burundi,2007,2007Burundi,49,99,34,128,0,0,310,80,90,34,173,0,0,377,687
3138,Burundi,2007,2007Burundi,57,62,31,97,0,0,247,45,63,25,172,0,0,305,552
3139,Burundi,2007,2007Burundi,77,68,111,228,8,0,492,79,70,81,295,0,0,525,1417
3140,Burundi,2007,2007Burundi,82,85,50,434,0,0,651,14,68,69,468,0,0,619,1270
3141,Burundi,2007,2007Burundi,234,277,120,442,7,0,1080,279,259,129,467,10,0,1144,2224
3142,Burundi,2007,2007Burundi,288,267,214,644,23,0,1436,279,290,246,545,21,0,1381,2817
3143,Burundi,2007,2007Burundi,31163,30143,33305,71594,4899,0,171104,31063,30015,32361,66397,5337,0,165173,336277
3144,Burundi,2008,2008Burundi,0,0,0,0,0,0,0,0,0,0,0,0,0,0,28159
3145,Burundi,2008,2008Burundi,0,0,0,0,0,0,0,0,0,0,5,0,0,5,10
3146,Burundi,2008,2008Burundi,0,0,0,0,0,0,0,0,0,0,6,0,0,6,6
3147,Burundi,2008,2008Burundi,0,0,0,0,0,0,0,0,0,0,7,0,0,7,14
3148,Burundi,2008,2008Burundi,0,0,0,0,0,0,0,0,5,0,0,0,0,5,10
3149,Burundi,2008,2008Burundi,0,0,0,0,0,0,0,0,6,0,0,0,0,6,6
3150,Burundi,2008,2008Burundi,0,0,0,0,0,115,115,0,0,0,0,0,128,128,243
3151,Burundi,2008,2008Burundi,0,0,0,0,0,160,160,0,0,0,0,0,142,142,302
3152,Burundi,2008,2008Burundi,0,0,0,5,0,0,5,0,0,5,24,0,0,29,34
3153,Burundi,2008,2008Burundi,0,0,0,7,0,0,7,0,0,0,0,0,0,0,7
3154,Burundi,2008,2008Burundi,0,0,0,9,0,0,9,0,0,0,30,0,0,30,39
3155,Burundi,2008,2008Burundi,0,0,0,30,0,0,30,0,0,0,26,0,0,26,56
3156,Burundi,2008,2008Burundi,0,0,5,12,0,0,17,0,0,0,34,0,0,34,51
3157,Burundi,2008,2008Burundi,0,5,0,8,0,0,13,0,9,0,14,0,0,23,36
3158,Burundi,2008,2008Burundi,0,6,0,8,0,0,14,7,0,0,14,0,0,21,35
3159,Burundi,2008,2008Burundi,0,8,5,8,0,0,21,9,0,0,42,0,0,51,72
3160,Burundi,2008,2008Burundi,0,9,0,15,0,0,24,0,9,0,18,0,0,27,51
3161,Burundi,2008,2008Burundi,5,5,7,20,0,0,37,0,0,9,11,0,0,20,57
3162,Burundi,2008,2008Burundi,5,9,5,8,0,0,27,0,0,5,7,0,0,12,39
3163,Burundi,2008,2008Burundi,6,0,0,18,0,26,50,0,0,0,19,0,29,48,98
3164,Burundi,2008,2008Burundi,7,7,0,10,0,0,24,0,10,0,20,0,0,30,54
3165,Burundi,2008,2008Burundi,8,0,0,5,0,0,13,0,0,6,9,0,0,15,28
3166,Burundi,2008,2008Burundi,8,8,18,75,0,0,109,6,12,16,117,0,0,151,260
3167,Burundi,2008,2008Burundi,9,0,0,21,0,0,30,0,9,0,21,0,0,30,60
3168,Burundi,2008,2008Burundi,13,10,5,30,0,0,58,7,12,8,42,0,0,69,127
3169,Burundi,2008,2008Burundi,16,14,14,25,0,0,69,15,6,12,69,0,0,102,171
3170,Burundi,2008,2008Burundi,46,93,80,421,5,0,645,33,80,83,457,15,0,668,1313
3171,Burundi,2008,2008Burundi,48,78,60,192,0,0,378,81,105,58,183,0,0,427,805
3172,Burundi,2008,2008Burundi,49,59,38,99,0,0,245,40,33,62,118,0,0,253,498
3173,Burundi,2008,2008Burundi,53,93,46,137,0,0,329,79,88,41,181,0,0,389,718
3174,Burundi,2008,2008Burundi,126,135,107,294,6,0,668,107,131,117,509,5,0,869,1937
3175,Burundi,2008,2008Burundi,278,263,202,555,27,0,1325,234,299,231,511,24,0,1299,2624
3176,Burundi,2008,2008Burundi,329,391,190,661,10,0,1581,365,362,189,664,22,0,1602,3183
3177,Burundi,2008,2008Burundi,22428,29145,14998,52089,3912,0,122572,22366,19305,24361,47900,3976,0,117908,240480
3178,Burundi,2009,2009Burundi,0,0,0,0,0,0,0,0,0,0,0,0,0,0,11016
3179,Burundi,2009,2009Burundi,0,0,0,0,0,0,0,0,0,0,5,0,0,5,10
3180,Burundi,2009,2009Burundi,0,0,0,0,0,0,0,0,0,0,6,0,0,6,6
3181,Burundi,2009,2009Burundi,0,0,0,0,0,0,0,0,0,0,8,0,0,8,8
3182,Burundi,2009,2009Burundi,0,0,0,0,0,0,0,0,0,0,9,0,0,9,9
3183,Burundi,2009,2009Burundi,0,0,0,0,0,5,5,0,0,0,0,0,6,6,11
3184,Burundi,2009,2009Burundi,0,0,0,0,0,125,125,0,0,0,0,0,120,120,245
3185,Burundi,2009,2009Burundi,0,0,0,5,0,0,5,0,0,5,24,0,0,29,34
3186,Burundi,2009,2009Burundi,0,0,0,7,0,0,7,0,0,0,0,0,0,0,7
3187,Burundi,2009,2009Burundi,0,0,0,10,0,0,10,0,0,0,31,0,0,31,41
3188,Burundi,2009,2009Burundi,0,0,5,11,0,0,16,0,0,0,35,0,0,35,51
3189,Burundi,2009,2009Burundi,0,0,5,25,0,0,30,0,0,0,24,0,0,24,54
3190,Burundi,2009,2009Burundi,0,5,0,6,0,0,11,0,8,0,14,0,0,22,33
3191,Burundi,2009,2009Burundi,0,5,0,19,0,22,46,0,0,0,11,0,25,36,82
3192,Burundi,2009,2009Burundi,0,6,0,7,0,0,13,8,0,0,12,0,0,20,33
3193,Burundi,2009,2009Burundi,0,8,5,10,0,0,23,6,5,0,48,0,0,59,82
3194,Burundi,2009,2009Burundi,0,9,5,9,0,0,23,0,0,5,7,0,0,12,35
3195,Burundi,2009,2009Burundi,5,0,5,21,0,0,31,0,9,0,22,0,0,31,62
3196,Burundi,2009,2009Burundi,5,5,5,17,0,0,32,0,9,10,27,0,0,46,78
3197,Burundi,2009,2009Burundi,5,5,8,56,0,0,74,5,5,6,50,5,0,71,145
3198,Burundi,2009,2009Burundi,5,6,0,14,0,0,25,0,9,0,17,0,0,26,51
3199,Burundi,2009,2009Burundi,7,10,19,74,0,0,110,5,14,15,107,5,0,146,256
3200,Burundi,2009,2009Burundi,8,0,0,5,0,0,13,0,0,6,7,0,0,13,26
3201,Burundi,2009,2009Burundi,14,12,5,32,0,0,63,8,15,9,58,0,0,90,153
3202,Burundi,2009,2009Burundi,16,14,14,25,0,0,69,15,6,11,69,0,0,101,170
3203,Burundi,2009,2009Burundi,16,36,20,102,5,0,179,15,18,43,76,5,0,157,336
3204,Burundi,2009,2009Burundi,41,86,90,425,10,0,652,35,73,56,490,7,0,661,1313
3205,Burundi,2009,2009Burundi,48,117,60,160,0,0,385,61,116,52,213,0,0,442,827
3206,Burundi,2009,2009Burundi,52,73,37,101,0,0,263,41,77,34,140,0,0,292,555
3207,Burundi,2009,2009Burundi,90,162,74,233,9,0,568,103,170,89,285,5,0,652,1220
3208,Burundi,2009,2009Burundi,131,155,107,319,6,0,718,121,144,132,567,5,0,969,2087
3209,Burundi,2009,2009Burundi,375,447,245,781,13,0,1861,414,438,250,788,26,0,1916,3777
3210,Burundi,2009,2009Burundi,484,601,681,1815,114,0,3695,583,661,702,1843,178,0,3967,17585
3211,Burundi,2009,2009Burundi,5588,6360,3367,8610,825,0,24750,6967,7988,4531,8955,632,0,29073,53823
3212,Burundi,2010,2010Burundi,0,0,0,0,0,0,0,0,0,0,0,0,0,0,12341
3213,Burundi,2010,2010Burundi,0,0,0,0,0,0,0,0,0,0,0,0,7,7,7
3214,Burundi,2010,2010Burundi,0,0,0,0,0,0,0,0,0,0,5,0,0,5,5
3215,Burundi,2010,2010Burundi,0,0,0,0,0,0,0,0,0,0,6,0,0,6,6
3216,Burundi,2010,2010Burundi,0,0,0,0,0,0,0,0,0,0,9,0,0,9,9
3217,Burundi,2010,2010Burundi,0,0,0,0,0,6,6,0,0,0,0,0,8,8,14
3218,Burundi,2010,2010Burundi,0,0,0,0,0,7,7,0,0,0,0,0,0,0,7
3219,Burundi,2010,2010Burundi,0,0,0,0,0,131,131,0,0,0,0,0,124,124,255
3220,Burundi,2010,2010Burundi,0,0,0,0,0,161,161,0,0,0,0,0,159,159,320
3221,Burundi,2010,2010Burundi,0,0,0,5,0,0,5,0,0,0,0,0,0,0,5
3222,Burundi,2010,2010Burundi,0,0,0,6,0,0,6,0,0,0,0,0,0,0,6
3223,Burundi,2010,2010Burundi,0,0,0,6,0,0,6,0,0,0,27,0,0,27,33
3224,Burundi,2010,2010Burundi,0,0,0,7,0,0,7,0,0,0,0,0,0,0,7
3225,Burundi,2010,2010Burundi,0,0,0,9,0,0,9,5,0,0,9,0,0,14,23
3226,Burundi,2010,2010Burundi,0,0,0,10,0,0,10,0,0,0,31,0,0,31,41
3227,Burundi,2010,2010Burundi,0,0,5,11,0,0,16,0,0,0,35,0,0,35,51
3228,Burundi,2010,2010Burundi,0,5,6,21,0,0,32,0,0,5,33,0,0,38,70
3229,Burundi,2010,2010Burundi,0,6,0,7,0,0,13,0,8,0,15,0,0,23,36
3230,Burundi,2010,2010Burundi,0,9,0,12,0,0,21,0,0,0,10,0,0,10,31
3231,Burundi,2010,2010Burundi,5,0,0,18,0,24,47,0,0,0,8,0,26,34,81
3232,Burundi,2010,2010Burundi,5,5,9,53,0,0,72,0,6,7,47,6,0,66,138
3233,Burundi,2010,2010Burundi,5,6,0,14,0,0,25,0,9,0,19,0,0,28,53
3234,Burundi,2010,2010Burundi,5,6,6,16,0,0,33,5,6,8,27,0,0,46,79
3235,Burundi,2010,2010Burundi,5,12,15,81,0,0,113,5,10,15,111,5,0,146,259
3236,Burundi,2010,2010Burundi,8,0,0,5,0,0,13,0,0,6,7,0,0,13,26
3237,Burundi,2010,2010Burundi,9,0,0,21,0,0,30,0,9,0,22,0,0,31,61
3238,Burundi,2010,2010Burundi,12,16,5,38,0,0,71,8,21,12,66,0,0,107,178
3239,Burundi,2010,2010Burundi,15,38,20,96,5,0,174,15,22,38,87,5,0,167,341
3240,Burundi,2010,2010Burundi,36,55,44,215,5,0,355,34,49,37,290,0,0,410,765
3241,Burundi,2010,2010Burundi,45,77,30,104,0,0,256,39,76,41,139,0,0,295,551
3242,Burundi,2010,2010Burundi,62,123,65,181,0,0,431,59,134,64,246,0,0,503,934
3243,Burundi,2010,2010Burundi,138,176,128,324,11,0,777,129,143,170,557,0,0,999,2175
3244,Burundi,2010,2010Burundi,510,568,324,1011,24,0,2437,541,625,334,972,41,0,2513,4950
3245,Burundi,2010,2010Burundi,1383,1442,904,2545,197,0,6471,1363,1450,889,2532,140,0,6374,12845
3246,Burundi,2010,2010Burundi,4579,5785,4012,8277,319,0,22972,4617,5675,4137,8497,373,0,23299,47350
3247,Burundi,2011,2011Burundi,0,0,0,0,0,0,0,0,0,0,0,0,0,0,8232
3248,Burundi,2011,2011Burundi,0,0,0,0,0,0,0,0,0,0,5,0,0,5,10
3249,Burundi,2011,2011Burundi,0,0,0,0,0,0,0,0,0,0,6,0,0,6,6
3250,Burundi,2011,2011Burundi,0,0,0,0,0,0,0,0,0,0,9,0,0,9,18
3251,Burundi,2011,2011Burundi,0,0,0,0,0,7,7,0,0,0,0,0,0,0,7
3252,Burundi,2011,2011Burundi,0,0,0,0,0,142,142,0,0,0,0,0,132,132,274
3253,Burundi,2011,2011Burundi,0,0,0,0,0,166,166,0,0,0,0,0,165,165,331
3254,Burundi,2011,2011Burundi,0,0,0,5,0,0,5,0,0,0,0,0,0,0,10
3255,Burundi,2011,2011Burundi,0,0,0,6,0,0,6,0,0,0,27,0,0,27,33
3256,Burundi,2011,2011Burundi,0,0,0,7,0,0,7,0,0,0,0,0,0,0,7
3257,Burundi,2011,2011Burundi,0,0,0,7,0,0,7,5,0,0,6,0,0,11,18
3258,Burundi,2011,2011Burundi,0,0,0,10,0,0,10,0,0,0,29,0,0,29,39
3259,Burundi,2011,2011Burundi,0,0,0,22,0,0,22,0,0,5,6,0,0,11,33
3260,Burundi,2011,2011Burundi,0,0,5,11,0,0,16,0,0,0,34,0,0,34,50
3261,Burundi,2011,2011Burundi,0,5,0,6,0,0,11,0,5,0,13,0,0,18,29
3262,Burundi,2011,2011Burundi,0,5,0,17,0,21,43,0,0,0,10,0,27,37,80
3263,Burundi,2011,2011Burundi,0,5,10,21,5,0,41,0,14,5,34,0,0,53,94
3264,Burundi,2011,2011Burundi,0,9,0,0,0,0,9,0,0,0,9,0,0,9,18
3265,Burundi,2011,2011Burundi,5,5,5,46,0,0,61,0,5,5,36,5,0,51,112
3266,Burundi,2011,2011Burundi,5,6,0,13,0,0,24,5,0,10,25,0,0,40,64
3267,Burundi,2011,2011Burundi,5,6,0,14,0,0,25,0,9,0,19,0,0,28,53
3268,Burundi,2011,2011Burundi,5,7,6,23,0,0,41,7,0,7,37,0,0,51,92
3269,Burundi,2011,2011Burundi,5,7,7,10,0,0,29,5,6,0,44,0,0,55,84
3270,Burundi,2011,2011Burundi,9,0,0,22,0,0,31,0,9,0,22,0,0,31,62
3271,Burundi,2011,2011Burundi,13,36,27,137,6,0,219,6,23,20,149,5,0,203,2148
3272,Burundi,2011,2011Burundi,13,39,20,98,5,0,175,11,18,46,85,5,0,165,340
3273,Burundi,2011,2011Burundi,17,17,16,42,0,0,92,15,17,17,63,0,0,112,204
3274,Burundi,2011,2011Burundi,28,66,52,221,0,0,367,30,53,45,303,5,0,436,803
3275,Burundi,2011,2011Burundi,42,68,38,95,0,0,243,40,71,50,117,0,0,278,521
3276,Burundi,2011,2011Burundi,46,124,62,190,0,0,422,50,116,86,253,0,0,505,927
3277,Burundi,2011,2011Burundi,92,178,97,269,12,0,648,100,170,130,339,7,0,746,1394
3278,Burundi,2011,2011Burundi,138,180,108,278,10,0,714,119,132,133,540,0,0,924,2038
3279,Burundi,2011,2011Burundi,657,745,529,1368,47,0,3346,675,844,492,1271,59,0,3341,6687
3280,Burundi,2011,2011Burundi,779,863,624,1840,152,0,4258,866,952,739,1970,130,0,4657,8915
3281,Burundi,2011,2011Burundi,5688,7260,5951,13331,759,0,32989,5760,7673,5931,14266,930,0,34560,67549
3282,Burundi,2012,2012Burundi,0,0,0,0,0,0,0,0,0,0,0,0,0,0,7142
3283,Burundi,2012,2012Burundi,0,0,0,0,0,0,0,0,0,0,0,0,7,7,14
3284,Burundi,2012,2012Burundi,0,0,0,0,0,0,0,0,0,0,5,0,0,5,10
3285,Burundi,2012,2012Burundi,0,0,0,0,0,0,0,0,0,0,6,0,0,6,6
3286,Burundi,2012,2012Burundi,0,0,0,0,0,0,0,0,0,0,9,0,0,9,9
3287,Burundi,2012,2012Burundi,0,0,0,0,0,149,149,0,0,0,0,0,141,141,290
3288,Burundi,2012,2012Burundi,0,0,0,0,0,171,171,0,0,0,0,0,177,177,348
3289,Burundi,2012,2012Burundi,0,0,0,5,0,0,5,0,0,0,5,0,0,5,10
3290,Burundi,2012,2012Burundi,0,0,0,6,0,0,6,0,0,0,0,0,0,0,6
3291,Burundi,2012,2012Burundi,0,0,0,6,0,0,6,0,0,0,27,0,0,27,33
3292,Burundi,2012,2012Burundi,0,0,0,7,0,0,7,0,0,0,0,0,0,0,7
3293,Burundi,2012,2012Burundi,0,0,5,0,0,0,5,0,0,0,9,0,0,9,14
3294,Burundi,2012,2012Burundi,0,0,5,11,0,0,16,0,0,0,34,0,0,34,50
3295,Burundi,2012,2012Burundi,0,0,8,5,0,0,13,0,0,0,29,0,0,29,42
3296,Burundi,2012,2012Burundi,0,0,9,13,0,0,22,0,0,5,6,0,0,11,33
3297,Burundi,2012,2012Burundi,0,5,0,5,0,0,10,0,7,0,6,0,0,13,23
3298,Burundi,2012,2012Burundi,0,5,0,7,0,0,12,0,7,0,14,0,0,21,33
3299,Burundi,2012,2012Burundi,0,5,0,15,0,21,41,0,0,0,10,0,30,40,81
3300,Burundi,2012,2012Burundi,0,5,6,46,0,0,57,0,5,0,38,5,0,48,105
3301,Burundi,2012,2012Burundi,0,5,10,23,5,0,43,0,5,13,34,0,0,52,95
3302,Burundi,2012,2012Burundi,0,6,5,12,0,0,23,5,5,6,27,0,0,43,66
3303,Burundi,2012,2012Burundi,0,6,5,20,0,0,31,5,0,5,26,0,0,36,67
3304,Burundi,2012,2012Burundi,0,6,14,19,0,0,39,5,11,6,29,0,0,51,90
3305,Burundi,2012,2012Burundi,0,9,0,5,0,0,14,0,0,6,5,0,0,11,25
3306,Burundi,2012,2012Burundi,0,10,12,57,0,0,79,5,5,14,52,0,0,76,2315
3307,Burundi,2012,2012Burundi,5,0,9,7,0,0,21,7,0,0,39,0,0,46,67
3308,Burundi,2012,2012Burundi,5,33,26,100,5,0,169,5,18,30,105,6,0,164,333
3309,Burundi,2012,2012Burundi,9,0,0,21,0,0,30,0,5,5,21,0,0,31,61
3310,Burundi,2012,2012Burundi,12,20,18,46,0,0,96,14,22,11,71,0,0,118,214
3311,Burundi,2012,2012Burundi,41,68,39,97,0,0,245,41,68,50,122,0,0,281,526
3312,Burundi,2012,2012Burundi,51,120,77,206,5,0,459,45,113,94,255,10,0,517,976
3313,Burundi,2012,2012Burundi,74,87,77,236,6,0,480,79,72,71,311,5,0,538,1018
3314,Burundi,2012,2012Burundi,103,165,113,281,15,0,677,110,169,134,329,9,0,751,1428
3315,Burundi,2012,2012Burundi,109,208,125,397,12,0,851,103,178,122,723,5,0,1131,2378
3316,Burundi,2012,2012Burundi,681,1077,644,2009,170,0,4581,704,1099,673,2151,160,0,4787,9368
3317,Burundi,2012,2012Burundi,999,1373,1067,1875,79,0,5393,1042,1440,1055,1716,82,0,5335,10728
3318,Burundi,2012,2012Burundi,2637,3383,3493,7349,646,0,17508,2439,3451,3519,7661,765,0,17835,35343
3319,Burundi,2013,2013Burundi,0,0,0,0,0,0,0,0,0,0,0,0,0,0,6159
3320,Burundi,2013,2013Burundi,0,0,0,0,0,0,0,0,0,0,0,0,7,7,7
3321,Burundi,2013,2013Burundi,0,0,0,0,0,0,0,0,0,0,5,0,0,5,15
3322,Burundi,2013,2013Burundi,0,0,0,0,0,130,130,0,0,0,0,0,131,131,309
3323,Burundi,2013,2013Burundi,0,0,0,0,0,175,175,0,0,0,0,0,186,186,361
3324,Burundi,2013,2013Burundi,0,0,0,5,0,0,5,0,0,0,0,0,0,0,5
3325,Burundi,2013,2013Burundi,0,0,0,6,0,0,6,0,0,0,7,0,0,7,13
3326,Burundi,2013,2013Burundi,0,0,0,6,0,0,6,0,0,0,27,0,0,27,33
3327,Burundi,2013,2013Burundi,0,0,0,7,0,0,7,0,0,0,0,0,0,0,7
3328,Burundi,2013,2013Burundi,0,0,0,11,0,0,11,0,0,0,14,0,0,14,25
3329,Burundi,2013,2013Burundi,0,0,0,13,0,0,13,0,0,0,30,0,0,30,43
3330,Burundi,2013,2013Burundi,0,0,5,11,0,0,16,0,0,0,34,0,0,34,50
3331,Burundi,2013,2013Burundi,0,0,9,12,0,0,21,0,0,0,7,0,0,7,28
3332,Burundi,2013,2013Burundi,0,0,14,22,5,0,41,0,5,13,32,0,0,50,91
3333,Burundi,2013,2013Burundi,0,5,0,7,0,0,12,0,7,0,14,0,0,21,33
3334,Burundi,2013,2013Burundi,0,5,0,12,0,17,34,0,0,5,8,0,25,38,72
3335,Burundi,2013,2013Burundi,0,6,11,22,0,0,39,0,7,14,31,0,0,52,91
3336,Burundi,2013,2013Burundi,0,8,5,22,0,0,35,5,0,5,26,0,0,36,71
3337,Burundi,2013,2013Burundi,0,9,0,5,0,0,14,0,0,6,5,0,0,11,25
3338,Burundi,2013,2013Burundi,0,9,0,32,0,0,41,0,0,5,26,0,0,31,72
3339,Burundi,2013,2013Burundi,5,0,8,7,0,0,20,0,9,0,39,0,0,48,68
3340,Burundi,2013,2013Burundi,5,15,14,64,0,0,98,5,5,17,48,6,0,81,2278
3341,Burundi,2013,2013Burundi,5,37,21,111,6,0,180,5,19,20,113,0,0,157,337
3342,Burundi,2013,2013Burundi,6,6,0,9,0,0,21,0,6,6,26,0,0,38,59
3343,Burundi,2013,2013Burundi,8,0,0,19,0,0,27,0,6,5,23,0,0,34,61
3344,Burundi,2013,2013Burundi,12,31,19,42,5,0,109,13,21,15,87,0,0,136,245
3345,Burundi,2013,2013Burundi,44,116,84,208,5,0,457,38,113,94,247,16,0,508,965
3346,Burundi,2013,2013Burundi,49,69,43,104,0,0,265,35,70,60,138,0,0,303,654
3347,Burundi,2013,2013Burundi,89,113,108,230,5,0,545,104,98,83,332,5,0,622,1167
3348,Burundi,2013,2013Burundi,91,153,108,270,15,0,637,98,149,132,302,7,0,688,1325
3349,Burundi,2013,2013Burundi,104,219,121,422,14,0,880,98,175,116,761,5,0,1155,2435
3350,Burundi,2013,2013Burundi,604,1224,726,2039,178,0,4771,606,1218,722,2293,152,0,4991,9762
3351,Burundi,2013,2013Burundi,1202,1897,1955,290,44,0,5388,1195,1856,1749,362,37,0,5199,10587
3352,Burundi,2013,2013Burundi,3280,3671,3551,6467,748,0,17717,2843,3921,3386,6577,739,0,17466,35183
3353,Burundi,2014,2014Burundi,0,0,0,0,0,0,0,0,0,0,0,0,0,0,3386
3354,Burundi,2014,2014Burundi,0,0,0,0,0,0,0,0,0,0,0,0,7,7,7
3355,Burundi,2014,2014Burundi,0,0,0,0,0,0,0,0,0,0,5,0,0,5,15
3356,Burundi,2014,2014Burundi,0,0,0,0,0,176,176,0,0,0,0,0,191,191,367
3357,Burundi,2014,2014Burundi,0,0,0,0,0,1194,1194,0,0,0,0,0,2459,2459,3653
3358,Burundi,2014,2014Burundi,0,0,0,0,6,0,6,0,0,0,7,0,0,7,13
3359,Burundi,2014,2014Burundi,0,0,0,5,0,0,5,0,0,0,0,0,0,0,5
3360,Burundi,2014,2014Burundi,0,0,0,6,0,0,6,0,0,0,27,0,0,27,33
3361,Burundi,2014,2014Burundi,0,0,0,7,0,0,7,0,0,0,0,0,0,0,7
3362,Burundi,2014,2014Burundi,0,0,0,8,0,0,8,0,0,10,10,0,0,20,28
3363,Burundi,2014,2014Burundi,0,0,5,11,0,0,16,0,0,0,34,0,0,34,50
3364,Burundi,2014,2014Burundi,0,0,7,30,0,0,37,0,5,0,29,0,0,34,2114
3365,Burundi,2014,2014Burundi,0,0,13,0,0,0,13,0,0,24,0,0,0,24,37
3366,Burundi,2014,2014Burundi,0,0,13,23,5,0,41,5,5,6,39,0,0,55,96
3367,Burundi,2014,2014Burundi,0,5,0,5,0,0,10,0,0,9,7,0,0,16,26
3368,Burundi,2014,2014Burundi,0,5,0,11,0,15,31,0,0,5,8,0,22,35,66
3369,Burundi,2014,2014Burundi,0,5,8,7,0,0,20,8,6,0,39,0,0,53,73
3370,Burundi,2014,2014Burundi,0,6,0,7,0,0,13,0,0,7,14,0,0,21,34
3371,Burundi,2014,2014Burundi,0,8,0,31,0,0,39,0,0,5,27,0,0,32,71
3372,Burundi,2014,2014Burundi,0,9,0,5,0,0,14,0,0,6,5,0,0,11,25
3373,Burundi,2014,2014Burundi,0,41,26,124,6,0,197,13,27,29,115,7,0,191,388
3374,Burundi,2014,2014Burundi,5,6,5,10,0,0,26,0,5,5,26,0,0,36,62
3375,Burundi,2014,2014Burundi,5,7,0,20,0,0,32,0,5,7,23,0,0,35,67
3376,Burundi,2014,2014Burundi,6,16,7,27,0,0,56,5,13,6,33,0,0,57,113
3377,Burundi,2014,2014Burundi,14,25,16,29,0,0,84,12,21,15,77,0,0,125,209
3378,Burundi,2014,2014Burundi,33,100,94,222,10,0,459,28,113,91,264,16,0,512,971
3379,Burundi,2014,2014Burundi,37,60,41,164,5,0,307,45,46,43,216,0,0,350,657
3380,Burundi,2014,2014Burundi,38,68,52,116,0,0,274,32,65,69,153,0,0,319,593
3381,Burundi,2014,2014Burundi,80,278,171,518,83,0,1130,82,232,172,831,54,0,1371,2501
3382,Burundi,2014,2014Burundi,91,140,118,278,15,0,642,93,147,126,320,7,0,693,1335
3383,Burundi,2014,2014Burundi,208,1294,746,2099,198,0,4545,207,1242,778,2324,163,0,4714,9259
3384,Burundi,2014,2014Burundi,1260,1462,1014,2220,109,0,6065,1203,1516,940,2083,96,0,5838,11903
3385,Burundi,2014,2014Burundi,2528,3504,3617,6559,582,0,16790,2461,3672,3566,7098,726,0,17523,34313
3386,Burundi,2015,2015Burundi,0,0,0,0,0,0,0,0,0,0,0,0,0,0,8029
3387,Burundi,2015,2015Burundi,0,0,0,0,0,0,0,0,0,0,0,0,6,6,6
3388,Burundi,2015,2015Burundi,0,0,0,0,0,0,0,0,0,0,5,0,0,5,15
3389,Burundi,2015,2015Burundi,0,0,0,0,0,0,0,0,0,8,0,0,0,8,8
3390,Burundi,2015,2015Burundi,0,0,0,0,0,150,150,0,0,0,0,0,161,161,311
3391,Burundi,2015,2015Burundi,0,0,0,0,0,182,182,0,0,0,0,0,193,193,375
3392,Burundi,2015,2015Burundi,0,0,0,6,0,0,6,0,0,0,31,0,0,31,37
3393,Burundi,2015,2015Burundi,0,0,0,7,0,0,7,0,0,0,0,0,0,0,7
3394,Burundi,2015,2015Burundi,0,0,0,7,0,0,7,0,0,0,7,0,0,7,14
3395,Burundi,2015,2015Burundi,0,0,0,7,0,0,7,0,0,0,15,0,0,15,22
3396,Burundi,2015,2015Burundi,0,0,0,8,0,0,8,0,0,0,0,0,0,0,8
3397,Burundi,2015,2015Burundi,0,0,0,9,0,0,9,0,0,10,12,0,0,22,31
3398,Burundi,2015,2015Burundi,0,0,5,5,0,0,10,0,0,9,7,0,0,16,26
3399,Burundi,2015,2015Burundi,0,0,5,11,0,0,16,0,0,0,34,0,0,34,50
3400,Burundi,2015,2015Burundi,0,0,8,5,0,0,13,7,0,0,24,0,0,31,44
3401,Burundi,2015,2015Burundi,0,0,16,24,0,0,40,0,0,10,34,5,0,49,89
3402,Burundi,2015,2015Burundi,0,5,0,11,0,23,39,0,0,0,12,0,16,28,67
3403,Burundi,2015,2015Burundi,0,6,0,8,0,0,14,0,0,7,15,0,0,22,36
3404,Burundi,2015,2015Burundi,0,6,0,33,0,0,39,0,0,5,27,0,0,32,71
3405,Burundi,2015,2015Burundi,0,10,0,17,0,0,27,0,5,5,24,0,0,34,61
3406,Burundi,2015,2015Burundi,5,0,0,12,0,0,17,0,0,0,7,0,0,7,24
3407,Burundi,2015,2015Burundi,5,6,5,9,0,0,25,0,8,0,19,0,0,27,52
3408,Burundi,2015,2015Burundi,10,15,12,33,0,0,70,5,14,13,42,0,0,74,144
3409,Burundi,2015,2015Burundi,14,21,18,29,0,0,82,24,10,21,79,0,0,134,216
3410,Burundi,2015,2015Burundi,37,64,56,123,0,0,280,31,61,67,169,0,0,328,608
3411,Burundi,2015,2015Burundi,47,79,54,220,5,0,405,69,78,59,227,10,0,443,848
3412,Burundi,2015,2015Burundi,47,119,101,253,10,0,530,32,134,97,310,16,0,589,1119
3413,Burundi,2015,2015Burundi,98,288,213,610,84,0,1293,91,246,221,1025,55,0,1638,2931
3414,Burundi,2015,2015Burundi,100,148,128,307,16,0,699,99,156,141,376,8,0,780,1479
3415,Burundi,2015,2015Burundi,2088,2777,1831,5847,305,0,12848,2065,2852,1696,6539,256,0,13408,26256
3416,Burundi,2015,2015Burundi,2718,2543,1188,5086,267,0,11802,2666,2606,1204,4707,178,0,11361,23163
3417,Burundi,2015,2015Burundi,5154,6752,4713,18185,1023,0,35827,5428,6785,4922,17338,548,0,35021,70848
3418,Burundi,2015,2015Burundi,13135,15656,17450,32664,2001,0,80906,13113,13592,16211,29823,2110,0,74849,155755
3419,Burundi,2016,2016Burundi,0,0,0,0,0,0,0,0,0,0,0,0,0,0,1642
3420,Burundi,2016,2016Burundi,0,0,0,0,0,0,0,0,0,0,0,0,6,6,6
3421,Burundi,2016,2016Burundi,0,0,0,0,0,0,0,0,0,0,5,0,0,5,15
3422,Burundi,2016,2016Burundi,0,0,0,0,0,0,0,0,0,0,6,0,0,6,6
3423,Burundi,2016,2016Burundi,0,0,0,0,0,0,0,0,0,0,8,0,0,8,8
3424,Burundi,2016,2016Burundi,0,0,0,0,0,205,205,0,0,0,0,0,249,249,454
3425,Burundi,2016,2016Burundi,0,0,0,0,0,240,240,0,0,0,0,0,269,269,509
3426,Burundi,2016,2016Burundi,0,0,0,0,0,1040,1040,0,0,0,0,0,1940,1940,2980
3427,Burundi,2016,2016Burundi,0,0,0,0,6,0,6,0,0,0,5,0,0,5,11
3428,Burundi,2016,2016Burundi,0,0,0,5,0,0,5,0,5,0,0,0,0,5,10
3429,Burundi,2016,2016Burundi,0,0,0,6,0,0,6,0,0,0,33,0,0,33,39
3430,Burundi,2016,2016Burundi,0,0,0,7,0,0,7,0,0,0,16,0,0,16,23
3431,Burundi,2016,2016Burundi,0,0,0,8,0,0,8,0,0,0,0,0,0,0,8
3432,Burundi,2016,2016Burundi,0,0,0,9,0,0,9,0,0,10,13,0,0,23,32
3433,Burundi,2016,2016Burundi,0,0,5,0,0,0,5,0,0,0,0,0,0,0,5
3434,Burundi,2016,2016Burundi,0,0,5,10,0,15,30,0,0,0,7,5,22,34,64
3435,Burundi,2016,2016Burundi,0,0,5,12,0,0,17,0,0,0,35,0,0,35,52
3436,Burundi,2016,2016Burundi,0,0,8,0,0,0,8,0,9,0,0,0,0,9,17
3437,Burundi,2016,2016Burundi,0,5,0,0,0,0,5,0,0,8,0,0,0,8,13
3438,Burundi,2016,2016Burundi,0,5,0,10,0,0,15,0,0,0,7,0,0,7,22
3439,Burundi,2016,2016Burundi,0,5,0,28,0,0,33,0,0,5,31,0,0,36,69
3440,Burundi,2016,2016Burundi,0,5,5,20,0,0,30,0,0,10,19,0,0,29,59
3441,Burundi,2016,2016Burundi,0,6,0,5,0,0,11,0,5,0,8,0,0,13,24
3442,Burundi,2016,2016Burundi,0,9,0,0,0,0,9,0,0,0,0,0,0,0,9
3443,Burundi,2016,2016Burundi,0,11,5,11,0,0,27,0,5,5,20,0,0,30,57
3444,Burundi,2016,2016Burundi,0,16,11,121,15,0,163,0,10,17,98,7,0,132,1715
3445,Burundi,2016,2016Burundi,5,0,0,28,5,0,38,0,9,11,38,0,0,58,96
3446,Burundi,2016,2016Burundi,7,0,0,8,0,0,15,7,0,0,23,0,0,30,45
3447,Burundi,2016,2016Burundi,9,18,13,34,0,0,74,5,13,14,43,0,0,75,149
3448,Burundi,2016,2016Burundi,12,25,15,37,0,0,89,20,20,18,82,0,0,140,229
3449,Burundi,2016,2016Burundi,38,64,62,133,0,0,297,32,63,69,165,5,0,334,631
3450,Burundi,2016,2016Burundi,47,97,95,223,11,0,473,52,93,90,273,10,0,518,991
3451,Burundi,2016,2016Burundi,118,158,152,356,17,0,801,108,171,150,402,10,0,841,1642
3452,Burundi,2016,2016Burundi,125,326,248,743,89,0,1531,113,291,257,1384,61,0,2106,3637
3453,Burundi,2016,2016Burundi,140,159,104,417,10,0,830,152,194,103,433,5,0,887,1717
3454,Burundi,2016,2016Burundi,3414,4023,2461,8776,429,176,19279,3405,4248,2472,11136,378,94,21733,41012
3455,Burundi,2016,2016Burundi,4562,4064,2038,7447,346,0,18457,4484,4209,2062,6897,223,0,17875,36332
3456,Burundi,2016,2016Burundi,5811,7627,5295,21044,1181,0,40958,6080,7764,5596,21821,667,0,41928,82886
3457,Burundi,2016,2016Burundi,22421,24344,19129,44044,2699,0,112637,22906,24871,20632,47186,2618,0,118213,230850
3458,Burundi,2017,2017Burundi,0,0,0,0,0,0,0,0,0,0,0,0,0,0,3951
3459,Burundi,2017,2017Burundi,0,0,0,0,0,0,0,0,0,0,0,0,9,9,9
3460,Burundi,2017,2017Burundi,0,0,0,0,0,0,0,0,0,0,5,0,0,5,20
3461,Burundi,2017,2017Burundi,0,0,0,0,0,0,0,0,0,0,6,0,0,6,6
3462,Burundi,2017,2017Burundi,0,0,0,0,0,0,0,0,0,0,7,0,0,7,7
3463,Burundi,2017,2017Burundi,0,0,0,0,0,6,6,0,0,0,0,0,0,0,6
3464,Burundi,2017,2017Burundi,0,0,0,0,0,282,282,0,0,0,0,0,325,325,607
3465,Burundi,2017,2017Burundi,0,0,0,0,0,1052,1052,0,0,0,0,0,1948,1948,3000
3466,Burundi,2017,2017Burundi,0,0,0,5,0,0,5,0,0,0,0,0,0,0,10
3467,Burundi,2017,2017Burundi,0,0,0,5,0,0,5,0,0,0,6,0,0,6,11
3468,Burundi,2017,2017Burundi,0,0,0,5,0,0,5,0,5,0,0,0,0,5,10
3469,Burundi,2017,2017Burundi,0,0,0,6,0,0,6,0,0,0,0,0,0,0,6
3470,Burundi,2017,2017Burundi,0,0,0,7,0,0,7,0,0,0,11,0,0,11,18
3471,Burundi,2017,2017Burundi,0,0,0,8,0,0,8,0,0,0,0,0,0,0,8
3472,Burundi,2017,2017Burundi,0,0,0,9,0,0,9,0,0,0,16,0,0,16,25
3473,Burundi,2017,2017Burundi,0,0,0,10,0,0,10,0,6,0,14,0,0,20,30
3474,Burundi,2017,2017Burundi,0,0,5,0,0,0,5,0,0,0,0,0,0,0,5
3475,Burundi,2017,2017Burundi,0,0,5,13,0,0,18,0,0,0,37,0,0,37,55
3476,Burundi,2017,2017Burundi,0,0,5,15,0,31,51,0,0,0,8,5,20,33,84
3477,Burundi,2017,2017Burundi,0,0,6,0,0,0,6,0,0,0,9,0,0,9,15
3478,Burundi,2017,2017Burundi,0,0,9,0,0,0,9,0,6,0,9,0,0,15,24
3479,Burundi,2017,2017Burundi,0,5,0,0,0,0,5,0,0,0,0,0,0,0,5
3480,Burundi,2017,2017Burundi,0,5,0,6,0,0,11,0,0,0,13,0,0,13,24
3481,Burundi,2017,2017Burundi,0,6,10,16,0,0,32,0,0,10,18,0,0,28,60
3482,Burundi,2017,2017Burundi,0,7,0,8,0,0,15,0,0,7,12,0,0,19,34
3483,Burundi,2017,2017Burundi,0,10,0,36,0,0,46,0,7,0,37,0,0,44,90
3484,Burundi,2017,2017Burundi,5,0,0,27,5,0,37,0,15,6,40,0,0,61,98
3485,Burundi,2017,2017Burundi,5,5,0,0,0,0,10,0,0,0,0,0,0,0,10
3486,Burundi,2017,2017Burundi,5,7,5,11,0,0,28,0,9,0,21,0,0,30,58
3487,Burundi,2017,2017Burundi,7,0,0,7,0,0,14,0,10,0,22,0,0,32,46
3488,Burundi,2017,2017Burundi,8,20,14,37,0,0,79,7,14,15,45,0,0,81,160
3489,Burundi,2017,2017Burundi,18,24,21,41,0,0,104,27,26,26,92,0,0,171,275
3490,Burundi,2017,2017Burundi,40,59,59,132,5,0,295,33,53,62,179,0,0,327,622
3491,Burundi,2017,2017Burundi,42,99,79,240,11,0,471,51,78,78,294,10,0,511,982
3492,Burundi,2017,2017Burundi,113,162,152,360,17,0,804,98,174,146,416,11,0,845,1649
3493,Burundi,2017,2017Burundi,160,173,119,453,12,0,917,165,219,133,458,10,0,985,1902
3494,Burundi,2017,2017Burundi,166,317,238,608,83,0,1412,177,288,234,1095,61,0,1855,3267
3495,Burundi,2017,2017Burundi,3014,3772,2359,8244,394,634,18417,3042,3951,2379,9812,302,342,19828,38245
3496,Burundi,2017,2017Burundi,4874,5976,2831,8712,399,0,22792,5023,5949,2745,7647,294,0,21658,44450
3497,Burundi,2017,2017Burundi,6150,7976,5406,22987,1103,0,43622,6440,8153,5766,23310,918,0,44587,88209
3498,Burundi,2017,2017Burundi,24640,27965,16822,53929,3656,0,127012,23649,26424,16633,54529,2980,0,124215,251227
3499,Burundi,2018,2018Burundi,0,0,0,0,0,0,0,0,0,0,0,0,0,0,4976
3500,Burundi,2018,2018Burundi,0,0,0,0,0,0,0,0,0,0,5,0,0,5,15
3501,Burundi,2018,2018Burundi,0,0,0,0,0,0,0,0,0,0,7,0,0,7,7
3502,Burundi,2018,2018Burundi,0,0,0,0,0,6,6,0,0,0,0,0,5,5,11
3503,Burundi,2018,2018Burundi,0,0,0,0,0,384,384,0,0,0,0,0,450,450,834
3504,Burundi,2018,2018Burundi,0,0,0,5,0,0,5,0,0,0,0,0,0,0,15
3505,Burundi,2018,2018Burundi,0,0,0,5,0,0,5,0,0,0,7,0,0,7,12
3506,Burundi,2018,2018Burundi,0,0,0,5,0,0,5,0,0,0,11,0,0,11,16
3507,Burundi,2018,2018Burundi,0,0,0,7,0,0,7,0,0,0,0,0,0,0,7
3508,Burundi,2018,2018Burundi,0,0,0,9,0,0,9,0,0,5,14,0,0,19,28
3509,Burundi,2018,2018Burundi,0,0,0,31,5,0,36,0,0,10,43,5,0,58,94
3510,Burundi,2018,2018Burundi,0,0,5,15,0,27,47,0,0,0,13,0,43,56,103
3511,Burundi,2018,2018Burundi,0,0,9,0,0,0,9,0,0,7,9,0,0,16,25
3512,Burundi,2018,2018Burundi,0,0,13,0,0,0,13,0,0,0,0,0,0,0,13
3513,Burundi,2018,2018Burundi,0,5,0,0,0,0,5,0,0,0,0,0,0,0,5
3514,Burundi,2018,2018Burundi,0,6,0,0,0,0,6,0,0,0,0,0,0,0,6
3515,Burundi,2018,2018Burundi,0,7,0,8,0,0,15,0,0,7,12,0,0,19,34
3516,Burundi,2018,2018Burundi,0,7,16,9,0,0,32,0,9,5,16,0,0,30,62
3517,Burundi,2018,2018Burundi,0,10,5,20,0,0,35,0,13,0,22,0,0,35,70
3518,Burundi,2018,2018Burundi,5,0,0,0,0,0,5,0,0,0,0,0,0,0,5
3519,Burundi,2018,2018Burundi,5,0,0,7,0,0,12,0,5,0,10,0,0,15,27
3520,Burundi,2018,2018Burundi,5,8,6,32,5,0,56,0,6,5,34,5,0,50,106
3521,Burundi,2018,2018Burundi,6,0,5,9,0,0,20,0,10,0,20,0,0,30,50
3522,Burundi,2018,2018Burundi,7,0,0,13,0,0,20,0,0,0,17,0,0,17,37
3523,Burundi,2018,2018Burundi,8,18,20,44,0,0,90,6,16,16,53,0,0,91,181
3524,Burundi,2018,2018Burundi,21,22,12,42,5,0,102,21,22,14,87,0,0,144,246
3525,Burundi,2018,2018Burundi,30,51,62,135,5,0,283,28,58,58,181,0,0,325,608
3526,Burundi,2018,2018Burundi,40,101,92,258,15,0,506,56,83,73,303,11,0,526,1032
3527,Burundi,2018,2018Burundi,65,103,101,320,24,0,613,43,107,79,323,16,0,568,2194
3528,Burundi,2018,2018Burundi,179,265,209,531,21,0,1205,172,268,222,634,13,0,1309,2514
3529,Burundi,2018,2018Burundi,194,376,272,790,84,0,1716,208,336,288,1870,65,0,2767,4483
3530,Burundi,2018,2018Burundi,395,478,292,1067,29,0,2261,409,535,299,1349,19,0,2611,4872
3531,Burundi,2018,2018Burundi,2886,3517,2050,7082,380,0,15915,2905,3514,2077,7800,307,0,16603,32518
3532,Burundi,2018,2018Burundi,4338,5903,3065,8411,435,0,22152,4464,5948,3004,7093,349,0,20858,43010
3533,Burundi,2018,2018Burundi,6023,6129,3997,14951,957,0,32057,6193,6418,4307,18607,698,0,36223,68280
3534,Burundi,2018,2018Burundi,22556,23127,15705,43637,2774,0,107799,22796,23876,15688,48468,2727,0,113555,221354
3535,Burundi,2019,2019Burundi,0,0,0,0,0,0,0,0,0,0,0,0,0,0,7921
3536,Burundi,2019,2019Burundi,0,0,0,0,0,0,0,0,0,0,5,0,0,5,15
3537,Burundi,2019,2019Burundi,0,0,0,0,0,493,493,0,0,0,0,0,596,596,1089
3538,Burundi,2019,2019Burundi,0,0,0,5,0,0,5,0,0,0,0,0,0,0,10
3539,Burundi,2019,2019Burundi,0,0,0,5,0,0,5,0,0,0,7,0,0,7,12
3540,Burundi,2019,2019Burundi,0,0,0,5,0,0,5,0,0,0,50,0,0,50,55
3541,Burundi,2019,2019Burundi,0,0,0,6,0,0,6,0,0,0,0,0,0,0,6
3542,Burundi,2019,2019Burundi,0,0,0,6,0,0,6,0,0,0,6,0,0,6,12
3543,Burundi,2019,2019Burundi,0,0,0,6,0,0,6,0,0,0,15,0,0,15,21
3544,Burundi,2019,2019Burundi,0,0,0,7,0,0,7,0,0,0,0,0,0,0,7
3545,Burundi,2019,2019Burundi,0,0,0,27,5,0,32,0,0,5,24,5,0,34,66
3546,Burundi,2019,2019Burundi,0,0,5,0,0,0,5,0,0,0,0,0,0,0,5
3547,Burundi,2019,2019Burundi,0,0,5,13,0,0,18,0,0,0,13,0,0,13,123
3548,Burundi,2019,2019Burundi,0,0,7,0,0,0,7,0,0,0,0,0,0,0,7
3549,Burundi,2019,2019Burundi,0,0,8,0,0,0,8,0,0,0,0,0,0,0,8
3550,Burundi,2019,2019Burundi,0,0,8,5,0,0,13,0,0,0,0,0,0,0,13
3551,Burundi,2019,2019Burundi,0,0,9,0,0,0,9,0,0,6,7,0,0,13,22
3552,Burundi,2019,2019Burundi,0,7,0,0,0,0,7,0,0,0,0,0,0,0,7
3553,Burundi,2019,2019Burundi,0,7,0,0,0,0,7,0,0,0,5,0,0,5,12
3554,Burundi,2019,2019Burundi,0,8,0,8,0,0,16,0,0,7,13,0,0,20,36
3555,Burundi,2019,2019Burundi,0,8,10,12,0,0,30,0,0,10,19,0,0,29,59
3556,Burundi,2019,2019Burundi,5,0,0,6,0,0,11,0,5,0,13,0,0,18,29
3557,Burundi,2019,2019Burundi,5,0,0,15,0,0,20,5,0,0,26,0,0,31,51
3558,Burundi,2019,2019Burundi,5,0,9,24,0,0,38,0,6,5,20,0,0,31,69
3559,Burundi,2019,2019Burundi,5,7,5,15,0,0,32,0,0,8,31,0,0,39,71
3560,Burundi,2019,2019Burundi,5,18,19,47,0,0,89,5,18,13,58,0,0,94,183
3561,Burundi,2019,2019Burundi,6,8,9,31,5,0,59,5,7,0,42,5,0,59,118
3562,Burundi,2019,2019Burundi,19,25,13,49,5,0,111,11,29,16,106,0,0,162,273
3563,Burundi,2019,2019Burundi,33,76,66,247,14,0,436,44,67,55,294,10,0,470,906
3564,Burundi,2019,2019Burundi,37,56,62,147,5,0,307,37,57,56,203,0,0,353,660
3565,Burundi,2019,2019Burundi,195,268,212,564,20,0,1259,182,264,211,660,16,0,1333,2592
3566,Burundi,2019,2019Burundi,214,395,323,918,85,0,1935,221,370,313,2584,67,0,3555,5490
3567,Burundi,2019,2019Burundi,472,545,351,1247,36,0,2651,444,606,364,1688,22,0,3124,5775
3568,Burundi,2019,2019Burundi,4425,4460,2747,9177,513,0,21322,4329,4534,2748,10512,443,0,22566,43888
3569,Burundi,2019,2019Burundi,4777,6500,3473,9243,490,0,24483,4767,6567,3442,7902,409,0,23087,47570
3570,Burundi,2019,2019Burundi,6192,5970,4192,15697,1162,0,33213,6234,6452,4378,20307,904,0,38275,71488
3571,Burundi,2019,2019Burundi,19858,19710,13775,40192,2225,0,95760,19765,20475,13823,40024,2384,0,96471,192231
3572,Burundi,2020,2020Burundi,0,0,0,0,0,0,0,0,0,0,0,0,0,0,2779
3573,Burundi,2020,2020Burundi,0,0,0,0,0,0,0,0,0,0,5,0,0,5,15
3574,Burundi,2020,2020Burundi,0,0,0,0,0,5,5,0,0,0,0,0,0,0,5
3575,Burundi,2020,2020Burundi,0,0,0,0,0,21,21,0,0,0,0,0,24,24,45
3576,Burundi,2020,2020Burundi,0,0,0,0,0,818,818,0,0,0,0,0,793,793,1611
3577,Burundi,2020,2020Burundi,0,0,0,5,0,0,5,0,0,0,0,0,0,0,5
3578,Burundi,2020,2020Burundi,0,0,0,5,0,0,5,0,0,0,9,0,0,9,14
3579,Burundi,2020,2020Burundi,0,0,0,6,0,0,6,0,0,0,0,0,0,0,6
3580,Burundi,2020,2020Burundi,0,0,0,6,0,0,6,0,0,0,6,0,0,6,12
3581,Burundi,2020,2020Burundi,0,0,0,6,0,0,6,0,0,0,16,0,0,16,22
3582,Burundi,2020,2020Burundi,0,0,0,7,0,0,7,0,0,0,0,0,0,0,14
3583,Burundi,2020,2020Burundi,0,0,0,7,0,0,7,0,0,0,5,0,0,5,12
3584,Burundi,2020,2020Burundi,0,0,0,8,0,0,8,0,0,0,0,0,0,0,8
3585,Burundi,2020,2020Burundi,0,0,5,0,0,0,5,0,0,0,0,0,0,0,5
3586,Burundi,2020,2020Burundi,0,0,5,29,0,0,34,0,0,10,27,0,0,37,71
3587,Burundi,2020,2020Burundi,0,0,7,0,0,0,7,0,0,0,0,0,0,0,7
3588,Burundi,2020,2020Burundi,0,0,7,8,0,0,15,0,0,8,12,0,0,20,35
3589,Burundi,2020,2020Burundi,0,0,8,0,0,0,8,0,0,0,0,0,0,0,8
3590,Burundi,2020,2020Burundi,0,0,20,156,25,32,233,0,0,0,148,0,60,208,2796
3591,Burundi,2020,2020Burundi,0,5,0,7,0,0,12,0,5,0,11,0,0,16,28
3592,Burundi,2020,2020Burundi,0,5,8,0,0,0,13,0,0,0,0,0,0,0,13
3593,Burundi,2020,2020Burundi,0,6,0,6,0,0,12,0,0,5,5,0,0,10,22
3594,Burundi,2020,2020Burundi,0,7,0,0,0,0,7,0,0,0,0,0,0,0,7
3595,Burundi,2020,2020Burundi,0,8,10,12,0,0,30,0,0,10,19,0,0,29,59
3596,Burundi,2020,2020Burundi,5,0,0,5,0,0,10,0,0,0,93,0,0,93,103
3597,Burundi,2020,2020Burundi,5,0,0,15,0,0,20,5,0,0,30,0,0,35,55
3598,Burundi,2020,2020Burundi,5,0,9,25,0,0,39,0,0,12,19,0,0,31,70
3599,Burundi,2020,2020Burundi,5,17,16,52,0,0,90,5,16,13,60,0,0,94,184
3600,Burundi,2020,2020Burundi,6,0,0,17,0,0,23,0,0,0,26,5,0,31,173
3601,Burundi,2020,2020Burundi,6,7,11,31,5,0,60,0,6,5,38,5,0,54,114
3602,Burundi,2020,2020Burundi,9,0,0,0,0,0,9,0,0,0,8,0,0,8,17
3603,Burundi,2020,2020Burundi,10,8,0,14,0,0,32,0,14,0,27,0,0,41,73
3604,Burundi,2020,2020Burundi,22,32,16,50,5,0,125,11,27,20,113,0,0,171,296
3605,Burundi,2020,2020Burundi,23,89,85,408,22,0,627,27,23,23,188,17,0,278,905
3606,Burundi,2020,2020Burundi,24,187,133,608,7,0,959,28,181,138,1318,12,0,1677,2636
3607,Burundi,2020,2020Burundi,29,64,54,161,5,0,313,36,49,56,217,5,0,363,676
3608,Burundi,2020,2020Burundi,199,266,217,609,22,0,1313,173,268,221,712,14,0,1388,2701
3609,Burundi,2020,2020Burundi,233,433,353,1093,96,0,2208,252,432,337,3441,73,0,4535,6743
3610,Burundi,2020,2020Burundi,503,688,418,1458,38,0,3105,506,723,461,1934,30,0,3654,6759
3611,Burundi,2020,2020Burundi,4194,6792,3516,9211,429,0,24142,4211,6827,3515,7762,372,0,22687,46829
3612,Burundi,2020,2020Burundi,4599,5113,3027,10239,596,0,23574,4495,5168,3062,11649,518,0,24892,48466
3613,Burundi,2020,2020Burundi,5784,5636,3835,13842,1018,0,30115,5811,6001,3971,17540,790,0,34113,65037
3614,Burundi,2020,2020Burundi,17987,18335,13018,39816,2340,0,91496,17843,18640,13282,39759,2495,0,92019,183515
3615,Burundi,2021,2021Burundi,0,0,0,0,0,0,0,0,0,0,0,0,0,0,5548
3616,Burundi,2021,2021Burundi,0,0,0,0,0,0,0,0,0,0,0,0,5,5,5
3617,Burundi,2021,2021Burundi,0,0,0,0,0,0,0,0,0,0,5,0,0,5,20
3618,Burundi,2021,2021Burundi,0,0,0,5,0,0,5,0,0,0,0,0,0,0,5
3619,Burundi,2021,2021Burundi,0,0,0,5,0,0,5,0,0,0,6,0,0,6,11
3620,Burundi,2021,2021Burundi,0,0,0,5,0,0,5,0,0,0,9,0,0,9,14
3621,Burundi,2021,2021Burundi,0,0,0,6,0,0,6,0,0,0,0,0,0,0,12
3622,Burundi,2021,2021Burundi,0,0,0,7,0,0,7,0,0,0,5,0,0,5,12
3623,Burundi,2021,2021Burundi,0,0,0,8,0,0,8,0,0,0,0,0,0,0,8
3624,Burundi,2021,2021Burundi,0,0,0,8,0,0,8,0,5,0,5,0,0,10,18
3625,Burundi,2021,2021Burundi,0,0,0,9,0,0,9,0,0,0,20,0,0,20,29
3626,Burundi,2021,2021Burundi,0,0,0,35,0,0,35,0,0,5,25,10,0,40,75
3627,Burundi,2021,2021Burundi,0,0,6,0,0,0,6,0,0,0,0,0,0,0,6
3628,Burundi,2021,2021Burundi,0,0,6,0,0,0,6,0,0,5,0,0,0,5,11
3629,Burundi,2021,2021Burundi,0,0,7,9,0,0,16,7,0,0,11,0,0,18,34
3630,Burundi,2021,2021Burundi,0,0,13,0,0,0,13,0,0,0,0,0,0,0,13
3631,Burundi,2021,2021Burundi,0,5,0,5,0,0,10,0,0,5,9,0,0,14,24
3632,Burundi,2021,2021Burundi,0,5,0,7,0,0,12,0,5,0,11,0,0,16,28
3633,Burundi,2021,2021Burundi,0,6,33,219,30,32,320,0,8,5,208,6,60,287,2870
3634,Burundi,2021,2021Burundi,0,9,0,15,0,0,24,0,0,8,26,0,0,34,58
3635,Burundi,2021,2021Burundi,5,0,0,14,0,0,19,5,0,0,31,0,0,36,55
3636,Burundi,2021,2021Burundi,5,0,7,17,0,0,29,0,5,5,15,0,0,25,54
3637,Burundi,2021,2021Burundi,5,6,10,13,0,0,34,0,0,8,13,0,0,21,55
3638,Burundi,2021,2021Burundi,7,0,0,19,0,0,26,0,0,0,26,5,0,31,189
3639,Burundi,2021,2021Burundi,7,5,10,36,5,0,63,5,7,0,48,5,0,65,145
3640,Burundi,2021,2021Burundi,7,140,157,631,7,0,942,8,129,163,1352,17,0,1669,2611
3641,Burundi,2021,2021Burundi,8,0,0,0,0,0,8,0,0,0,0,0,0,0,8
3642,Burundi,2021,2021Burundi,8,0,0,13,0,0,21,0,5,0,156,0,0,161,182
3643,Burundi,2021,2021Burundi,10,15,15,52,0,0,92,0,11,22,45,5,0,83,175
3644,Burundi,2021,2021Burundi,16,77,56,274,13,0,436,25,64,63,305,15,0,472,908
3645,Burundi,2021,2021Burundi,24,33,19,53,5,0,134,17,31,17,111,0,0,176,310
3646,Burundi,2021,2021Burundi,26,66,48,165,5,0,310,36,43,60,211,5,0,355,665
3647,Burundi,2021,2021Burundi,236,478,365,1274,98,0,2451,273,453,392,4473,85,0,5676,8127
3648,Burundi,2021,2021Burundi,298,364,283,880,29,0,1854,250,367,304,1154,22,0,2097,3951
3649,Burundi,2021,2021Burundi,611,711,457,1523,42,0,3344,588,763,502,1976,30,0,3859,7203
3650,Burundi,2021,2021Burundi,3795,3909,2590,10336,690,0,21320,3782,4126,2733,14466,616,0,25723,47884
3651,Burundi,2021,2021Burundi,3939,5617,3116,7964,420,0,21056,3968,5622,3156,6828,401,0,19975,41031
3652,Burundi,2021,2021Burundi,4142,4878,3003,9750,573,0,22346,4004,4871,3125,11248,515,0,23763,46109
3653,Burundi,2021,2021Burundi,15245,15451,10938,32982,2153,0,76769,15372,15879,11207,33639,2306,0,78403,155172
3654,Cambodia,2001,2001Cambodia,0,0,0,0,0,0,0,0,0,0,0,0,0,0,868
3655,Cambodia,2001,2001Cambodia,0,0,0,0,0,0,0,0,0,5,0,0,0,5,5
3656,Cambodia,2001,2001Cambodia,0,0,0,0,0,38,38,0,0,0,0,0,40,40,78
3657,Cambodia,2001,2001Cambodia,0,0,0,0,0,132,132,0,0,0,0,0,178,178,310
3658,Cambodia,2001,2001Cambodia,0,0,0,0,0,370,370,0,0,0,0,0,413,413,783
3659,Cambodia,2001,2001Cambodia,0,0,0,0,0,1118,1118,0,0,0,0,0,963,963,15945
3660,Cambodia,2001,2001Cambodia,0,0,0,0,0,8313,8313,0,0,0,0,0,8328,8328,16641
3661,Cambodia,2001,2001Cambodia,0,0,0,17,0,0,17,0,0,0,12,5,0,17,34
3662,Cambodia,2001,2001Cambodia,5,7,5,27,0,0,44,5,7,7,29,0,0,48,92
3663,Cambodia,2002,2002Cambodia,0,0,0,0,0,0,0,0,0,0,0,0,0,0,1113
3664,Cambodia,2002,2002Cambodia,0,0,0,0,0,82,82,0,0,0,0,0,97,97,179
3665,Cambodia,2002,2002Cambodia,0,0,0,0,0,302,302,0,0,0,0,0,344,344,659
3666,Cambodia,2002,2002Cambodia,0,0,0,0,0,1118,1118,0,0,0,0,0,963,963,15945
3667,Cambodia,2002,2002Cambodia,0,0,0,0,0,7778,7778,0,0,0,0,0,7661,7661,15439
3668,Cambodia,2002,2002Cambodia,0,0,0,17,0,0,17,0,0,0,12,5,0,17,34
3669,Cambodia,2002,2002Cambodia,5,5,5,24,0,0,39,5,6,6,26,0,0,43,82
3670,Cambodia,2003,2003Cambodia,0,0,0,0,0,0,0,0,0,0,0,0,0,0,938
3671,Cambodia,2003,2003Cambodia,0,0,0,0,0,35,35,0,0,0,0,0,50,50,85
3672,Cambodia,2003,2003Cambodia,0,0,0,0,0,284,284,0,0,0,0,0,329,329,625
3673,Cambodia,2003,2003Cambodia,0,0,0,0,0,7249,7249,0,0,0,0,0,7054,7054,14303
3674,Cambodia,2003,2003Cambodia,0,0,0,0,0,9028,9028,0,0,0,0,0,6332,6332,15360
3675,Cambodia,2003,2003Cambodia,0,0,0,19,0,0,19,0,0,0,14,5,0,19,38
3676,Cambodia,2003,2003Cambodia,0,5,5,19,0,0,29,7,7,0,12,0,0,26,55
3677,Cambodia,2004,2004Cambodia,0,0,0,0,0,0,0,0,0,0,0,0,0,0,14900
3678,Cambodia,2004,2004Cambodia,0,0,0,0,0,35,35,0,0,0,0,0,53,53,88
3679,Cambodia,2004,2004Cambodia,0,0,0,0,0,1228,1228,0,0,0,0,0,1132,1132,2360
3680,Cambodia,2004,2004Cambodia,0,0,0,7,0,276,283,0,0,0,0,0,318,318,601
3681,Cambodia,2004,2004Cambodia,0,0,0,20,0,0,20,0,5,0,9,5,0,19,39
3682,Cambodia,2004,2004Cambodia,0,6,7,15,5,0,33,0,7,6,24,0,0,37,70
3683,Cambodia,2004,2004Cambodia,0,7,0,18,0,0,25,0,0,0,21,5,0,26,51
3684,Cambodia,2005,2005Cambodia,0,0,0,0,0,0,0,0,0,0,0,0,0,0,847
3685,Cambodia,2005,2005Cambodia,0,0,0,0,0,40,40,0,0,0,0,0,63,63,103
3686,Cambodia,2005,2005Cambodia,0,0,0,0,0,1228,1228,0,0,0,0,0,1129,1129,2357
3687,Cambodia,2005,2005Cambodia,0,0,0,0,0,6977,6977,0,0,0,0,0,6759,6759,13736
3688,Cambodia,2005,2005Cambodia,0,0,0,6,0,0,6,0,0,0,0,0,0,0,6
3689,Cambodia,2005,2005Cambodia,0,0,0,7,0,260,267,0,0,0,0,0,309,309,576
3690,Cambodia,2005,2005Cambodia,0,0,0,12,5,0,17,0,7,0,10,5,0,22,39
3691,Cambodia,2005,2005Cambodia,0,0,6,18,0,0,24,0,0,0,21,6,0,27,51
3692,Cambodia,2005,2005Cambodia,0,7,7,31,0,0,45,0,6,6,32,0,0,44,89
3693,Cambodia,2006,2006Cambodia,0,0,0,0,0,0,0,0,0,0,0,0,0,0,1257
3694,Cambodia,2006,2006Cambodia,0,0,0,0,0,0,0,0,0,0,6,0,0,6,6
3695,Cambodia,2006,2006Cambodia,0,0,0,0,0,10,10,0,0,0,0,0,15,15,25
3696,Cambodia,2006,2006Cambodia,0,0,0,0,0,40,40,0,0,0,0,0,63,63,103
3697,Cambodia,2006,2006Cambodia,0,0,0,0,0,240,240,0,0,0,0,0,285,285,525
3698,Cambodia,2006,2006Cambodia,0,0,0,0,0,1228,1228,0,0,0,0,0,1129,1129,2357
3699,Cambodia,2006,2006Cambodia,0,0,0,0,0,6883,6883,0,0,0,0,0,6631,6631,13514
3700,Cambodia,2006,2006Cambodia,0,0,0,5,0,0,5,0,0,0,0,0,0,0,5
3701,Cambodia,2006,2006Cambodia,0,0,0,11,5,0,16,5,0,0,11,6,0,22,38
3702,Cambodia,2006,2006Cambodia,0,0,5,17,0,0,22,0,0,0,21,6,0,27,49
3703,Cambodia,2006,2006Cambodia,0,7,11,23,0,0,41,5,7,6,25,0,0,43,84
3704,Cambodia,2007,2007Cambodia,0,0,0,0,0,0,0,0,0,0,0,0,0,0,1220
3705,Cambodia,2007,2007Cambodia,0,0,0,0,0,0,0,0,0,0,6,0,0,6,6
3706,Cambodia,2007,2007Cambodia,0,0,0,0,0,13,13,0,0,0,0,0,16,16,29
3707,Cambodia,2007,2007Cambodia,0,0,0,0,0,37,37,0,0,0,0,0,66,66,103
3708,Cambodia,2007,2007Cambodia,0,0,0,0,0,1228,1228,0,0,0,0,0,1129,1129,2357
3709,Cambodia,2007,2007Cambodia,0,0,0,0,0,6818,6818,0,0,0,0,0,6552,6552,13370
3710,Cambodia,2007,2007Cambodia,0,0,0,0,5,222,227,0,0,0,0,0,262,262,489
3711,Cambodia,2007,2007Cambodia,0,0,0,9,0,0,9,0,0,0,5,5,0,10,19
3712,Cambodia,2007,2007Cambodia,0,0,5,17,0,0,22,0,0,0,21,6,0,27,49
3713,Cambodia,2007,2007Cambodia,0,0,7,8,0,0,15,0,6,5,15,0,0,26,41
3714,Cambodia,2007,2007Cambodia,5,0,0,5,0,0,10,0,0,0,0,0,0,0,17
3715,Cambodia,2008,2008Cambodia,0,0,0,0,0,0,0,0,0,0,0,0,0,0,1063
3716,Cambodia,2008,2008Cambodia,0,0,0,0,0,0,0,0,0,0,6,0,0,6,6
3717,Cambodia,2008,2008Cambodia,0,0,0,0,0,6,6,0,0,0,0,0,12,12,18
3718,Cambodia,2008,2008Cambodia,0,0,0,0,0,29,29,0,0,0,0,0,50,50,79
3719,Cambodia,2008,2008Cambodia,0,0,0,0,0,1228,1228,0,0,0,0,0,1129,1129,2357
3720,Cambodia,2008,2008Cambodia,0,0,0,0,0,6690,6690,0,0,0,0,0,6505,6505,13195
3721,Cambodia,2008,2008Cambodia,0,0,0,0,5,193,198,0,0,0,0,0,234,234,432
3722,Cambodia,2008,2008Cambodia,0,0,5,9,0,0,14,0,0,0,0,0,0,0,22
3723,Cambodia,2008,2008Cambodia,0,5,0,5,0,0,10,0,0,0,7,5,0,12,22
3724,Cambodia,2008,2008Cambodia,0,6,7,12,0,0,25,0,5,5,21,0,0,31,56
3725,Cambodia,2009,2009Cambodia,0,0,0,0,0,0,0,0,0,0,0,0,0,0,13894
3726,Cambodia,2009,2009Cambodia,0,0,0,0,0,0,0,0,0,0,5,0,0,5,5
3727,Cambodia,2009,2009Cambodia,0,0,0,0,0,5,5,0,0,0,0,0,11,11,16
3728,Cambodia,2009,2009Cambodia,0,0,0,0,0,25,25,0,0,0,0,0,57,57,82
3729,Cambodia,2009,2009Cambodia,0,0,0,0,0,187,187,0,0,0,0,0,228,228,415
3730,Cambodia,2009,2009Cambodia,0,0,0,0,0,1228,1228,0,0,0,0,0,1129,1129,2357
3731,Cambodia,2009,2009Cambodia,0,0,5,8,0,0,13,0,0,0,0,0,0,0,27
3732,Cambodia,2009,2009Cambodia,0,5,0,6,0,0,11,0,0,0,7,5,0,12,23
3733,Cambodia,2009,2009Cambodia,0,5,6,13,0,0,24,0,0,6,17,0,0,23,47
3734,Cambodia,2009,2009Cambodia,0,6,5,36,5,0,52,0,8,9,79,8,0,104,156
3735,Cambodia,2010,2010Cambodia,0,0,0,0,0,0,0,0,0,0,0,0,0,0,684
3736,Cambodia,2010,2010Cambodia,0,0,0,0,0,0,0,0,0,0,5,0,0,5,5
3737,Cambodia,2010,2010Cambodia,0,0,0,0,0,5,5,0,0,0,0,0,8,8,13
3738,Cambodia,2010,2010Cambodia,0,0,0,0,0,31,31,0,0,0,0,0,42,42,73
3739,Cambodia,2010,2010Cambodia,0,0,0,0,0,1001,1001,0,0,0,0,0,927,927,1928
3740,Cambodia,2010,2010Cambodia,0,0,0,0,0,6542,6542,0,0,0,0,0,6414,6414,12956
3741,Cambodia,2010,2010Cambodia,0,0,0,0,5,175,180,0,0,0,0,0,218,218,398
3742,Cambodia,2010,2010Cambodia,0,5,0,8,0,0,13,0,0,5,0,7,0,12,25
3743,Cambodia,2010,2010Cambodia,0,6,0,15,0,0,21,0,5,0,0,0,0,5,39
3744,Cambodia,2010,2010Cambodia,0,7,0,7,0,0,14,0,0,5,11,0,0,16,30
3745,Cambodia,2010,2010Cambodia,0,8,5,40,5,0,58,0,10,7,73,9,0,99,157
3746,Cambodia,2011,2011Cambodia,0,0,0,0,0,0,0,0,0,0,0,0,0,0,500
3747,Cambodia,2011,2011Cambodia,0,0,0,0,0,0,0,0,0,0,5,0,0,5,5
3748,Cambodia,2011,2011Cambodia,0,0,0,0,0,6,6,0,0,0,0,0,7,7,13
3749,Cambodia,2011,2011Cambodia,0,0,0,0,0,17,17,0,0,0,0,0,16,16,33
3750,Cambodia,2011,2011Cambodia,0,0,0,0,0,517,517,0,0,0,0,0,473,473,990
3751,Cambodia,2011,2011Cambodia,0,0,0,0,0,6409,6409,0,0,0,0,0,6409,6409,12818
3752,Cambodia,2011,2011Cambodia,0,0,0,0,5,171,176,0,0,0,0,0,213,213,389
3753,Cambodia,2011,2011Cambodia,0,0,0,6,5,0,11,0,0,0,16,0,0,16,174
3754,Cambodia,2011,2011Cambodia,0,0,5,16,0,0,21,0,5,0,0,0,0,5,47
3755,Cambodia,2011,2011Cambodia,0,5,0,8,0,0,13,0,0,5,8,0,0,13,26
3756,Cambodia,2011,2011Cambodia,0,6,7,42,5,0,60,0,8,10,74,9,0,101,161
3757,Cambodia,2011,2011Cambodia,0,8,0,13,0,0,21,0,7,0,17,0,0,24,45
3758,Cambodia,2012,2012Cambodia,0,0,0,0,0,0,0,0,0,0,0,0,0,0,425
3759,Cambodia,2012,2012Cambodia,0,0,0,0,0,0,0,0,0,0,5,0,0,5,5
3760,Cambodia,2012,2012Cambodia,0,0,0,0,0,0,0,0,0,0,6,0,0,6,176
3761,Cambodia,2012,2012Cambodia,0,0,0,0,0,5,5,0,0,0,0,0,8,8,13
3762,Cambodia,2012,2012Cambodia,0,0,0,0,0,9,9,0,0,0,0,0,16,16,25
3763,Cambodia,2012,2012Cambodia,0,0,0,0,0,6333,6333,0,0,0,0,0,6333,6333,12666
3764,Cambodia,2012,2012Cambodia,0,0,0,0,5,163,168,0,0,0,0,0,208,208,376
3765,Cambodia,2012,2012Cambodia,0,0,5,6,0,0,11,0,5,0,8,0,0,13,24
3766,Cambodia,2012,2012Cambodia,0,5,0,17,0,0,22,0,0,5,0,0,0,5,58
3767,Cambodia,2012,2012Cambodia,0,5,9,45,5,0,64,0,8,8,74,10,0,100,164
3768,Cambodia,2012,2012Cambodia,5,8,5,21,0,0,39,6,6,5,28,0,0,45,84
3769,Cambodia,2013,2013Cambodia,0,0,0,0,0,0,0,0,0,0,0,0,0,0,407
3770,Cambodia,2013,2013Cambodia,0,0,0,0,0,0,0,0,0,0,5,0,0,5,5
3771,Cambodia,2013,2013Cambodia,0,0,0,0,0,5,5,0,0,0,0,0,0,0,5
3772,Cambodia,2013,2013Cambodia,0,0,0,0,0,7,7,0,0,0,0,0,17,17,24
3773,Cambodia,2013,2013Cambodia,0,0,0,0,0,6289,6289,0,0,0,0,0,6271,6271,12560
3774,Cambodia,2013,2013Cambodia,0,0,0,0,5,158,163,0,0,0,0,0,201,201,364
3775,Cambodia,2013,2013Cambodia,0,0,0,6,0,0,6,0,0,0,7,0,0,7,13
3776,Cambodia,2013,2013Cambodia,0,0,0,9,0,0,9,0,0,0,6,0,0,6,186
3777,Cambodia,2013,2013Cambodia,0,0,0,9,0,0,9,0,0,5,7,5,0,17,26
3778,Cambodia,2013,2013Cambodia,0,0,5,9,0,0,14,0,5,0,9,0,0,14,28
3779,Cambodia,2013,2013Cambodia,0,5,0,17,0,0,22,0,0,0,5,0,0,5,61
3780,Cambodia,2013,2013Cambodia,0,9,0,16,0,0,25,0,9,0,20,5,0,34,59
3781,Cambodia,2014,2014Cambodia,0,0,0,0,0,0,0,0,0,0,0,0,0,0,369
3782,Cambodia,2014,2014Cambodia,0,0,0,0,0,0,0,0,0,0,5,0,0,5,5
3783,Cambodia,2014,2014Cambodia,0,0,0,0,0,159,159,0,0,0,0,0,197,197,356
3784,Cambodia,2014,2014Cambodia,0,0,0,0,0,5985,5985,0,0,0,0,0,6018,6018,12003
3785,Cambodia,2014,2014Cambodia,0,0,0,5,0,0,5,0,0,0,0,0,0,0,162
3786,Cambodia,2014,2014Cambodia,0,0,0,9,0,0,9,0,0,0,12,5,0,17,26
3787,Cambodia,2014,2014Cambodia,0,0,5,9,0,0,14,0,0,5,9,0,0,14,28
3788,Cambodia,2014,2014Cambodia,0,5,0,22,0,0,27,0,7,0,31,0,0,38,65
3789,Cambodia,2014,2014Cambodia,0,6,0,32,0,0,38,0,5,0,0,0,0,5,52
3790,Cambodia,2015,2015Cambodia,0,0,0,0,0,0,0,0,0,0,0,0,0,0,429
3791,Cambodia,2015,2015Cambodia,0,0,0,0,0,0,0,0,0,0,0,0,9,9,9
3792,Cambodia,2015,2015Cambodia,0,0,0,0,0,187,187,0,0,0,0,0,155,155,342
3793,Cambodia,2015,2015Cambodia,0,0,0,0,0,5866,5866,0,0,0,0,0,5958,5958,11824
3794,Cambodia,2015,2015Cambodia,0,0,0,0,5,0,5,0,0,0,0,0,0,0,5
3795,Cambodia,2015,2015Cambodia,0,0,0,10,0,0,10,0,0,0,11,5,0,16,26
3796,Cambodia,2015,2015Cambodia,0,0,5,9,0,0,14,0,0,5,9,0,0,14,28
3797,Cambodia,2015,2015Cambodia,0,0,9,25,0,0,34,5,0,5,38,0,0,48,82
3798,Cambodia,2015,2015Cambodia,0,8,0,39,0,0,47,0,5,0,0,0,0,5,57
3799,Cambodia,2016,2016Cambodia,0,0,0,0,0,0,0,0,0,0,0,0,0,0,253
3800,Cambodia,2016,2016Cambodia,0,0,0,0,0,0,0,0,0,0,0,0,8,8,8
3801,Cambodia,2016,2016Cambodia,0,0,0,0,0,0,0,0,0,0,5,0,0,5,5
3802,Cambodia,2016,2016Cambodia,0,0,0,0,0,0,0,0,0,0,8,0,0,8,67
3803,Cambodia,2016,2016Cambodia,0,0,0,0,0,145,145,0,0,0,0,0,183,183,328
3804,Cambodia,2016,2016Cambodia,0,0,0,0,0,5745,5745,0,0,0,0,0,5821,5821,11566
3805,Cambodia,2016,2016Cambodia,0,0,0,5,0,0,5,0,0,0,0,0,0,0,5
3806,Cambodia,2016,2016Cambodia,0,0,0,10,0,0,10,0,0,0,11,5,0,16,26
3807,Cambodia,2016,2016Cambodia,0,0,0,18,0,0,18,7,0,0,21,0,0,28,60
3808,Cambodia,2016,2016Cambodia,5,9,6,32,0,0,52,5,6,5,37,5,0,58,110
3809,Cambodia,2017,2017Cambodia,0,0,0,0,0,0,0,0,0,0,0,0,0,0,281
3810,Cambodia,2017,2017Cambodia,0,0,0,0,0,0,0,0,0,0,5,0,0,5,5
3811,Cambodia,2017,2017Cambodia,0,0,0,0,0,183,183,0,0,0,0,0,139,139,322
3812,Cambodia,2017,2017Cambodia,0,0,0,0,0,5640,5640,0,0,0,0,0,5721,5721,11361
3813,Cambodia,2017,2017Cambodia,0,0,0,5,0,0,5,0,0,0,0,0,0,0,5
3814,Cambodia,2017,2017Cambodia,0,0,0,9,0,0,9,0,0,0,13,5,0,18,27
3815,Cambodia,2017,2017Cambodia,0,0,5,30,0,0,35,0,0,0,0,0,0,0,71
3816,Cambodia,2017,2017Cambodia,8,10,9,51,5,0,83,7,13,11,47,5,0,83,166
3817,Cambodia,2018,2018Cambodia,0,0,0,0,0,0,0,0,0,0,0,0,0,0,247
3818,Cambodia,2018,2018Cambodia,0,0,0,0,0,0,0,0,0,0,5,0,0,5,5
3819,Cambodia,2018,2018Cambodia,0,0,0,0,0,0,0,0,0,0,6,0,0,6,6
3820,Cambodia,2018,2018Cambodia,0,0,0,0,0,130,130,0,0,0,0,0,177,177,307
3821,Cambodia,2018,2018Cambodia,0,0,0,0,0,5530,5530,0,0,0,0,0,5663,5663,11193
3822,Cambodia,2018,2018Cambodia,0,0,0,5,0,0,5,0,0,0,0,0,0,0,5
3823,Cambodia,2018,2018Cambodia,0,0,0,5,0,0,5,0,0,0,7,0,0,7,71
3824,Cambodia,2018,2018Cambodia,0,0,5,8,0,0,13,0,0,0,11,6,0,17,30
3825,Cambodia,2018,2018Cambodia,0,0,7,60,0,0,67,0,5,0,0,0,0,5,72
3826,Cambodia,2018,2018Cambodia,8,10,10,63,5,0,96,7,14,9,72,5,0,107,203
3827,Cambodia,2019,2019Cambodia,0,0,0,0,0,0,0,0,0,0,0,0,0,0,596
3828,Cambodia,2019,2019Cambodia,0,0,0,0,0,0,0,0,0,0,5,0,0,5,5
3829,Cambodia,2019,2019Cambodia,0,0,0,0,0,5434,5434,0,0,0,0,0,5587,5587,11021
3830,Cambodia,2019,2019Cambodia,0,0,0,5,0,0,5,0,0,0,8,0,0,8,13
3831,Cambodia,2019,2019Cambodia,0,0,0,5,5,0,10,0,0,0,0,0,0,0,10
3832,Cambodia,2019,2019Cambodia,0,0,5,8,0,0,13,0,0,0,12,8,0,20,33
3833,Cambodia,2019,2019Cambodia,0,0,5,66,0,0,71,0,0,0,9,0,0,9,80
3834,Cambodia,2019,2019Cambodia,7,8,15,69,7,0,106,8,14,11,83,6,0,122,228
3835,Cambodia,2020,2020Cambodia,0,0,0,0,0,0,0,0,0,0,0,0,0,0,11413
3836,Cambodia,2020,2020Cambodia,0,0,0,0,0,0,0,0,0,0,8,5,0,13,42
3837,Cambodia,2020,2020Cambodia,0,0,0,0,0,5,5,0,0,0,0,0,8,8,13
3838,Cambodia,2020,2020Cambodia,0,0,0,5,0,0,5,0,0,0,8,0,0,8,13
3839,Cambodia,2020,2020Cambodia,0,0,0,5,5,0,10,0,0,0,0,0,0,0,10
3840,Cambodia,2020,2020Cambodia,0,0,5,9,0,0,14,0,0,0,12,8,0,20,34
3841,Cambodia,2020,2020Cambodia,0,0,5,63,0,0,68,0,0,0,9,0,0,9,77
3842,Cambodia,2020,2020Cambodia,9,10,13,83,7,0,122,10,13,13,94,8,0,138,260
3843,Cambodia,2021,2021Cambodia,0,0,0,0,0,0,0,0,0,0,0,0,0,0,11554
3844,Cambodia,2021,2021Cambodia,0,0,0,5,0,0,5,0,0,0,8,0,0,8,13
3845,Cambodia,2021,2021Cambodia,0,0,0,6,0,0,6,0,0,0,14,5,0,19,49
3846,Cambodia,2021,2021Cambodia,0,0,0,8,0,0,8,0,0,0,0,0,0,0,8
3847,Cambodia,2021,2021Cambodia,0,0,5,6,0,0,11,0,0,0,10,9,0,19,30
3848,Cambodia,2021,2021Cambodia,0,0,5,6,0,0,11,0,0,5,8,0,0,13,24
3849,Cambodia,2021,2021Cambodia,0,0,5,62,0,0,67,0,0,0,10,0,0,10,77
3850,Cambodia,2021,2021Cambodia,10,14,11,101,9,0,145,16,15,15,116,10,0,172,317
3851,Cameroon,2001,2001Cameroon,0,0,0,0,0,0,0,0,0,0,0,0,0,0,2459
3852,Cameroon,2001,2001Cameroon,0,0,0,0,0,0,0,0,0,0,5,0,0,5,10
3853,Cameroon,2001,2001Cameroon,0,0,0,0,0,0,0,0,0,0,6,0,0,6,6
3854,Cameroon,2001,2001Cameroon,0,0,0,0,0,0,0,0,0,0,8,0,0,8,8
3855,Cameroon,2001,2001Cameroon,0,0,0,0,0,0,0,0,0,0,9,0,0,9,18
3856,Cameroon,2001,2001Cameroon,0,0,0,0,0,13,13,0,0,0,0,0,9,9,22
3857,Cameroon,2001,2001Cameroon,0,0,0,0,0,15,15,0,0,0,0,0,13,13,28
3858,Cameroon,2001,2001Cameroon,0,0,0,0,0,30,30,0,0,0,0,0,86,86,116
3859,Cameroon,2001,2001Cameroon,0,0,0,5,0,0,5,0,0,0,0,0,0,0,5
3860,Cameroon,2001,2001Cameroon,0,5,0,0,0,0,5,0,0,0,0,0,0,0,5
3861,Cameroon,2001,2001Cameroon,5,0,0,14,0,0,19,0,0,0,33,0,0,33,52
3862,Cameroon,2002,2002Cameroon,0,0,0,0,0,0,0,0,0,0,0,0,0,0,4881
3863,Cameroon,2002,2002Cameroon,0,0,0,0,0,0,0,0,0,0,5,0,0,5,32
3864,Cameroon,2002,2002Cameroon,0,0,0,0,0,0,0,0,0,0,6,0,0,6,6
3865,Cameroon,2002,2002Cameroon,0,0,0,0,0,0,0,0,0,0,7,0,0,7,7
3866,Cameroon,2002,2002Cameroon,0,0,0,0,0,0,0,0,0,0,8,0,0,8,8
3867,Cameroon,2002,2002Cameroon,0,0,0,0,0,0,0,0,0,0,9,0,0,9,18
3868,Cameroon,2002,2002Cameroon,0,0,0,0,0,5,5,0,0,0,0,0,10,10,25
3869,Cameroon,2002,2002Cameroon,0,0,0,0,0,37,37,0,0,0,0,0,127,127,164
3870,Cameroon,2002,2002Cameroon,0,0,0,5,0,0,5,0,0,0,0,0,0,0,10
3871,Cameroon,2002,2002Cameroon,0,0,0,8,0,0,8,0,0,5,10,0,0,15,23
3872,Cameroon,2002,2002Cameroon,5,0,0,14,0,0,19,0,0,0,35,0,0,35,54
3873,Cameroon,2003,2003Cameroon,0,0,0,0,0,0,0,0,0,0,0,0,0,0,5780
3874,Cameroon,2003,2003Cameroon,0,0,0,0,0,0,0,0,0,0,5,0,0,5,39
3875,Cameroon,2003,2003Cameroon,0,0,0,0,0,0,0,0,0,0,6,0,0,6,6
3876,Cameroon,2003,2003Cameroon,0,0,0,0,0,0,0,0,0,0,7,0,0,7,7
3877,Cameroon,2003,2003Cameroon,0,0,0,0,0,0,0,0,0,0,8,0,0,8,8
3878,Cameroon,2003,2003Cameroon,0,0,0,0,0,0,0,0,0,0,9,0,0,9,18
3879,Cameroon,2003,2003Cameroon,0,0,0,0,0,0,0,0,5,0,15,0,0,20,20
3880,Cameroon,2003,2003Cameroon,0,0,0,0,0,5,5,0,0,0,0,0,12,12,37
3881,Cameroon,2003,2003Cameroon,0,0,0,0,0,58,58,0,0,0,0,0,168,168,226
3882,Cameroon,2003,2003Cameroon,0,0,0,5,0,0,5,0,0,0,0,0,0,0,15
3883,Cameroon,2003,2003Cameroon,5,0,0,0,0,0,5,0,0,0,0,0,0,0,5
3884,Cameroon,2003,2003Cameroon,5,0,0,13,0,0,18,0,0,0,36,0,0,36,54
3885,Cameroon,2004,2004Cameroon,0,0,0,0,0,0,0,0,0,0,0,0,0,0,7376
3886,Cameroon,2004,2004Cameroon,0,0,0,0,0,0,0,0,0,0,5,0,0,5,10
3887,Cameroon,2004,2004Cameroon,0,0,0,0,0,0,0,0,0,0,6,0,0,6,12
3888,Cameroon,2004,2004Cameroon,0,0,0,0,0,0,0,0,0,0,8,0,0,8,8
3889,Cameroon,2004,2004Cameroon,0,0,0,0,0,0,0,0,0,0,15,0,0,15,15
3890,Cameroon,2004,2004Cameroon,0,0,0,0,0,0,0,0,5,0,15,0,0,20,20
3891,Cameroon,2004,2004Cameroon,0,0,0,5,0,0,5,0,0,0,0,0,0,0,20
3892,Cameroon,2004,2004Cameroon,0,0,0,5,0,0,5,0,0,0,6,0,0,6,11
3893,Cameroon,2004,2004Cameroon,0,0,0,10,0,0,10,0,0,0,44,0,0,44,54
3894,Cameroon,2004,2004Cameroon,0,0,0,14,0,6,20,0,0,0,8,0,18,26,46
3895,Cameroon,2004,2004Cameroon,5,0,0,0,0,0,5,0,0,0,0,0,0,0,5
3896,Cameroon,2004,2004Cameroon,5,0,0,13,0,0,18,0,0,0,36,0,0,36,54
3897,Cameroon,2005,2005Cameroon,0,0,0,0,0,0,0,0,0,0,0,0,0,0,8430
3898,Cameroon,2005,2005Cameroon,0,0,0,0,0,0,0,0,0,0,5,0,0,5,25
3899,Cameroon,2005,2005Cameroon,0,0,0,0,0,0,0,0,0,0,6,0,0,6,6
3900,Cameroon,2005,2005Cameroon,0,0,0,0,0,0,0,0,5,0,15,0,0,20,20
3901,Cameroon,2005,2005Cameroon,0,0,0,0,0,5,5,0,0,0,0,0,0,0,5
3902,Cameroon,2005,2005Cameroon,0,0,0,0,0,117,117,0,0,0,0,0,298,298,415
3903,Cameroon,2005,2005Cameroon,0,0,0,5,0,0,5,0,0,0,6,0,0,6,11
3904,Cameroon,2005,2005Cameroon,0,0,0,10,0,0,10,0,0,0,46,0,0,46,56
3905,Cameroon,2005,2005Cameroon,0,0,0,19,0,9,28,0,0,0,9,0,22,31,59
3906,Cameroon,2005,2005Cameroon,5,0,0,0,0,0,5,0,0,0,0,0,0,0,15
3907,Cameroon,2005,2005Cameroon,5,0,0,13,0,0,18,0,0,0,36,0,0,36,54
3908,Cameroon,2006,2006Cameroon,0,0,0,0,0,0,0,0,0,0,0,0,0,0,9615
3909,Cameroon,2006,2006Cameroon,0,0,0,0,0,0,0,0,0,0,0,0,6,6,6
3910,Cameroon,2006,2006Cameroon,0,0,0,0,0,0,0,0,0,0,5,0,0,5,20
3911,Cameroon,2006,2006Cameroon,0,0,0,0,0,0,0,0,0,0,6,0,0,6,6
3912,Cameroon,2006,2006Cameroon,0,0,0,0,0,0,0,0,0,0,7,0,0,7,7
3913,Cameroon,2006,2006Cameroon,0,0,0,0,0,0,0,0,0,0,9,0,0,9,9
3914,Cameroon,2006,2006Cameroon,0,0,0,0,0,0,0,0,0,0,10,0,0,10,10
3915,Cameroon,2006,2006Cameroon,0,0,0,0,0,0,0,0,5,0,15,0,0,20,20
3916,Cameroon,2006,2006Cameroon,0,0,0,0,0,6,6,0,0,0,0,0,0,0,6
3917,Cameroon,2006,2006Cameroon,0,0,0,0,0,34,34,0,0,0,0,0,48,48,82
3918,Cameroon,2006,2006Cameroon,0,0,0,0,0,43,43,0,0,0,0,0,33,33,76
3919,Cameroon,2006,2006Cameroon,0,0,0,0,0,138,138,0,0,0,0,0,334,334,472
3920,Cameroon,2006,2006Cameroon,0,0,0,5,0,0,5,0,0,0,6,0,0,6,11
3921,Cameroon,2006,2006Cameroon,0,0,0,8,0,0,8,0,0,0,20,0,0,20,28
3922,Cameroon,2006,2006Cameroon,0,5,0,0,0,0,5,0,0,0,0,0,0,0,5
3923,Cameroon,2007,2007Cameroon,0,0,0,0,0,0,0,0,0,0,0,0,0,0,10635
3924,Cameroon,2007,2007Cameroon,0,0,0,0,0,0,0,0,0,0,5,0,0,5,30
3925,Cameroon,2007,2007Cameroon,0,0,0,0,0,0,0,0,0,0,6,0,0,6,18
3926,Cameroon,2007,2007Cameroon,0,0,0,0,0,0,0,0,0,0,7,0,0,7,7
3927,Cameroon,2007,2007Cameroon,0,0,0,0,0,0,0,0,5,0,15,0,0,20,20
3928,Cameroon,2007,2007Cameroon,0,0,0,0,0,39,39,0,0,0,0,0,69,69,108
3929,Cameroon,2007,2007Cameroon,0,0,0,0,0,165,165,0,0,0,0,0,369,369,534
3930,Cameroon,2007,2007Cameroon,0,0,0,5,0,0,5,0,0,0,23,0,0,23,28
3931,Cameroon,2007,2007Cameroon,0,0,0,6,0,0,6,0,0,0,5,0,0,5,11
3932,Cameroon,2007,2007Cameroon,0,5,0,0,0,0,5,0,0,0,0,0,0,0,5
3933,Cameroon,2007,2007Cameroon,0,5,0,0,0,0,5,0,0,0,8,0,0,8,13
3934,Cameroon,2007,2007Cameroon,7,0,0,25,0,22,54,5,0,0,8,0,23,36,90
3935,Cameroon,2008,2008Cameroon,0,0,0,0,0,0,0,0,0,0,0,0,0,0,11071
3936,Cameroon,2008,2008Cameroon,0,0,0,0,0,0,0,0,0,0,5,0,0,5,20
3937,Cameroon,2008,2008Cameroon,0,0,0,0,0,0,0,0,0,0,6,0,0,6,18
3938,Cameroon,2008,2008Cameroon,0,0,0,0,0,0,0,0,0,0,7,0,0,7,7
3939,Cameroon,2008,2008Cameroon,0,0,0,0,0,0,0,0,5,0,15,0,0,20,20
3940,Cameroon,2008,2008Cameroon,0,0,0,0,0,62,62,0,0,0,0,0,101,101,163
3941,Cameroon,2008,2008Cameroon,0,0,0,0,0,191,191,0,0,0,0,0,391,391,582
3942,Cameroon,2008,2008Cameroon,0,0,0,5,0,0,5,0,0,0,0,0,0,0,5
3943,Cameroon,2008,2008Cameroon,0,0,0,6,0,0,6,0,0,0,5,0,0,5,11
3944,Cameroon,2008,2008Cameroon,0,5,0,0,0,0,5,0,0,0,7,0,0,7,12
3945,Cameroon,2008,2008Cameroon,5,0,0,0,0,0,5,0,0,0,0,0,0,0,5
3946,Cameroon,2008,2008Cameroon,7,0,0,36,0,32,75,8,0,0,7,0,29,44,119
3947,Cameroon,2008,2008Cameroon,245,154,200,476,49,0,1124,187,104,180,202,22,0,695,1819
3948,Cameroon,2009,2009Cameroon,0,0,0,0,0,0,0,0,0,0,0,0,0,0,11123
3949,Cameroon,2009,2009Cameroon,0,0,0,0,0,0,0,0,0,0,5,0,0,5,15
3950,Cameroon,2009,2009Cameroon,0,0,0,0,0,0,0,0,0,0,6,0,0,6,18
3951,Cameroon,2009,2009Cameroon,0,0,0,0,0,0,0,0,0,0,8,0,0,8,8
3952,Cameroon,2009,2009Cameroon,0,0,0,0,0,0,0,0,0,0,9,0,0,9,9
3953,Cameroon,2009,2009Cameroon,0,0,0,0,0,0,0,0,5,0,15,0,0,20,20
3954,Cameroon,2009,2009Cameroon,0,0,0,0,0,0,0,0,6,0,0,0,0,6,6
3955,Cameroon,2009,2009Cameroon,0,0,0,0,0,92,92,0,0,0,0,0,128,128,220
3956,Cameroon,2009,2009Cameroon,0,0,0,5,0,0,5,0,0,0,0,0,0,0,5
3957,Cameroon,2009,2009Cameroon,0,0,0,5,0,0,5,0,0,0,6,0,0,6,11
3958,Cameroon,2009,2009Cameroon,0,5,0,0,0,0,5,0,0,0,0,0,0,0,5
3959,Cameroon,2009,2009Cameroon,0,5,0,0,0,0,5,0,0,0,7,0,0,7,12
3960,Cameroon,2009,2009Cameroon,0,8,0,37,0,35,80,7,0,0,7,0,31,45,125
3961,Cameroon,2009,2009Cameroon,29,59,24,401,7,0,520,30,68,23,534,5,0,660,1180
3962,Cameroon,2009,2009Cameroon,222,150,265,523,58,0,1218,170,138,206,233,30,0,777,1995
3963,Cameroon,2010,2010Cameroon,0,0,0,0,0,0,0,0,0,0,0,0,0,0,10521
3964,Cameroon,2010,2010Cameroon,0,0,0,0,0,0,0,0,0,0,5,0,0,5,25
3965,Cameroon,2010,2010Cameroon,0,0,0,0,0,0,0,0,0,0,6,0,0,6,24
3966,Cameroon,2010,2010Cameroon,0,0,0,0,0,0,0,0,0,0,8,0,0,8,16
3967,Cameroon,2010,2010Cameroon,0,0,0,0,0,0,0,0,0,5,0,0,0,5,5
3968,Cameroon,2010,2010Cameroon,0,0,0,0,0,0,0,0,5,0,15,0,0,20,20
3969,Cameroon,2010,2010Cameroon,0,0,0,0,0,112,112,0,0,0,0,0,154,154,266
3970,Cameroon,2010,2010Cameroon,0,0,0,0,0,225,225,0,0,0,0,0,430,430,655
3971,Cameroon,2010,2010Cameroon,0,0,0,5,0,0,5,0,0,0,5,0,0,5,10
3972,Cameroon,2010,2010Cameroon,0,0,0,5,0,0,5,0,0,0,6,0,0,6,11
3973,Cameroon,2010,2010Cameroon,0,5,0,0,0,0,5,0,0,0,7,0,0,7,12
3974,Cameroon,2010,2010Cameroon,6,6,0,43,0,41,96,7,5,0,10,0,35,57,153
3975,Cameroon,2010,2010Cameroon,22,69,28,419,9,0,547,25,72,32,555,5,0,689,1236
3976,Cameroon,2010,2010Cameroon,222,225,192,523,59,0,1221,170,180,164,232,31,0,777,1998
3977,Cameroon,2011,2011Cameroon,0,0,0,0,0,0,0,0,0,0,0,0,0,0,9803
3978,Cameroon,2011,2011Cameroon,0,0,0,0,0,0,0,0,0,0,5,0,0,5,20
3979,Cameroon,2011,2011Cameroon,0,0,0,0,0,0,0,0,0,0,6,0,0,6,24
3980,Cameroon,2011,2011Cameroon,0,0,0,0,0,0,0,0,0,0,7,0,0,7,14
3981,Cameroon,2011,2011Cameroon,0,0,0,0,0,0,0,0,0,0,8,0,0,8,24
3982,Cameroon,2011,2011Cameroon,0,0,0,0,0,0,0,0,0,6,0,0,0,6,6
3983,Cameroon,2011,2011Cameroon,0,0,0,0,0,0,0,0,5,0,15,0,0,20,20
3984,Cameroon,2011,2011Cameroon,0,0,0,0,0,130,130,0,0,0,0,0,194,194,324
3985,Cameroon,2011,2011Cameroon,0,0,0,0,0,241,241,0,0,0,0,0,448,448,689
3986,Cameroon,2011,2011Cameroon,0,0,0,5,0,0,5,0,0,0,6,0,0,6,11
3987,Cameroon,2011,2011Cameroon,0,0,0,9,0,0,9,0,0,0,0,0,0,0,14
3988,Cameroon,2011,2011Cameroon,0,5,0,0,0,0,5,0,0,0,0,0,0,0,5
3989,Cameroon,2011,2011Cameroon,0,5,0,0,0,0,5,0,0,0,7,0,0,7,12
3990,Cameroon,2011,2011Cameroon,5,0,0,0,0,0,5,0,0,0,0,0,0,0,5
3991,Cameroon,2011,2011Cameroon,6,0,5,106,5,0,122,0,8,5,95,0,0,108,798
3992,Cameroon,2011,2011Cameroon,7,5,5,53,0,41,111,10,5,0,10,0,37,62,173
3993,Cameroon,2011,2011Cameroon,14,72,30,397,9,0,522,21,75,28,559,5,0,688,1210
3994,Cameroon,2011,2011Cameroon,227,220,192,531,54,0,1224,172,180,184,206,31,0,773,1997
3995,Cameroon,2012,2012Cameroon,0,0,0,0,0,0,0,0,0,0,0,0,0,0,8976
3996,Cameroon,2012,2012Cameroon,0,0,0,0,0,0,0,0,0,0,0,0,5,5,5
3997,Cameroon,2012,2012Cameroon,0,0,0,0,0,0,0,0,0,0,5,0,0,5,40
3998,Cameroon,2012,2012Cameroon,0,0,0,0,0,0,0,0,0,0,6,0,0,6,30
3999,Cameroon,2012,2012Cameroon,0,0,0,0,0,0,0,0,0,0,8,0,0,8,16
4000,Cameroon,2012,2012Cameroon,0,0,0,0,0,0,0,0,0,0,9,0,0,9,9
4001,Cameroon,2012,2012Cameroon,0,0,0,0,0,0,0,0,0,7,0,0,0,7,7
4002,Cameroon,2012,2012Cameroon,0,0,0,0,0,0,0,0,6,0,0,0,0,6,6
4003,Cameroon,2012,2012Cameroon,0,0,0,0,0,128,128,0,0,0,0,0,217,217,345
4004,Cameroon,2012,2012Cameroon,0,0,0,0,0,253,253,0,0,0,0,0,491,491,744
4005,Cameroon,2012,2012Cameroon,0,0,0,5,0,0,5,0,0,0,6,0,0,6,22
4006,Cameroon,2012,2012Cameroon,0,0,5,46,0,0,51,0,0,0,49,0,0,49,864
4007,Cameroon,2012,2012Cameroon,0,6,0,0,0,0,6,0,0,0,0,0,0,0,6
4008,Cameroon,2012,2012Cameroon,5,0,0,0,0,0,5,0,0,0,0,0,0,0,10
4009,Cameroon,2012,2012Cameroon,5,7,5,54,0,41,112,8,7,0,13,0,38,66,178
4010,Cameroon,2012,2012Cameroon,14,67,32,413,17,0,543,20,76,38,559,8,0,701,1244
4011,Cameroon,2012,2012Cameroon,27,155,82,199,26,0,489,35,119,73,125,17,0,369,858
4012,Cameroon,2013,2013Cameroon,0,0,0,0,0,0,0,0,0,0,0,0,0,0,7842
4013,Cameroon,2013,2013Cameroon,0,0,0,0,0,0,0,0,0,0,5,0,0,5,15
4014,Cameroon,2013,2013Cameroon,0,0,0,0,0,0,0,0,0,0,7,0,0,7,14
4015,Cameroon,2013,2013Cameroon,0,0,0,0,0,0,0,0,0,0,8,0,0,8,16
4016,Cameroon,2013,2013Cameroon,0,0,0,0,0,0,0,0,0,0,9,0,0,9,9
4017,Cameroon,2013,2013Cameroon,0,0,0,0,0,0,0,0,0,0,11,0,0,11,11
4018,Cameroon,2013,2013Cameroon,0,0,0,0,0,0,0,0,0,6,0,0,0,6,18
4019,Cameroon,2013,2013Cameroon,0,0,0,0,0,98,98,0,0,0,0,0,190,190,354
4020,Cameroon,2013,2013Cameroon,0,0,0,0,0,275,275,0,0,0,0,0,515,515,790
4021,Cameroon,2013,2013Cameroon,0,0,0,5,0,0,5,0,0,0,5,0,0,5,10
4022,Cameroon,2013,2013Cameroon,0,0,0,5,0,0,5,0,0,0,6,0,0,6,11
4023,Cameroon,2013,2013Cameroon,0,0,0,5,0,0,5,0,0,0,7,0,0,7,12
4024,Cameroon,2013,2013Cameroon,0,0,0,5,0,0,5,0,0,0,8,0,0,8,13
4025,Cameroon,2013,2013Cameroon,0,0,0,5,0,0,5,0,0,0,9,0,0,9,14
4026,Cameroon,2013,2013Cameroon,0,0,5,0,0,0,5,0,0,0,0,0,0,0,5
4027,Cameroon,2013,2013Cameroon,0,0,7,33,0,0,40,0,0,6,28,0,0,34,74
4028,Cameroon,2013,2013Cameroon,0,8,9,44,0,0,61,0,5,8,45,0,0,58,932
4029,Cameroon,2013,2013Cameroon,5,23,13,206,14,0,261,5,27,9,220,6,0,267,528
4030,Cameroon,2013,2013Cameroon,10,11,0,59,0,43,123,9,8,0,14,0,40,71,194
4031,Cameroon,2013,2013Cameroon,19,90,44,128,16,0,297,26,57,54,106,8,0,251,548
4032,Cameroon,2014,2014Cameroon,0,0,0,0,0,0,0,0,0,0,0,0,0,0,7320
4033,Cameroon,2014,2014Cameroon,0,0,0,0,0,0,0,0,0,0,0,0,5,5,5
4034,Cameroon,2014,2014Cameroon,0,0,0,0,0,0,0,0,0,0,5,0,0,5,38
4035,Cameroon,2014,2014Cameroon,0,0,0,0,0,0,0,0,0,0,8,0,0,8,16
4036,Cameroon,2014,2014Cameroon,0,0,0,0,0,0,0,0,0,0,9,0,0,9,9
4037,Cameroon,2014,2014Cameroon,0,0,0,0,0,0,0,0,0,0,11,0,0,11,11
4038,Cameroon,2014,2014Cameroon,0,0,0,0,0,0,0,0,0,5,0,0,0,5,5
4039,Cameroon,2014,2014Cameroon,0,0,0,0,0,0,0,0,0,5,10,0,0,15,15
4040,Cameroon,2014,2014Cameroon,0,0,0,0,0,0,0,0,0,6,0,0,0,6,6
4041,Cameroon,2014,2014Cameroon,0,0,0,0,0,0,0,0,0,7,0,0,0,7,7
4042,Cameroon,2014,2014Cameroon,0,0,0,0,0,0,0,0,5,0,0,0,0,5,5
4043,Cameroon,2014,2014Cameroon,0,0,0,0,0,0,0,9,0,0,0,0,0,9,9
4044,Cameroon,2014,2014Cameroon,0,0,0,0,0,182,182,0,0,0,0,0,343,343,525
4045,Cameroon,2014,2014Cameroon,0,0,0,0,0,269,269,0,0,0,0,0,527,527,796
4046,Cameroon,2014,2014Cameroon,0,0,0,5,0,0,5,0,0,0,8,0,0,8,13
4047,Cameroon,2014,2014Cameroon,0,0,0,5,0,0,5,0,0,0,16,0,0,16,21
4048,Cameroon,2014,2014Cameroon,0,0,0,6,0,0,6,0,0,0,6,0,0,6,12
4049,Cameroon,2014,2014Cameroon,0,0,0,6,0,0,6,0,0,0,7,0,0,7,13
4050,Cameroon,2014,2014Cameroon,0,0,0,63,0,0,63,0,0,0,82,0,0,82,985
4051,Cameroon,2014,2014Cameroon,0,0,5,0,0,0,5,0,5,0,15,0,0,20,25
4052,Cameroon,2014,2014Cameroon,0,6,0,0,0,0,6,0,0,0,0,0,0,0,6
4053,Cameroon,2014,2014Cameroon,5,25,14,216,18,0,278,0,25,12,217,6,0,260,538
4054,Cameroon,2014,2014Cameroon,5,27,17,42,5,0,96,0,10,11,40,5,0,66,162
4055,Cameroon,2014,2014Cameroon,9,13,0,52,5,42,121,13,5,0,17,0,41,76,197
4056,Cameroon,2015,2015Cameroon,0,0,0,0,0,0,0,0,0,0,0,0,0,0,8120
4057,Cameroon,2015,2015Cameroon,0,0,0,0,0,0,0,0,0,0,0,0,5,5,35
4058,Cameroon,2015,2015Cameroon,0,0,0,0,0,0,0,0,0,0,0,0,9,9,9
4059,Cameroon,2015,2015Cameroon,0,0,0,0,0,0,0,0,0,0,5,0,0,5,15
4060,Cameroon,2015,2015Cameroon,0,0,0,0,0,0,0,0,0,0,6,0,0,6,6
4061,Cameroon,2015,2015Cameroon,0,0,0,0,0,0,0,0,0,0,8,0,0,8,16
4062,Cameroon,2015,2015Cameroon,0,0,0,0,0,0,0,0,0,6,0,0,0,6,6
4063,Cameroon,2015,2015Cameroon,0,0,0,0,0,0,0,0,0,8,0,0,0,8,8
4064,Cameroon,2015,2015Cameroon,0,0,0,0,0,0,0,0,5,0,0,0,0,5,5
4065,Cameroon,2015,2015Cameroon,0,0,0,0,0,0,0,0,8,0,0,0,0,8,8
4066,Cameroon,2015,2015Cameroon,0,0,0,0,0,126,126,0,0,0,0,0,260,260,386
4067,Cameroon,2015,2015Cameroon,0,0,0,0,0,271,271,0,0,0,0,0,545,545,816
4068,Cameroon,2015,2015Cameroon,0,0,0,5,0,0,5,0,0,0,5,0,0,5,10
4069,Cameroon,2015,2015Cameroon,0,0,0,5,0,0,5,0,0,0,20,0,0,20,25
4070,Cameroon,2015,2015Cameroon,0,0,0,6,0,0,6,0,0,0,6,0,0,6,12
4071,Cameroon,2015,2015Cameroon,0,0,0,7,0,0,7,0,0,0,25,0,0,25,32
4072,Cameroon,2015,2015Cameroon,0,0,0,8,0,0,8,0,0,0,7,0,0,7,15
4073,Cameroon,2015,2015Cameroon,0,0,0,13,0,0,13,0,0,5,37,0,0,42,55
4074,Cameroon,2015,2015Cameroon,0,0,5,0,0,0,5,0,0,0,0,0,0,0,5
4075,Cameroon,2015,2015Cameroon,0,0,5,30,0,0,35,0,0,5,39,0,0,44,79
4076,Cameroon,2015,2015Cameroon,0,5,0,0,0,0,5,0,0,0,0,0,0,0,5
4077,Cameroon,2015,2015Cameroon,0,6,0,0,0,0,6,0,0,0,0,0,0,0,6
4078,Cameroon,2015,2015Cameroon,5,19,8,214,20,0,266,0,19,11,212,7,0,249,515
4079,Cameroon,2015,2015Cameroon,5,20,19,47,5,0,96,0,10,11,39,5,0,65,161
4080,Cameroon,2015,2015Cameroon,12,15,0,62,0,45,134,12,10,0,11,5,43,81,215
4081,Cameroon,2016,2016Cameroon,0,0,0,0,0,0,0,0,0,0,0,0,0,0,6562
4082,Cameroon,2016,2016Cameroon,0,0,0,0,0,0,0,0,0,0,0,0,5,5,5
4083,Cameroon,2016,2016Cameroon,0,0,0,0,0,0,0,0,0,0,5,0,0,5,15
4084,Cameroon,2016,2016Cameroon,0,0,0,0,0,0,0,0,0,0,6,0,0,6,6
4085,Cameroon,2016,2016Cameroon,0,0,0,0,0,0,0,0,0,0,7,0,0,7,14
4086,Cameroon,2016,2016Cameroon,0,0,0,0,0,0,0,0,0,8,0,0,0,8,8
4087,Cameroon,2016,2016Cameroon,0,0,0,0,0,0,0,0,5,0,0,0,0,5,5
4088,Cameroon,2016,2016Cameroon,0,0,0,0,0,0,0,0,7,0,0,0,0,7,7
4089,Cameroon,2016,2016Cameroon,0,0,0,0,0,5,5,0,0,0,0,0,7,7,12
4090,Cameroon,2016,2016Cameroon,0,0,0,0,0,130,130,0,0,0,0,0,274,274,404
4091,Cameroon,2016,2016Cameroon,0,0,0,0,0,147,147,0,0,0,0,0,249,249,396
4092,Cameroon,2016,2016Cameroon,0,0,0,0,0,297,297,0,0,0,0,0,600,600,897
4093,Cameroon,2016,2016Cameroon,0,0,0,5,0,0,5,0,0,0,0,0,0,0,5
4094,Cameroon,2016,2016Cameroon,0,0,0,5,0,0,5,0,0,0,9,0,0,9,14
4095,Cameroon,2016,2016Cameroon,0,0,0,5,0,0,5,0,0,0,17,0,0,17,22
4096,Cameroon,2016,2016Cameroon,0,0,0,5,0,0,5,0,0,6,0,0,0,6,11
4097,Cameroon,2016,2016Cameroon,0,0,0,6,0,0,6,0,0,0,6,0,0,6,12
4098,Cameroon,2016,2016Cameroon,0,0,0,8,0,0,8,0,0,0,8,0,0,8,16
4099,Cameroon,2016,2016Cameroon,0,0,0,13,0,0,13,0,0,0,16,0,0,16,29
4100,Cameroon,2016,2016Cameroon,0,0,0,13,0,0,13,0,0,0,37,0,0,37,50
4101,Cameroon,2016,2016Cameroon,0,0,5,0,0,0,5,0,0,0,0,0,0,0,5
4102,Cameroon,2016,2016Cameroon,0,0,5,32,0,0,37,0,0,5,42,0,0,47,84
4103,Cameroon,2016,2016Cameroon,0,0,6,0,0,0,6,0,0,0,0,0,0,0,6
4104,Cameroon,2016,2016Cameroon,0,6,0,0,0,0,6,0,0,0,0,0,0,0,6
4105,Cameroon,2016,2016Cameroon,0,15,11,207,25,0,258,0,19,11,204,11,0,245,503
4106,Cameroon,2016,2016Cameroon,5,10,7,73,0,0,95,5,16,9,74,0,0,104,975
4107,Cameroon,2016,2016Cameroon,7,0,0,11,0,0,18,0,0,6,41,0,0,47,65
4108,Cameroon,2016,2016Cameroon,10,17,0,56,0,43,126,9,11,0,15,5,44,84,210
4109,Cameroon,2017,2017Cameroon,0,0,0,0,0,0,0,0,0,0,0,0,0,0,8318
4110,Cameroon,2017,2017Cameroon,0,0,0,0,0,0,0,0,0,0,0,0,5,5,5
4111,Cameroon,2017,2017Cameroon,0,0,0,0,0,0,0,0,0,0,5,0,0,5,15
4112,Cameroon,2017,2017Cameroon,0,0,0,0,0,0,0,0,0,0,6,0,0,6,74
4113,Cameroon,2017,2017Cameroon,0,0,0,0,0,0,0,0,0,0,7,0,0,7,7
4114,Cameroon,2017,2017Cameroon,0,0,0,0,0,0,0,0,0,0,8,0,0,8,8
4115,Cameroon,2017,2017Cameroon,0,0,0,0,0,0,0,0,0,8,0,0,0,8,8
4116,Cameroon,2017,2017Cameroon,0,0,0,0,0,0,0,0,5,0,0,0,0,5,5
4117,Cameroon,2017,2017Cameroon,0,0,0,0,0,0,0,5,0,0,0,0,0,5,5
4118,Cameroon,2017,2017Cameroon,0,0,0,0,0,147,147,0,0,0,0,0,245,245,392
4119,Cameroon,2017,2017Cameroon,0,0,0,0,0,357,357,0,0,0,0,0,684,684,1041
4120,Cameroon,2017,2017Cameroon,0,0,0,5,0,0,5,0,0,0,0,0,0,0,5
4121,Cameroon,2017,2017Cameroon,0,0,0,5,0,0,5,0,0,5,6,0,0,11,16
4122,Cameroon,2017,2017Cameroon,0,0,0,5,0,0,5,0,0,6,0,0,0,6,11
4123,Cameroon,2017,2017Cameroon,0,0,0,6,0,0,6,0,0,0,6,0,0,6,12
4124,Cameroon,2017,2017Cameroon,0,0,0,6,0,0,6,0,0,5,13,0,0,18,24
4125,Cameroon,2017,2017Cameroon,0,0,5,0,0,0,5,0,0,0,0,0,0,0,10
4126,Cameroon,2017,2017Cameroon,0,0,5,0,0,0,5,0,0,0,6,0,0,6,11
4127,Cameroon,2017,2017Cameroon,0,0,5,32,0,0,37,0,0,5,43,0,0,48,85
4128,Cameroon,2017,2017Cameroon,0,5,5,22,0,0,32,5,0,8,45,5,0,63,95
4129,Cameroon,2017,2017Cameroon,0,6,0,0,0,0,6,0,0,0,0,0,0,0,6
4130,Cameroon,2017,2017Cameroon,5,0,0,5,0,0,10,0,0,0,8,0,0,8,18
4131,Cameroon,2017,2017Cameroon,5,0,0,16,0,0,21,0,0,8,50,0,0,58,79
4132,Cameroon,2017,2017Cameroon,8,14,6,231,26,0,285,12,18,12,258,9,0,309,594
4133,Cameroon,2017,2017Cameroon,9,11,5,49,5,36,115,7,8,5,11,5,37,73,188
4134,Cameroon,2018,2018Cameroon,0,0,0,0,0,0,0,0,0,0,0,0,0,0,8767
4135,Cameroon,2018,2018Cameroon,0,0,0,0,0,0,0,0,0,0,5,0,0,5,10
4136,Cameroon,2018,2018Cameroon,0,0,0,0,0,0,0,0,0,0,6,0,0,6,12
4137,Cameroon,2018,2018Cameroon,0,0,0,0,0,0,0,0,0,0,7,0,0,7,7
4138,Cameroon,2018,2018Cameroon,0,0,0,0,0,0,0,0,0,0,9,0,0,9,9
4139,Cameroon,2018,2018Cameroon,0,0,0,0,0,0,0,0,0,0,12,0,0,12,12
4140,Cameroon,2018,2018Cameroon,0,0,0,0,0,0,0,0,0,5,0,0,0,5,5
4141,Cameroon,2018,2018Cameroon,0,0,0,0,0,0,0,0,5,0,0,0,0,5,5
4142,Cameroon,2018,2018Cameroon,0,0,0,0,0,0,0,0,6,0,0,0,0,6,6
4143,Cameroon,2018,2018Cameroon,0,0,0,0,0,0,0,5,0,0,0,0,0,5,5
4144,Cameroon,2018,2018Cameroon,0,0,0,0,0,441,441,0,0,0,0,0,805,805,1246
4145,Cameroon,2018,2018Cameroon,0,0,0,5,0,0,5,0,0,0,5,0,0,5,10
4146,Cameroon,2018,2018Cameroon,0,0,0,5,0,0,5,0,0,0,7,0,0,7,12
4147,Cameroon,2018,2018Cameroon,0,0,0,6,0,0,6,0,0,0,0,0,0,0,6
4148,Cameroon,2018,2018Cameroon,0,0,0,7,0,0,7,0,0,0,0,0,0,0,7
4149,Cameroon,2018,2018Cameroon,0,0,0,8,0,0,8,0,0,5,11,0,0,16,24
4150,Cameroon,2018,2018Cameroon,0,0,5,9,0,0,14,6,0,0,15,0,0,21,35
4151,Cameroon,2018,2018Cameroon,0,0,5,28,0,0,33,0,0,5,35,0,0,40,73
4152,Cameroon,2018,2018Cameroon,0,5,0,0,0,0,5,0,0,0,0,0,0,0,5
4153,Cameroon,2018,2018Cameroon,5,0,0,5,0,0,10,0,5,0,5,0,0,10,20
4154,Cameroon,2018,2018Cameroon,6,0,0,24,0,0,30,5,0,0,65,0,0,70,100
4155,Cameroon,2018,2018Cameroon,7,10,5,45,5,37,109,5,7,5,10,5,36,68,177
4156,Cameroon,2018,2018Cameroon,8,22,11,88,0,0,129,9,23,15,99,0,0,146,1116
4157,Cameroon,2018,2018Cameroon,21,22,12,271,27,0,353,23,18,15,280,9,0,345,698
4158,Cameroon,2018,2018Cameroon,2619,3568,2153,9252,792,0,18384,2621,3428,1842,6035,441,0,14367,32751
4159,Cameroon,2019,2019Cameroon,0,0,0,0,0,0,0,0,0,0,0,0,0,0,11186
4160,Cameroon,2019,2019Cameroon,0,0,0,0,0,0,0,0,0,0,0,0,5,5,5
4161,Cameroon,2019,2019Cameroon,0,0,0,0,0,0,0,0,0,0,5,0,0,5,30
4162,Cameroon,2019,2019Cameroon,0,0,0,0,0,0,0,0,0,0,7,0,0,7,14
4163,Cameroon,2019,2019Cameroon,0,0,0,0,0,0,0,0,0,0,10,0,0,10,10
4164,Cameroon,2019,2019Cameroon,0,0,0,0,0,0,0,0,0,5,0,0,0,5,10
4165,Cameroon,2019,2019Cameroon,0,0,0,0,0,0,0,5,0,0,0,0,0,5,5
4166,Cameroon,2019,2019Cameroon,0,0,0,0,0,556,556,0,0,0,0,0,968,968,1524
4167,Cameroon,2019,2019Cameroon,0,0,0,5,0,0,5,0,0,0,0,0,0,0,20
4168,Cameroon,2019,2019Cameroon,0,0,0,5,0,0,5,0,0,0,19,0,0,19,24
4169,Cameroon,2019,2019Cameroon,0,0,0,6,0,0,6,0,0,0,0,0,0,0,6
4170,Cameroon,2019,2019Cameroon,0,0,0,6,0,0,6,0,0,0,9,0,0,9,15
4171,Cameroon,2019,2019Cameroon,0,0,0,7,0,0,7,0,0,0,0,0,0,0,7
4172,Cameroon,2019,2019Cameroon,0,0,0,8,0,0,8,0,0,0,8,0,0,8,16
4173,Cameroon,2019,2019Cameroon,0,0,0,8,0,0,8,0,0,0,21,0,0,21,29
4174,Cameroon,2019,2019Cameroon,0,0,0,8,0,0,8,0,0,5,10,0,0,15,23
4175,Cameroon,2019,2019Cameroon,0,0,0,12,0,0,12,0,0,8,0,0,0,8,20
4176,Cameroon,2019,2019Cameroon,0,0,0,31,5,0,36,0,5,0,31,0,0,36,72
4177,Cameroon,2019,2019Cameroon,5,0,5,25,0,0,35,8,0,5,24,0,0,37,72
4178,Cameroon,2019,2019Cameroon,5,14,6,47,0,0,72,5,12,5,15,5,0,42,181
4179,Cameroon,2019,2019Cameroon,8,0,0,0,0,0,8,5,0,0,5,0,0,10,18
4180,Cameroon,2019,2019Cameroon,9,0,0,30,0,0,39,7,0,0,64,0,0,71,110
4181,Cameroon,2019,2019Cameroon,25,26,12,290,34,0,387,30,23,17,312,9,0,391,778
4182,Cameroon,2019,2019Cameroon,4195,5854,3507,13527,1020,0,28103,4344,5677,3312,9989,641,0,23963,52066
4183,Cameroon,2020,2020Cameroon,0,0,0,0,0,0,0,0,0,0,0,0,0,0,11029
4184,Cameroon,2020,2020Cameroon,0,0,0,0,0,0,0,0,0,0,0,0,5,5,5
4185,Cameroon,2020,2020Cameroon,0,0,0,0,0,0,0,0,0,0,5,0,0,5,55
4186,Cameroon,2020,2020Cameroon,0,0,0,0,0,0,0,0,0,0,6,0,0,6,6
4187,Cameroon,2020,2020Cameroon,0,0,0,0,0,0,0,0,0,0,7,0,0,7,21
4188,Cameroon,2020,2020Cameroon,0,0,0,0,0,0,0,0,0,0,12,0,0,12,12
4189,Cameroon,2020,2020Cameroon,0,0,0,0,0,0,0,0,0,0,17,0,0,17,17
4190,Cameroon,2020,2020Cameroon,0,0,0,0,0,0,0,5,0,0,0,0,0,5,5
4191,Cameroon,2020,2020Cameroon,0,0,0,0,0,6,6,0,0,0,0,0,11,11,17
4192,Cameroon,2020,2020Cameroon,0,0,0,0,0,10,10,0,0,0,0,0,12,12,22
4193,Cameroon,2020,2020Cameroon,0,0,0,0,0,13,13,0,0,0,0,0,27,27,40
4194,Cameroon,2020,2020Cameroon,0,0,0,0,0,191,191,0,0,0,0,0,287,287,478
4195,Cameroon,2020,2020Cameroon,0,0,0,5,0,0,5,0,0,0,0,0,0,0,5
4196,Cameroon,2020,2020Cameroon,0,0,0,5,0,0,5,0,0,0,29,0,0,29,34
4197,Cameroon,2020,2020Cameroon,0,0,0,6,0,0,6,0,0,0,13,0,0,13,19
4198,Cameroon,2020,2020Cameroon,0,0,0,6,0,0,6,0,5,0,6,0,0,11,17
4199,Cameroon,2020,2020Cameroon,0,0,0,7,0,0,7,0,0,0,0,0,0,0,7
4200,Cameroon,2020,2020Cameroon,0,0,0,7,0,0,7,0,0,0,7,0,0,7,14
4201,Cameroon,2020,2020Cameroon,0,0,0,7,0,0,7,0,0,8,7,0,0,15,22
4202,Cameroon,2020,2020Cameroon,0,0,0,8,0,0,8,0,0,0,13,0,0,13,21
4203,Cameroon,2020,2020Cameroon,0,0,0,14,0,0,14,0,0,0,5,0,0,5,19
4204,Cameroon,2020,2020Cameroon,0,0,0,14,0,0,14,5,0,0,27,0,0,32,46
4205,Cameroon,2020,2020Cameroon,0,0,0,17,0,0,17,0,0,0,18,0,0,18,35
4206,Cameroon,2020,2020Cameroon,0,0,0,34,0,30,64,0,0,0,43,0,15,58,964
4207,Cameroon,2020,2020Cameroon,0,0,0,40,5,0,45,0,0,5,44,0,0,49,94
4208,Cameroon,2020,2020Cameroon,0,6,0,5,0,0,11,8,0,0,0,0,0,8,19
4209,Cameroon,2020,2020Cameroon,0,8,16,101,0,0,125,0,11,13,177,0,0,201,326
4210,Cameroon,2020,2020Cameroon,5,11,8,44,5,0,73,9,9,5,19,5,0,47,192
4211,Cameroon,2020,2020Cameroon,8,0,5,43,0,0,56,6,5,0,76,0,0,87,143
4212,Cameroon,2020,2020Cameroon,10,0,9,74,5,0,98,5,6,6,97,0,0,114,212
4213,Cameroon,2020,2020Cameroon,10,5,5,43,0,0,63,12,8,5,39,0,0,64,127
4214,Cameroon,2020,2020Cameroon,31,33,14,292,38,0,408,27,27,16,336,10,0,416,824
4215,Cameroon,2020,2020Cameroon,4386,7463,4496,16574,1440,0,34359,4544,7351,4250,12232,898,0,29275,63634
4216,Cameroon,2021,2021Cameroon,0,0,0,0,0,0,0,0,0,0,0,0,0,0,12746
4217,Cameroon,2021,2021Cameroon,0,0,0,0,0,0,0,0,0,0,0,0,5,5,5
4218,Cameroon,2021,2021Cameroon,0,0,0,0,0,0,0,0,0,0,5,0,0,5,40
4219,Cameroon,2021,2021Cameroon,0,0,0,0,0,0,0,0,0,0,6,0,0,6,6
4220,Cameroon,2021,2021Cameroon,0,0,0,0,0,0,0,0,0,0,7,0,0,7,14
4221,Cameroon,2021,2021Cameroon,0,0,0,0,0,0,0,0,0,0,10,0,0,10,10
4222,Cameroon,2021,2021Cameroon,0,0,0,0,0,0,0,0,0,0,11,0,0,11,11
4223,Cameroon,2021,2021Cameroon,0,0,0,0,0,0,0,0,0,0,12,0,0,12,12
4224,Cameroon,2021,2021Cameroon,0,0,0,0,0,0,0,0,0,0,17,0,0,17,17
4225,Cameroon,2021,2021Cameroon,0,0,0,0,0,0,0,0,5,0,0,0,0,5,5
4226,Cameroon,2021,2021Cameroon,0,0,0,6,0,0,6,0,0,0,14,0,0,14,20
4227,Cameroon,2021,2021Cameroon,0,0,0,7,0,0,7,0,0,0,0,0,0,0,7
4228,Cameroon,2021,2021Cameroon,0,0,0,7,0,0,7,0,0,0,10,0,0,10,17
4229,Cameroon,2021,2021Cameroon,0,0,0,8,0,0,8,0,0,0,0,0,0,0,8
4230,Cameroon,2021,2021Cameroon,0,0,0,8,0,0,8,0,0,0,9,0,0,9,17
4231,Cameroon,2021,2021Cameroon,0,0,0,8,0,0,8,0,0,0,16,0,0,16,24
4232,Cameroon,2021,2021Cameroon,0,0,0,10,0,0,10,0,0,0,12,0,0,12,22
4233,Cameroon,2021,2021Cameroon,0,0,0,11,0,0,11,0,0,0,19,0,0,19,30
4234,Cameroon,2021,2021Cameroon,0,0,0,12,0,0,12,0,0,0,7,0,0,7,19
4235,Cameroon,2021,2021Cameroon,0,0,0,15,0,0,15,0,0,0,6,0,0,6,21
4236,Cameroon,2021,2021Cameroon,0,0,0,15,0,0,15,5,0,0,33,0,0,38,53
4237,Cameroon,2021,2021Cameroon,0,0,0,16,0,0,16,0,5,0,21,0,0,26,42
4238,Cameroon,2021,2021Cameroon,0,0,0,48,5,0,53,8,0,0,43,0,0,51,104
4239,Cameroon,2021,2021Cameroon,0,0,5,7,0,0,12,0,0,5,9,0,0,14,26
4240,Cameroon,2021,2021Cameroon,0,0,5,166,12,29,212,0,5,0,170,7,15,197,1140
4241,Cameroon,2021,2021Cameroon,0,0,6,0,0,0,6,0,0,0,0,0,0,0,6
4242,Cameroon,2021,2021Cameroon,0,5,0,13,0,0,18,0,7,0,17,0,0,24,42
4243,Cameroon,2021,2021Cameroon,0,7,8,110,0,0,125,0,6,15,172,5,0,198,323
4244,Cameroon,2021,2021Cameroon,5,0,0,5,0,0,10,0,0,0,24,0,0,24,34
4245,Cameroon,2021,2021Cameroon,5,6,0,23,0,0,34,0,7,0,38,0,0,45,79
4246,Cameroon,2021,2021Cameroon,5,10,8,47,5,0,75,9,11,0,21,5,0,46,201
4247,Cameroon,2021,2021Cameroon,9,5,0,57,0,0,71,8,5,0,92,0,0,105,176
4248,Cameroon,2021,2021Cameroon,9,7,8,88,5,0,117,7,9,10,127,0,0,153,270
4249,Cameroon,2021,2021Cameroon,12,5,5,53,0,0,75,12,8,5,54,0,0,79,154
4250,Cameroon,2021,2021Cameroon,12,11,5,21,0,0,49,9,10,5,24,0,0,48,35878
4251,Cameroon,2021,2021Cameroon,27,49,19,318,44,0,457,27,39,21,372,11,0,470,927
4252,Cameroon,2021,2021Cameroon,4551,8873,5183,19349,1668,0,39624,4642,8748,4802,14094,1061,0,33347,72971
4253,Central African Rep.,2001,2001Central African Rep.,0,0,0,0,0,0,0,0,0,0,0,0,0,0,394
4254,Central African Rep.,2001,2001Central African Rep.,0,0,0,0,0,0,0,0,0,0,5,0,0,5,26554
4255,Central African Rep.,2001,2001Central African Rep.,0,0,0,0,0,5,5,0,0,0,0,0,16,16,1585
4256,Central African Rep.,2001,2001Central African Rep.,0,0,0,0,0,38,38,0,0,0,0,0,80,80,118
4257,Central African Rep.,2001,2001Central African Rep.,0,0,0,5,0,0,5,0,0,0,9,0,0,9,14
4258,Central African Rep.,2001,2001Central African Rep.,0,0,0,9,0,0,9,0,7,0,17,0,0,24,33
4259,Central African Rep.,2002,2002Central African Rep.,0,0,0,0,0,0,0,0,0,0,0,0,0,0,409
4260,Central African Rep.,2002,2002Central African Rep.,0,0,0,0,0,0,0,0,0,0,6,0,0,6,6
4261,Central African Rep.,2002,2002Central African Rep.,0,0,0,0,0,0,0,0,0,0,9,0,0,9,9
4262,Central African Rep.,2002,2002Central African Rep.,0,0,0,0,0,80,80,0,0,0,0,0,140,140,220
4263,Central African Rep.,2002,2002Central African Rep.,0,0,0,0,5,0,5,0,0,0,9,0,0,9,14
4264,Central African Rep.,2002,2002Central African Rep.,0,0,0,10,0,0,10,0,0,0,10,0,0,10,20
4265,Central African Rep.,2002,2002Central African Rep.,0,0,5,12,0,0,17,0,5,5,25,0,0,35,52
4266,Central African Rep.,2002,2002Central African Rep.,0,5,0,0,0,0,5,0,0,0,0,0,0,0,5
4267,Central African Rep.,2002,2002Central African Rep.,109,135,109,315,13,0,681,116,120,104,691,12,0,1043,1724
4268,Central African Rep.,2002,2002Central African Rep.,180,376,323,539,28,0,1446,172,382,328,520,16,0,1418,2864
4269,Central African Rep.,2002,2002Central African Rep.,1500,1688,1447,4809,0,0,9444,1045,2051,1754,5751,0,0,10601,20045
4270,Central African Rep.,2003,2003Central African Rep.,0,0,0,0,0,0,0,0,0,0,0,0,0,0,517
4271,Central African Rep.,2003,2003Central African Rep.,0,0,0,0,0,0,0,0,0,0,5,0,0,5,15
4272,Central African Rep.,2003,2003Central African Rep.,0,0,0,0,0,0,0,0,0,0,9,0,0,9,9
4273,Central African Rep.,2003,2003Central African Rep.,0,0,0,0,0,126,126,0,0,0,0,0,183,183,309
4274,Central African Rep.,2003,2003Central African Rep.,0,0,0,0,0,18150,18150,0,0,0,0,0,14850,14850,33893
4275,Central African Rep.,2003,2003Central African Rep.,0,0,0,0,5,0,5,0,0,0,9,0,0,9,14
4276,Central African Rep.,2003,2003Central African Rep.,0,0,0,5,0,0,5,0,0,0,5,0,0,5,10
4277,Central African Rep.,2003,2003Central African Rep.,0,0,0,6,0,0,6,0,0,0,0,0,0,0,6
4278,Central African Rep.,2003,2003Central African Rep.,0,0,0,7,5,0,12,0,0,0,16,0,0,16,28
4279,Central African Rep.,2003,2003Central African Rep.,0,0,0,14,0,0,14,0,9,0,25,0,0,34,48
4280,Central African Rep.,2003,2003Central African Rep.,7,23,19,55,0,0,104,13,10,14,61,5,0,103,207
4281,Central African Rep.,2003,2003Central African Rep.,9,8,19,32,0,0,68,13,7,6,133,0,111,270,338
4282,Central African Rep.,2004,2004Central African Rep.,0,0,0,0,0,0,0,0,0,0,0,0,0,0,1192
4283,Central African Rep.,2004,2004Central African Rep.,0,0,0,0,0,0,0,0,0,0,5,0,0,5,10
4284,Central African Rep.,2004,2004Central African Rep.,0,0,0,0,0,0,0,0,0,0,6,0,0,6,6
4285,Central African Rep.,2004,2004Central African Rep.,0,0,0,0,0,0,0,0,0,0,9,0,0,9,9
4286,Central African Rep.,2004,2004Central African Rep.,0,0,0,0,0,0,0,0,0,7,0,0,0,7,7
4287,Central African Rep.,2004,2004Central African Rep.,0,0,0,0,5,0,5,0,0,0,9,0,0,9,14
4288,Central African Rep.,2004,2004Central African Rep.,0,0,0,6,0,0,6,0,0,0,0,0,0,0,6
4289,Central African Rep.,2004,2004Central African Rep.,0,0,0,12,0,0,12,0,0,7,23,0,0,30,42
4290,Central African Rep.,2004,2004Central African Rep.,0,6,5,26,0,0,37,7,0,6,32,5,0,50,87
4291,Central African Rep.,2004,2004Central African Rep.,3633,3013,2584,6026,219,0,15475,3448,2782,2385,5284,309,0,14208,29683
4292,Central African Rep.,2005,2005Central African Rep.,0,0,0,0,0,0,0,0,0,0,0,0,0,0,1009
4293,Central African Rep.,2005,2005Central African Rep.,0,0,0,0,0,0,0,0,0,0,5,0,0,5,10
4294,Central African Rep.,2005,2005Central African Rep.,0,0,0,0,0,0,0,0,0,0,6,0,0,6,12
4295,Central African Rep.,2005,2005Central African Rep.,0,0,0,0,0,0,0,0,0,7,0,0,0,7,7
4296,Central African Rep.,2005,2005Central African Rep.,0,0,0,0,0,189,189,0,0,0,0,0,251,251,440
4297,Central African Rep.,2005,2005Central African Rep.,0,0,0,6,0,0,6,0,0,0,0,0,0,0,6
4298,Central African Rep.,2005,2005Central African Rep.,0,0,0,10,0,0,10,0,5,0,22,0,0,27,37
4299,Central African Rep.,2005,2005Central African Rep.,0,0,0,12,0,0,12,0,0,0,14,0,0,14,26
4300,Central African Rep.,2005,2005Central African Rep.,0,5,0,23,0,0,28,6,0,5,30,5,0,46,74
4301,Central African Rep.,2005,2005Central African Rep.,0,8,0,0,0,0,8,0,0,0,0,0,0,0,8
4302,Central African Rep.,2005,2005Central African Rep.,5108,4337,3719,8684,335,0,22183,4920,3659,3137,6861,486,0,19063,41246
4303,Central African Rep.,2006,2006Central African Rep.,0,0,0,0,0,0,0,0,0,0,0,0,0,0,340
4304,Central African Rep.,2006,2006Central African Rep.,0,0,0,0,0,0,0,0,0,0,0,0,5,5,5
4305,Central African Rep.,2006,2006Central African Rep.,0,0,0,0,0,0,0,0,0,0,5,0,0,5,15
4306,Central African Rep.,2006,2006Central African Rep.,0,0,0,0,0,0,0,0,0,0,6,0,0,6,6
4307,Central African Rep.,2006,2006Central African Rep.,0,0,0,0,0,0,0,0,0,0,10,0,0,10,10
4308,Central African Rep.,2006,2006Central African Rep.,0,0,0,0,0,209,209,0,0,0,0,0,259,259,468
4309,Central African Rep.,2006,2006Central African Rep.,0,0,0,8,0,0,8,0,0,5,6,0,0,11,19
4310,Central African Rep.,2006,2006Central African Rep.,0,0,0,9,0,0,9,0,0,0,0,0,0,0,9
4311,Central African Rep.,2006,2006Central African Rep.,0,9,0,0,0,0,9,0,0,0,0,0,0,0,9
4312,Central African Rep.,2006,2006Central African Rep.,0,9,0,8,0,0,17,0,7,0,7,0,0,14,31
4313,Central African Rep.,2006,2006Central African Rep.,5,0,0,0,0,0,5,0,0,0,10,0,0,10,15
4314,Central African Rep.,2006,2006Central African Rep.,1992,2833,1578,4578,170,0,11151,1998,3020,1432,4300,441,0,11191,22342
4315,Central African Rep.,2006,2006Central African Rep.,3897,7186,3451,9560,529,0,24623,3827,7042,3391,6559,420,0,21239,48400
4316,Central African Rep.,2007,2007Central African Rep.,0,0,0,0,0,0,0,0,0,0,0,0,0,0,46483
4317,Central African Rep.,2007,2007Central African Rep.,0,0,0,0,0,0,0,0,0,0,0,0,5,5,5
4318,Central African Rep.,2007,2007Central African Rep.,0,0,0,0,0,0,0,0,0,0,5,0,0,5,15
4319,Central African Rep.,2007,2007Central African Rep.,0,0,0,0,0,0,0,0,0,0,7,0,0,7,7
4320,Central African Rep.,2007,2007Central African Rep.,0,0,0,0,0,0,0,0,0,0,11,0,0,11,22
4321,Central African Rep.,2007,2007Central African Rep.,0,0,0,0,0,5,5,0,0,0,0,0,0,0,5
4322,Central African Rep.,2007,2007Central African Rep.,0,0,0,0,0,218,218,0,0,0,0,0,279,279,497
4323,Central African Rep.,2007,2007Central African Rep.,0,0,0,0,0,1250,1250,0,0,0,0,0,1250,1250,2500
4324,Central African Rep.,2007,2007Central African Rep.,0,0,0,14,0,0,14,0,0,0,9,0,0,9,23
4325,Central African Rep.,2007,2007Central African Rep.,0,0,9,0,0,0,9,0,0,0,0,0,0,0,9
4326,Central African Rep.,2007,2007Central African Rep.,0,5,0,0,0,0,5,0,0,0,7,0,0,7,12
4327,Central African Rep.,2007,2007Central African Rep.,5,0,0,0,0,0,5,0,0,0,11,0,0,11,16
4328,Central African Rep.,2007,2007Central African Rep.,4267,6564,3278,10480,425,0,25014,4243,6854,2885,8660,842,0,23484,48498
4329,Central African Rep.,2008,2008Central African Rep.,0,0,0,0,0,0,0,0,0,0,0,0,0,0,333
4330,Central African Rep.,2008,2008Central African Rep.,0,0,0,0,0,0,0,0,0,0,0,0,15,15,15
4331,Central African Rep.,2008,2008Central African Rep.,0,0,0,0,0,0,0,0,0,0,5,0,0,5,10
4332,Central African Rep.,2008,2008Central African Rep.,0,0,0,0,0,0,0,0,0,0,6,0,0,6,6
4333,Central African Rep.,2008,2008Central African Rep.,0,0,0,0,0,0,0,0,0,0,7,0,0,7,7
4334,Central African Rep.,2008,2008Central African Rep.,0,0,0,0,0,0,0,0,0,0,9,0,0,9,18
4335,Central African Rep.,2008,2008Central African Rep.,0,0,0,0,0,0,0,0,0,0,11,0,0,11,11
4336,Central African Rep.,2008,2008Central African Rep.,0,0,0,0,0,232,232,0,0,0,0,0,298,298,530
4337,Central African Rep.,2008,2008Central African Rep.,0,0,0,7,0,0,7,0,0,0,0,0,0,0,7
4338,Central African Rep.,2008,2008Central African Rep.,0,0,0,14,0,0,14,0,0,5,5,0,0,10,24
4339,Central African Rep.,2008,2008Central African Rep.,0,0,8,0,0,0,8,0,0,0,0,0,0,0,8
4340,Central African Rep.,2008,2008Central African Rep.,0,8,0,0,0,0,8,0,0,0,8,0,0,8,16
4341,Central African Rep.,2008,2008Central African Rep.,9,0,5,10,0,100,124,0,0,6,16,0,99,121,245
4342,Central African Rep.,2008,2008Central African Rep.,4276,7086,3917,9718,517,0,25514,4135,7011,3877,6701,457,0,22181,57258
4343,Central African Rep.,2008,2008Central African Rep.,6319,9264,4338,14310,600,0,34831,6526,9489,3781,10903,1072,0,31771,66602
4344,Central African Rep.,2009,2009Central African Rep.,0,0,0,0,0,0,0,0,0,0,0,0,0,0,875
4345,Central African Rep.,2009,2009Central African Rep.,0,0,0,0,0,0,0,0,0,0,0,0,19,19,19
4346,Central African Rep.,2009,2009Central African Rep.,0,0,0,0,0,0,0,0,0,0,5,0,0,5,15
4347,Central African Rep.,2009,2009Central African Rep.,0,0,0,0,0,0,0,0,0,0,6,0,0,6,6
4348,Central African Rep.,2009,2009Central African Rep.,0,0,0,0,0,0,0,0,0,0,7,0,0,7,14
4349,Central African Rep.,2009,2009Central African Rep.,0,0,0,0,0,0,0,0,0,0,11,0,0,11,11
4350,Central African Rep.,2009,2009Central African Rep.,0,0,0,0,0,0,0,0,0,0,12,0,0,12,12
4351,Central African Rep.,2009,2009Central African Rep.,0,0,0,5,0,0,5,0,0,0,10,0,0,10,15
4352,Central African Rep.,2009,2009Central African Rep.,0,0,0,7,0,0,7,0,0,0,0,0,0,0,7
4353,Central African Rep.,2009,2009Central African Rep.,0,5,0,5,0,0,10,0,0,0,0,0,0,0,10
4354,Central African Rep.,2009,2009Central African Rep.,0,5,7,25,0,0,37,0,0,13,22,0,0,35,72
4355,Central African Rep.,2009,2009Central African Rep.,0,7,0,0,0,0,7,0,0,0,8,0,0,8,15
4356,Central African Rep.,2009,2009Central African Rep.,0,8,0,8,0,0,16,0,0,9,11,0,0,20,36
4357,Central African Rep.,2009,2009Central African Rep.,5,0,0,0,0,0,5,0,0,0,0,0,0,0,5
4358,Central African Rep.,2009,2009Central African Rep.,9,0,0,0,0,0,9,0,0,0,0,0,0,0,9
4359,Central African Rep.,2009,2009Central African Rep.,62,64,34,166,9,179,514,60,67,43,165,5,179,519,1582
4360,Central African Rep.,2009,2009Central African Rep.,6114,8178,4636,13026,1690,0,33644,5428,7627,4518,8872,1278,0,27723,71015
4361,Central African Rep.,2009,2009Central African Rep.,7225,12493,6146,18695,785,0,45344,7302,12561,5711,13615,1291,0,40480,85824
4362,Central African Rep.,2010,2010Central African Rep.,0,0,0,0,0,0,0,0,0,0,0,0,0,0,343
4363,Central African Rep.,2010,2010Central African Rep.,0,0,0,0,0,0,0,0,0,0,0,0,6,6,6
4364,Central African Rep.,2010,2010Central African Rep.,0,0,0,0,0,0,0,0,0,0,0,0,18,18,18
4365,Central African Rep.,2010,2010Central African Rep.,0,0,0,0,0,0,0,0,0,0,5,0,0,5,15
4366,Central African Rep.,2010,2010Central African Rep.,0,0,0,0,0,0,0,0,0,0,7,0,0,7,14
4367,Central African Rep.,2010,2010Central African Rep.,0,0,0,0,0,0,0,0,0,0,11,0,0,11,11
4368,Central African Rep.,2010,2010Central African Rep.,0,0,0,0,0,0,0,0,0,0,12,0,0,12,12
4369,Central African Rep.,2010,2010Central African Rep.,0,0,0,0,0,0,0,0,0,5,0,0,0,5,5
4370,Central African Rep.,2010,2010Central African Rep.,0,0,0,0,0,257,257,0,0,0,0,0,320,320,577
4371,Central African Rep.,2010,2010Central African Rep.,0,0,0,5,0,0,5,0,0,0,9,0,0,9,14
4372,Central African Rep.,2010,2010Central African Rep.,0,0,0,7,0,0,7,0,0,0,0,0,0,0,7
4373,Central African Rep.,2010,2010Central African Rep.,0,0,9,0,0,0,9,0,0,0,0,0,0,0,9
4374,Central African Rep.,2010,2010Central African Rep.,0,6,0,5,0,0,11,0,0,0,0,0,0,0,11
4375,Central African Rep.,2010,2010Central African Rep.,0,6,14,20,0,0,40,0,6,13,35,0,0,54,94
4376,Central African Rep.,2010,2010Central African Rep.,0,7,0,0,0,0,7,0,7,0,0,0,0,7,14
4377,Central African Rep.,2010,2010Central African Rep.,5,0,0,0,0,0,5,0,0,0,0,0,0,0,5
4378,Central African Rep.,2010,2010Central African Rep.,78,51,39,174,11,0,353,85,44,38,177,9,0,353,706
4379,Central African Rep.,2010,2010Central African Rep.,78,65,68,108,5,449,773,71,53,52,139,0,448,763,3686
4380,Central African Rep.,2010,2010Central African Rep.,4697,8369,5448,15078,2120,0,35712,3928,7602,5464,10168,1554,0,28716,69428
4381,Central African Rep.,2010,2010Central African Rep.,7376,12617,6874,19577,900,0,47344,7546,12743,6532,14345,1417,0,42583,89927
4382,Central African Rep.,2011,2011Central African Rep.,0,0,0,0,0,0,0,0,0,0,0,0,0,0,300
4383,Central African Rep.,2011,2011Central African Rep.,0,0,0,0,0,0,0,0,0,0,0,0,17,17,17
4384,Central African Rep.,2011,2011Central African Rep.,0,0,0,0,0,0,0,0,0,0,5,0,0,5,83
4385,Central African Rep.,2011,2011Central African Rep.,0,0,0,0,0,0,0,0,0,0,7,0,0,7,14
4386,Central African Rep.,2011,2011Central African Rep.,0,0,0,0,0,0,0,0,0,0,11,0,0,11,11
4387,Central African Rep.,2011,2011Central African Rep.,0,0,0,0,0,23,23,0,0,0,0,0,19,19,2168
4388,Central African Rep.,2011,2011Central African Rep.,0,0,0,0,0,257,257,0,0,0,0,0,326,326,583
4389,Central African Rep.,2011,2011Central African Rep.,0,0,0,6,0,0,6,0,0,0,0,0,0,0,6
4390,Central African Rep.,2011,2011Central African Rep.,0,0,5,0,0,0,5,0,0,0,7,0,0,7,12
4391,Central African Rep.,2011,2011Central African Rep.,0,0,7,0,0,0,7,0,8,0,0,0,0,8,15
4392,Central African Rep.,2011,2011Central African Rep.,0,0,9,0,0,0,9,0,0,0,0,0,0,0,9
4393,Central African Rep.,2011,2011Central African Rep.,0,5,0,5,0,0,10,0,0,0,5,0,0,5,15
4394,Central African Rep.,2011,2011Central African Rep.,0,7,12,21,0,0,40,0,15,5,38,0,0,58,98
4395,Central African Rep.,2011,2011Central African Rep.,5,0,0,0,0,0,5,0,0,0,0,0,0,0,5
4396,Central African Rep.,2011,2011Central African Rep.,76,65,40,263,15,0,459,104,63,37,236,11,0,451,910
4397,Central African Rep.,2011,2011Central African Rep.,119,88,37,279,0,0,523,112,123,42,220,5,0,502,1025
4398,Central African Rep.,2011,2011Central African Rep.,5223,9749,5576,14617,1214,0,36379,5034,9558,5554,9473,916,0,30535,67414
4399,Central African Rep.,2011,2011Central African Rep.,6463,12398,7770,19988,938,0,47557,6623,12601,7443,14449,1503,0,42619,90176
4400,Central African Rep.,2012,2012Central African Rep.,0,0,0,0,0,0,0,0,0,0,0,0,0,0,277
4401,Central African Rep.,2012,2012Central African Rep.,0,0,0,0,0,0,0,0,0,0,0,0,15,15,15
4402,Central African Rep.,2012,2012Central African Rep.,0,0,0,0,0,0,0,0,0,0,5,0,0,5,93
4403,Central African Rep.,2012,2012Central African Rep.,0,0,0,0,0,0,0,0,0,0,7,0,0,7,7
4404,Central African Rep.,2012,2012Central African Rep.,0,0,0,0,0,26,26,0,0,0,0,0,20,20,2172
4405,Central African Rep.,2012,2012Central African Rep.,0,0,0,0,0,261,261,0,0,0,0,0,332,332,593
4406,Central African Rep.,2012,2012Central African Rep.,0,0,0,6,0,0,6,0,0,0,0,0,0,0,6
4407,Central African Rep.,2012,2012Central African Rep.,0,0,5,0,0,0,5,0,0,0,7,0,0,7,12
4408,Central African Rep.,2012,2012Central African Rep.,0,0,7,0,0,0,7,0,8,0,0,0,0,8,15
4409,Central African Rep.,2012,2012Central African Rep.,0,0,9,0,0,0,9,0,0,0,0,0,0,0,9
4410,Central African Rep.,2012,2012Central African Rep.,0,6,0,9,0,0,15,0,0,0,8,0,0,8,23
4411,Central African Rep.,2012,2012Central African Rep.,0,6,15,26,0,0,47,0,16,7,46,0,0,69,116
4412,Central African Rep.,2012,2012Central African Rep.,5,0,0,0,0,0,5,0,0,0,0,0,0,0,10
4413,Central African Rep.,2012,2012Central African Rep.,99,219,63,432,8,0,821,121,199,81,331,7,0,739,1560
4414,Central African Rep.,2012,2012Central African Rep.,162,143,88,449,17,0,859,161,122,68,459,22,0,832,1691
4415,Central African Rep.,2012,2012Central African Rep.,3957,7490,5941,13164,933,0,31485,3919,7211,5927,9131,701,0,26889,65874
4416,Central African Rep.,2012,2012Central African Rep.,6107,12052,8531,20794,1022,0,48506,6223,12315,8340,15058,1652,0,43588,92094
4417,Central African Rep.,2013,2013Central African Rep.,0,0,0,0,0,0,0,0,0,0,0,0,0,0,265
4418,Central African Rep.,2013,2013Central African Rep.,0,0,0,0,0,0,0,0,0,0,5,0,0,5,15
4419,Central African Rep.,2013,2013Central African Rep.,0,0,0,0,0,0,0,0,0,0,11,0,0,11,64
4420,Central African Rep.,2013,2013Central African Rep.,0,0,0,0,0,5,5,0,0,0,0,0,5,5,10
4421,Central African Rep.,2013,2013Central African Rep.,0,0,0,0,0,30,30,0,0,0,0,0,27,27,2183
4422,Central African Rep.,2013,2013Central African Rep.,0,0,0,0,0,265,265,0,0,0,0,0,340,340,605
4423,Central African Rep.,2013,2013Central African Rep.,0,0,0,5,0,0,5,0,0,0,0,0,0,0,10
4424,Central African Rep.,2013,2013Central African Rep.,0,0,0,5,0,0,5,0,6,0,0,0,0,6,11
4425,Central African Rep.,2013,2013Central African Rep.,0,0,0,7,0,0,7,0,0,0,11,0,0,11,18
4426,Central African Rep.,2013,2013Central African Rep.,0,0,0,9,0,0,9,0,0,0,0,0,0,0,9
4427,Central African Rep.,2013,2013Central African Rep.,0,0,6,0,0,0,6,0,0,5,0,0,0,5,11
4428,Central African Rep.,2013,2013Central African Rep.,0,5,0,0,0,0,5,0,0,0,0,0,0,0,5
4429,Central African Rep.,2013,2013Central African Rep.,0,5,0,7,0,0,12,0,0,5,6,0,0,11,23
4430,Central African Rep.,2013,2013Central African Rep.,0,8,0,0,0,0,8,0,0,0,0,0,0,0,8
4431,Central African Rep.,2013,2013Central African Rep.,0,8,0,10,0,0,18,0,6,0,19,0,0,25,43
4432,Central African Rep.,2013,2013Central African Rep.,0,9,0,0,0,0,9,0,0,0,6,0,0,6,15
4433,Central African Rep.,2013,2013Central African Rep.,5,0,0,6,0,0,11,0,0,0,8,0,0,8,19
4434,Central African Rep.,2013,2013Central African Rep.,178,219,60,435,9,0,901,221,189,67,250,6,0,733,1634
4435,Central African Rep.,2013,2013Central African Rep.,1172,997,568,2178,88,0,5003,1054,1040,526,2413,48,0,5081,10084
4436,Central African Rep.,2013,2013Central African Rep.,5328,5635,3446,11984,970,0,27363,5306,5532,4254,10249,681,0,26022,53385
4437,Central African Rep.,2013,2013Central African Rep.,6538,10190,7169,14419,995,0,39311,6518,9738,6832,9509,706,0,33303,80545
4438,Central African Rep.,2013,2013Central African Rep.,7378,13283,9468,22550,1438,0,54117,7424,13556,9107,16039,1952,0,48078,103892
4439,Central African Rep.,2014,2014Central African Rep.,0,0,0,0,0,0,0,0,0,0,0,0,0,0,316
4440,Central African Rep.,2014,2014Central African Rep.,0,0,0,0,0,0,0,0,0,0,5,0,0,5,5
4441,Central African Rep.,2014,2014Central African Rep.,0,0,0,0,0,0,0,0,0,0,6,0,0,6,6
4442,Central African Rep.,2014,2014Central African Rep.,0,0,0,0,0,0,0,0,0,0,9,0,0,9,9
4443,Central African Rep.,2014,2014Central African Rep.,0,0,0,0,0,0,0,0,0,5,0,0,0,5,5
4444,Central African Rep.,2014,2014Central African Rep.,0,0,0,0,0,8,8,0,0,0,0,0,0,0,8
4445,Central African Rep.,2014,2014Central African Rep.,0,0,0,0,0,417,417,0,0,0,0,0,587,587,1004
4446,Central African Rep.,2014,2014Central African Rep.,0,0,0,5,0,0,5,0,0,0,0,0,0,0,5
4447,Central African Rep.,2014,2014Central African Rep.,0,0,0,5,0,0,5,0,0,0,15,0,0,15,67
4448,Central African Rep.,2014,2014Central African Rep.,0,0,0,7,0,0,7,0,0,0,7,0,0,7,14
4449,Central African Rep.,2014,2014Central African Rep.,0,0,0,8,0,0,8,0,0,0,10,0,0,10,18
4450,Central African Rep.,2014,2014Central African Rep.,0,0,0,14,0,0,14,0,0,0,26,0,0,26,40
4451,Central African Rep.,2014,2014Central African Rep.,0,0,6,0,0,0,6,0,0,5,0,0,0,5,11
4452,Central African Rep.,2014,2014Central African Rep.,5,11,9,18,0,0,43,5,8,5,16,0,0,34,77
4453,Central African Rep.,2014,2014Central African Rep.,6,29,13,931,0,1064,2043,5,24,24,955,0,1062,2070,4113
4454,Central African Rep.,2014,2014Central African Rep.,8,6,0,10,0,0,24,0,5,6,8,0,0,19,43
4455,Central African Rep.,2014,2014Central African Rep.,10,17,10,59,0,0,96,9,26,15,94,0,0,144,240
4456,Central African Rep.,2014,2014Central African Rep.,12,16,21,65,0,0,114,12,21,18,69,0,0,120,234
4457,Central African Rep.,2014,2014Central African Rep.,14,26,26,52,5,0,123,12,29,13,40,0,0,94,217
4458,Central African Rep.,2014,2014Central African Rep.,15,24,21,96,0,0,156,19,25,24,113,0,0,181,337
4459,Central African Rep.,2014,2014Central African Rep.,60,77,61,273,5,0,476,49,82,64,203,0,0,398,874
4460,Central African Rep.,2014,2014Central African Rep.,173,290,102,521,19,0,1105,205,277,101,335,17,0,935,2040
4461,Central African Rep.,2014,2014Central African Rep.,2054,2054,1175,4879,171,0,10333,1924,2004,1193,6142,99,0,11362,21695
4462,Central African Rep.,2014,2014Central African Rep.,7163,7539,4163,14428,962,0,34255,7276,7380,5265,13282,707,0,33910,68165
4463,Central African Rep.,2014,2014Central African Rep.,7656,12382,7974,19894,1322,0,49228,7759,11830,8019,13961,986,0,42555,91783
4464,Central African Rep.,2014,2014Central African Rep.,14754,28550,18667,50578,3106,0,115655,14835,28264,17498,37762,4187,0,102546,220702
4465,Central African Rep.,2015,2015Central African Rep.,0,0,0,0,0,0,0,0,0,0,0,0,0,0,382
4466,Central African Rep.,2015,2015Central African Rep.,0,0,0,0,0,0,0,0,0,0,5,0,0,5,15
4467,Central African Rep.,2015,2015Central African Rep.,0,0,0,0,0,0,0,0,0,0,8,0,0,8,8
4468,Central African Rep.,2015,2015Central African Rep.,0,0,0,0,0,5,5,0,0,0,6,0,0,6,11
4469,Central African Rep.,2015,2015Central African Rep.,0,0,0,0,0,8,8,0,0,0,0,0,23,23,31
4470,Central African Rep.,2015,2015Central African Rep.,0,0,0,0,0,724,724,0,0,0,0,0,883,883,1607
4471,Central African Rep.,2015,2015Central African Rep.,0,0,0,5,0,0,5,0,0,0,5,0,0,5,10
4472,Central African Rep.,2015,2015Central African Rep.,0,0,0,7,0,0,7,0,0,0,6,0,0,6,13
4473,Central African Rep.,2015,2015Central African Rep.,0,0,0,54,0,0,54,0,0,0,43,0,0,43,97
4474,Central African Rep.,2015,2015Central African Rep.,0,0,9,0,0,0,9,0,0,0,17,0,0,17,26
4475,Central African Rep.,2015,2015Central African Rep.,0,0,22,10,0,0,32,0,6,34,30,0,0,70,102
4476,Central African Rep.,2015,2015Central African Rep.,0,5,0,0,0,0,5,0,0,0,0,0,0,0,5
4477,Central African Rep.,2015,2015Central African Rep.,0,6,0,8,0,0,14,0,5,0,10,0,0,15,29
4478,Central African Rep.,2015,2015Central African Rep.,0,9,0,25,0,0,34,0,9,0,28,0,0,37,71
4479,Central African Rep.,2015,2015Central African Rep.,5,5,6,15,0,0,31,0,6,6,14,0,0,26,57
4480,Central African Rep.,2015,2015Central African Rep.,6,0,0,0,0,0,6,0,0,0,14,0,0,14,20
4481,Central African Rep.,2015,2015Central African Rep.,7,5,5,47,0,0,64,5,6,5,73,0,0,89,153
4482,Central African Rep.,2015,2015Central African Rep.,11,18,18,38,0,0,85,9,15,6,34,0,0,64,149
4483,Central African Rep.,2015,2015Central African Rep.,12,24,12,74,5,0,127,9,27,19,137,0,0,192,319
4484,Central African Rep.,2015,2015Central African Rep.,14,20,27,109,0,0,170,16,22,28,113,0,0,179,349
4485,Central African Rep.,2015,2015Central African Rep.,15,24,21,166,0,0,226,19,25,24,182,0,0,250,476
4486,Central African Rep.,2015,2015Central African Rep.,37,59,39,97,7,0,239,30,37,27,77,0,0,171,410
4487,Central African Rep.,2015,2015Central African Rep.,52,91,77,281,22,0,523,40,100,99,210,7,0,456,979
4488,Central African Rep.,2015,2015Central African Rep.,96,200,101,292,27,0,716,88,186,111,322,16,0,723,1439
4489,Central African Rep.,2015,2015Central African Rep.,173,271,83,472,17,0,1016,208,259,107,278,14,0,866,1882
4490,Central African Rep.,2015,2015Central African Rep.,2126,2293,1208,5664,166,0,11457,2109,2193,1105,6667,133,0,12207,23664
4491,Central African Rep.,2015,2015Central African Rep.,3830,8664,5465,14816,1282,0,34057,3871,8570,5553,10447,899,0,29340,63397
4492,Central African Rep.,2015,2015Central African Rep.,12577,13749,5838,22689,1203,0,56056,12277,13381,6579,18908,728,0,51873,107929
4493,Central African Rep.,2015,2015Central African Rep.,19410,36609,24579,57639,3495,0,141732,19654,36199,22100,43260,4518,0,125731,267463
4494,Central African Rep.,2016,2016Central African Rep.,0,0,0,0,0,0,0,0,0,0,0,0,0,0,343
4495,Central African Rep.,2016,2016Central African Rep.,0,0,0,0,0,0,0,0,0,0,5,0,0,5,15
4496,Central African Rep.,2016,2016Central African Rep.,0,0,0,0,0,0,0,0,0,0,6,0,0,6,6
4497,Central African Rep.,2016,2016Central African Rep.,0,0,0,0,0,0,0,0,0,0,8,0,5,13,13
4498,Central African Rep.,2016,2016Central African Rep.,0,0,0,0,0,0,0,0,0,0,9,0,0,9,9
4499,Central African Rep.,2016,2016Central African Rep.,0,0,0,0,0,15,15,0,0,0,0,0,26,26,41
4500,Central African Rep.,2016,2016Central African Rep.,0,0,0,0,0,1095,1095,0,0,0,0,0,1217,1217,2312
4501,Central African Rep.,2016,2016Central African Rep.,0,0,0,15,0,0,15,0,0,0,6,0,0,6,21
4502,Central African Rep.,2016,2016Central African Rep.,0,0,5,0,0,0,5,0,0,5,5,0,0,10,64
4503,Central African Rep.,2016,2016Central African Rep.,0,0,6,17,0,0,23,0,9,0,35,0,0,44,67
4504,Central African Rep.,2016,2016Central African Rep.,0,0,9,0,0,0,9,0,0,0,19,0,0,19,28
4505,Central African Rep.,2016,2016Central African Rep.,0,5,0,0,0,0,5,0,0,0,5,0,0,5,10
4506,Central African Rep.,2016,2016Central African Rep.,0,5,12,0,0,0,17,5,7,0,5,0,0,17,34
4507,Central African Rep.,2016,2016Central African Rep.,0,7,0,22,0,0,29,9,0,13,58,0,0,80,109
4508,Central African Rep.,2016,2016Central African Rep.,6,0,0,5,0,0,11,0,0,7,29,0,0,36,47
4509,Central African Rep.,2016,2016Central African Rep.,6,7,0,48,0,0,61,7,5,12,88,0,0,112,173
4510,Central African Rep.,2016,2016Central African Rep.,7,6,8,69,0,0,90,6,8,11,113,0,0,138,228
4511,Central African Rep.,2016,2016Central African Rep.,7,22,7,97,0,0,133,11,12,10,82,0,0,115,248
4512,Central African Rep.,2016,2016Central African Rep.,9,18,20,45,0,0,92,7,16,8,43,0,0,74,166
4513,Central African Rep.,2016,2016Central African Rep.,15,14,13,101,5,0,148,12,17,10,141,0,0,180,328
4514,Central African Rep.,2016,2016Central African Rep.,16,21,11,55,5,0,108,5,25,19,109,0,0,158,266
4515,Central African Rep.,2016,2016Central African Rep.,29,43,44,176,5,0,297,35,42,37,206,0,0,320,617
4516,Central African Rep.,2016,2016Central African Rep.,49,79,61,123,7,0,319,17,32,37,118,5,0,209,528
4517,Central African Rep.,2016,2016Central African Rep.,61,100,91,291,22,0,565,51,103,88,169,10,0,421,986
4518,Central African Rep.,2016,2016Central African Rep.,92,215,111,331,28,0,777,99,199,119,367,18,0,802,1579
4519,Central African Rep.,2016,2016Central African Rep.,155,271,92,464,17,0,999,200,265,112,263,14,0,854,1853
4520,Central African Rep.,2016,2016Central African Rep.,2231,2455,1280,5796,184,0,11946,2189,2351,1205,6647,136,0,12528,24474
4521,Central African Rep.,2016,2016Central African Rep.,5464,9169,5790,15845,1330,0,37598,5489,9015,5847,11353,921,0,32625,70223
4522,Central African Rep.,2016,2016Central African Rep.,12524,13802,5639,21617,1250,0,54832,12229,13420,5813,15435,760,0,47657,102489
4523,Central African Rep.,2016,2016Central African Rep.,16847,36207,24027,68682,4481,0,150244,17229,36163,23459,51030,5477,0,133358,283602
4524,Central African Rep.,2017,2017Central African Rep.,0,0,0,0,0,0,0,0,0,0,0,0,0,0,508
4525,Central African Rep.,2017,2017Central African Rep.,0,0,0,0,0,0,0,0,0,0,0,0,9,9,9
4526,Central African Rep.,2017,2017Central African Rep.,0,0,0,0,0,0,0,0,0,0,5,0,0,5,5
4527,Central African Rep.,2017,2017Central African Rep.,0,0,0,0,0,0,0,0,0,0,9,0,0,9,9
4528,Central African Rep.,2017,2017Central African Rep.,0,0,0,0,0,5,5,0,0,0,8,0,0,8,13
4529,Central African Rep.,2017,2017Central African Rep.,0,0,0,0,0,1264,1264,0,0,0,0,0,1378,1378,2642
4530,Central African Rep.,2017,2017Central African Rep.,0,0,0,5,0,0,5,0,0,0,27,0,0,27,32
4531,Central African Rep.,2017,2017Central African Rep.,0,0,0,15,0,0,15,0,0,0,6,0,0,6,21
4532,Central African Rep.,2017,2017Central African Rep.,0,0,5,0,0,0,5,0,0,5,33,0,0,38,43
4533,Central African Rep.,2017,2017Central African Rep.,0,0,6,16,0,0,22,0,8,0,35,0,0,43,65
4534,Central African Rep.,2017,2017Central African Rep.,0,5,0,0,0,0,5,0,0,0,5,0,0,5,10
4535,Central African Rep.,2017,2017Central African Rep.,0,5,8,0,0,0,13,5,5,0,15,0,0,25,38
4536,Central African Rep.,2017,2017Central African Rep.,0,6,0,13,0,0,19,0,6,6,6,0,0,18,37
4537,Central African Rep.,2017,2017Central African Rep.,0,7,0,22,0,0,29,0,8,12,58,0,0,78,107
4538,Central African Rep.,2017,2017Central African Rep.,5,0,0,0,0,0,5,0,0,0,12,0,0,12,17
4539,Central African Rep.,2017,2017Central African Rep.,5,5,7,58,0,0,75,0,7,6,79,0,0,92,167
4540,Central African Rep.,2017,2017Central African Rep.,5,7,0,56,0,0,68,11,0,15,149,0,0,175,243
4541,Central African Rep.,2017,2017Central African Rep.,8,24,14,108,5,0,159,11,14,7,98,0,0,130,289
4542,Central African Rep.,2017,2017Central African Rep.,16,13,16,109,5,0,159,12,18,5,155,0,0,190,349
4543,Central African Rep.,2017,2017Central African Rep.,20,23,14,75,5,0,137,7,24,22,142,0,0,195,332
4544,Central African Rep.,2017,2017Central African Rep.,21,47,41,105,9,0,223,18,43,32,87,0,0,180,403
4545,Central African Rep.,2017,2017Central African Rep.,33,79,54,133,9,0,308,35,49,49,109,5,0,247,555
4546,Central African Rep.,2017,2017Central African Rep.,37,52,57,242,7,0,395,48,56,54,290,5,0,453,848
4547,Central African Rep.,2017,2017Central African Rep.,47,83,74,239,12,0,455,38,84,82,142,8,0,354,809
4548,Central African Rep.,2017,2017Central African Rep.,96,274,134,485,18,0,1007,139,272,135,294,22,0,862,1869
4549,Central African Rep.,2017,2017Central African Rep.,116,282,184,491,39,0,1112,106,269,204,556,30,0,1165,2277
4550,Central African Rep.,2017,2017Central African Rep.,1751,2937,1509,6476,237,0,12910,1730,2833,1420,7321,189,0,13493,26403
4551,Central African Rep.,2017,2017Central African Rep.,5230,6591,17632,9898,1466,0,40817,5357,6656,12972,9799,1052,0,35836,76653
4552,Central African Rep.,2017,2017Central African Rep.,21716,23925,10716,38829,2522,0,97708,21233,23489,10873,26857,1757,0,84209,181917
4553,Central African Rep.,2017,2017Central African Rep.,23445,31064,16648,55588,3830,0,130575,24061,31005,16239,42506,4457,0,118268,248843
4554,Central African Rep.,2018,2018Central African Rep.,0,0,0,0,0,0,0,0,0,0,0,0,0,0,566
4555,Central African Rep.,2018,2018Central African Rep.,0,0,0,0,0,0,0,0,0,0,0,0,5,5,5
4556,Central African Rep.,2018,2018Central African Rep.,0,0,0,0,0,0,0,0,0,0,7,0,0,7,14
4557,Central African Rep.,2018,2018Central African Rep.,0,0,0,0,0,0,0,0,0,0,8,0,0,8,8
4558,Central African Rep.,2018,2018Central African Rep.,0,0,0,0,0,1426,1426,0,0,0,0,0,1536,1536,2962
4559,Central African Rep.,2018,2018Central African Rep.,0,0,0,5,0,0,5,0,0,0,5,0,5,10,15
4560,Central African Rep.,2018,2018Central African Rep.,0,0,0,5,0,0,5,0,0,0,17,0,0,17,22
4561,Central African Rep.,2018,2018Central African Rep.,0,0,0,5,0,0,5,5,0,0,27,0,0,32,37
4562,Central African Rep.,2018,2018Central African Rep.,0,0,0,9,0,0,9,0,0,0,40,0,0,40,49
4563,Central African Rep.,2018,2018Central African Rep.,0,0,0,23,0,0,23,0,0,0,0,0,0,0,23
4564,Central African Rep.,2018,2018Central African Rep.,0,0,6,14,0,0,20,0,9,0,30,0,0,39,59
4565,Central African Rep.,2018,2018Central African Rep.,0,5,0,8,0,0,13,0,10,0,15,0,0,25,38
4566,Central African Rep.,2018,2018Central African Rep.,0,6,0,13,0,0,19,0,5,7,6,0,0,18,37
4567,Central African Rep.,2018,2018Central African Rep.,0,7,0,21,0,0,28,5,5,13,66,0,0,89,117
4568,Central African Rep.,2018,2018Central African Rep.,0,8,6,69,0,0,83,0,6,8,90,0,0,104,187
4569,Central African Rep.,2018,2018Central African Rep.,5,6,6,20,0,0,37,5,9,6,16,0,0,36,73
4570,Central African Rep.,2018,2018Central African Rep.,5,9,0,95,0,0,109,7,6,10,276,0,0,299,408
4571,Central African Rep.,2018,2018Central African Rep.,8,20,21,42,5,0,96,8,10,10,49,0,0,77,173
4572,Central African Rep.,2018,2018Central African Rep.,22,13,14,111,5,0,165,13,19,20,144,0,0,196,361
4573,Central African Rep.,2018,2018Central African Rep.,22,28,29,105,6,0,190,16,33,27,196,0,0,272,462
4574,Central African Rep.,2018,2018Central African Rep.,22,49,45,115,9,0,240,22,45,32,93,0,0,192,432
4575,Central African Rep.,2018,2018Central African Rep.,35,82,59,135,10,0,321,33,46,56,102,0,0,237,558
4576,Central African Rep.,2018,2018Central African Rep.,35,88,81,256,14,0,474,36,80,86,168,10,0,380,854
4577,Central African Rep.,2018,2018Central African Rep.,36,46,52,283,8,0,425,43,61,50,336,0,0,490,915
4578,Central African Rep.,2018,2018Central African Rep.,84,267,161,516,20,0,1048,104,307,152,371,24,0,958,2006
4579,Central African Rep.,2018,2018Central African Rep.,344,609,290,985,109,0,2337,327,519,271,768,74,0,1959,6995
4580,Central African Rep.,2018,2018Central African Rep.,1426,2929,1581,6262,211,0,12409,1442,2093,1417,7147,188,0,12287,24696
4581,Central African Rep.,2018,2018Central African Rep.,8267,12962,8029,23237,1895,0,54390,8452,13101,7843,16967,1334,0,47697,102087
4582,Central African Rep.,2018,2018Central African Rep.,18732,23605,10595,37408,2300,0,92640,18601,23270,10718,25312,1470,0,79371,172011
4583,Central African Rep.,2018,2018Central African Rep.,19739,33150,21009,64594,4600,0,143092,20450,33286,20968,51546,5346,0,131596,274688
4584,Central African Rep.,2019,2019Central African Rep.,0,0,0,0,0,0,0,0,0,0,0,0,0,0,656
4585,Central African Rep.,2019,2019Central African Rep.,0,0,0,0,0,0,0,0,0,0,5,0,0,5,15
4586,Central African Rep.,2019,2019Central African Rep.,0,0,0,0,0,0,0,0,0,0,7,0,0,7,7
4587,Central African Rep.,2019,2019Central African Rep.,0,0,0,0,0,0,0,0,0,0,8,0,0,8,8
4588,Central African Rep.,2019,2019Central African Rep.,0,0,0,0,0,0,0,0,0,0,9,0,0,9,9
4589,Central African Rep.,2019,2019Central African Rep.,0,0,0,0,0,0,0,0,0,5,0,0,0,5,5
4590,Central African Rep.,2019,2019Central African Rep.,0,0,0,0,0,0,0,0,5,0,11,0,0,16,16
4591,Central African Rep.,2019,2019Central African Rep.,0,0,0,0,0,1687,1687,0,0,0,0,0,1732,1732,3419
4592,Central African Rep.,2019,2019Central African Rep.,0,0,0,5,0,0,5,0,0,0,5,0,0,5,16
4593,Central African Rep.,2019,2019Central African Rep.,0,0,0,5,0,0,5,0,0,0,32,0,0,32,37
4594,Central African Rep.,2019,2019Central African Rep.,0,0,0,8,0,0,8,5,0,0,27,0,0,32,40
4595,Central African Rep.,2019,2019Central African Rep.,0,0,7,0,0,0,7,0,0,0,0,0,0,0,7
4596,Central African Rep.,2019,2019Central African Rep.,0,0,9,11,0,0,20,7,5,0,0,0,0,12,32
4597,Central African Rep.,2019,2019Central African Rep.,0,5,0,5,0,0,10,7,0,0,50,0,0,57,67
4598,Central African Rep.,2019,2019Central African Rep.,0,6,0,13,0,0,19,0,5,7,6,0,0,18,37
4599,Central African Rep.,2019,2019Central African Rep.,0,6,7,77,0,0,90,0,6,7,91,0,0,104,194
4600,Central African Rep.,2019,2019Central African Rep.,0,11,0,25,0,0,36,5,6,6,66,0,0,83,119
4601,Central African Rep.,2019,2019Central African Rep.,5,17,7,38,0,0,67,6,10,10,52,0,0,78,145
4602,Central African Rep.,2019,2019Central African Rep.,10,14,13,76,5,0,118,9,15,5,89,0,0,118,236
4603,Central African Rep.,2019,2019Central African Rep.,12,6,0,136,0,0,154,8,7,13,378,0,0,406,560
4604,Central African Rep.,2019,2019Central African Rep.,12,19,26,69,5,0,131,11,13,15,58,0,0,97,228
4605,Central African Rep.,2019,2019Central African Rep.,12,45,53,133,11,0,254,12,48,36,110,0,0,206,460
4606,Central African Rep.,2019,2019Central African Rep.,19,39,32,123,6,0,219,14,31,35,226,0,0,306,525
4607,Central African Rep.,2019,2019Central African Rep.,28,47,51,311,6,0,443,33,60,55,362,0,0,510,953
4608,Central African Rep.,2019,2019Central African Rep.,28,104,94,302,20,0,548,33,93,93,193,11,0,423,971
4609,Central African Rep.,2019,2019Central African Rep.,39,90,64,155,10,0,358,35,51,56,122,0,0,264,622
4610,Central African Rep.,2019,2019Central African Rep.,49,309,169,529,21,0,1077,71,351,157,401,24,0,1004,2081
4611,Central African Rep.,2019,2019Central African Rep.,1022,1729,1053,3768,127,0,7699,766,1395,1034,3980,140,0,7315,15014
4612,Central African Rep.,2019,2019Central African Rep.,2019,3608,1812,6009,689,0,14137,1946,3334,1700,4380,464,0,11824,25961
4613,Central African Rep.,2019,2019Central African Rep.,7548,11989,7490,21717,1692,0,50436,7814,12126,7260,14908,1167,0,43275,93711
4614,Central African Rep.,2019,2019Central African Rep.,15120,24760,11993,37221,2458,0,91552,14867,24365,12136,26641,1673,0,79682,171234
4615,Central African Rep.,2019,2019Central African Rep.,21622,35823,22042,67780,4799,0,152066,22382,35998,21874,55047,5400,0,140701,292767
4616,Central African Rep.,2020,2020Central African Rep.,0,0,0,0,0,0,0,0,0,0,0,0,0,0,4210
4617,Central African Rep.,2020,2020Central African Rep.,0,0,0,0,0,0,0,0,0,0,5,0,0,5,20
4618,Central African Rep.,2020,2020Central African Rep.,0,0,0,0,0,0,0,0,0,0,9,0,0,9,9
4619,Central African Rep.,2020,2020Central African Rep.,0,0,0,0,0,0,0,0,0,0,10,0,0,10,10
4620,Central African Rep.,2020,2020Central African Rep.,0,0,0,0,0,0,0,0,0,5,0,0,0,5,5
4621,Central African Rep.,2020,2020Central African Rep.,0,0,0,0,0,0,0,0,5,0,14,0,0,19,19
4622,Central African Rep.,2020,2020Central African Rep.,0,0,0,0,0,21,21,0,0,0,0,0,41,41,62
4623,Central African Rep.,2020,2020Central African Rep.,0,0,0,5,0,0,5,0,0,0,35,0,0,35,40
4624,Central African Rep.,2020,2020Central African Rep.,0,0,0,6,0,0,6,0,0,0,5,0,0,5,19
4625,Central African Rep.,2020,2020Central African Rep.,0,0,5,8,0,0,13,5,0,0,30,0,0,35,48
4626,Central African Rep.,2020,2020Central African Rep.,0,0,7,0,0,0,7,0,0,0,0,0,0,0,7
4627,Central African Rep.,2020,2020Central African Rep.,0,6,0,13,0,0,19,0,9,0,12,0,0,21,40
4628,Central African Rep.,2020,2020Central African Rep.,0,7,0,8,0,0,15,7,0,5,54,0,0,66,81
4629,Central African Rep.,2020,2020Central African Rep.,0,8,8,75,0,0,91,0,6,8,88,0,0,102,193
4630,Central African Rep.,2020,2020Central African Rep.,0,9,0,10,0,0,19,6,5,0,0,0,0,11,30
4631,Central African Rep.,2020,2020Central African Rep.,0,10,5,43,0,0,58,5,7,8,91,0,0,111,169
4632,Central African Rep.,2020,2020Central African Rep.,5,15,9,40,0,0,69,5,14,9,62,0,0,90,159
4633,Central African Rep.,2020,2020Central African Rep.,5,17,15,50,5,0,92,9,8,12,34,0,0,63,155
4634,Central African Rep.,2020,2020Central African Rep.,12,16,12,75,6,0,121,10,17,6,88,0,0,121,242
4635,Central African Rep.,2020,2020Central African Rep.,12,37,34,125,6,0,214,11,29,35,236,0,0,311,525
4636,Central African Rep.,2020,2020Central African Rep.,13,0,5,140,0,0,158,10,8,7,402,0,0,427,585
4637,Central African Rep.,2020,2020Central African Rep.,24,70,82,222,13,0,411,23,72,54,151,0,0,300,711
4638,Central African Rep.,2020,2020Central African Rep.,26,55,45,348,12,0,486,35,59,64,406,0,0,564,1050
4639,Central African Rep.,2020,2020Central African Rep.,27,101,93,292,20,0,533,33,92,92,186,9,0,412,945
4640,Central African Rep.,2020,2020Central African Rep.,31,305,198,556,21,0,1111,45,367,182,404,26,0,1024,2135
4641,Central African Rep.,2020,2020Central African Rep.,39,89,66,165,10,0,369,28,59,58,125,5,0,275,644
4642,Central African Rep.,2020,2020Central African Rep.,1312,1807,1137,4000,141,0,8397,1076,1493,1079,4183,150,0,7981,16378
4643,Central African Rep.,2020,2020Central African Rep.,2480,4101,1980,5923,830,0,15314,2472,3561,1712,3340,529,0,11614,26928
4644,Central African Rep.,2020,2020Central African Rep.,7187,12030,8143,22867,1863,0,52090,7382,12284,7857,15945,1325,0,44793,96883
4645,Central African Rep.,2020,2020Central African Rep.,15365,25212,12383,37680,2531,0,93171,15121,24739,12470,26504,1726,0,80560,173731
4646,Central African Rep.,2020,2020Central African Rep.,22051,39687,23910,73248,5329,0,164225,22962,39845,23584,59623,5889,0,151903,316128
4647,Central African Rep.,2021,2021Central African Rep.,0,0,0,0,0,0,0,0,0,0,0,0,0,0,5596
4648,Central African Rep.,2021,2021Central African Rep.,0,0,0,0,0,0,0,0,0,0,5,0,0,5,68
4649,Central African Rep.,2021,2021Central African Rep.,0,0,0,0,0,0,0,0,0,0,7,0,0,7,7
4650,Central African Rep.,2021,2021Central African Rep.,0,0,0,0,0,0,0,0,0,0,9,0,0,9,9
4651,Central African Rep.,2021,2021Central African Rep.,0,0,0,0,0,0,0,0,0,0,16,0,0,16,16
4652,Central African Rep.,2021,2021Central African Rep.,0,0,0,0,0,0,0,0,0,5,0,0,0,5,5
4653,Central African Rep.,2021,2021Central African Rep.,0,0,0,0,0,0,0,0,5,0,14,0,0,19,19
4654,Central African Rep.,2021,2021Central African Rep.,0,0,0,5,0,0,5,0,0,0,0,0,0,0,5
4655,Central African Rep.,2021,2021Central African Rep.,0,0,0,5,0,0,5,0,0,0,7,0,0,7,19
4656,Central African Rep.,2021,2021Central African Rep.,0,0,0,6,0,0,6,0,0,5,34,0,0,39,45
4657,Central African Rep.,2021,2021Central African Rep.,0,0,8,0,0,0,8,0,0,0,0,0,0,0,8
4658,Central African Rep.,2021,2021Central African Rep.,0,5,0,11,0,0,16,0,0,9,5,0,0,14,30
4659,Central African Rep.,2021,2021Central African Rep.,0,5,8,10,0,0,23,0,6,0,0,0,0,6,29
4660,Central African Rep.,2021,2021Central African Rep.,0,5,12,40,0,0,57,0,9,9,74,0,0,92,149
4661,Central African Rep.,2021,2021Central African Rep.,0,6,9,72,0,0,87,0,0,9,91,0,0,100,187
4662,Central African Rep.,2021,2021Central African Rep.,0,8,0,12,0,0,20,9,0,5,69,0,0,83,103
4663,Central African Rep.,2021,2021Central African Rep.,5,0,0,7,0,0,12,0,5,0,34,0,0,39,51
4664,Central African Rep.,2021,2021Central African Rep.,5,11,10,36,0,0,62,6,21,8,45,0,0,80,142
4665,Central African Rep.,2021,2021Central African Rep.,6,18,15,71,5,0,115,8,8,13,76,0,0,105,220
4666,Central African Rep.,2021,2021Central African Rep.,11,5,5,139,0,0,160,12,9,6,407,0,0,434,594
4667,Central African Rep.,2021,2021Central African Rep.,11,16,11,81,5,0,124,10,18,6,93,0,0,127,251
4668,Central African Rep.,2021,2021Central African Rep.,20,37,31,137,7,0,232,10,30,28,250,0,0,318,550
4669,Central African Rep.,2021,2021Central African Rep.,22,61,50,370,12,0,515,27,74,68,438,0,0,607,1122
4670,Central African Rep.,2021,2021Central African Rep.,23,97,90,380,33,0,623,22,86,116,279,10,0,513,1136
4671,Central African Rep.,2021,2021Central African Rep.,29,91,72,258,19,0,469,36,80,69,174,0,0,359,828
4672,Central African Rep.,2021,2021Central African Rep.,34,89,63,176,10,0,372,25,56,54,141,5,0,281,653
4673,Central African Rep.,2021,2021Central African Rep.,88,284,237,630,27,0,1266,86,349,231,492,33,0,1191,2457
4674,Central African Rep.,2021,2021Central African Rep.,1533,3020,1754,6582,268,0,13157,1588,2813,1604,6509,247,0,12761,25918
4675,Central African Rep.,2021,2021Central African Rep.,2101,4293,2112,6306,872,0,15684,2020,3931,1815,3612,551,0,11929,27613
4676,Central African Rep.,2021,2021Central African Rep.,8488,15148,9530,28336,2293,0,63795,8622,15223,9239,19992,1539,0,54615,123320
4677,Central African Rep.,2021,2021Central African Rep.,16509,30193,16759,46853,3333,0,113647,15787,29749,16330,34740,2377,0,98983,212630
4678,Central African Rep.,2021,2021Central African Rep.,21163,42501,26321,78556,5654,0,174195,22008,42682,25750,63019,6224,0,159683,333878
4679,Chad,2001,2001Chad,0,0,0,0,0,0,0,0,0,0,0,0,0,0,40142
4680,Chad,2001,2001Chad,0,0,0,0,0,0,0,0,0,0,0,0,9,9,23
4681,Chad,2001,2001Chad,0,0,0,0,0,0,0,0,0,0,5,0,0,5,5
4682,Chad,2001,2001Chad,0,0,0,0,0,0,0,0,0,0,6,0,0,6,6
4683,Chad,2001,2001Chad,0,0,0,0,0,0,0,0,0,0,7,0,0,7,7
4684,Chad,2001,2001Chad,0,0,0,0,0,9,9,0,0,0,0,0,12,12,21
4685,Chad,2001,2001Chad,0,0,0,0,0,93,93,0,0,0,0,0,230,230,323
4686,Chad,2001,2001Chad,0,0,0,5,0,0,5,0,0,0,8,0,0,8,13
4687,Chad,2001,2001Chad,0,0,5,6,0,0,11,0,0,5,15,0,0,20,31
4688,Chad,2001,2001Chad,0,0,7,0,0,0,7,0,0,0,0,0,0,0,7
4689,Chad,2001,2001Chad,0,7,0,0,0,0,7,0,0,0,0,0,0,0,7
4690,Chad,2001,2001Chad,0,7,0,9,0,0,16,0,8,7,12,0,0,27,189
4691,Chad,2001,2001Chad,8,0,0,0,0,0,8,0,5,0,15,0,0,20,28
4692,Chad,2001,2001Chad,8,16,21,58,0,0,103,6,46,32,240,0,0,324,427
4693,Chad,2001,2001Chad,12,14,12,61,0,0,99,14,13,11,56,0,0,94,3193
4694,Chad,2001,2001Chad,113,185,164,378,0,0,840,128,231,202,459,0,0,1020,1860
4695,Chad,2002,2002Chad,0,0,0,0,0,0,0,0,0,0,0,0,0,0,40108
4696,Chad,2002,2002Chad,0,0,0,0,0,0,0,0,0,0,5,0,0,5,5
4697,Chad,2002,2002Chad,0,0,0,0,0,0,0,0,0,0,8,0,0,8,8
4698,Chad,2002,2002Chad,0,0,0,0,0,13,13,0,0,0,0,0,7,7,25
4699,Chad,2002,2002Chad,0,0,0,0,0,97,97,0,0,0,0,0,283,283,380
4700,Chad,2002,2002Chad,0,0,0,5,0,0,5,0,0,0,7,0,0,7,12
4701,Chad,2002,2002Chad,0,0,0,8,0,0,8,0,0,5,13,0,0,18,26
4702,Chad,2002,2002Chad,0,0,7,0,0,0,7,0,0,0,0,0,0,0,7
4703,Chad,2002,2002Chad,5,0,0,0,0,0,5,0,0,0,0,0,0,0,5
4704,Chad,2002,2002Chad,8,0,0,0,0,0,8,0,5,0,16,0,0,21,29
4705,Chad,2002,2002Chad,9,17,22,61,0,0,109,7,46,32,261,0,0,346,455
4706,Chad,2002,2002Chad,10,13,12,26,5,0,66,10,13,12,35,5,0,75,141
4707,Chad,2002,2002Chad,10,13,12,64,0,0,99,11,13,12,59,0,0,95,3194
4708,Chad,2002,2002Chad,50,86,66,173,5,0,380,50,75,66,463,19,0,673,1053
4709,Chad,2002,2002Chad,133,177,145,330,0,0,785,99,263,231,514,0,0,1107,1892
4710,Chad,2003,2003Chad,0,0,0,0,0,0,0,0,0,0,0,0,0,0,45194
4711,Chad,2003,2003Chad,0,0,0,0,0,0,0,0,0,0,8,0,0,8,8
4712,Chad,2003,2003Chad,0,0,0,0,0,0,0,0,0,7,0,0,0,7,7
4713,Chad,2003,2003Chad,0,0,0,0,0,0,0,0,9,0,0,0,0,9,9
4714,Chad,2003,2003Chad,0,0,0,0,0,0,0,5,0,0,0,0,0,5,5
4715,Chad,2003,2003Chad,0,0,0,0,0,12,12,0,0,0,0,0,8,8,25
4716,Chad,2003,2003Chad,0,0,0,0,0,117,117,0,0,0,0,0,401,401,518
4717,Chad,2003,2003Chad,0,0,0,5,0,0,5,0,0,0,7,0,0,7,12
4718,Chad,2003,2003Chad,0,0,0,8,0,0,8,0,0,5,14,0,0,19,27
4719,Chad,2003,2003Chad,0,0,6,5,0,0,11,5,0,0,46,0,0,51,62
4720,Chad,2003,2003Chad,0,8,0,10,0,0,18,0,6,0,14,0,0,20,38
4721,Chad,2003,2003Chad,9,22,20,64,0,0,115,7,46,32,266,0,0,351,466
4722,Chad,2003,2003Chad,10,13,12,64,0,0,99,11,13,11,59,0,0,94,3193
4723,Chad,2003,2003Chad,15,15,12,24,5,0,71,10,15,12,38,5,0,80,151
4724,Chad,2003,2003Chad,66,122,99,237,0,0,524,90,148,132,347,0,0,717,1241
4725,Chad,2003,2003Chad,69,99,92,218,7,0,485,55,83,80,579,30,0,827,1312
4726,Chad,2004,2004Chad,0,0,0,0,0,0,0,0,0,0,0,0,0,0,45743
4727,Chad,2004,2004Chad,0,0,0,0,0,0,0,0,0,0,5,0,0,5,5
4728,Chad,2004,2004Chad,0,0,0,0,0,0,0,0,0,0,7,0,0,7,7
4729,Chad,2004,2004Chad,0,0,0,0,0,0,0,0,9,0,0,0,0,9,9
4730,Chad,2004,2004Chad,0,0,0,0,0,0,0,5,0,0,0,0,0,5,5
4731,Chad,2004,2004Chad,0,0,0,0,0,21,21,0,0,0,0,0,10,10,31
4732,Chad,2004,2004Chad,0,0,0,5,0,0,5,0,0,0,5,0,0,5,20
4733,Chad,2004,2004Chad,0,0,0,5,0,0,5,0,0,0,7,0,0,7,12
4734,Chad,2004,2004Chad,0,0,0,9,0,0,9,0,0,0,20,0,0,20,29
4735,Chad,2004,2004Chad,0,0,6,5,0,0,11,5,0,0,46,0,0,51,62
4736,Chad,2004,2004Chad,0,8,0,10,0,0,18,0,6,0,16,0,0,22,40
4737,Chad,2004,2004Chad,9,18,18,47,0,0,92,6,32,33,246,0,0,317,409
4738,Chad,2004,2004Chad,10,13,12,54,0,0,89,11,13,11,71,0,0,106,3195
4739,Chad,2004,2004Chad,16,15,12,24,5,0,72,10,15,12,39,5,0,81,153
4740,Chad,2004,2004Chad,34,80,75,192,7,0,388,43,89,76,584,36,0,828,1216
4741,Chad,2004,2004Chad,80,161,138,401,0,0,780,128,192,164,440,5,0,929,1709
4742,Chad,2005,2005Chad,0,0,0,0,0,0,0,0,0,0,0,0,0,0,44977
4743,Chad,2005,2005Chad,0,0,0,0,0,0,0,0,0,0,7,0,0,7,90
4744,Chad,2005,2005Chad,0,0,0,0,0,0,0,0,9,0,0,0,0,9,9
4745,Chad,2005,2005Chad,0,0,0,0,0,0,0,5,0,0,0,0,0,5,5
4746,Chad,2005,2005Chad,0,0,0,0,0,22,22,0,0,0,0,0,10,10,32
4747,Chad,2005,2005Chad,0,0,0,0,0,164,164,0,0,0,0,0,559,559,723
4748,Chad,2005,2005Chad,0,0,0,5,0,0,5,0,0,0,5,0,0,5,10
4749,Chad,2005,2005Chad,0,0,6,5,0,0,11,5,0,0,46,0,0,51,62
4750,Chad,2005,2005Chad,0,5,0,0,0,0,5,0,0,0,7,0,0,7,12
4751,Chad,2005,2005Chad,0,5,0,5,0,0,10,0,0,0,19,0,0,19,29
4752,Chad,2005,2005Chad,0,8,0,10,0,0,18,0,6,0,17,0,0,23,41
4753,Chad,2005,2005Chad,5,0,0,15,0,0,20,0,8,0,33,0,0,41,61
4754,Chad,2005,2005Chad,8,20,18,25,0,0,71,5,10,9,57,0,0,81,152
4755,Chad,2005,2005Chad,10,9,13,45,0,0,77,6,28,24,235,0,0,293,370
4756,Chad,2005,2005Chad,14,11,9,22,0,0,56,7,11,9,37,0,0,64,120
4757,Chad,2005,2005Chad,28,80,68,301,0,0,477,43,46,39,212,5,0,345,822
4758,Chad,2005,2005Chad,44,63,55,144,7,0,313,43,55,41,405,17,0,561,874
4759,Chad,2006,2006Chad,0,0,0,0,0,0,0,0,0,0,0,0,0,0,797
4760,Chad,2006,2006Chad,0,0,0,0,0,0,0,0,0,0,0,0,19,19,19
4761,Chad,2006,2006Chad,0,0,0,0,0,0,0,0,0,0,5,0,0,5,5
4762,Chad,2006,2006Chad,0,0,0,0,0,0,0,0,0,0,7,0,0,7,93
4763,Chad,2006,2006Chad,0,0,0,0,0,0,0,0,0,0,9,0,0,9,9
4764,Chad,2006,2006Chad,0,0,0,0,0,24,24,0,0,0,0,0,12,12,36
4765,Chad,2006,2006Chad,0,0,0,0,0,174,174,0,0,0,0,0,600,600,774
4766,Chad,2006,2006Chad,0,0,0,0,0,12512,12512,0,0,0,0,0,12511,12511,25023
4767,Chad,2006,2006Chad,0,0,0,5,0,0,5,0,0,0,6,0,0,6,11
4768,Chad,2006,2006Chad,0,0,0,6,0,0,6,0,0,0,10,0,0,10,16
4769,Chad,2006,2006Chad,0,0,0,8,0,0,8,0,0,0,0,0,0,0,16
4770,Chad,2006,2006Chad,0,0,0,9,0,0,9,0,0,0,16,0,0,16,25
4771,Chad,2006,2006Chad,0,0,6,5,0,0,11,5,0,0,27,0,0,32,43
4772,Chad,2006,2006Chad,0,8,0,10,0,0,18,0,0,6,18,0,0,24,42
4773,Chad,2006,2006Chad,0,11,17,35,0,0,63,8,8,9,44,0,0,69,132
4774,Chad,2006,2006Chad,6,0,0,10,0,0,16,0,0,8,38,0,0,46,62
4775,Chad,2006,2006Chad,6,9,5,11,0,0,31,5,12,5,48,0,0,70,101
4776,Chad,2006,2006Chad,7,0,38,25,0,0,70,5,18,0,59,0,0,82,152
4777,Chad,2006,2006Chad,28,66,77,171,5,0,347,35,69,35,402,17,0,558,905
4778,Chad,2006,2006Chad,28,88,60,301,0,0,477,43,52,33,320,5,0,453,930
4779,Chad,2006,2006Chad,73,213,511,2118,30,0,2945,78,222,642,3127,81,0,4150,7095
4780,Chad,2007,2007Chad,0,0,0,0,0,0,0,0,0,0,0,0,0,0,1166
4781,Chad,2007,2007Chad,0,0,0,0,0,0,0,0,0,0,0,0,7,7,7
4782,Chad,2007,2007Chad,0,0,0,0,0,0,0,0,0,0,5,0,0,5,5
4783,Chad,2007,2007Chad,0,0,0,0,0,0,0,0,0,5,7,0,0,12,12
4784,Chad,2007,2007Chad,0,0,0,0,0,7,7,0,0,0,0,0,25,25,32
4785,Chad,2007,2007Chad,0,0,0,0,0,190,190,0,0,0,0,0,637,637,827
4786,Chad,2007,2007Chad,0,0,0,0,0,22514,22514,0,0,0,0,0,22510,22510,45024
4787,Chad,2007,2007Chad,0,0,0,5,0,0,5,0,0,0,6,0,0,6,11
4788,Chad,2007,2007Chad,0,0,0,5,0,21,26,0,0,0,5,0,10,15,41
4789,Chad,2007,2007Chad,0,0,0,8,0,0,8,0,0,0,0,0,0,0,16
4790,Chad,2007,2007Chad,0,0,0,9,0,0,9,0,0,0,16,0,0,16,25
4791,Chad,2007,2007Chad,0,0,0,13,0,0,13,0,0,0,44,0,0,44,57
4792,Chad,2007,2007Chad,0,5,7,25,0,0,37,0,0,17,36,0,0,53,90
4793,Chad,2007,2007Chad,0,8,0,10,0,0,18,0,0,6,18,0,0,24,42
4794,Chad,2007,2007Chad,0,13,15,33,5,0,66,5,8,11,37,5,0,66,132
4795,Chad,2007,2007Chad,6,7,8,35,0,0,56,6,17,9,78,0,0,110,166
4796,Chad,2007,2007Chad,9,75,52,168,7,0,311,24,78,36,420,28,0,586,897
4797,Chad,2007,2007Chad,11,18,22,26,0,0,77,5,8,8,57,0,0,78,155
4798,Chad,2007,2007Chad,28,88,61,301,0,0,478,43,52,33,407,5,0,540,1018
4799,Chad,2007,2007Chad,79,171,414,1763,28,0,2455,82,189,472,2712,64,0,3519,5974
4800,Chad,2008,2008Chad,0,0,0,0,0,0,0,0,0,0,0,0,0,0,1286
4801,Chad,2008,2008Chad,0,0,0,0,0,0,0,0,0,0,5,0,0,5,15
4802,Chad,2008,2008Chad,0,0,0,0,0,0,0,0,0,0,7,0,0,7,7
4803,Chad,2008,2008Chad,0,0,0,0,0,0,0,0,0,9,0,0,0,9,9
4804,Chad,2008,2008Chad,0,0,0,0,0,11,11,0,0,0,0,0,24,24,35
4805,Chad,2008,2008Chad,0,0,0,0,0,210,210,0,0,0,0,0,682,682,892
4806,Chad,2008,2008Chad,0,0,0,5,0,0,5,0,0,0,10,0,0,10,15
4807,Chad,2008,2008Chad,0,0,0,5,0,0,5,0,0,0,11,0,0,11,16
4808,Chad,2008,2008Chad,0,0,0,5,0,22,27,0,0,0,5,0,9,14,41
4809,Chad,2008,2008Chad,0,0,8,28,0,0,36,0,0,12,41,0,0,53,89
4810,Chad,2008,2008Chad,0,5,0,6,0,0,11,0,0,0,16,0,0,16,27
4811,Chad,2008,2008Chad,0,8,0,0,0,0,8,0,0,0,0,0,0,0,8
4812,Chad,2008,2008Chad,0,8,0,10,0,0,18,0,0,6,18,0,0,24,42
4813,Chad,2008,2008Chad,5,10,11,36,5,0,67,5,10,9,41,5,0,70,137
4814,Chad,2008,2008Chad,6,6,0,11,0,0,23,0,8,5,76,0,0,89,112
4815,Chad,2008,2008Chad,9,7,10,33,0,0,59,12,19,9,111,0,0,151,210
4816,Chad,2008,2008Chad,11,18,23,29,0,0,81,7,8,8,64,0,0,87,168
4817,Chad,2008,2008Chad,18,75,53,184,6,0,336,10,78,34,446,36,0,604,940
4818,Chad,2008,2008Chad,28,88,60,235,0,0,411,43,52,33,515,5,0,648,1059
4819,Chad,2008,2008Chad,486,608,474,2217,116,0,3901,501,585,485,3206,95,0,4872,8773
4820,Chad,2008,2008Chad,1176,0,1054,1635,335,16912,21112,1057,0,1110,834,179,16910,20090,41202
4821,Chad,2009,2009Chad,0,0,0,0,0,0,0,0,0,0,0,0,0,0,2203
4822,Chad,2009,2009Chad,0,0,0,0,0,0,0,0,0,0,5,0,0,5,15
4823,Chad,2009,2009Chad,0,0,0,0,0,0,0,0,0,0,7,0,0,7,7
4824,Chad,2009,2009Chad,0,0,0,0,0,0,0,0,0,5,0,0,0,5,5
4825,Chad,2009,2009Chad,0,0,0,0,0,0,0,0,0,7,0,0,0,7,7
4826,Chad,2009,2009Chad,0,0,0,0,0,12,12,0,0,0,0,0,27,27,39
4827,Chad,2009,2009Chad,0,0,0,0,0,33,33,0,0,0,0,0,99,99,132
4828,Chad,2009,2009Chad,0,0,0,5,0,0,5,0,0,0,11,0,0,11,16
4829,Chad,2009,2009Chad,0,0,0,5,0,24,29,0,0,0,5,0,11,16,45
4830,Chad,2009,2009Chad,0,0,0,11,0,0,11,0,0,0,14,0,0,14,25
4831,Chad,2009,2009Chad,0,0,0,17,0,0,17,0,0,5,29,0,0,34,51
4832,Chad,2009,2009Chad,0,5,0,5,0,0,10,0,0,5,6,0,0,11,21
4833,Chad,2009,2009Chad,0,7,0,10,0,0,17,0,0,0,22,0,0,22,39
4834,Chad,2009,2009Chad,0,8,0,0,0,0,8,0,0,8,0,0,0,8,16
4835,Chad,2009,2009Chad,0,8,0,10,0,0,18,0,0,6,18,0,0,24,42
4836,Chad,2009,2009Chad,5,10,12,39,0,0,66,9,10,70,18,5,0,112,178
4837,Chad,2009,2009Chad,5,15,11,31,5,0,67,5,10,9,40,5,0,69,136
4838,Chad,2009,2009Chad,10,8,11,34,0,0,63,14,20,9,109,0,0,152,215
4839,Chad,2009,2009Chad,11,18,23,31,0,0,83,7,8,8,64,0,0,87,170
4840,Chad,2009,2009Chad,17,73,59,186,6,0,341,17,72,41,447,36,0,613,954
4841,Chad,2009,2009Chad,28,88,129,270,0,0,515,43,52,53,533,5,0,686,1201
4842,Chad,2009,2009Chad,240,182,21,328,62,3157,3990,219,190,24,170,32,3145,3780,41138
4843,Chad,2009,2009Chad,411,625,407,2165,118,0,3726,440,580,400,3071,125,0,4616,8342
4844,Chad,2010,2010Chad,0,0,0,0,0,0,0,0,0,0,0,0,0,0,1184
4845,Chad,2010,2010Chad,0,0,0,0,0,0,0,0,0,0,0,0,7,7,7
4846,Chad,2010,2010Chad,0,0,0,0,0,0,0,0,0,0,5,0,0,5,20
4847,Chad,2010,2010Chad,0,0,0,0,0,0,0,0,0,7,0,0,0,7,7
4848,Chad,2010,2010Chad,0,0,0,0,0,15,15,0,0,0,0,0,34,34,49
4849,Chad,2010,2010Chad,0,0,0,0,0,39,39,0,0,0,0,0,109,109,148
4850,Chad,2010,2010Chad,0,0,0,0,0,269,269,0,0,0,0,0,757,757,1026
4851,Chad,2010,2010Chad,0,0,0,5,0,0,5,0,0,6,11,0,0,17,22
4852,Chad,2010,2010Chad,0,0,0,5,0,25,30,0,0,0,0,0,16,16,46
4853,Chad,2010,2010Chad,0,0,0,10,0,0,10,0,0,0,12,0,0,12,22
4854,Chad,2010,2010Chad,0,0,5,5,0,0,10,0,5,0,0,0,0,5,15
4855,Chad,2010,2010Chad,0,5,0,5,0,0,10,0,5,0,5,0,0,10,20
4856,Chad,2010,2010Chad,0,7,0,9,0,0,16,0,0,5,19,0,0,24,40
4857,Chad,2010,2010Chad,0,7,0,16,0,0,23,0,5,0,25,0,0,30,53
4858,Chad,2010,2010Chad,0,8,0,0,0,0,8,0,0,0,8,0,0,8,47
4859,Chad,2010,2010Chad,0,8,0,10,0,0,18,0,6,0,22,0,0,28,46
4860,Chad,2010,2010Chad,5,6,17,34,5,0,67,5,8,6,48,6,0,73,140
4861,Chad,2010,2010Chad,5,10,12,39,0,0,66,9,10,70,18,5,0,112,178
4862,Chad,2010,2010Chad,10,8,11,34,0,0,63,14,20,9,108,0,0,151,214
4863,Chad,2010,2010Chad,11,18,23,33,0,0,85,7,8,8,62,0,0,85,170
4864,Chad,2010,2010Chad,12,63,65,208,6,0,354,13,88,45,445,46,0,637,991
4865,Chad,2010,2010Chad,28,88,129,269,0,0,514,43,52,53,531,5,0,684,1198
4866,Chad,2010,2010Chad,156,172,90,316,57,3021,3812,139,163,94,179,26,3015,3616,39578
4867,Chad,2010,2010Chad,420,622,404,2229,121,0,3796,436,588,391,3151,130,0,4696,8492
4868,Chad,2011,2011Chad,0,0,0,0,0,0,0,0,0,0,0,0,0,0,821
4869,Chad,2011,2011Chad,0,0,0,0,0,0,0,0,0,0,5,0,0,5,10
4870,Chad,2011,2011Chad,0,0,0,0,0,0,0,0,0,6,0,0,0,6,6
4871,Chad,2011,2011Chad,0,0,0,0,0,0,0,0,0,7,0,0,0,7,7
4872,Chad,2011,2011Chad,0,0,0,0,0,16,16,0,0,0,0,0,35,35,51
4873,Chad,2011,2011Chad,0,0,0,0,0,27,27,0,0,0,0,0,16,16,43
4874,Chad,2011,2011Chad,0,0,0,0,0,283,283,0,0,0,0,0,807,807,1090
4875,Chad,2011,2011Chad,0,0,0,5,0,0,5,0,0,5,9,0,0,14,19
4876,Chad,2011,2011Chad,0,0,0,10,0,0,10,0,0,0,12,0,0,12,22
4877,Chad,2011,2011Chad,0,0,5,5,0,0,10,0,0,0,6,0,0,6,16
4878,Chad,2011,2011Chad,0,0,6,9,0,0,15,0,0,5,20,5,0,30,45
4879,Chad,2011,2011Chad,0,0,6,16,0,0,22,5,0,0,24,0,0,29,51
4880,Chad,2011,2011Chad,0,5,0,0,0,0,5,0,0,0,0,0,0,0,90
4881,Chad,2011,2011Chad,0,6,0,0,0,0,6,0,0,5,7,0,0,12,18
4882,Chad,2011,2011Chad,0,8,0,0,0,0,8,0,0,0,8,0,0,8,16
4883,Chad,2011,2011Chad,0,8,0,10,0,0,18,0,6,0,22,0,0,28,46
4884,Chad,2011,2011Chad,0,8,0,18,0,0,26,0,6,0,25,0,0,31,568
4885,Chad,2011,2011Chad,0,10,15,38,5,0,68,8,16,10,65,12,0,111,179
4886,Chad,2011,2011Chad,5,0,0,0,0,0,5,0,0,0,0,0,0,0,5
4887,Chad,2011,2011Chad,5,5,17,33,5,0,65,5,8,6,49,6,0,74,139
4888,Chad,2011,2011Chad,9,55,70,215,12,0,361,6,69,52,451,57,0,635,996
4889,Chad,2011,2011Chad,10,8,11,35,0,0,64,14,20,9,107,0,0,150,214
4890,Chad,2011,2011Chad,13,20,24,35,0,0,92,8,9,9,66,0,0,92,184
4891,Chad,2011,2011Chad,46,86,59,194,13,0,398,60,91,65,230,17,0,463,861
4892,Chad,2011,2011Chad,215,260,123,460,78,3002,4138,198,232,147,269,41,2996,3883,31871
4893,Chad,2011,2011Chad,299,604,369,1137,94,0,2503,319,581,339,1444,65,0,2748,5251
4894,Chad,2012,2012Chad,0,0,0,0,0,0,0,0,0,0,0,0,0,0,977
4895,Chad,2012,2012Chad,0,0,0,0,0,0,0,0,0,0,0,0,7,7,7
4896,Chad,2012,2012Chad,0,0,0,0,0,0,0,0,0,0,5,0,0,5,10
4897,Chad,2012,2012Chad,0,0,0,0,0,0,0,0,0,6,0,0,0,6,6
4898,Chad,2012,2012Chad,0,0,0,0,0,0,0,0,0,7,0,0,0,7,7
4899,Chad,2012,2012Chad,0,0,0,0,0,14,14,0,0,0,0,0,34,34,48
4900,Chad,2012,2012Chad,0,0,0,0,0,31,31,0,0,0,0,0,17,17,48
4901,Chad,2012,2012Chad,0,0,0,0,0,311,311,0,0,0,0,0,839,839,1150
4902,Chad,2012,2012Chad,0,0,0,5,0,0,5,0,0,0,0,0,0,0,5
4903,Chad,2012,2012Chad,0,0,0,7,0,0,7,0,0,0,10,0,0,10,543
4904,Chad,2012,2012Chad,0,0,0,8,0,0,8,0,0,0,7,0,0,7,15
4905,Chad,2012,2012Chad,0,0,5,5,0,0,10,0,0,0,6,0,0,6,16
4906,Chad,2012,2012Chad,0,0,6,6,0,0,12,0,0,5,19,0,0,24,36
4907,Chad,2012,2012Chad,0,0,6,8,0,0,14,0,0,8,14,0,0,22,36
4908,Chad,2012,2012Chad,0,0,6,14,0,0,20,0,0,0,24,0,0,24,44
4909,Chad,2012,2012Chad,0,0,9,0,0,0,9,0,0,5,7,0,0,12,21
4910,Chad,2012,2012Chad,0,5,7,0,0,0,12,0,7,0,0,0,0,7,19
4911,Chad,2012,2012Chad,0,7,6,22,0,0,35,5,5,5,25,5,0,45,80
4912,Chad,2012,2012Chad,0,8,0,0,0,0,8,0,0,0,9,0,0,9,17
4913,Chad,2012,2012Chad,0,15,17,43,5,0,80,11,18,14,77,13,0,133,213
4914,Chad,2012,2012Chad,5,0,0,0,0,0,5,0,0,0,0,0,0,0,5
4915,Chad,2012,2012Chad,6,6,17,33,5,0,67,5,8,7,49,6,0,75,142
4916,Chad,2012,2012Chad,12,37,62,232,12,0,355,11,47,62,468,51,0,639,994
4917,Chad,2012,2012Chad,13,20,24,35,0,0,92,8,9,9,64,0,0,90,182
4918,Chad,2012,2012Chad,45,87,60,193,13,0,398,62,89,64,231,17,0,463,861
4919,Chad,2012,2012Chad,114,184,116,439,11,0,864,112,196,101,677,22,0,1108,1972
4920,Chad,2012,2012Chad,233,265,146,493,81,3102,4320,219,235,165,293,46,3092,4050,32220
4921,Chad,2013,2013Chad,0,0,0,0,0,0,0,0,0,0,0,0,0,0,1850
4922,Chad,2013,2013Chad,0,0,0,0,0,0,0,0,0,0,6,0,0,6,6
4923,Chad,2013,2013Chad,0,0,0,0,0,0,0,0,0,0,7,0,0,7,7
4924,Chad,2013,2013Chad,0,0,0,0,0,12,12,0,0,0,0,0,27,27,39
4925,Chad,2013,2013Chad,0,0,0,0,0,317,317,0,0,0,0,0,855,855,1172
4926,Chad,2013,2013Chad,0,0,0,5,0,0,5,0,0,0,0,0,0,0,5
4927,Chad,2013,2013Chad,0,0,0,5,0,26,31,0,5,0,0,0,13,18,49
4928,Chad,2013,2013Chad,0,0,0,7,0,0,7,0,0,5,8,0,0,13,519
4929,Chad,2013,2013Chad,0,0,0,9,0,0,9,0,0,0,7,0,0,7,32
4930,Chad,2013,2013Chad,0,0,0,10,0,0,10,0,0,0,8,0,0,8,18
4931,Chad,2013,2013Chad,0,0,5,0,0,0,5,0,0,5,28,0,0,33,38
4932,Chad,2013,2013Chad,0,0,9,7,0,0,16,0,5,0,26,0,0,31,47
4933,Chad,2013,2013Chad,0,5,0,0,0,0,5,0,0,0,0,0,0,0,5
4934,Chad,2013,2013Chad,0,5,13,46,5,0,69,0,9,6,51,8,0,74,143
4935,Chad,2013,2013Chad,0,6,0,0,0,0,6,0,0,0,8,0,0,8,14
4936,Chad,2013,2013Chad,0,6,0,5,0,0,11,0,0,0,9,0,0,9,20
4937,Chad,2013,2013Chad,0,8,0,0,0,0,8,0,0,0,9,0,0,9,17
4938,Chad,2013,2013Chad,0,8,6,14,0,0,28,6,5,8,24,0,0,43,71
4939,Chad,2013,2013Chad,5,42,49,236,14,0,346,5,45,64,470,62,0,646,992
4940,Chad,2013,2013Chad,12,24,23,35,0,0,94,7,6,11,69,0,0,93,187
4941,Chad,2013,2013Chad,80,172,106,360,5,0,723,74,178,109,613,24,0,998,1721
4942,Chad,2013,2013Chad,173,187,123,381,54,3319,4237,179,168,123,216,31,3309,4026,41666
4943,Chad,2014,2014Chad,0,0,0,0,0,0,0,0,0,0,0,0,0,0,1031
4944,Chad,2014,2014Chad,0,0,0,0,0,0,0,0,0,0,0,0,6,6,6
4945,Chad,2014,2014Chad,0,0,0,0,0,0,0,0,0,0,5,0,0,5,15
4946,Chad,2014,2014Chad,0,0,0,0,0,0,0,0,0,0,6,0,0,6,6
4947,Chad,2014,2014Chad,0,0,0,0,0,0,0,0,0,0,7,0,0,7,7
4948,Chad,2014,2014Chad,0,0,0,0,0,327,327,0,0,0,0,0,870,870,1197
4949,Chad,2014,2014Chad,0,0,0,5,0,25,30,0,5,0,0,0,13,18,48
4950,Chad,2014,2014Chad,0,0,0,9,0,0,9,0,0,0,7,0,0,7,16
4951,Chad,2014,2014Chad,0,0,0,9,0,0,9,0,0,0,11,0,0,11,20
4952,Chad,2014,2014Chad,0,0,0,10,0,0,10,0,0,0,6,0,0,6,16
4953,Chad,2014,2014Chad,0,0,0,10,0,0,10,0,0,5,25,0,0,30,474
4954,Chad,2014,2014Chad,0,0,8,8,0,0,16,0,5,0,24,0,0,29,45
4955,Chad,2014,2014Chad,0,0,10,0,0,0,10,0,5,25,0,0,0,30,40
4956,Chad,2014,2014Chad,0,5,0,0,0,0,5,0,0,0,0,0,0,0,5
4957,Chad,2014,2014Chad,0,5,18,46,5,0,74,0,9,12,55,8,0,84,158
4958,Chad,2014,2014Chad,0,6,0,0,0,0,6,0,0,0,0,0,0,0,6
4959,Chad,2014,2014Chad,0,6,0,5,0,0,11,0,0,0,9,0,0,9,20
4960,Chad,2014,2014Chad,0,8,0,0,0,0,8,0,0,0,9,0,0,9,17
4961,Chad,2014,2014Chad,0,15,8,17,0,0,40,0,6,17,22,5,0,50,90
4962,Chad,2014,2014Chad,5,6,5,18,0,0,34,7,5,10,23,0,0,45,79
4963,Chad,2014,2014Chad,8,19,14,44,0,0,85,10,20,13,74,5,0,122,207
4964,Chad,2014,2014Chad,28,42,49,156,5,0,280,34,51,42,224,30,0,381,661
4965,Chad,2014,2014Chad,79,184,103,373,5,0,744,74,168,120,609,23,0,994,1738
4966,Chad,2014,2014Chad,229,137,428,60,183,3647,4684,211,137,259,36,201,3403,4247,42334
4967,Chad,2015,2015Chad,0,0,0,0,0,0,0,0,0,0,0,0,0,0,1450
4968,Chad,2015,2015Chad,0,0,0,0,0,0,0,0,0,0,0,0,7,7,7
4969,Chad,2015,2015Chad,0,0,0,0,0,0,0,0,0,0,5,0,0,5,10
4970,Chad,2015,2015Chad,0,0,0,0,0,0,0,0,0,0,7,0,0,7,14
4971,Chad,2015,2015Chad,0,0,0,0,0,0,0,0,0,8,0,0,0,8,8
4972,Chad,2015,2015Chad,0,0,0,0,0,12,12,0,0,0,0,0,29,29,41
4973,Chad,2015,2015Chad,0,0,0,0,0,351,351,0,0,0,0,0,881,881,1232
4974,Chad,2015,2015Chad,0,0,0,9,0,0,9,0,0,0,10,0,0,10,19
4975,Chad,2015,2015Chad,0,0,0,10,0,0,10,0,0,0,7,0,0,7,17
4976,Chad,2015,2015Chad,0,0,5,8,0,0,13,0,0,11,0,0,0,11,24
4977,Chad,2015,2015Chad,0,0,6,5,0,0,11,0,0,0,9,0,0,9,20
4978,Chad,2015,2015Chad,0,5,0,0,0,0,5,0,0,0,0,0,0,0,5
4979,Chad,2015,2015Chad,0,6,0,0,0,13,19,0,0,0,8,0,23,31,50
4980,Chad,2015,2015Chad,0,6,0,10,0,0,16,0,0,7,22,0,0,29,45
4981,Chad,2015,2015Chad,0,6,7,17,0,0,30,5,5,9,25,0,0,44,74
4982,Chad,2015,2015Chad,0,8,0,0,0,0,8,0,0,0,9,0,0,9,17
4983,Chad,2015,2015Chad,5,0,5,11,0,0,21,0,5,0,10,0,0,15,36
4984,Chad,2015,2015Chad,5,13,9,42,6,0,75,5,19,11,49,5,0,89,164
4985,Chad,2015,2015Chad,8,14,19,51,0,0,92,9,21,21,86,8,0,145,237
4986,Chad,2015,2015Chad,13,7,7,22,0,0,49,5,6,14,33,5,0,63,112
4987,Chad,2015,2015Chad,18,41,42,162,5,0,268,32,41,42,231,33,0,379,647
4988,Chad,2015,2015Chad,107,176,117,364,10,0,774,113,164,103,617,27,0,1024,1798
4989,Chad,2015,2015Chad,843,1081,719,1969,284,0,4896,920,1002,661,1247,168,0,3998,8894
4990,Chad,2016,2016Chad,0,0,0,0,0,0,0,0,0,0,0,0,0,0,1064
4991,Chad,2016,2016Chad,0,0,0,0,0,0,0,0,0,0,0,0,7,7,7
4992,Chad,2016,2016Chad,0,0,0,0,0,0,0,0,0,0,5,0,0,5,5
4993,Chad,2016,2016Chad,0,0,0,0,0,0,0,0,0,0,7,0,0,7,7
4994,Chad,2016,2016Chad,0,0,0,0,0,0,0,0,7,0,0,0,0,7,7
4995,Chad,2016,2016Chad,0,0,0,0,0,0,0,5,0,0,0,0,0,5,5
4996,Chad,2016,2016Chad,0,0,0,0,0,8,8,0,0,0,0,0,26,26,34
4997,Chad,2016,2016Chad,0,0,0,0,0,377,377,0,0,0,0,0,938,938,1315
4998,Chad,2016,2016Chad,0,0,0,9,0,0,9,0,0,0,8,0,0,8,17
4999,Chad,2016,2016Chad,0,0,0,10,0,0,10,0,0,0,7,0,0,7,17
5000,Chad,2016,2016Chad,0,0,6,5,0,0,11,0,0,0,9,0,0,9,20
5001,Chad,2016,2016Chad,0,5,0,0,0,0,5,0,0,0,0,0,0,0,5
5002,Chad,2016,2016Chad,0,5,0,10,0,0,15,0,0,7,20,0,0,27,42
5003,Chad,2016,2016Chad,0,7,0,0,0,0,7,0,0,0,0,0,0,0,7
5004,Chad,2016,2016Chad,0,7,0,0,0,0,7,0,7,0,0,0,0,7,14
5005,Chad,2016,2016Chad,0,7,6,18,0,0,31,5,5,6,30,0,0,46,77
5006,Chad,2016,2016Chad,0,8,0,0,0,27,35,0,0,0,0,0,14,14,49
5007,Chad,2016,2016Chad,0,8,0,12,0,0,20,0,0,5,51,0,0,56,345
5008,Chad,2016,2016Chad,5,5,0,6,5,0,21,0,5,0,11,0,0,16,37
5009,Chad,2016,2016Chad,5,13,9,42,6,0,75,5,19,11,50,5,0,90,165
5010,Chad,2016,2016Chad,5,13,10,23,0,0,51,5,6,6,42,6,0,65,116
5011,Chad,2016,2016Chad,9,0,0,11,0,0,20,0,8,0,18,0,0,26,46
5012,Chad,2016,2016Chad,9,7,10,29,0,0,55,5,12,10,73,8,0,108,163
5013,Chad,2016,2016Chad,18,40,41,164,5,0,268,32,38,41,230,36,0,377,645
5014,Chad,2016,2016Chad,95,144,114,299,5,0,657,103,142,90,449,24,0,808,1465
5015,Chad,2016,2016Chad,865,1010,668,1934,253,0,4730,948,954,601,1129,140,0,3772,8502
5016,Chad,2017,2017Chad,0,0,0,0,0,0,0,0,0,0,0,0,0,0,1325
5017,Chad,2017,2017Chad,0,0,0,0,0,0,0,0,0,0,0,0,7,7,7
5018,Chad,2017,2017Chad,0,0,0,0,0,0,0,0,0,0,0,0,184,184,184
5019,Chad,2017,2017Chad,0,0,0,0,0,0,0,0,0,0,5,0,0,5,15
5020,Chad,2017,2017Chad,0,0,0,0,0,0,0,0,0,0,7,0,0,7,7
5021,Chad,2017,2017Chad,0,0,0,0,0,0,0,5,0,0,0,0,0,5,5
5022,Chad,2017,2017Chad,0,0,0,0,0,14,14,0,0,9,0,0,26,35,49
5023,Chad,2017,2017Chad,0,0,0,0,0,411,411,0,0,0,0,0,981,981,1392
5024,Chad,2017,2017Chad,0,0,0,11,0,0,11,0,0,0,7,0,0,7,18
5025,Chad,2017,2017Chad,0,0,5,5,0,0,10,0,0,0,8,0,0,8,18
5026,Chad,2017,2017Chad,0,0,6,5,0,0,11,0,0,0,9,0,0,9,20
5027,Chad,2017,2017Chad,0,0,9,0,0,0,9,0,0,0,0,0,0,0,9
5028,Chad,2017,2017Chad,0,5,0,0,0,0,5,0,0,0,0,0,0,0,5
5029,Chad,2017,2017Chad,0,5,11,16,0,0,32,0,5,12,28,5,0,50,82
5030,Chad,2017,2017Chad,0,7,0,5,0,0,12,0,5,8,5,0,0,18,30
5031,Chad,2017,2017Chad,0,8,0,0,0,0,8,0,0,0,0,0,0,0,8
5032,Chad,2017,2017Chad,0,9,0,16,0,0,25,0,0,6,15,0,0,21,46
5033,Chad,2017,2017Chad,0,10,0,6,5,0,21,0,5,0,11,0,0,16,37
5034,Chad,2017,2017Chad,0,15,9,43,6,0,73,0,20,14,52,6,0,92,165
5035,Chad,2017,2017Chad,0,21,36,162,9,0,228,17,36,34,215,40,0,342,570
5036,Chad,2017,2017Chad,5,5,6,21,0,0,37,5,6,6,33,0,0,50,87
5037,Chad,2017,2017Chad,7,10,0,19,0,0,36,8,11,8,20,0,0,47,83
5038,Chad,2017,2017Chad,93,140,132,319,5,0,689,82,147,99,479,25,0,832,1521
5039,Chad,2017,2017Chad,340,323,126,787,57,0,1633,349,323,127,707,45,0,1551,3184
5040,Chad,2017,2017Chad,710,1037,658,1497,200,0,4102,721,951,589,953,142,0,3356,7458
5041,Chad,2018,2018Chad,0,0,0,0,0,0,0,0,0,0,0,0,0,0,1093
5042,Chad,2018,2018Chad,0,0,0,0,0,0,0,0,0,0,5,0,0,5,15
5043,Chad,2018,2018Chad,0,0,0,0,0,0,0,0,0,0,7,0,0,7,7
5044,Chad,2018,2018Chad,0,0,0,0,0,0,0,0,0,6,0,0,0,6,6
5045,Chad,2018,2018Chad,0,0,0,0,0,0,0,5,0,0,0,0,0,5,5
5046,Chad,2018,2018Chad,0,0,0,0,0,505,505,0,0,0,0,0,1099,1099,1604
5047,Chad,2018,2018Chad,0,0,0,6,0,0,6,0,0,0,0,0,0,0,6
5048,Chad,2018,2018Chad,0,0,0,8,0,0,8,0,0,0,7,0,0,7,15
5049,Chad,2018,2018Chad,0,0,0,9,0,0,9,0,0,0,0,0,0,0,9
5050,Chad,2018,2018Chad,0,0,0,10,0,0,10,0,0,0,7,0,0,7,17
5051,Chad,2018,2018Chad,0,0,8,5,0,0,13,0,5,0,13,0,0,18,31
5052,Chad,2018,2018Chad,0,5,0,0,0,0,5,0,0,0,0,0,0,0,10
5053,Chad,2018,2018Chad,0,5,0,15,0,0,20,0,5,0,11,0,0,16,36
5054,Chad,2018,2018Chad,0,5,7,11,0,0,23,0,0,8,16,0,0,24,47
5055,Chad,2018,2018Chad,0,5,10,19,0,0,34,0,5,5,34,5,0,49,83
5056,Chad,2018,2018Chad,0,8,0,0,0,0,8,0,0,0,0,0,0,0,8
5057,Chad,2018,2018Chad,5,0,0,0,0,23,28,0,0,7,0,0,11,18,46
5058,Chad,2018,2018Chad,5,5,6,21,0,0,37,5,6,6,33,0,0,50,87
5059,Chad,2018,2018Chad,5,8,5,18,0,0,36,6,13,10,26,0,0,55,91
5060,Chad,2018,2018Chad,5,14,9,39,6,0,73,5,19,11,52,5,0,92,165
5061,Chad,2018,2018Chad,5,16,13,27,0,0,61,5,9,12,74,0,0,100,458
5062,Chad,2018,2018Chad,5,17,35,117,8,0,182,0,28,22,155,34,0,239,421
5063,Chad,2018,2018Chad,74,147,123,347,5,0,696,78,151,110,503,29,0,871,1567
5064,Chad,2018,2018Chad,169,219,109,335,22,0,854,168,187,110,349,27,0,841,1695
5065,Chad,2018,2018Chad,307,514,267,704,104,0,1896,324,333,344,418,58,0,1477,3373
5066,Chad,2019,2019Chad,0,0,0,0,0,0,0,0,0,0,0,0,0,0,1565
5067,Chad,2019,2019Chad,0,0,0,0,0,0,0,0,0,0,0,0,7,7,7
5068,Chad,2019,2019Chad,0,0,0,0,0,0,0,0,0,0,0,5,0,5,5
5069,Chad,2019,2019Chad,0,0,0,0,0,0,0,0,0,0,5,0,0,5,10
5070,Chad,2019,2019Chad,0,0,0,0,0,0,0,0,0,0,6,0,0,6,6
5071,Chad,2019,2019Chad,0,0,0,0,0,0,0,0,0,0,8,0,0,8,16
5072,Chad,2019,2019Chad,0,0,0,0,0,0,0,5,0,0,0,0,0,5,5
5073,Chad,2019,2019Chad,0,0,0,0,0,643,643,0,0,0,0,0,1247,1247,1890
5074,Chad,2019,2019Chad,0,0,0,6,0,0,6,0,0,0,0,0,0,0,6
5075,Chad,2019,2019Chad,0,0,0,7,0,0,7,0,0,0,5,0,0,5,12
5076,Chad,2019,2019Chad,0,0,0,8,0,0,8,0,0,0,0,0,0,0,8
5077,Chad,2019,2019Chad,0,0,0,9,0,0,9,0,0,0,0,0,0,0,9
5078,Chad,2019,2019Chad,0,0,5,6,0,0,11,0,5,0,8,0,0,13,24
5079,Chad,2019,2019Chad,0,0,6,0,0,0,6,0,0,0,0,0,0,0,6
5080,Chad,2019,2019Chad,0,0,8,6,0,0,14,0,5,0,13,0,0,18,32
5081,Chad,2019,2019Chad,0,0,9,0,0,0,9,0,0,0,0,0,0,0,9
5082,Chad,2019,2019Chad,0,0,9,23,0,0,32,0,5,5,30,11,0,51,83
5083,Chad,2019,2019Chad,0,5,0,0,0,0,5,0,0,0,0,0,0,0,5
5084,Chad,2019,2019Chad,0,5,6,15,0,0,26,0,0,6,16,0,0,22,48
5085,Chad,2019,2019Chad,0,12,10,46,6,0,74,0,16,15,53,8,0,92,166
5086,Chad,2019,2019Chad,0,15,15,80,5,0,115,5,11,22,82,7,0,127,242
5087,Chad,2019,2019Chad,5,0,0,0,0,0,5,0,0,0,5,0,0,5,36
5088,Chad,2019,2019Chad,5,6,6,21,0,0,38,5,6,6,33,0,0,50,88
5089,Chad,2019,2019Chad,5,9,7,20,0,0,41,5,14,9,31,0,0,59,100
5090,Chad,2019,2019Chad,61,161,135,356,6,0,719,50,160,135,504,36,0,885,1604
5091,Chad,2019,2019Chad,89,271,111,365,24,0,860,104,222,124,354,30,0,834,1694
5092,Chad,2019,2019Chad,329,242,794,365,104,0,1834,337,241,618,401,56,0,1653,3487
5093,Chad,2020,2020Chad,0,0,0,0,0,0,0,0,0,0,0,0,0,0,2666
5094,Chad,2020,2020Chad,0,0,0,0,0,0,0,0,0,0,0,0,7,7,7
5095,Chad,2020,2020Chad,0,0,0,0,0,0,0,0,0,0,0,5,0,5,5
5096,Chad,2020,2020Chad,0,0,0,0,0,0,0,0,0,0,5,0,0,5,15
5097,Chad,2020,2020Chad,0,0,0,0,0,0,0,0,0,0,7,0,0,7,7
5098,Chad,2020,2020Chad,0,0,0,0,0,0,0,0,0,0,9,0,0,9,9
5099,Chad,2020,2020Chad,0,0,0,0,0,0,0,5,0,0,0,0,0,5,5
5100,Chad,2020,2020Chad,0,0,0,0,0,18,18,0,0,0,0,0,28,28,46
5101,Chad,2020,2020Chad,0,0,0,5,0,0,5,0,0,0,0,0,0,0,5
5102,Chad,2020,2020Chad,0,0,0,7,0,0,7,0,0,0,5,0,0,5,12
5103,Chad,2020,2020Chad,0,0,0,9,0,0,9,0,0,0,0,0,0,0,9
5104,Chad,2020,2020Chad,0,0,0,21,0,26,47,0,0,0,55,0,27,82,577
5105,Chad,2020,2020Chad,0,0,5,0,0,0,5,0,0,0,0,0,0,0,5
5106,Chad,2020,2020Chad,0,0,5,7,0,0,12,0,0,5,9,0,0,14,26
5107,Chad,2020,2020Chad,0,0,6,0,0,0,6,0,0,0,0,0,0,0,6
5108,Chad,2020,2020Chad,0,0,8,6,0,0,14,0,5,0,15,0,0,20,34
5109,Chad,2020,2020Chad,0,0,9,0,0,0,9,0,0,0,0,0,0,0,9
5110,Chad,2020,2020Chad,0,0,9,22,0,0,31,0,0,8,31,11,0,50,81
5111,Chad,2020,2020Chad,0,5,0,0,0,0,5,0,0,0,10,0,0,10,15
5112,Chad,2020,2020Chad,0,5,8,20,0,0,33,0,8,5,40,0,0,53,86
5113,Chad,2020,2020Chad,0,10,5,18,0,0,33,0,0,5,18,0,0,23,56
5114,Chad,2020,2020Chad,0,12,11,46,6,0,75,0,16,15,57,8,0,96,171
5115,Chad,2020,2020Chad,5,0,0,0,0,0,5,0,0,0,0,0,0,0,5
5116,Chad,2020,2020Chad,5,0,0,0,0,0,5,0,0,0,7,0,0,7,39
5117,Chad,2020,2020Chad,5,6,6,21,0,0,38,5,13,6,33,0,0,57,95
5118,Chad,2020,2020Chad,5,10,11,85,5,0,116,0,9,21,99,9,0,138,254
5119,Chad,2020,2020Chad,50,163,142,364,6,0,725,43,145,142,508,37,0,875,1600
5120,Chad,2020,2020Chad,97,123,61,158,23,0,462,93,172,71,222,21,0,579,1041
5121,Chad,2020,2020Chad,297,377,269,793,104,0,1840,314,416,251,625,56,0,1662,3502
5122,Chad,2021,2021Chad,0,0,0,0,0,0,0,0,0,0,0,0,0,0,3751
5123,Chad,2021,2021Chad,0,0,0,0,0,0,0,0,0,0,0,5,0,5,5
5124,Chad,2021,2021Chad,0,0,0,0,0,0,0,0,0,0,5,0,0,5,20
5125,Chad,2021,2021Chad,0,0,0,0,0,0,0,0,0,0,6,0,0,6,6
5126,Chad,2021,2021Chad,0,0,0,0,0,0,0,0,0,0,7,0,0,7,7
5127,Chad,2021,2021Chad,0,0,0,0,0,0,0,0,0,0,17,0,0,17,17
5128,Chad,2021,2021Chad,0,0,0,0,0,0,0,0,0,7,0,0,0,7,7
5129,Chad,2021,2021Chad,0,0,0,0,0,0,0,0,5,0,6,0,0,11,11
5130,Chad,2021,2021Chad,0,0,0,0,0,0,0,5,0,0,0,0,0,5,5
5131,Chad,2021,2021Chad,0,0,0,5,0,0,5,0,0,0,0,0,0,0,5
5132,Chad,2021,2021Chad,0,0,0,5,0,0,5,0,0,0,5,0,0,5,35
5133,Chad,2021,2021Chad,0,0,0,8,0,0,8,0,0,0,5,0,0,5,13
5134,Chad,2021,2021Chad,0,0,0,9,0,0,9,0,0,0,0,0,0,0,9
5135,Chad,2021,2021Chad,0,0,5,0,0,0,5,0,0,0,0,0,0,0,5
5136,Chad,2021,2021Chad,0,0,5,30,0,0,35,0,8,0,38,5,0,51,86
5137,Chad,2021,2021Chad,0,0,6,22,0,0,28,0,0,5,36,5,0,46,74
5138,Chad,2021,2021Chad,0,0,9,0,0,0,9,0,0,0,0,0,0,0,9
5139,Chad,2021,2021Chad,0,0,9,7,0,0,16,0,0,5,17,0,0,22,38
5140,Chad,2021,2021Chad,0,5,0,7,0,0,12,0,0,5,6,5,0,16,28
5141,Chad,2021,2021Chad,0,5,7,21,0,0,33,0,8,5,41,0,0,54,87
5142,Chad,2021,2021Chad,0,8,6,31,5,0,50,0,12,10,33,6,0,61,111
5143,Chad,2021,2021Chad,0,10,6,17,0,0,33,0,0,7,20,0,0,27,60
5144,Chad,2021,2021Chad,5,0,0,0,0,0,5,0,0,0,0,0,0,0,5
5145,Chad,2021,2021Chad,6,11,8,24,0,0,49,7,13,11,43,0,0,74,123
5146,Chad,2021,2021Chad,7,9,11,75,0,26,128,13,12,5,168,0,26,224,784
5147,Chad,2021,2021Chad,49,137,117,362,6,0,671,43,144,114,433,40,0,774,1445
5148,Chad,2021,2021Chad,84,151,98,237,26,0,596,68,124,72,209,25,0,498,1094
5149,Chad,2021,2021Chad,388,421,285,863,107,0,2064,398,449,273,691,56,0,1867,3931
5150,China,2001,2001China,0,0,0,0,0,0,0,0,0,0,0,0,0,0,116622
5151,China,2001,2001China,0,0,0,0,0,0,0,0,0,0,0,0,6,6,6
5152,China,2001,2001China,0,0,0,0,0,0,0,0,0,0,5,0,0,5,10
5153,China,2001,2001China,0,0,0,0,0,0,0,0,0,0,12,0,0,12,12
5154,China,2001,2001China,0,0,0,0,0,60,60,0,0,0,0,0,75,75,135
5155,China,2001,2001China,0,0,0,0,0,204,204,0,0,0,0,0,323,323,527
5156,China,2001,2001China,0,0,0,5,0,0,5,0,0,0,0,0,0,0,10
5157,China,2001,2001China,0,0,0,5,0,0,5,0,0,0,5,0,0,5,10
5158,China,2001,2001China,0,9,0,18,0,0,27,0,8,0,26,5,0,39,66
5159,China,2001,2001China,5,0,0,0,0,0,5,0,0,0,0,0,0,0,5
5160,China,2002,2002China,0,0,0,0,0,0,0,0,0,0,0,0,0,0,38475
5161,China,2002,2002China,0,0,0,0,0,0,0,0,0,0,5,0,0,5,5
5162,China,2002,2002China,0,0,0,0,0,0,0,0,0,0,7,0,0,7,7
5163,China,2002,2002China,0,0,0,0,0,0,0,0,0,0,13,0,0,13,13
5164,China,2002,2002China,0,0,0,0,0,0,0,0,0,6,0,0,0,6,6
5165,China,2002,2002China,0,0,0,0,0,5,5,0,0,0,0,0,18,18,23
5166,China,2002,2002China,0,0,0,0,0,11,11,0,0,0,0,0,23,23,34
5167,China,2002,2002China,0,0,0,0,0,169,169,0,0,0,0,0,273,273,442
5168,China,2002,2002China,0,0,0,0,0,289,289,0,0,0,0,0,369,369,658
5169,China,2002,2002China,0,0,0,0,0,36937,36937,0,0,0,5,0,55404,55409,92346
5170,China,2002,2002China,0,0,0,5,0,0,5,0,0,0,0,0,0,0,10
5171,China,2002,2002China,0,5,5,19,7,0,36,0,0,9,28,7,0,44,80
5172,China,2003,2003China,0,0,0,0,0,0,0,0,0,0,0,0,0,0,38941
5173,China,2003,2003China,0,0,0,0,0,0,0,0,0,0,5,0,0,5,5
5174,China,2003,2003China,0,0,0,0,0,0,0,0,0,0,7,0,0,7,92349
5175,China,2003,2003China,0,0,0,0,0,0,0,0,0,0,9,0,0,9,9
5176,China,2003,2003China,0,0,0,0,0,0,0,0,0,6,0,0,0,6,6
5177,China,2003,2003China,0,0,0,0,0,21,21,0,0,0,0,0,14,14,35
5178,China,2003,2003China,0,0,0,0,0,145,145,0,0,0,0,0,227,227,372
5179,China,2003,2003China,0,0,0,0,0,220,220,0,0,0,0,0,291,291,567
5180,China,2003,2003China,0,0,0,5,0,0,5,0,0,0,0,0,0,0,5
5181,China,2003,2003China,0,0,0,5,0,0,5,8,0,0,6,0,0,14,19
5182,China,2003,2003China,0,0,8,16,0,0,24,0,0,8,15,5,0,28,52
5183,China,2003,2003China,5,0,0,6,0,0,11,5,7,0,7,0,0,19,30
5184,China,2004,2004China,0,0,0,0,0,0,0,0,0,0,0,0,0,0,39578
5185,China,2004,2004China,0,0,0,0,0,0,0,0,0,0,5,0,0,5,10
5186,China,2004,2004China,0,0,0,0,0,0,0,0,0,0,6,0,0,6,12
5187,China,2004,2004China,0,0,0,0,0,0,0,0,0,0,7,0,0,7,94349
5188,China,2004,2004China,0,0,0,0,0,21,21,0,0,0,0,0,14,14,35
5189,China,2004,2004China,0,0,0,8,0,0,8,8,0,0,8,0,0,16,24
5190,China,2004,2004China,0,0,0,18,0,0,18,0,0,5,23,0,0,28,46
5191,China,2004,2004China,0,6,0,9,0,0,15,5,0,0,6,0,0,11,26
5192,China,2004,2004China,5,0,0,0,0,0,5,0,0,0,0,0,0,0,5
5193,China,2004,2004China,5,5,0,19,0,224,253,5,0,0,80,0,285,370,623
5194,China,2005,2005China,0,0,0,0,0,0,0,0,0,0,0,0,0,0,45594
5195,China,2005,2005China,0,0,0,0,0,0,0,0,0,0,5,0,0,5,77210
5196,China,2005,2005China,0,0,0,0,0,0,0,0,0,0,7,0,0,7,7
5197,China,2005,2005China,0,0,0,0,0,23,23,0,0,0,0,0,9,9,32
5198,China,2005,2005China,0,0,0,0,0,179,179,0,0,0,0,0,261,261,440
5199,China,2005,2005China,0,0,0,5,0,0,5,0,0,0,10,0,0,10,15
5200,China,2005,2005China,0,0,0,6,0,0,6,10,0,0,7,0,0,17,23
5201,China,2005,2005China,0,5,0,0,0,0,5,0,0,0,0,0,0,0,5
5202,China,2005,2005China,0,6,0,0,0,0,6,0,0,0,0,0,0,0,6
5203,China,2005,2005China,0,6,6,31,0,221,264,5,5,0,102,0,291,403,667
5204,China,2005,2005China,0,7,0,20,0,0,27,6,0,0,24,0,0,30,57
5205,China,2005,2005China,0,8,0,7,0,0,15,0,0,5,10,0,0,15,30
5206,China,2006,2006China,0,0,0,0,0,0,0,0,0,0,0,0,0,0,61545
5207,China,2006,2006China,0,0,0,0,0,0,0,0,0,0,5,0,0,5,77225
5208,China,2006,2006China,0,0,0,0,0,24,24,0,0,0,0,0,19,19,43
5209,China,2006,2006China,0,0,0,0,0,36,36,0,0,0,0,0,113,113,149
5210,China,2006,2006China,0,0,0,0,0,198,198,0,0,0,0,0,295,295,493
5211,China,2006,2006China,0,0,0,0,0,398,398,0,0,0,0,0,585,585,983
5212,China,2006,2006China,0,0,0,5,0,0,5,0,0,0,0,0,0,0,5
5213,China,2006,2006China,0,0,0,6,0,0,6,0,0,0,10,0,0,10,16
5214,China,2006,2006China,0,0,0,8,0,0,8,0,0,0,0,0,0,0,8
5215,China,2006,2006China,0,0,8,0,0,0,8,0,0,0,0,0,0,0,8
5216,China,2006,2006China,0,0,8,6,0,0,14,0,0,0,12,0,0,12,26
5217,China,2006,2006China,0,6,0,34,6,0,46,6,0,0,17,5,0,28,74
5218,China,2006,2006China,9,0,0,0,0,0,9,0,0,0,0,0,0,0,9
5219,China,2007,2007China,0,0,0,0,0,0,0,0,0,0,0,0,0,0,69662
5220,China,2007,2007China,0,0,0,0,0,0,0,0,0,0,5,0,0,5,77225
5221,China,2007,2007China,0,0,0,0,0,0,0,0,5,0,0,0,0,5,5
5222,China,2007,2007China,0,0,0,0,0,16,16,0,0,0,0,0,28,28,44
5223,China,2007,2007China,0,0,0,0,0,50,50,0,0,0,0,0,175,175,225
5224,China,2007,2007China,0,0,0,0,0,228,228,0,0,0,0,0,342,342,570
5225,China,2007,2007China,0,0,0,5,0,0,5,0,0,0,0,0,0,0,5
5226,China,2007,2007China,0,0,0,6,0,0,6,0,0,0,6,0,0,6,12
5227,China,2007,2007China,0,0,0,8,0,0,8,0,0,0,0,0,0,0,8
5228,China,2007,2007China,0,0,0,13,0,0,13,0,0,5,8,0,0,13,26
5229,China,2007,2007China,0,0,6,0,0,0,6,0,0,0,0,0,0,0,6
5230,China,2007,2007China,0,0,6,0,0,0,6,8,0,0,0,0,0,8,14
5231,China,2007,2007China,0,0,8,0,0,0,8,0,5,0,6,0,0,11,19
5232,China,2007,2007China,0,5,0,0,0,0,5,0,0,0,5,0,0,5,10
5233,China,2007,2007China,5,6,0,63,8,0,82,7,0,5,46,7,0,65,147
5234,China,2007,2007China,16,30,19,175,0,230,470,19,26,15,277,0,302,639,1109
5235,China,2008,2008China,0,0,0,0,0,0,0,0,0,0,0,0,0,0,72735
5236,China,2008,2008China,0,0,0,0,0,0,0,0,0,0,5,0,0,5,100018
5237,China,2008,2008China,0,0,0,0,0,0,0,0,5,0,0,0,0,5,5
5238,China,2008,2008China,0,0,0,0,0,16,16,0,0,0,0,0,27,27,43
5239,China,2008,2008China,0,0,0,0,0,71,71,0,0,0,0,0,202,202,273
5240,China,2008,2008China,0,0,0,0,0,277,277,0,0,0,0,0,388,388,665
5241,China,2008,2008China,0,0,0,5,0,0,5,0,0,0,6,0,0,6,11
5242,China,2008,2008China,0,0,0,5,0,0,5,0,5,0,9,0,0,14,19
5243,China,2008,2008China,0,0,0,6,0,0,6,0,0,0,6,0,0,6,24
5244,China,2008,2008China,0,0,0,9,5,0,14,0,0,0,14,0,0,14,28
5245,China,2008,2008China,0,0,5,0,0,0,5,0,0,0,0,0,0,0,5
5246,China,2008,2008China,0,0,5,0,0,0,5,5,0,0,0,0,0,5,10
5247,China,2008,2008China,0,5,0,0,0,0,5,0,0,0,5,0,0,5,10
5248,China,2008,2008China,0,8,0,63,5,0,76,7,6,0,49,6,0,68,144
5249,China,2008,2008China,23,31,26,190,0,231,501,19,32,21,306,0,300,678,1179
5250,China,2009,2009China,0,0,0,0,0,0,0,0,0,0,0,0,0,0,74980
5251,China,2009,2009China,0,0,0,0,0,0,0,0,0,0,5,0,0,5,100013
5252,China,2009,2009China,0,0,0,0,0,0,0,0,0,0,6,0,0,6,6
5253,China,2009,2009China,0,0,0,0,0,19,19,0,0,0,0,0,41,41,60
5254,China,2009,2009China,0,0,0,0,0,102,102,0,0,0,0,0,282,282,384
5255,China,2009,2009China,0,0,0,5,0,0,5,0,0,0,6,0,0,6,11
5256,China,2009,2009China,0,0,0,5,0,0,5,0,0,0,9,0,0,9,14
5257,China,2009,2009China,0,0,0,6,0,0,6,0,0,0,6,0,0,6,12
5258,China,2009,2009China,0,0,0,7,0,0,7,0,0,5,5,0,0,10,17
5259,China,2009,2009China,0,0,7,0,0,0,7,0,0,0,0,0,0,0,7
5260,China,2009,2009China,0,5,0,13,5,0,23,0,0,5,13,0,0,18,41
5261,China,2009,2009China,0,7,0,27,5,0,39,5,5,5,30,5,0,50,89
5262,China,2009,2009China,0,9,0,0,0,0,9,0,5,0,5,0,0,10,19
5263,China,2009,2009China,29,37,28,213,0,228,535,21,35,28,322,0,298,704,1239
5264,China,2009,2009China,59,145,121,1140,60,0,1525,63,155,135,1708,68,0,2129,3654
5265,China,2010,2010China,0,0,0,0,0,0,0,0,0,0,0,0,0,0,77727
5266,China,2010,2010China,0,0,0,0,0,0,0,0,0,0,5,0,0,5,100018
5267,China,2010,2010China,0,0,0,0,0,0,0,0,0,0,6,0,0,6,6
5268,China,2010,2010China,0,0,0,0,0,5,5,0,0,0,0,0,0,0,5
5269,China,2010,2010China,0,0,0,0,0,29,29,0,0,0,0,0,40,40,69
5270,China,2010,2010China,0,0,0,0,0,117,117,0,0,0,0,0,324,324,441
5271,China,2010,2010China,0,0,0,0,0,411,411,0,0,0,0,0,591,591,1002
5272,China,2010,2010China,0,0,0,5,0,0,5,0,0,0,0,0,0,0,5
5273,China,2010,2010China,0,0,0,6,0,0,6,0,0,0,6,0,0,6,12
5274,China,2010,2010China,0,0,0,6,0,0,6,0,0,0,7,0,0,7,13
5275,China,2010,2010China,0,0,0,11,0,0,11,0,0,0,6,0,0,6,17
5276,China,2010,2010China,0,5,0,0,0,0,5,0,0,0,0,0,0,0,5
5277,China,2010,2010China,0,5,0,18,5,0,28,0,0,6,20,0,0,26,54
5278,China,2010,2010China,0,5,0,21,0,0,26,5,7,0,23,0,0,35,61
5279,China,2010,2010China,0,9,0,0,0,0,9,0,0,0,5,0,0,5,14
5280,China,2010,2010China,35,41,43,280,0,227,626,18,36,32,385,0,303,774,1400
5281,China,2010,2010China,55,153,128,1199,62,0,1597,43,166,130,1740,76,0,2155,3752
5282,China,2011,2011China,0,0,0,0,0,0,0,0,0,0,0,0,0,0,65850
5283,China,2011,2011China,0,0,0,0,0,0,0,0,0,0,5,0,0,5,100018
5284,China,2011,2011China,0,0,0,0,0,31,31,0,0,0,0,0,43,43,74
5285,China,2011,2011China,0,0,0,0,0,176,176,0,0,0,0,0,427,427,603
5286,China,2011,2011China,0,0,0,0,0,495,495,0,0,0,0,0,712,712,1207
5287,China,2011,2011China,0,0,0,5,0,0,5,0,0,0,0,0,0,0,5
5288,China,2011,2011China,0,0,0,6,0,0,6,0,0,0,6,0,0,6,12
5289,China,2011,2011China,0,0,0,8,0,0,8,0,0,5,5,0,0,10,18
5290,China,2011,2011China,0,0,0,9,0,0,9,0,0,0,0,0,0,0,9
5291,China,2011,2011China,0,0,0,9,0,0,9,0,0,0,5,0,0,5,14
5292,China,2011,2011China,0,0,0,14,0,0,14,0,0,0,7,0,0,7,21
5293,China,2011,2011China,0,0,5,0,0,0,5,0,0,0,0,0,0,0,5
5294,China,2011,2011China,0,6,0,27,5,0,38,0,0,7,16,5,0,28,66
5295,China,2011,2011China,0,8,0,29,5,0,42,0,6,5,25,5,0,41,83
5296,China,2011,2011China,0,9,0,0,0,0,9,0,0,0,5,0,0,5,14
5297,China,2011,2011China,25,64,48,839,84,0,1060,17,70,65,1024,65,0,1241,17024
5298,China,2011,2011China,39,45,47,370,0,240,741,26,39,32,541,0,328,966,1707
5299,China,2011,2011China,43,146,117,1176,66,0,1548,46,149,135,1671,90,0,2091,3639
5300,China,2012,2012China,0,0,0,0,0,0,0,0,0,0,0,0,0,0,68314
5301,China,2012,2012China,0,0,0,0,0,0,0,0,0,0,0,0,9,9,9
5302,China,2012,2012China,0,0,0,0,0,0,0,0,0,0,5,0,0,5,100018
5303,China,2012,2012China,0,0,0,0,0,0,0,0,5,0,0,0,0,5,5
5304,China,2012,2012China,0,0,0,0,0,28,28,0,0,0,0,0,51,51,79
5305,China,2012,2012China,0,0,0,0,0,287,287,0,0,0,0,0,579,579,866
5306,China,2012,2012China,0,0,0,0,0,628,628,0,0,0,0,0,941,941,1569
5307,China,2012,2012China,0,0,0,5,0,0,5,0,0,0,0,0,0,0,5
5308,China,2012,2012China,0,0,0,5,5,0,10,0,0,0,15,0,0,15,25
5309,China,2012,2012China,0,0,0,6,0,0,6,0,0,0,6,0,0,6,12
5310,China,2012,2012China,0,0,0,7,0,0,7,0,0,9,0,0,0,9,16
5311,China,2012,2012China,0,0,0,7,0,696,703,0,5,0,15,0,939,959,1662
5312,China,2012,2012China,0,5,7,0,0,0,12,0,0,6,0,0,0,6,18
5313,China,2012,2012China,0,6,5,43,5,0,59,5,6,5,37,5,0,58,117
5314,China,2012,2012China,0,8,0,32,5,0,45,0,5,5,27,0,0,37,82
5315,China,2012,2012China,0,9,0,0,0,0,9,0,0,0,5,0,0,5,14
5316,China,2012,2012China,5,0,0,0,0,0,5,0,0,0,5,0,0,5,10
5317,China,2012,2012China,6,13,9,259,23,0,310,9,10,7,275,15,0,316,16813
5318,China,2012,2012China,45,159,119,1253,72,0,1648,42,154,137,1726,108,0,2167,3815
5319,China,2013,2013China,0,0,0,0,0,0,0,0,0,0,0,0,0,0,73318
5320,China,2013,2013China,0,0,0,0,0,0,0,0,0,0,5,0,0,5,100013
5321,China,2013,2013China,0,0,0,0,0,0,0,0,0,0,8,0,0,8,8
5322,China,2013,2013China,0,0,0,0,0,0,0,0,5,0,0,0,0,5,5
5323,China,2013,2013China,0,0,0,0,0,23,23,0,0,0,0,0,56,56,79
5324,China,2013,2013China,0,0,0,0,0,312,312,0,0,0,0,0,646,646,958
5325,China,2013,2013China,0,0,0,0,0,753,753,0,0,0,0,0,1151,1151,1904
5326,China,2013,2013China,0,0,0,5,0,0,5,0,0,0,11,0,0,11,16
5327,China,2013,2013China,0,0,0,6,0,0,6,0,0,0,6,0,0,6,12
5328,China,2013,2013China,0,0,0,7,0,0,7,0,0,0,5,0,0,5,12
5329,China,2013,2013China,0,0,0,7,0,0,7,0,0,9,0,0,0,9,16
5330,China,2013,2013China,0,0,0,9,0,0,9,0,0,0,13,5,0,18,27
5331,China,2013,2013China,0,0,0,21,0,0,21,0,0,0,32,0,0,32,53
5332,China,2013,2013China,0,0,5,13,0,0,18,0,0,0,12,0,0,12,30
5333,China,2013,2013China,0,0,5,19,5,0,29,0,0,5,25,0,0,30,59
5334,China,2013,2013China,0,9,0,0,0,0,9,0,0,0,5,0,0,5,14
5335,China,2013,2013China,5,5,0,32,0,0,42,0,5,5,22,5,0,37,79
5336,China,2013,2013China,5,55,41,416,15,0,532,16,42,46,345,18,0,467,15344
5337,China,2013,2013China,37,36,38,365,0,235,711,40,25,24,546,5,333,973,1684
5338,China,2013,2013China,37,60,41,385,24,0,547,41,69,41,742,50,0,943,1490
5339,China,2014,2014China,0,0,0,0,0,0,0,0,0,0,0,0,0,0,80866
5340,China,2014,2014China,0,0,0,0,0,0,0,0,0,0,0,0,5,5,5
5341,China,2014,2014China,0,0,0,0,0,0,0,0,0,0,0,0,7,7,7
5342,China,2014,2014China,0,0,0,0,0,0,0,0,0,0,5,0,0,5,109018
5343,China,2014,2014China,0,0,0,0,0,0,0,0,0,5,0,0,0,5,5
5344,China,2014,2014China,0,0,0,0,0,24,24,0,0,0,0,0,55,55,79
5345,China,2014,2014China,0,0,0,0,0,983,983,0,0,0,0,0,1493,1493,2476
5346,China,2014,2014China,0,0,0,5,0,0,5,0,0,0,11,0,0,11,16
5347,China,2014,2014China,0,0,0,9,0,0,9,0,0,0,0,0,0,0,9
5348,China,2014,2014China,0,0,0,11,0,0,11,0,0,0,16,0,0,16,27
5349,China,2014,2014China,0,0,0,11,5,0,16,0,0,0,6,5,0,11,27
5350,China,2014,2014China,0,0,0,19,8,0,27,0,0,5,14,5,0,24,51
5351,China,2014,2014China,0,5,0,29,6,0,40,0,0,6,22,8,0,36,76
5352,China,2014,2014China,0,9,0,0,0,0,9,0,0,0,5,0,0,5,14
5353,China,2014,2014China,6,0,0,0,0,0,6,0,0,0,6,0,0,6,12
5354,China,2014,2014China,23,31,16,390,20,0,480,20,22,21,362,12,0,437,13231
5355,China,2014,2014China,59,66,51,386,26,0,588,35,82,40,733,52,0,942,1530
5356,China,2014,2014China,61,50,33,633,0,578,1355,63,30,29,1038,5,824,1989,3344
5357,China,2015,2015China,0,0,0,0,0,0,0,0,0,0,0,0,0,0,93475
5358,China,2015,2015China,0,0,0,0,0,0,0,0,0,0,0,0,5,5,10
5359,China,2015,2015China,0,0,0,0,0,0,0,0,0,0,5,0,0,5,110098
5360,China,2015,2015China,0,0,0,0,0,0,0,0,0,0,6,0,0,6,6
5361,China,2015,2015China,0,0,0,0,0,0,0,0,5,0,0,0,0,5,5
5362,China,2015,2015China,0,0,0,0,0,497,497,0,0,0,0,0,808,808,1305
5363,China,2015,2015China,0,0,0,0,0,1292,1292,0,0,0,0,0,1968,1968,3260
5364,China,2015,2015China,0,0,0,5,0,0,5,0,0,0,9,0,0,9,14
5365,China,2015,2015China,0,0,0,6,0,0,6,0,0,0,6,0,0,6,12
5366,China,2015,2015China,0,0,0,7,0,0,7,0,0,0,13,0,0,13,20
5367,China,2015,2015China,0,0,0,8,0,0,8,0,0,0,0,0,0,0,8
5368,China,2015,2015China,0,0,0,23,0,0,23,0,0,0,30,0,0,30,53
5369,China,2015,2015China,0,0,5,16,0,0,21,0,0,0,14,5,0,19,40
5370,China,2015,2015China,0,0,8,44,9,0,61,0,9,0,33,9,0,51,112
5371,China,2015,2015China,0,0,9,0,0,0,9,0,0,5,0,0,0,5,14
5372,China,2015,2015China,0,5,0,0,0,0,5,0,0,0,0,0,0,0,5
5373,China,2015,2015China,0,5,0,8,0,0,13,5,0,0,12,5,0,22,35
5374,China,2015,2015China,0,9,0,11,0,483,503,0,0,6,15,0,346,367,3022
5375,China,2015,2015China,5,0,0,0,0,0,5,0,0,0,6,0,0,6,11
5376,China,2015,2015China,33,60,38,364,31,0,526,22,65,34,695,64,0,880,1406
5377,China,2016,2016China,0,0,0,0,0,0,0,0,0,0,0,0,0,0,80356
5378,China,2016,2016China,0,0,0,0,0,0,0,0,0,0,0,0,5,5,5
5379,China,2016,2016China,0,0,0,0,0,0,0,0,0,0,5,0,0,5,110103
5380,China,2016,2016China,0,0,0,0,0,0,0,0,0,0,13,0,0,13,13
5381,China,2016,2016China,0,0,0,0,0,0,0,0,0,9,0,0,0,9,9
5382,China,2016,2016China,0,0,0,0,0,466,466,0,0,0,0,0,731,731,1197
5383,China,2016,2016China,0,0,0,0,0,1618,1618,0,0,0,0,0,2371,2371,3989
5384,China,2016,2016China,0,0,0,5,0,0,5,0,0,0,0,0,0,0,5
5385,China,2016,2016China,0,0,0,5,0,0,5,5,0,0,18,0,0,23,28
5386,China,2016,2016China,0,0,0,6,0,0,6,0,0,0,0,0,0,0,6
5387,China,2016,2016China,0,0,0,24,0,0,24,0,0,0,28,0,0,28,52
5388,China,2016,2016China,0,0,9,0,0,0,9,0,0,5,0,0,0,5,14
5389,China,2016,2016China,0,5,0,0,7,0,12,5,0,0,14,5,0,24,36
5390,China,2016,2016China,0,5,7,61,13,0,86,0,6,5,59,5,0,75,161
5391,China,2016,2016China,5,0,0,0,0,0,5,0,0,0,6,0,0,6,11
5392,China,2016,2016China,8,52,21,226,10,0,317,10,40,23,213,5,0,291,7356
5393,China,2016,2016China,28,46,33,377,32,0,516,27,55,35,676,76,0,869,1385
5394,China,2016,2016China,93,58,34,727,5,361,1278,111,36,33,1079,6,499,1764,3042
5395,China,2017,2017China,0,0,0,0,0,0,0,0,0,0,0,0,0,0,90248
5396,China,2017,2017China,0,0,0,0,0,0,0,0,0,0,5,0,0,5,108013
5397,China,2017,2017China,0,0,0,0,0,0,0,0,0,0,13,0,0,13,13
5398,China,2017,2017China,0,0,0,0,0,1875,1875,0,0,0,0,0,2666,2666,4541
5399,China,2017,2017China,0,0,0,0,9,0,9,0,0,0,0,5,0,5,14
5400,China,2017,2017China,0,0,0,5,0,0,5,0,0,0,7,0,0,7,12
5401,China,2017,2017China,0,0,0,6,0,0,6,0,0,0,0,0,0,0,6
5402,China,2017,2017China,0,0,0,6,0,0,6,0,0,0,6,0,0,6,12
5403,China,2017,2017China,0,0,0,6,0,0,6,0,0,0,9,0,0,9,15
5404,China,2017,2017China,0,0,0,9,0,0,9,0,0,0,0,0,0,0,9
5405,China,2017,2017China,0,0,0,24,0,0,24,0,0,0,30,0,0,30,54
5406,China,2017,2017China,0,5,0,9,0,0,14,0,5,0,15,5,0,25,39
5407,China,2017,2017China,0,5,6,64,16,0,91,6,9,0,67,6,0,88,179
5408,China,2017,2017China,27,49,38,484,46,0,644,28,64,43,721,88,0,944,1588
5409,China,2017,2017China,101,55,34,711,5,501,1407,119,44,29,1003,8,363,1566,2973
5410,China,2018,2018China,0,0,0,0,0,0,0,0,0,0,0,0,0,0,86086
5411,China,2018,2018China,0,0,0,0,0,0,0,0,0,0,5,0,0,5,108013
5412,China,2018,2018China,0,0,0,0,0,0,0,0,0,0,13,0,0,13,13
5413,China,2018,2018China,0,0,0,0,0,2406,2406,0,0,0,0,0,3404,3404,5810
5414,China,2018,2018China,0,0,0,5,0,0,5,0,0,0,7,0,0,7,12
5415,China,2018,2018China,0,0,0,8,5,0,13,0,0,0,14,0,0,14,27
5416,China,2018,2018China,0,0,0,9,0,0,9,0,0,0,5,0,0,5,14
5417,China,2018,2018China,0,0,0,12,0,0,12,0,0,0,0,0,0,0,12
5418,China,2018,2018China,0,0,0,19,5,0,24,0,0,0,30,0,0,30,54
5419,China,2018,2018China,0,5,0,7,7,0,19,0,11,0,8,5,0,24,43
5420,China,2018,2018China,0,5,6,67,15,0,93,5,12,0,70,6,0,93,186
5421,China,2018,2018China,5,31,29,275,27,0,367,6,40,33,252,16,0,347,7192
5422,China,2018,2018China,27,54,28,511,52,0,672,26,55,42,724,101,0,948,1620
5423,China,2018,2018China,124,62,30,686,5,387,1294,141,50,35,919,9,509,1663,2957
5424,China,2019,2019China,0,0,0,0,0,0,0,0,0,0,0,0,0,0,92991
5425,China,2019,2019China,0,0,0,0,0,0,0,0,0,0,5,0,0,5,108013
5426,China,2019,2019China,0,0,0,0,0,0,0,0,0,0,6,0,0,6,27
5427,China,2019,2019China,0,0,0,0,0,2897,2897,0,0,0,0,0,4021,4021,6918
5428,China,2019,2019China,0,0,0,6,0,0,6,0,0,0,6,0,0,6,12
5429,China,2019,2019China,0,0,0,9,0,0,9,0,0,0,5,0,0,5,14
5430,China,2019,2019China,0,0,0,19,5,0,24,0,5,0,15,0,0,20,44
5431,China,2019,2019China,0,0,5,0,0,0,5,0,0,0,0,0,0,0,5
5432,China,2019,2019China,0,0,8,65,15,0,88,0,10,5,65,6,0,86,174
5433,China,2019,2019China,0,5,0,18,5,0,28,0,5,0,30,0,0,35,63
5434,China,2019,2019China,5,0,0,0,0,0,5,0,0,0,0,0,0,0,5
5435,China,2019,2019China,5,0,0,0,0,0,5,0,0,0,7,0,0,7,12
5436,China,2019,2019China,27,59,29,586,53,0,754,33,65,48,746,114,0,1006,1760
5437,China,2019,2019China,125,64,36,631,7,0,863,126,64,42,795,9,0,1036,2825
5438,China,2020,2020China,0,0,0,0,0,0,0,0,0,0,0,0,0,0,89778
5439,China,2020,2020China,0,0,0,0,0,0,0,0,0,0,0,0,7,7,7
5440,China,2020,2020China,0,0,0,0,0,0,0,0,0,0,5,0,0,5,73422
5441,China,2020,2020China,0,0,0,0,0,5,5,0,0,0,0,0,0,0,5
5442,China,2020,2020China,0,0,0,0,0,19,19,0,0,0,0,0,27,27,46
5443,China,2020,2020China,0,0,0,0,0,509,509,0,0,0,0,0,642,642,1151
5444,China,2020,2020China,0,0,0,5,0,0,5,0,0,0,9,0,0,9,35
5445,China,2020,2020China,0,0,0,6,0,0,6,0,0,0,6,0,0,6,12
5446,China,2020,2020China,0,0,0,9,0,0,9,0,0,0,5,0,0,5,14
5447,China,2020,2020China,0,0,0,11,0,0,11,0,0,0,0,0,0,0,11
5448,China,2020,2020China,0,0,0,19,5,0,24,0,0,5,15,0,0,20,44
5449,China,2020,2020China,0,0,0,260,0,63,323,13,0,0,329,26,48,416,5916
5450,China,2020,2020China,0,0,5,0,0,0,5,0,0,0,0,0,0,0,5
5451,China,2020,2020China,0,0,5,0,0,0,5,0,9,0,0,0,0,9,14
5452,China,2020,2020China,0,0,7,66,15,0,88,5,7,5,65,7,0,89,177
5453,China,2020,2020China,0,5,0,25,0,0,30,0,7,0,31,0,0,38,68
5454,China,2020,2020China,5,0,0,0,0,0,5,0,0,0,0,0,0,0,5
5455,China,2020,2020China,31,52,35,691,64,0,873,37,72,51,825,128,0,1113,1986
5456,China,2020,2020China,119,59,38,599,7,0,822,114,71,39,676,10,0,910,2665
5457,China,2021,2021China,0,0,0,0,0,0,0,0,0,0,0,0,0,0,85991
5458,China,2021,2021China,0,0,0,0,0,0,0,0,0,0,5,0,0,5,73427
5459,China,2021,2021China,0,0,0,6,0,0,6,0,0,0,0,0,0,0,6
5460,China,2021,2021China,0,0,0,6,0,0,6,0,0,0,6,0,0,6,12
5461,China,2021,2021China,0,0,0,9,0,0,9,0,0,0,5,0,0,5,14
5462,China,2021,2021China,0,0,0,11,0,0,11,0,0,0,0,0,0,0,11
5463,China,2021,2021China,0,0,0,19,0,21,40,0,0,0,11,0,11,22,62
5464,China,2021,2021China,0,0,0,21,5,0,26,0,5,0,15,0,0,20,46
5465,China,2021,2021China,0,0,5,0,0,0,5,0,9,0,0,0,0,9,14
5466,China,2021,2021China,0,5,0,26,0,0,31,0,7,0,33,0,0,40,71
5467,China,2021,2021China,0,7,0,65,16,0,88,5,5,5,70,8,0,93,181
5468,China,2021,2021China,5,8,13,603,22,63,714,19,14,20,849,35,48,985,5925
5469,China,2021,2021China,37,54,33,705,68,0,897,38,63,52,834,135,0,1122,2019
5470,China,2021,2021China,100,56,30,512,7,0,705,92,72,36,580,10,0,790,2443
5471,Colombia,2001,2001Colombia,0,0,0,0,0,0,0,0,0,0,0,0,0,0,16348
5472,Colombia,2001,2001Colombia,0,0,0,0,0,30,30,0,0,0,0,0,32,32,62
5473,Colombia,2001,2001Colombia,0,0,0,0,0,81,81,0,0,0,0,0,105,105,186
5474,Colombia,2001,2001Colombia,0,0,0,0,0,98,98,0,0,0,0,0,155,155,253
5475,Colombia,2001,2001Colombia,0,0,0,5,0,0,5,0,0,0,0,0,0,0,5
5476,Colombia,2001,2001Colombia,0,0,0,5,0,0,5,0,0,6,7,0,0,13,18
5477,Colombia,2001,2001Colombia,0,0,0,6,0,0,6,0,7,0,0,0,0,7,13
5478,Colombia,2001,2001Colombia,0,0,0,7,0,0,7,0,0,5,9,0,0,14,21
5479,Colombia,2001,2001Colombia,0,5,0,0,0,0,5,0,0,0,0,0,0,0,5
5480,Colombia,2001,2001Colombia,0,5,0,7,0,0,12,0,0,9,6,0,0,15,51
5481,Colombia,2001,2001Colombia,0,5,0,19,5,0,29,0,5,6,54,0,0,65,94
5482,Colombia,2001,2001Colombia,44,93,90,183,17,0,427,48,94,75,216,21,0,454,881
5483,Colombia,2002,2002Colombia,0,0,0,0,0,0,0,0,0,0,0,0,0,0,21581
5484,Colombia,2002,2002Colombia,0,0,0,0,0,0,0,0,0,5,0,0,0,5,5
5485,Colombia,2002,2002Colombia,0,0,0,0,0,0,0,0,5,0,0,0,0,5,5
5486,Colombia,2002,2002Colombia,0,0,0,0,0,80,80,0,0,0,0,0,94,94,201
5487,Colombia,2002,2002Colombia,0,0,0,0,0,99,99,0,0,0,0,0,165,165,264
5488,Colombia,2002,2002Colombia,0,0,0,5,0,0,5,0,0,0,0,0,0,0,5
5489,Colombia,2002,2002Colombia,0,0,0,7,0,0,7,0,0,5,9,0,0,14,21
5490,Colombia,2002,2002Colombia,0,0,0,7,0,0,7,0,0,5,11,0,0,16,23
5491,Colombia,2002,2002Colombia,0,0,0,7,0,0,7,0,6,0,5,0,0,11,18
5492,Colombia,2002,2002Colombia,0,0,0,14,0,0,14,8,0,0,15,0,0,23,72
5493,Colombia,2002,2002Colombia,0,5,0,23,5,0,33,0,5,6,70,0,0,81,114
5494,Colombia,2002,2002Colombia,48,92,92,211,15,0,458,50,112,96,255,18,0,531,989
5495,Colombia,2002,2002Colombia,76,234,204,1755,42,0,2311,74,250,221,2127,41,0,2713,7326
5496,Colombia,2003,2003Colombia,0,0,0,0,0,0,0,0,0,0,0,0,0,0,36536
5497,Colombia,2003,2003Colombia,0,0,0,0,0,0,0,0,5,0,0,0,0,5,5
5498,Colombia,2003,2003Colombia,0,0,0,0,0,95,95,0,0,0,0,0,100,100,220
5499,Colombia,2003,2003Colombia,0,0,0,0,0,99,99,0,0,0,0,0,163,163,262
5500,Colombia,2003,2003Colombia,0,0,0,7,0,0,7,0,0,5,9,0,0,14,21
5501,Colombia,2003,2003Colombia,0,0,0,7,0,0,7,9,0,0,0,0,0,9,16
5502,Colombia,2003,2003Colombia,0,0,0,20,0,0,20,0,5,0,23,0,0,28,48
5503,Colombia,2003,2003Colombia,0,0,5,5,0,0,10,7,0,0,7,0,0,14,24
5504,Colombia,2003,2003Colombia,36,77,73,152,15,25,378,44,99,88,230,16,5,482,860
5505,Colombia,2004,2004Colombia,0,0,0,0,0,0,0,0,0,0,0,0,0,0,36651
5506,Colombia,2004,2004Colombia,0,0,0,0,0,0,0,0,0,0,5,0,0,5,5
5507,Colombia,2004,2004Colombia,0,0,0,0,0,0,0,0,0,0,8,0,0,8,8
5508,Colombia,2004,2004Colombia,0,0,0,0,0,0,0,0,5,0,0,0,0,5,5
5509,Colombia,2004,2004Colombia,0,0,0,5,0,0,5,0,0,0,8,0,0,8,13
5510,Colombia,2004,2004Colombia,0,0,0,6,0,0,6,0,0,0,0,0,0,0,6
5511,Colombia,2004,2004Colombia,0,0,0,7,0,0,7,0,0,5,9,0,0,14,199
5512,Colombia,2004,2004Colombia,0,0,0,9,0,0,9,0,0,0,15,0,0,15,24
5513,Colombia,2004,2004Colombia,0,0,5,7,0,96,108,0,0,6,6,0,101,113,221
5514,Colombia,2004,2004Colombia,0,0,5,11,0,0,16,0,5,0,13,0,0,18,34
5515,Colombia,2004,2004Colombia,0,0,6,10,0,0,16,0,0,0,0,0,0,0,1022
5516,Colombia,2004,2004Colombia,0,5,0,21,0,0,26,0,5,0,24,0,0,29,55
5517,Colombia,2004,2004Colombia,0,6,6,12,0,0,24,10,5,5,22,0,0,42,66
5518,Colombia,2004,2004Colombia,5,7,6,41,0,0,59,5,9,8,108,0,0,130,189
5519,Colombia,2004,2004Colombia,5,8,8,38,5,0,64,5,6,6,46,5,0,68,132
5520,Colombia,2004,2004Colombia,98,578,497,2612,98,0,3883,110,515,442,3665,135,0,4867,8750
5521,Colombia,2005,2005Colombia,0,0,0,0,0,0,0,0,0,0,0,0,0,0,58036
5522,Colombia,2005,2005Colombia,0,0,0,0,0,0,0,0,0,0,5,0,0,5,5
5523,Colombia,2005,2005Colombia,0,0,0,0,0,0,0,0,5,0,0,0,0,5,5
5524,Colombia,2005,2005Colombia,0,0,0,0,0,119,119,0,0,0,0,0,176,176,295
5525,Colombia,2005,2005Colombia,0,0,0,5,0,0,5,0,0,0,5,0,0,5,10
5526,Colombia,2005,2005Colombia,0,0,0,5,0,0,5,0,0,0,7,0,0,7,12
5527,Colombia,2005,2005Colombia,0,0,0,7,0,0,7,0,0,0,13,0,0,13,20
5528,Colombia,2005,2005Colombia,0,0,0,22,0,0,22,0,0,7,19,0,0,26,48
5529,Colombia,2005,2005Colombia,0,0,5,10,0,0,15,0,5,0,20,0,0,25,40
5530,Colombia,2005,2005Colombia,0,0,6,23,0,0,29,0,7,0,27,0,0,34,63
5531,Colombia,2005,2005Colombia,0,5,0,12,0,99,116,0,0,6,6,0,114,126,242
5532,Colombia,2005,2005Colombia,5,6,5,27,0,0,43,11,6,6,52,0,0,75,118
5533,Colombia,2005,2005Colombia,5,31,27,118,0,0,181,7,22,19,187,0,0,235,416
5534,Colombia,2005,2005Colombia,80,100,85,248,21,0,534,83,88,77,319,36,0,603,1137
5535,Colombia,2006,2006Colombia,0,0,0,0,0,0,0,0,0,0,0,0,0,0,68635
5536,Colombia,2006,2006Colombia,0,0,0,0,0,0,0,0,5,0,0,0,0,5,5
5537,Colombia,2006,2006Colombia,0,0,0,0,0,21,21,0,0,0,0,0,33,33,54
5538,Colombia,2006,2006Colombia,0,0,0,0,0,122,122,0,0,0,0,0,133,133,255
5539,Colombia,2006,2006Colombia,0,0,0,0,0,143,143,0,0,0,0,0,194,194,337
5540,Colombia,2006,2006Colombia,0,0,0,0,0,193,193,0,0,0,0,0,222,222,415
5541,Colombia,2006,2006Colombia,0,0,0,5,0,0,5,0,0,0,5,0,0,5,10
5542,Colombia,2006,2006Colombia,0,0,0,5,0,0,5,0,0,0,7,0,0,7,12
5543,Colombia,2006,2006Colombia,0,0,5,8,0,0,13,0,7,0,25,0,0,32,45
5544,Colombia,2006,2006Colombia,0,0,5,12,0,0,17,0,0,5,19,0,0,24,41
5545,Colombia,2006,2006Colombia,0,0,6,43,5,0,54,0,5,6,34,0,0,45,99
5546,Colombia,2006,2006Colombia,0,9,0,36,5,0,50,0,5,12,33,0,0,50,100
5547,Colombia,2006,2006Colombia,0,10,10,43,0,0,63,6,13,13,57,0,0,89,152
5548,Colombia,2006,2006Colombia,21,52,49,215,0,0,337,24,52,34,272,0,0,382,725
5549,Colombia,2006,2006Colombia,24,52,61,170,6,0,313,31,58,57,187,14,0,347,660
5550,Colombia,2006,2006Colombia,87,91,98,301,26,0,603,87,79,90,348,41,0,645,1248
5551,Colombia,2007,2007Colombia,0,0,0,0,0,0,0,0,0,0,0,0,0,0,41238
5552,Colombia,2007,2007Colombia,0,0,0,0,0,0,0,0,0,0,8,0,0,8,8
5553,Colombia,2007,2007Colombia,0,0,0,0,0,0,0,0,0,5,0,0,0,5,5
5554,Colombia,2007,2007Colombia,0,0,0,0,0,0,0,0,5,0,0,0,0,5,5
5555,Colombia,2007,2007Colombia,0,0,0,0,0,16,16,0,0,0,0,0,21,21,37
5556,Colombia,2007,2007Colombia,0,0,0,0,0,158,158,0,0,0,0,0,210,210,368
5557,Colombia,2007,2007Colombia,0,0,0,6,0,0,6,0,0,0,11,0,0,11,17
5558,Colombia,2007,2007Colombia,0,0,5,15,0,0,20,0,0,5,24,0,0,29,49
5559,Colombia,2007,2007Colombia,0,0,5,15,0,0,20,0,5,6,36,0,0,47,67
5560,Colombia,2007,2007Colombia,0,0,13,33,7,0,53,5,0,8,70,5,0,88,147
5561,Colombia,2007,2007Colombia,0,5,0,6,0,113,124,0,0,0,5,0,137,142,266
5562,Colombia,2007,2007Colombia,0,6,6,55,5,0,72,0,9,17,54,0,0,80,152
5563,Colombia,2007,2007Colombia,0,13,13,51,0,0,77,7,20,18,73,0,0,118,195
5564,Colombia,2007,2007Colombia,9,42,17,145,0,0,213,13,39,22,198,13,0,285,17498
5565,Colombia,2007,2007Colombia,26,57,64,236,10,0,393,37,65,68,263,17,0,450,200843
5566,Colombia,2007,2007Colombia,35,60,50,283,0,0,428,31,60,38,391,0,0,520,948
5567,Colombia,2007,2007Colombia,90,177,138,114,42,0,561,156,156,178,199,34,0,723,15904
5568,Colombia,2007,2007Colombia,185,429,429,2999,88,0,4130,273,560,560,3943,273,0,5609,9739
5569,Colombia,2007,2007Colombia,257,1065,819,4332,161,0,6634,277,1108,944,4981,300,0,7610,264255
5570,Colombia,2008,2008Colombia,0,0,0,0,0,0,0,0,0,0,0,0,0,0,44708
5571,Colombia,2008,2008Colombia,0,0,0,0,0,0,0,0,0,0,0,5,0,5,5
5572,Colombia,2008,2008Colombia,0,0,0,0,0,0,0,0,0,5,0,0,0,5,5
5573,Colombia,2008,2008Colombia,0,0,0,0,0,0,0,0,5,0,0,0,0,5,5
5574,Colombia,2008,2008Colombia,0,0,0,0,0,13,13,0,0,0,0,0,16,16,29
5575,Colombia,2008,2008Colombia,0,0,0,0,0,169,169,0,0,0,0,0,228,228,397
5576,Colombia,2008,2008Colombia,0,0,0,6,0,523,529,0,0,0,0,0,565,565,201094
5577,Colombia,2008,2008Colombia,0,0,0,7,0,0,7,0,0,0,6,0,0,6,13
5578,Colombia,2008,2008Colombia,0,0,5,15,0,0,20,0,0,5,24,0,0,29,49
5579,Colombia,2008,2008Colombia,0,0,13,22,0,0,35,0,5,16,41,0,0,62,97
5580,Colombia,2008,2008Colombia,0,5,0,0,0,0,5,0,0,0,9,0,0,9,14
5581,Colombia,2008,2008Colombia,0,9,25,59,0,0,93,0,27,20,92,0,0,139,232
5582,Colombia,2008,2008Colombia,5,0,0,8,0,133,146,0,0,5,5,0,142,152,298
5583,Colombia,2008,2008Colombia,5,5,10,50,8,0,78,0,5,10,78,7,0,100,178
5584,Colombia,2008,2008Colombia,9,44,19,150,0,0,222,13,41,25,215,13,0,307,529
5585,Colombia,2008,2008Colombia,28,67,177,245,65,0,582,28,70,219,335,69,0,721,15303
5586,Colombia,2008,2008Colombia,189,437,437,3061,90,0,4214,278,572,572,4025,278,0,5725,9939
5587,Colombia,2008,2008Colombia,418,1354,1065,5584,208,0,8629,426,1411,1226,6247,360,0,9670,100637
5588,Colombia,2009,2009Colombia,0,0,0,0,0,0,0,0,0,0,0,0,0,0,45409
5589,Colombia,2009,2009Colombia,0,0,0,0,0,0,0,0,0,0,6,0,0,6,6
5590,Colombia,2009,2009Colombia,0,0,0,0,0,0,0,0,0,5,0,0,0,5,5
5591,Colombia,2009,2009Colombia,0,0,0,0,0,0,0,0,5,0,0,0,0,5,10
5592,Colombia,2009,2009Colombia,0,0,0,0,0,14,14,0,0,0,0,0,18,18,32
5593,Colombia,2009,2009Colombia,0,0,0,5,0,0,5,0,0,0,13,0,0,13,18
5594,Colombia,2009,2009Colombia,0,0,0,7,0,0,7,0,0,0,0,0,0,0,7
5595,Colombia,2009,2009Colombia,0,0,7,20,5,0,32,0,0,9,27,0,0,36,68
5596,Colombia,2009,2009Colombia,0,0,8,0,0,593,601,0,0,0,0,0,643,643,201244
5597,Colombia,2009,2009Colombia,0,0,11,33,0,0,44,0,5,16,45,0,0,66,110
5598,Colombia,2009,2009Colombia,0,5,0,7,0,133,145,0,0,5,5,0,135,145,290
5599,Colombia,2009,2009Colombia,0,9,30,73,0,0,112,0,28,25,110,0,0,163,275
5600,Colombia,2009,2009Colombia,0,16,21,87,8,0,132,5,9,14,69,0,0,97,229
5601,Colombia,2009,2009Colombia,5,8,16,51,8,0,88,0,5,19,88,10,0,122,210
5602,Colombia,2009,2009Colombia,10,49,25,174,0,0,258,16,48,25,236,14,0,339,597
5603,Colombia,2009,2009Colombia,28,66,177,244,65,0,580,29,70,218,332,70,0,719,15299
5604,Colombia,2009,2009Colombia,194,449,449,3141,92,0,4325,285,586,586,4131,286,0,5874,10199
5605,Colombia,2009,2009Colombia,883,2773,2427,14612,609,0,21304,894,2790,2660,15872,860,0,23076,115745
5606,Colombia,2010,2010Colombia,0,0,0,0,0,0,0,0,0,0,0,0,0,0,45623
5607,Colombia,2010,2010Colombia,0,0,0,0,0,0,0,0,0,5,0,0,0,5,5
5608,Colombia,2010,2010Colombia,0,0,0,0,0,0,0,0,5,0,0,0,0,5,15
5609,Colombia,2010,2010Colombia,0,0,0,0,0,13,13,0,0,0,0,0,20,20,33
5610,Colombia,2010,2010Colombia,0,0,0,0,0,182,182,0,0,0,0,0,254,254,436
5611,Colombia,2010,2010Colombia,0,0,0,5,0,700,705,0,0,0,5,0,757,762,201467
5612,Colombia,2010,2010Colombia,0,0,0,6,0,0,6,0,0,0,0,0,0,0,6
5613,Colombia,2010,2010Colombia,0,0,0,7,0,0,7,0,0,0,24,0,0,24,31
5614,Colombia,2010,2010Colombia,0,0,9,22,5,0,36,0,5,6,35,0,0,46,82
5615,Colombia,2010,2010Colombia,0,5,0,6,0,139,150,0,0,5,5,0,150,160,310
5616,Colombia,2010,2010Colombia,0,7,17,70,0,0,94,0,8,13,118,0,0,139,233
5617,Colombia,2010,2010Colombia,0,9,33,83,0,0,125,5,27,26,124,0,0,182,307
5618,Colombia,2010,2010Colombia,0,13,12,34,0,0,59,0,7,23,38,0,0,68,127
5619,Colombia,2010,2010Colombia,0,18,25,91,9,0,143,6,7,13,84,0,0,110,253
5620,Colombia,2010,2010Colombia,10,33,34,188,5,0,270,5,50,34,237,6,0,332,602
5621,Colombia,2010,2010Colombia,30,74,195,271,71,0,641,30,79,242,365,75,0,791,15432
5622,Colombia,2010,2010Colombia,195,456,456,3145,78,0,4330,285,596,596,4137,270,0,5884,10214
5623,Colombia,2010,2010Colombia,779,3183,2788,17421,820,0,24991,791,3157,3055,18965,1100,0,27068,120403
5624,Colombia,2011,2011Colombia,0,0,0,0,0,0,0,0,0,0,0,0,0,0,25247
5625,Colombia,2011,2011Colombia,0,0,0,0,0,0,0,0,0,0,8,0,0,8,8
5626,Colombia,2011,2011Colombia,0,0,0,0,0,0,0,0,0,5,0,0,0,5,5
5627,Colombia,2011,2011Colombia,0,0,0,0,0,0,0,0,5,0,0,0,0,5,15
5628,Colombia,2011,2011Colombia,0,0,0,0,0,17,17,0,0,0,0,0,22,22,39
5629,Colombia,2011,2011Colombia,0,0,0,0,0,191,191,0,0,0,0,0,264,264,455
5630,Colombia,2011,2011Colombia,0,0,0,7,0,149,156,0,0,0,8,0,160,168,324
5631,Colombia,2011,2011Colombia,0,0,5,0,0,0,5,0,0,0,0,0,0,0,5
5632,Colombia,2011,2011Colombia,0,0,5,5,0,920,930,0,0,5,6,0,1000,1011,201941
5633,Colombia,2011,2011Colombia,0,5,5,8,0,0,18,0,0,5,17,0,0,22,40
5634,Colombia,2011,2011Colombia,0,5,5,23,5,0,38,0,0,10,38,0,0,48,86
5635,Colombia,2011,2011Colombia,0,5,10,66,6,0,87,0,10,9,81,5,0,105,456
5636,Colombia,2011,2011Colombia,0,7,17,69,0,0,93,0,8,14,119,0,0,141,252
5637,Colombia,2011,2011Colombia,0,7,18,41,0,0,66,0,7,23,52,0,0,82,148
5638,Colombia,2011,2011Colombia,0,9,33,84,0,0,126,5,27,26,124,0,0,182,308
5639,Colombia,2011,2011Colombia,0,16,23,83,11,0,133,0,10,14,80,5,0,109,242
5640,Colombia,2011,2011Colombia,10,33,34,194,5,0,276,5,50,34,283,6,0,378,654
5641,Colombia,2011,2011Colombia,34,82,220,300,79,0,715,34,88,267,406,88,0,883,15598
5642,Colombia,2011,2011Colombia,38,125,181,930,62,0,1336,36,142,216,909,39,0,1342,17243
5643,Colombia,2011,2011Colombia,196,458,466,3164,83,0,4367,286,598,610,4157,279,0,5930,10297
5644,Colombia,2011,2011Colombia,254,1363,1330,8148,407,0,11502,262,1363,1455,8867,553,0,12500,122587
5645,Colombia,2012,2012Colombia,0,0,0,0,0,0,0,0,0,0,0,0,0,0,20671
5646,Colombia,2012,2012Colombia,0,0,0,0,0,0,0,0,0,0,6,0,0,6,6
5647,Colombia,2012,2012Colombia,0,0,0,0,0,0,0,0,0,0,7,0,0,7,7
5648,Colombia,2012,2012Colombia,0,0,0,0,0,0,0,0,0,0,8,0,0,8,8
5649,Colombia,2012,2012Colombia,0,0,0,0,0,0,0,0,0,5,0,0,0,5,5
5650,Colombia,2012,2012Colombia,0,0,0,0,0,17,17,0,0,0,0,0,22,22,39
5651,Colombia,2012,2012Colombia,0,0,0,0,0,200,200,0,0,0,0,0,276,276,476
5652,Colombia,2012,2012Colombia,0,0,0,5,0,0,5,0,0,0,0,0,0,0,5
5653,Colombia,2012,2012Colombia,0,0,0,5,0,156,161,0,0,0,6,0,160,166,327
5654,Colombia,2012,2012Colombia,0,0,9,21,0,1676,1706,0,5,6,21,0,1825,1857,203563
5655,Colombia,2012,2012Colombia,0,5,5,8,0,0,18,0,0,5,17,0,0,22,40
5656,Colombia,2012,2012Colombia,0,6,8,26,5,0,45,0,0,11,38,0,0,49,94
5657,Colombia,2012,2012Colombia,0,6,21,76,0,0,103,0,8,18,113,0,0,139,247
5658,Colombia,2012,2012Colombia,0,8,0,0,0,0,8,0,0,0,0,0,0,0,8
5659,Colombia,2012,2012Colombia,0,11,18,92,12,0,133,0,12,9,82,5,0,108,241
5660,Colombia,2012,2012Colombia,0,11,28,166,16,0,221,0,11,38,203,7,0,259,497
5661,Colombia,2012,2012Colombia,5,12,37,111,0,0,165,5,32,34,177,0,0,248,413
5662,Colombia,2012,2012Colombia,5,14,10,50,0,0,79,5,11,19,54,0,0,89,168
5663,Colombia,2012,2012Colombia,8,30,23,168,11,0,240,6,20,36,175,5,0,242,17563
5664,Colombia,2012,2012Colombia,10,40,45,216,5,0,316,10,57,41,312,6,0,426,742
5665,Colombia,2012,2012Colombia,36,88,237,327,84,0,772,35,93,293,436,94,0,951,15723
5666,Colombia,2012,2012Colombia,155,1250,1385,8363,458,0,11611,147,1290,1445,9149,620,0,12651,122964
5667,Colombia,2012,2012Colombia,196,459,468,3164,83,0,4370,286,599,611,4160,279,0,5935,10305
5668,Colombia,2013,2013Colombia,0,0,0,0,0,0,0,0,0,0,0,0,0,0,16550
5669,Colombia,2013,2013Colombia,0,0,0,0,0,0,0,0,0,0,6,0,0,6,6
5670,Colombia,2013,2013Colombia,0,0,0,0,0,0,0,0,0,0,9,0,0,9,9
5671,Colombia,2013,2013Colombia,0,0,0,0,0,0,0,0,0,5,0,0,0,5,5
5672,Colombia,2013,2013Colombia,0,0,0,0,0,12,12,0,0,0,0,0,16,16,28
5673,Colombia,2013,2013Colombia,0,0,0,0,0,198,198,0,0,0,0,0,282,282,480
5674,Colombia,2013,2013Colombia,0,0,0,5,0,0,5,0,0,0,0,0,0,0,5
5675,Colombia,2013,2013Colombia,0,0,0,5,0,143,148,0,0,0,6,0,154,160,308
5676,Colombia,2013,2013Colombia,0,0,0,6,0,0,6,0,0,0,0,0,0,0,6
5677,Colombia,2013,2013Colombia,0,0,5,0,0,0,5,0,0,0,0,0,0,0,5
5678,Colombia,2013,2013Colombia,0,5,5,8,0,0,18,0,0,5,17,0,0,22,40
5679,Colombia,2013,2013Colombia,0,5,9,36,5,0,55,0,5,10,45,0,0,60,115
5680,Colombia,2013,2013Colombia,0,6,5,22,0,0,33,0,9,0,23,5,0,37,70
5681,Colombia,2013,2013Colombia,0,6,9,28,0,1997,2040,5,5,7,29,0,2173,2219,204259
5682,Colombia,2013,2013Colombia,0,6,21,79,0,0,106,0,8,19,122,0,0,149,255
5683,Colombia,2013,2013Colombia,5,11,39,116,0,0,171,6,35,36,188,0,0,265,436
5684,Colombia,2013,2013Colombia,5,13,31,186,18,0,253,5,17,39,205,7,0,273,526
5685,Colombia,2013,2013Colombia,5,15,15,47,0,0,82,5,11,21,59,0,0,96,178
5686,Colombia,2013,2013Colombia,15,26,37,171,10,0,259,9,29,56,168,5,0,267,17381
5687,Colombia,2013,2013Colombia,34,58,51,358,15,0,516,32,56,57,480,6,0,631,1147
5688,Colombia,2013,2013Colombia,41,98,266,380,94,0,879,40,105,328,501,104,0,1078,15957
5689,Colombia,2013,2013Colombia,74,1170,1374,8300,485,0,11403,78,1177,1431,9101,655,0,12442,122359
5690,Colombia,2013,2013Colombia,122,287,292,1974,52,0,2727,178,373,382,2599,175,0,3707,16586
5691,Colombia,2014,2014Colombia,0,0,0,0,0,0,0,0,0,0,0,0,0,0,151037
5692,Colombia,2014,2014Colombia,0,0,0,0,0,0,0,0,0,0,5,0,0,5,5
5693,Colombia,2014,2014Colombia,0,0,0,0,0,194,194,0,0,0,0,0,276,276,470
5694,Colombia,2014,2014Colombia,0,0,0,5,0,0,5,0,0,0,0,0,0,0,5
5695,Colombia,2014,2014Colombia,0,0,0,5,0,0,5,0,0,0,5,0,0,5,10
5696,Colombia,2014,2014Colombia,0,0,0,5,0,140,145,0,0,0,6,0,151,157,302
5697,Colombia,2014,2014Colombia,0,0,0,8,0,0,8,0,0,0,0,0,0,0,8
5698,Colombia,2014,2014Colombia,0,0,5,10,0,0,15,0,0,5,7,0,0,12,27
5699,Colombia,2014,2014Colombia,0,0,8,18,0,0,26,0,8,0,23,6,0,37,63
5700,Colombia,2014,2014Colombia,0,0,43,393,10,0,446,0,22,33,689,10,0,754,1200
5701,Colombia,2014,2014Colombia,0,5,10,42,5,0,62,0,5,10,53,0,0,68,130
5702,Colombia,2014,2014Colombia,0,6,21,79,0,0,106,0,8,19,122,0,0,149,255
5703,Colombia,2014,2014Colombia,0,9,0,8,0,0,17,0,0,5,17,0,0,22,39
5704,Colombia,2014,2014Colombia,5,7,10,45,0,1789,1856,5,9,14,42,5,2034,2109,173519
5705,Colombia,2014,2014Colombia,5,16,11,52,0,0,84,5,14,21,60,0,0,100,184
5706,Colombia,2014,2014Colombia,5,16,33,192,18,0,264,5,19,40,215,8,0,287,551
5707,Colombia,2014,2014Colombia,6,13,45,142,0,0,206,8,44,38,211,0,0,301,507
5708,Colombia,2014,2014Colombia,17,21,20,130,6,0,194,19,23,27,143,0,0,212,16428
5709,Colombia,2014,2014Colombia,26,73,215,303,76,0,693,26,80,267,404,81,0,858,15551
5710,Colombia,2015,2015Colombia,0,0,0,0,0,0,0,0,0,0,0,0,0,0,27068
5711,Colombia,2015,2015Colombia,0,0,0,0,0,0,0,0,0,0,5,0,0,5,5
5712,Colombia,2015,2015Colombia,0,0,0,0,0,0,0,0,0,0,6,0,0,6,6
5713,Colombia,2015,2015Colombia,0,0,0,0,0,13,13,0,0,0,0,0,23,23,36
5714,Colombia,2015,2015Colombia,0,0,0,0,0,138,138,0,0,0,0,6,130,136,274
5715,Colombia,2015,2015Colombia,0,0,0,0,0,197,197,0,0,0,0,0,278,278,475
5716,Colombia,2015,2015Colombia,0,0,0,5,0,0,5,0,0,0,7,0,0,7,12
5717,Colombia,2015,2015Colombia,0,0,0,6,0,0,6,0,0,0,0,0,0,0,6
5718,Colombia,2015,2015Colombia,0,0,6,14,5,0,25,0,6,0,24,6,0,36,61
5719,Colombia,2015,2015Colombia,0,0,7,12,0,0,19,0,0,0,15,0,0,15,34
5720,Colombia,2015,2015Colombia,0,5,9,47,5,0,66,0,0,14,55,5,0,74,140
5721,Colombia,2015,2015Colombia,0,6,0,6,0,0,12,0,0,5,17,0,0,22,34
5722,Colombia,2015,2015Colombia,0,10,23,57,0,0,90,0,10,23,70,0,0,103,193
5723,Colombia,2015,2015Colombia,0,12,23,199,23,0,257,0,14,35,226,9,0,284,541
5724,Colombia,2015,2015Colombia,0,58,81,253,5,0,397,0,57,13,808,5,0,883,1280
5725,Colombia,2015,2015Colombia,6,13,21,74,5,2986,3105,8,17,28,74,6,3375,3508,173673
5726,Colombia,2015,2015Colombia,29,78,212,314,79,0,712,29,85,265,418,84,0,881,15593
5727,Colombia,2015,2015Colombia,102,3602,10236,9071,583,0,23594,110,3667,10160,11556,830,0,26323,120685
5728,Colombia,2016,2016Colombia,0,0,0,0,0,0,0,0,0,0,0,0,0,0,110096
5729,Colombia,2016,2016Colombia,0,0,0,0,0,0,0,0,0,0,5,0,0,5,5
5730,Colombia,2016,2016Colombia,0,0,0,0,0,0,0,0,0,0,6,0,0,6,6
5731,Colombia,2016,2016Colombia,0,0,0,0,0,13,13,0,0,0,0,0,20,20,33
5732,Colombia,2016,2016Colombia,0,0,0,0,0,122,122,0,0,0,7,0,137,144,266
5733,Colombia,2016,2016Colombia,0,0,0,0,0,196,196,0,0,0,0,0,276,276,472
5734,Colombia,2016,2016Colombia,0,0,0,0,0,934,934,0,0,0,0,0,1401,1401,2335
5735,Colombia,2016,2016Colombia,0,0,0,6,0,0,6,0,0,0,0,0,0,0,6
5736,Colombia,2016,2016Colombia,0,0,0,6,0,0,6,0,0,0,7,0,0,7,13
5737,Colombia,2016,2016Colombia,0,0,5,21,0,0,26,0,9,0,24,6,0,39,65
5738,Colombia,2016,2016Colombia,0,0,6,13,0,0,19,0,5,0,11,0,0,16,35
5739,Colombia,2016,2016Colombia,0,0,8,73,0,0,81,0,0,11,77,0,0,88,8228
5740,Colombia,2016,2016Colombia,0,5,7,46,5,0,63,0,0,8,59,5,0,72,135
5741,Colombia,2016,2016Colombia,0,9,22,205,23,0,259,0,11,33,230,9,0,283,542
5742,Colombia,2016,2016Colombia,0,58,82,257,5,0,402,0,58,13,810,5,0,886,1288
5743,Colombia,2016,2016Colombia,22,32,46,60,7,3546,3713,6,7,11,152,42,3797,4015,171920
5744,Colombia,2016,2016Colombia,29,78,215,318,81,0,721,29,86,268,425,85,0,893,15614
5745,Colombia,2017,2017Colombia,0,0,0,0,0,0,0,0,0,0,0,0,0,0,15489
5746,Colombia,2017,2017Colombia,0,0,0,0,0,0,0,0,0,0,5,0,0,5,1296
5747,Colombia,2017,2017Colombia,0,0,0,0,0,8,8,0,0,0,0,0,0,0,8
5748,Colombia,2017,2017Colombia,0,0,0,0,0,127,127,0,0,0,7,0,120,127,254
5749,Colombia,2017,2017Colombia,0,0,0,0,0,207,207,0,0,0,0,0,281,281,488
5750,Colombia,2017,2017Colombia,0,0,0,0,0,936,936,0,0,0,0,0,1404,1404,2340
5751,Colombia,2017,2017Colombia,0,0,0,6,0,0,6,0,0,0,0,0,0,0,6
5752,Colombia,2017,2017Colombia,0,0,0,6,0,0,6,0,0,0,8,0,0,8,14
5753,Colombia,2017,2017Colombia,0,5,5,50,5,0,65,0,0,6,64,6,0,76,141
5754,Colombia,2017,2017Colombia,0,6,0,7,0,0,13,0,0,5,17,0,0,22,35
5755,Colombia,2017,2017Colombia,0,6,20,209,25,0,260,0,11,26,236,11,0,284,544
5756,Colombia,2017,2017Colombia,5,0,0,23,0,0,28,0,5,5,23,6,0,39,67
5757,Colombia,2017,2017Colombia,5,462,1273,8619,771,0,11130,5,471,1292,9765,1056,0,12589,46616
5758,Colombia,2017,2017Colombia,33,62,85,579,27,0,786,30,77,103,640,24,0,874,1660
5759,Colombia,2017,2017Colombia,35,47,64,89,12,1646,1893,38,51,69,94,13,1764,2029,122677
5760,Colombia,2018,2018Colombia,0,0,0,0,0,0,0,0,0,0,0,0,0,0,12006
5761,Colombia,2018,2018Colombia,0,0,0,0,0,0,0,0,0,0,5,0,0,5,5
5762,Colombia,2018,2018Colombia,0,0,0,0,0,0,0,0,0,5,0,0,0,5,5
5763,Colombia,2018,2018Colombia,0,0,0,0,0,104,104,0,0,0,8,0,116,124,228
5764,Colombia,2018,2018Colombia,0,0,0,0,0,228,228,0,0,0,0,0,299,299,527
5765,Colombia,2018,2018Colombia,0,0,0,6,0,0,6,0,0,0,0,0,0,0,6
5766,Colombia,2018,2018Colombia,0,0,11,54,5,0,70,0,0,8,65,6,0,79,149
5767,Colombia,2018,2018Colombia,0,5,0,15,5,0,25,0,5,5,25,6,0,41,66
5768,Colombia,2018,2018Colombia,0,5,22,206,27,0,260,0,7,26,243,11,0,287,547
5769,Colombia,2018,2018Colombia,17,68,45,291,18,0,439,23,63,65,289,8,0,448,7356
5770,Colombia,2018,2018Colombia,68,276,375,1430,60,0,2209,80,315,363,1425,76,0,2259,50532
5771,Colombia,2018,2018Colombia,4833,6447,8055,11283,1612,0,32230,5238,6987,8732,12222,1747,0,34926,67156
5772,Colombia,2019,2019Colombia,0,0,0,0,0,0,0,0,0,0,0,0,0,0,118771
5773,Colombia,2019,2019Colombia,0,0,0,0,0,0,0,0,0,0,5,0,0,5,5
5774,Colombia,2019,2019Colombia,0,0,0,0,0,0,0,0,0,5,0,0,0,5,5
5775,Colombia,2019,2019Colombia,0,0,0,0,0,262,262,0,0,0,0,0,325,325,587
5776,Colombia,2019,2019Colombia,0,0,0,6,0,0,6,0,0,0,0,0,0,0,6
5777,Colombia,2019,2019Colombia,0,0,0,41,0,0,41,0,0,5,20,0,0,25,1227
5778,Colombia,2019,2019Colombia,0,0,5,5,0,0,10,0,0,0,12,0,0,12,246
5779,Colombia,2019,2019Colombia,0,0,8,62,5,0,75,0,0,8,68,7,0,83,158
5780,Colombia,2019,2019Colombia,0,5,0,17,6,0,28,0,5,5,24,7,0,41,69
5781,Colombia,2019,2019Colombia,0,5,15,217,28,0,265,0,6,18,254,15,0,293,558
5782,Colombia,2019,2019Colombia,5035,6716,8395,11769,1679,0,33594,5100,6801,8501,11924,1702,0,34028,67622
5783,Colombia,2020,2020Colombia,0,0,0,0,0,0,0,0,0,0,0,0,0,0,12005
5784,Colombia,2020,2020Colombia,0,0,0,0,0,0,0,0,0,0,5,0,0,5,10
5785,Colombia,2020,2020Colombia,0,0,0,0,0,50,50,0,0,0,0,0,55,55,105
5786,Colombia,2020,2020Colombia,0,0,0,6,0,0,6,0,0,0,0,0,0,0,6
5787,Colombia,2020,2020Colombia,0,0,5,18,7,0,30,0,0,9,23,7,0,39,69
5788,Colombia,2020,2020Colombia,0,0,5,32,0,0,37,0,0,8,22,5,0,35,1231
5789,Colombia,2020,2020Colombia,0,0,9,63,6,0,78,0,0,6,71,7,0,84,162
5790,Colombia,2020,2020Colombia,0,5,0,11,0,0,16,0,0,5,14,0,0,19,275
5791,Colombia,2020,2020Colombia,0,5,13,214,34,0,266,0,5,17,256,16,0,294,560
5792,Colombia,2020,2020Colombia,34,51,38,253,7,59,442,28,61,39,250,0,41,419,4577
5793,Colombia,2020,2020Colombia,97,561,2397,19873,2182,0,25110,111,588,2415,21813,2944,0,27871,102931
5794,Colombia,2020,2020Colombia,5035,6716,8395,11928,1679,0,33753,5100,6801,8501,12078,1702,0,34182,67935
5795,Colombia,2021,2021Colombia,0,0,0,0,0,0,0,0,0,0,0,0,0,0,13416
5796,Colombia,2021,2021Colombia,0,0,0,0,0,0,0,0,0,0,10,0,0,10,10
5797,Colombia,2021,2021Colombia,0,0,0,8,0,0,8,0,5,0,5,0,0,10,18
5798,Colombia,2021,2021Colombia,0,0,5,21,8,0,34,0,6,5,27,7,0,45,79
5799,Colombia,2021,2021Colombia,0,0,9,61,8,0,78,0,0,5,70,9,0,84,162
5800,Colombia,2021,2021Colombia,0,5,0,12,0,0,17,0,5,0,16,0,0,21,288
5801,Colombia,2021,2021Colombia,0,5,12,212,38,0,267,0,5,13,255,21,0,294,561
5802,Colombia,2021,2021Colombia,11,32,17,193,10,0,263,25,23,19,189,11,0,267,530
5803,Colombia,2021,2021Colombia,25,74,37,480,25,0,641,25,62,37,457,12,0,593,1234
5804,Colombia,2021,2021Colombia,94,582,2203,20603,2382,0,25864,112,624,2225,22432,3234,0,28627,54491
5805,Colombia,2021,2021Colombia,103,175,156,899,35,59,1427,94,190,127,853,19,41,1324,5835
5806,Colombia,2021,2021Colombia,2959,3949,4947,7103,994,0,19952,2853,3811,4755,6867,930,0,19216,39168
5807,Congo,2001,2001Congo,0,0,0,0,0,0,0,0,0,0,0,0,0,0,2239
5808,Congo,2001,2001Congo,0,0,0,0,0,0,0,0,0,0,5,0,0,5,5
5809,Congo,2001,2001Congo,0,0,0,0,0,0,0,0,0,6,0,0,0,6,6
5810,Congo,2001,2001Congo,0,0,0,0,0,23,23,0,0,0,0,0,22,22,45
5811,Congo,2001,2001Congo,0,0,0,0,0,35,35,0,0,0,0,0,31,31,66
5812,Congo,2001,2001Congo,0,0,0,0,0,358,358,0,0,0,0,0,379,379,737
5813,Congo,2001,2001Congo,0,0,0,5,0,0,5,0,0,0,0,0,0,0,5
5814,Congo,2001,2001Congo,0,0,0,6,0,0,6,0,0,5,0,0,0,5,11
5815,Congo,2001,2001Congo,0,0,0,7,0,0,7,0,0,0,13,0,0,13,20
5816,Congo,2001,2001Congo,0,0,5,23,0,0,28,6,6,0,29,0,0,41,69
5817,Congo,2001,2001Congo,0,6,0,14,0,0,20,5,10,0,18,0,0,33,53
5818,Congo,2001,2001Congo,0,6,7,5,0,0,18,8,5,0,20,0,0,33,51
5819,Congo,2001,2001Congo,0,7,12,12,0,0,31,0,0,11,78,0,0,89,120
5820,Congo,2001,2001Congo,5,0,6,11,0,0,22,0,0,0,10,0,0,10,32
5821,Congo,2001,2001Congo,5,5,5,32,0,0,47,0,28,24,136,0,0,188,811
5822,Congo,2001,2001Congo,6,0,9,12,0,0,27,13,0,0,8,0,0,21,48
5823,Congo,2001,2001Congo,7,0,0,0,0,0,7,0,0,0,6,0,0,6,13
5824,Congo,2001,2001Congo,8,0,0,0,0,0,8,0,0,0,8,0,0,8,16
5825,Congo,2001,2001Congo,10,64,55,116,0,0,245,13,54,54,139,5,0,265,510
5826,Congo,2001,2001Congo,17,17,15,56,0,0,105,10,16,13,72,0,0,111,216
5827,Congo,2001,2001Congo,39,64,54,327,0,0,484,50,55,47,600,5,0,757,1241
5828,Congo,2001,2001Congo,186,161,138,364,13,0,862,179,187,160,519,15,0,1060,2922
5829,Congo,2001,2001Congo,655,962,837,3321,141,0,5916,603,1132,950,4006,96,0,6787,15001
5830,Congo,2002,2002Congo,0,0,0,0,0,0,0,0,0,0,0,0,0,0,4292
5831,Congo,2002,2002Congo,0,0,0,0,0,0,0,0,0,0,5,0,0,5,10
5832,Congo,2002,2002Congo,0,0,0,0,0,0,0,0,0,0,6,0,0,6,6
5833,Congo,2002,2002Congo,0,0,0,0,0,0,0,0,0,0,8,0,0,8,8
5834,Congo,2002,2002Congo,0,0,0,0,0,0,0,0,0,0,11,0,0,11,11
5835,Congo,2002,2002Congo,0,0,0,0,0,0,0,0,5,0,0,0,0,5,5
5836,Congo,2002,2002Congo,0,0,0,0,0,18,18,0,0,0,0,0,19,19,42
5837,Congo,2002,2002Congo,0,0,0,0,0,581,581,0,0,0,0,0,550,550,1131
5838,Congo,2002,2002Congo,0,0,0,7,0,0,7,0,0,0,13,0,0,13,20
5839,Congo,2002,2002Congo,0,0,5,23,0,0,28,6,6,0,29,0,0,41,69
5840,Congo,2002,2002Congo,0,7,7,5,0,0,19,8,5,0,21,0,0,34,53
5841,Congo,2002,2002Congo,0,7,7,41,0,0,55,15,59,50,37,0,0,161,927
5842,Congo,2002,2002Congo,0,7,12,12,0,0,31,0,0,11,78,0,0,89,120
5843,Congo,2002,2002Congo,5,0,9,18,0,0,32,7,0,0,14,0,0,21,53
5844,Congo,2002,2002Congo,15,0,0,12,0,0,27,11,0,0,17,0,0,28,55
5845,Congo,2002,2002Congo,15,72,62,125,6,0,280,18,58,50,156,13,0,295,575
5846,Congo,2002,2002Congo,17,16,14,55,0,0,102,10,15,13,77,0,0,115,217
5847,Congo,2002,2002Congo,41,64,54,331,0,0,490,50,54,47,597,5,0,753,1243
5848,Congo,2002,2002Congo,158,162,138,356,10,0,824,151,169,145,497,15,0,977,7212
5849,Congo,2002,2002Congo,904,1061,925,2818,110,0,5818,847,982,849,3373,76,0,6127,11945
5850,Congo,2003,2003Congo,0,0,0,0,0,0,0,0,0,0,0,0,0,0,5303
5851,Congo,2003,2003Congo,0,0,0,0,0,0,0,0,0,0,5,0,0,5,10
5852,Congo,2003,2003Congo,0,0,0,0,0,0,0,0,0,0,6,0,0,6,6
5853,Congo,2003,2003Congo,0,0,0,0,0,0,0,0,0,0,8,0,0,8,8
5854,Congo,2003,2003Congo,0,0,0,0,0,25,25,0,0,0,0,0,19,19,49
5855,Congo,2003,2003Congo,0,0,0,0,0,809,809,0,0,0,0,0,763,763,1572
5856,Congo,2003,2003Congo,0,0,7,5,0,0,12,0,5,0,18,0,0,23,35
5857,Congo,2003,2003Congo,0,5,0,23,0,0,28,6,6,0,30,0,0,42,70
5858,Congo,2003,2003Congo,0,5,5,13,0,0,23,6,5,0,17,0,0,28,51
5859,Congo,2003,2003Congo,0,5,5,19,0,0,29,7,0,0,15,0,0,22,56
5860,Congo,2003,2003Congo,0,6,7,17,0,0,30,5,11,11,33,0,0,60,90
5861,Congo,2003,2003Congo,0,7,0,0,0,0,7,0,0,0,15,0,0,15,22
5862,Congo,2003,2003Congo,0,7,7,41,0,0,55,15,59,50,37,0,0,161,1053
5863,Congo,2003,2003Congo,5,6,5,12,0,0,28,0,6,5,76,0,0,87,115
5864,Congo,2003,2003Congo,15,74,63,124,6,0,282,21,60,51,156,13,0,301,583
5865,Congo,2003,2003Congo,39,59,50,317,0,0,465,47,49,43,570,5,0,714,1179
5866,Congo,2003,2003Congo,103,90,78,213,5,0,489,120,99,86,404,17,0,726,6626
5867,Congo,2003,2003Congo,762,1101,940,2931,126,0,5860,734,997,857,3583,91,0,6262,12122
5868,Congo,2004,2004Congo,0,0,0,0,0,0,0,0,0,0,0,0,0,0,8663
5869,Congo,2004,2004Congo,0,0,0,0,0,0,0,0,0,0,5,0,0,5,15
5870,Congo,2004,2004Congo,0,0,0,0,0,0,0,0,0,0,7,0,0,7,7
5871,Congo,2004,2004Congo,0,0,0,0,0,28,28,0,0,0,5,0,22,27,55
5872,Congo,2004,2004Congo,0,0,0,6,0,0,6,5,0,0,13,0,0,18,48
5873,Congo,2004,2004Congo,0,0,0,7,0,0,7,0,0,0,15,0,0,15,22
5874,Congo,2004,2004Congo,0,0,5,8,0,0,13,0,0,8,13,0,0,21,34
5875,Congo,2004,2004Congo,0,0,7,5,0,0,12,0,5,0,28,0,0,33,45
5876,Congo,2004,2004Congo,0,5,0,0,0,0,5,0,0,0,0,0,0,0,5
5877,Congo,2004,2004Congo,0,5,6,20,0,0,31,9,0,0,16,0,0,25,56
5878,Congo,2004,2004Congo,0,8,0,13,0,0,21,0,7,0,68,0,0,75,96
5879,Congo,2004,2004Congo,0,9,0,13,0,0,22,5,0,5,16,0,0,26,48
5880,Congo,2004,2004Congo,5,0,0,5,0,0,10,5,7,6,12,0,0,30,40
5881,Congo,2004,2004Congo,5,0,0,18,0,0,23,5,5,0,29,0,0,39,62
5882,Congo,2004,2004Congo,12,33,28,112,6,0,191,16,76,66,161,29,0,348,539
5883,Congo,2004,2004Congo,40,55,47,307,0,0,449,47,48,41,550,5,0,691,1140
5884,Congo,2004,2004Congo,64,60,52,133,0,0,309,89,69,59,325,15,0,557,5277
5885,Congo,2004,2004Congo,665,1071,924,2891,136,0,5687,605,1031,891,3659,115,0,6301,11988
5886,Congo,2005,2005Congo,0,0,0,0,0,0,0,0,0,0,0,0,0,0,7109
5887,Congo,2005,2005Congo,0,0,0,0,0,0,0,0,0,0,5,0,0,5,10
5888,Congo,2005,2005Congo,0,0,0,0,0,0,0,0,0,0,6,0,0,6,6
5889,Congo,2005,2005Congo,0,0,0,0,0,0,0,0,0,0,7,0,0,7,7
5890,Congo,2005,2005Congo,0,0,0,0,0,6,6,0,0,0,0,0,0,0,6
5891,Congo,2005,2005Congo,0,0,0,0,0,1241,1241,0,0,0,0,0,1213,1213,2454
5892,Congo,2005,2005Congo,0,0,0,5,0,0,5,0,0,0,13,0,0,13,53
5893,Congo,2005,2005Congo,0,0,0,5,0,28,33,0,0,0,6,0,33,39,72
5894,Congo,2005,2005Congo,0,0,0,8,0,0,8,0,0,0,15,0,0,15,23
5895,Congo,2005,2005Congo,0,0,7,5,0,0,12,0,5,0,29,0,0,34,46
5896,Congo,2005,2005Congo,0,5,6,20,0,0,31,9,0,0,16,0,0,25,56
5897,Congo,2005,2005Congo,0,8,0,14,0,0,22,0,0,8,62,0,0,70,92
5898,Congo,2005,2005Congo,0,9,0,12,0,0,21,9,0,0,20,0,0,29,50
5899,Congo,2005,2005Congo,0,13,12,30,0,0,55,5,7,5,18,0,0,35,90
5900,Congo,2005,2005Congo,5,0,0,18,0,0,23,6,5,0,29,0,0,40,63
5901,Congo,2005,2005Congo,5,5,5,20,0,0,35,0,6,6,17,0,0,29,64
5902,Congo,2005,2005Congo,5,32,28,156,5,0,226,5,41,36,242,10,0,334,560
5903,Congo,2005,2005Congo,40,54,46,304,0,0,444,46,45,40,546,5,0,682,1126
5904,Congo,2005,2005Congo,62,56,49,123,0,0,290,86,65,57,322,14,0,544,5243
5905,Congo,2005,2005Congo,526,599,524,1762,80,0,3491,484,598,508,2154,63,0,3807,7298
5906,Congo,2006,2006Congo,0,0,0,0,0,0,0,0,0,0,0,0,0,0,8358
5907,Congo,2006,2006Congo,0,0,0,0,0,0,0,0,0,0,0,0,8,8,8
5908,Congo,2006,2006Congo,0,0,0,0,0,0,0,0,0,0,5,0,0,5,20
5909,Congo,2006,2006Congo,0,0,0,0,0,0,0,0,0,0,6,0,0,6,12
5910,Congo,2006,2006Congo,0,0,0,0,0,0,0,0,0,0,7,0,0,7,7
5911,Congo,2006,2006Congo,0,0,0,0,0,0,0,0,0,0,11,0,0,11,11
5912,Congo,2006,2006Congo,0,0,0,0,0,0,0,0,5,0,0,0,0,5,5
5913,Congo,2006,2006Congo,0,0,0,0,0,21,21,0,0,0,0,0,68,68,89
5914,Congo,2006,2006Congo,0,0,0,0,0,26,26,0,0,0,0,0,29,29,55
5915,Congo,2006,2006Congo,0,0,0,0,0,33,33,0,0,0,0,0,42,42,75
5916,Congo,2006,2006Congo,0,0,0,0,0,1287,1287,0,0,0,0,0,1283,1283,2570
5917,Congo,2006,2006Congo,0,0,0,5,0,0,5,0,0,0,12,0,0,12,17
5918,Congo,2006,2006Congo,0,0,0,5,0,0,5,0,0,0,13,0,0,13,18
5919,Congo,2006,2006Congo,0,0,0,6,0,0,6,0,0,5,13,0,0,18,55
5920,Congo,2006,2006Congo,0,0,5,0,0,0,5,0,0,6,0,0,0,6,11
5921,Congo,2006,2006Congo,0,0,8,8,0,0,16,0,0,5,25,0,0,30,46
5922,Congo,2006,2006Congo,0,0,21,24,0,0,45,5,0,11,37,0,0,53,98
5923,Congo,2006,2006Congo,0,5,0,5,0,0,10,0,0,0,8,0,0,8,18
5924,Congo,2006,2006Congo,0,5,6,20,0,0,31,0,0,9,16,0,0,25,56
5925,Congo,2006,2006Congo,0,7,0,11,0,0,18,0,8,0,24,0,0,32,50
5926,Congo,2006,2006Congo,0,10,13,40,0,0,63,5,14,15,62,0,0,96,159
5927,Congo,2006,2006Congo,5,0,0,18,0,0,23,9,0,0,28,0,0,37,60
5928,Congo,2006,2006Congo,5,5,5,20,0,0,35,0,7,5,19,0,0,31,66
5929,Congo,2006,2006Congo,6,16,8,61,0,0,91,18,15,10,118,0,0,161,252
5930,Congo,2006,2006Congo,7,18,27,169,5,0,226,14,17,15,207,9,0,262,488
5931,Congo,2006,2006Congo,58,110,0,167,0,0,335,61,127,0,279,15,0,482,817
5932,Congo,2006,2006Congo,465,632,503,1800,62,0,3462,430,626,452,2162,46,0,3716,7178
5933,Congo,2007,2007Congo,0,0,0,0,0,0,0,0,0,0,0,0,0,0,8223
5934,Congo,2007,2007Congo,0,0,0,0,0,0,0,0,0,0,5,0,0,5,15
5935,Congo,2007,2007Congo,0,0,0,0,0,0,0,0,0,0,6,0,0,6,6
5936,Congo,2007,2007Congo,0,0,0,0,0,0,0,0,0,0,7,0,0,7,14
5937,Congo,2007,2007Congo,0,0,0,0,0,0,0,0,0,0,8,0,0,8,8
5938,Congo,2007,2007Congo,0,0,0,0,0,0,0,0,0,0,9,0,0,9,9
5939,Congo,2007,2007Congo,0,0,0,0,0,0,0,0,0,0,11,0,0,11,11
5940,Congo,2007,2007Congo,0,0,0,0,0,18,18,0,0,0,0,0,23,23,41
5941,Congo,2007,2007Congo,0,0,0,0,0,20,20,0,0,0,0,0,65,65,85
5942,Congo,2007,2007Congo,0,0,0,0,0,1347,1347,0,0,0,0,0,1347,1347,2694
5943,Congo,2007,2007Congo,0,0,0,5,0,0,5,0,0,0,13,0,0,13,18
5944,Congo,2007,2007Congo,0,0,0,5,0,0,5,0,0,0,14,0,0,14,19
5945,Congo,2007,2007Congo,0,0,0,6,0,0,6,0,0,0,7,0,0,7,13
5946,Congo,2007,2007Congo,0,0,5,0,0,0,5,0,0,7,0,0,0,7,12
5947,Congo,2007,2007Congo,0,0,5,5,0,34,44,0,0,0,6,0,36,42,86
5948,Congo,2007,2007Congo,0,5,6,20,0,0,31,9,0,0,16,0,0,25,56
5949,Congo,2007,2007Congo,0,6,5,6,0,0,17,0,7,5,8,0,0,20,37
5950,Congo,2007,2007Congo,0,8,0,7,0,0,15,5,0,0,12,0,0,17,32
5951,Congo,2007,2007Congo,0,8,10,38,0,0,56,0,15,11,67,0,0,93,149
5952,Congo,2007,2007Congo,0,13,8,23,0,0,44,5,6,5,39,0,0,55,99
5953,Congo,2007,2007Congo,5,0,0,9,0,0,14,7,0,0,24,0,0,31,45
5954,Congo,2007,2007Congo,5,5,0,0,0,0,10,0,0,0,10,0,0,10,20
5955,Congo,2007,2007Congo,6,0,0,15,0,0,21,9,0,0,25,0,0,34,55
5956,Congo,2007,2007Congo,7,19,12,71,0,0,109,23,19,6,125,5,0,178,287
5957,Congo,2007,2007Congo,10,5,6,27,0,0,48,13,7,5,59,5,0,89,137
5958,Congo,2007,2007Congo,364,675,544,1975,76,0,3634,359,647,474,2381,60,0,3921,7555
5959,Congo,2008,2008Congo,0,0,0,0,0,0,0,0,0,0,0,0,0,0,8223
5960,Congo,2008,2008Congo,0,0,0,0,0,0,0,0,0,0,5,0,0,5,20
5961,Congo,2008,2008Congo,0,0,0,0,0,0,0,0,0,0,6,0,0,6,6
5962,Congo,2008,2008Congo,0,0,0,0,0,0,0,0,0,0,8,0,0,8,8
5963,Congo,2008,2008Congo,0,0,0,0,0,0,0,0,0,0,9,0,0,9,18
5964,Congo,2008,2008Congo,0,0,0,0,0,17,17,0,0,0,0,0,19,19,36
5965,Congo,2008,2008Congo,0,0,0,0,0,1411,1411,0,0,0,0,0,1419,1419,2830
5966,Congo,2008,2008Congo,0,0,0,5,0,0,5,0,0,0,14,0,0,14,38
5967,Congo,2008,2008Congo,0,0,0,6,0,0,6,0,0,0,7,0,0,7,13
5968,Congo,2008,2008Congo,0,0,5,0,0,0,5,0,0,0,7,0,0,7,12
5969,Congo,2008,2008Congo,0,0,5,0,0,0,5,0,0,0,39,0,0,39,44
5970,Congo,2008,2008Congo,0,0,5,5,0,36,46,5,0,0,5,0,37,47,93
5971,Congo,2008,2008Congo,0,0,7,0,0,0,7,0,6,0,5,0,0,11,18
5972,Congo,2008,2008Congo,0,5,0,5,0,0,10,0,0,0,10,0,0,10,20
5973,Congo,2008,2008Congo,0,5,6,20,0,0,31,9,0,0,16,0,0,25,56
5974,Congo,2008,2008Congo,0,9,0,8,0,0,17,0,0,5,6,0,0,11,28
5975,Congo,2008,2008Congo,5,0,0,0,0,0,5,0,0,0,0,0,0,0,5
5976,Congo,2008,2008Congo,5,0,0,9,0,0,14,7,0,0,24,0,0,31,45
5977,Congo,2008,2008Congo,5,0,0,18,0,0,23,9,0,0,30,0,0,39,62
5978,Congo,2008,2008Congo,5,5,7,37,0,0,54,0,11,10,71,0,0,92,146
5979,Congo,2008,2008Congo,5,11,6,22,0,0,44,6,7,6,38,0,0,57,101
5980,Congo,2008,2008Congo,7,13,12,70,0,0,102,14,21,5,125,5,0,170,272
5981,Congo,2008,2008Congo,13,5,5,33,0,0,56,13,7,8,65,5,0,98,154
5982,Congo,2008,2008Congo,235,708,589,2095,97,0,3724,243,734,485,2408,80,0,3950,7674
5983,Congo,2009,2009Congo,0,0,0,0,0,0,0,0,0,0,0,0,0,0,10403
5984,Congo,2009,2009Congo,0,0,0,0,0,0,0,0,0,0,5,0,0,5,20
5985,Congo,2009,2009Congo,0,0,0,0,0,0,0,0,0,0,8,0,0,8,8
5986,Congo,2009,2009Congo,0,0,0,0,0,0,0,0,0,0,9,0,0,9,18
5987,Congo,2009,2009Congo,0,0,0,0,0,0,0,0,0,6,0,0,0,6,6
5988,Congo,2009,2009Congo,0,0,0,0,0,12,12,0,0,0,0,0,31,31,43
5989,Congo,2009,2009Congo,0,0,0,0,0,14,14,0,0,0,0,0,20,20,34
5990,Congo,2009,2009Congo,0,0,0,5,0,0,5,0,0,0,7,0,0,7,12
5991,Congo,2009,2009Congo,0,0,0,5,0,0,5,0,0,0,14,0,0,14,19
5992,Congo,2009,2009Congo,0,0,0,5,0,0,5,0,0,0,16,0,0,16,21
5993,Congo,2009,2009Congo,0,0,0,7,0,0,7,0,0,0,9,0,0,9,16
5994,Congo,2009,2009Congo,0,0,0,9,0,0,9,0,0,6,10,0,0,16,25
5995,Congo,2009,2009Congo,0,0,5,0,0,0,5,0,0,0,7,0,0,7,12
5996,Congo,2009,2009Congo,0,0,5,0,0,0,5,0,0,0,22,0,0,22,27
5997,Congo,2009,2009Congo,0,0,6,13,0,0,19,0,7,0,19,0,0,26,45
5998,Congo,2009,2009Congo,0,0,7,0,0,0,7,0,6,0,5,0,0,11,18
5999,Congo,2009,2009Congo,0,0,8,8,0,0,16,5,0,0,11,0,0,16,32
6000,Congo,2009,2009Congo,0,5,0,0,0,0,5,6,0,0,0,0,0,6,11
6001,Congo,2009,2009Congo,0,5,0,0,0,0,5,6,0,0,9,0,0,15,20
6002,Congo,2009,2009Congo,0,7,0,5,0,0,12,0,0,0,5,0,0,5,17
6003,Congo,2009,2009Congo,5,0,0,0,0,0,5,0,0,0,0,0,0,0,5
6004,Congo,2009,2009Congo,5,0,0,6,0,32,43,0,5,0,5,0,39,49,92
6005,Congo,2009,2009Congo,5,0,7,20,0,0,32,0,0,8,16,0,0,24,56
6006,Congo,2009,2009Congo,5,5,7,41,0,0,58,5,7,14,76,0,0,102,160
6007,Congo,2009,2009Congo,5,11,6,22,0,0,44,6,7,6,35,0,0,54,98
6008,Congo,2009,2009Congo,8,11,0,36,0,0,55,10,9,9,61,5,0,94,149
6009,Congo,2009,2009Congo,9,12,17,65,0,0,103,12,13,5,128,5,0,163,266
6010,Congo,2009,2009Congo,29,63,43,208,5,0,348,25,55,27,229,0,0,336,684
6011,Congo,2009,2009Congo,52,48,45,141,0,0,286,53,59,49,248,11,0,420,706
6012,Congo,2009,2009Congo,275,701,572,2004,97,0,3649,240,733,489,2320,92,0,3874,7523
6013,Congo,2010,2010Congo,0,0,0,0,0,0,0,0,0,0,0,0,0,0,7347
6014,Congo,2010,2010Congo,0,0,0,0,0,0,0,0,0,0,5,0,0,5,30
6015,Congo,2010,2010Congo,0,0,0,0,0,0,0,0,0,0,6,0,0,6,6
6016,Congo,2010,2010Congo,0,0,0,0,0,0,0,0,0,0,8,0,0,8,8
6017,Congo,2010,2010Congo,0,0,0,0,0,0,0,0,0,0,9,0,0,9,9
6018,Congo,2010,2010Congo,0,0,0,0,0,0,0,0,0,6,0,0,0,6,6
6019,Congo,2010,2010Congo,0,0,0,0,0,5,5,0,0,0,0,0,25,25,30
6020,Congo,2010,2010Congo,0,0,0,0,0,13,13,0,0,0,0,0,32,32,45
6021,Congo,2010,2010Congo,0,0,0,0,0,14,14,0,0,0,0,0,17,17,31
6022,Congo,2010,2010Congo,0,0,0,0,0,1556,1556,0,0,0,0,0,1568,1568,3124
6023,Congo,2010,2010Congo,0,0,0,5,0,0,5,0,0,0,0,0,0,0,5
6024,Congo,2010,2010Congo,0,0,0,5,0,0,5,0,0,0,5,0,0,5,10
6025,Congo,2010,2010Congo,0,0,0,5,0,0,5,0,0,0,14,0,0,14,19
6026,Congo,2010,2010Congo,0,0,0,5,0,0,5,0,0,0,15,0,0,15,20
6027,Congo,2010,2010Congo,0,0,0,9,0,0,9,0,0,0,9,0,0,9,18
6028,Congo,2010,2010Congo,0,0,5,0,0,0,5,0,0,7,0,0,0,7,12
6029,Congo,2010,2010Congo,0,0,5,5,0,0,10,0,0,5,5,0,0,10,20
6030,Congo,2010,2010Congo,0,0,5,5,0,0,10,0,0,12,0,0,0,12,22
6031,Congo,2010,2010Congo,0,5,0,0,0,0,5,0,0,6,10,0,0,16,21
6032,Congo,2010,2010Congo,0,5,0,0,0,0,5,6,0,0,0,0,0,6,11
6033,Congo,2010,2010Congo,0,5,0,0,0,0,5,6,0,0,9,0,0,15,20
6034,Congo,2010,2010Congo,0,5,0,6,0,29,40,0,0,0,8,0,38,46,86
6035,Congo,2010,2010Congo,0,6,0,12,0,0,18,8,0,0,20,0,0,28,46
6036,Congo,2010,2010Congo,0,7,10,39,0,0,56,5,5,13,73,5,0,101,157
6037,Congo,2010,2010Congo,0,8,0,0,0,0,8,0,0,0,10,0,0,10,18
6038,Congo,2010,2010Congo,5,0,9,0,0,0,14,0,7,0,0,0,0,7,21
6039,Congo,2010,2010Congo,5,11,6,22,0,0,44,6,7,6,35,0,0,54,98
6040,Congo,2010,2010Congo,8,11,0,33,0,0,52,14,7,7,51,5,0,84,136
6041,Congo,2010,2010Congo,9,12,17,67,0,0,105,14,13,5,129,5,0,166,271
6042,Congo,2010,2010Congo,19,48,45,188,5,0,305,17,48,31,202,5,0,303,608
6043,Congo,2010,2010Congo,53,86,138,30,0,0,307,45,101,240,61,8,0,455,762
6044,Congo,2010,2010Congo,120,696,585,2167,111,0,3679,113,714,541,2517,101,0,3986,7665
6045,Congo,2011,2011Congo,0,0,0,0,0,0,0,0,0,0,0,0,0,0,6660
6046,Congo,2011,2011Congo,0,0,0,0,0,0,0,0,0,0,5,0,0,5,25
6047,Congo,2011,2011Congo,0,0,0,0,0,0,0,0,0,0,6,0,0,6,6
6048,Congo,2011,2011Congo,0,0,0,0,0,0,0,0,0,0,8,0,0,8,8
6049,Congo,2011,2011Congo,0,0,0,0,0,0,0,0,0,0,9,0,0,9,18
6050,Congo,2011,2011Congo,0,0,0,0,0,0,0,0,0,7,0,0,0,7,7
6051,Congo,2011,2011Congo,0,0,0,0,0,16,16,0,0,0,0,0,19,19,35
6052,Congo,2011,2011Congo,0,0,0,0,0,1614,1614,0,0,0,0,0,1613,1613,3227
6053,Congo,2011,2011Congo,0,0,0,5,0,0,5,0,0,0,0,0,0,0,5
6054,Congo,2011,2011Congo,0,0,0,5,0,0,5,0,0,0,7,0,0,7,12
6055,Congo,2011,2011Congo,0,0,0,5,0,0,5,0,0,0,14,0,0,14,19
6056,Congo,2011,2011Congo,0,0,0,6,0,0,6,0,0,0,6,0,0,6,12
6057,Congo,2011,2011Congo,0,0,0,13,0,0,13,6,0,0,10,0,0,16,29
6058,Congo,2011,2011Congo,0,0,5,0,0,0,5,0,0,0,5,0,0,5,10
6059,Congo,2011,2011Congo,0,0,9,0,0,0,9,0,0,6,0,0,0,6,21
6060,Congo,2011,2011Congo,0,5,0,0,0,0,5,6,0,0,0,0,0,6,11
6061,Congo,2011,2011Congo,0,5,0,15,0,0,20,0,0,0,23,0,0,23,312
6062,Congo,2011,2011Congo,0,5,7,13,0,0,25,0,5,7,29,5,0,46,71
6063,Congo,2011,2011Congo,0,6,0,12,0,0,18,8,0,0,20,0,0,28,46
6064,Congo,2011,2011Congo,0,9,0,0,0,0,9,0,0,0,5,0,0,5,14
6065,Congo,2011,2011Congo,5,0,0,0,0,0,5,0,0,0,6,0,0,6,11
6066,Congo,2011,2011Congo,5,7,7,22,0,0,41,0,7,7,41,0,0,55,96
6067,Congo,2011,2011Congo,6,0,0,8,0,29,43,5,0,0,5,0,34,44,87
6068,Congo,2011,2011Congo,6,12,10,66,0,0,94,14,12,5,132,0,0,163,257
6069,Congo,2011,2011Congo,7,15,0,37,0,0,59,11,13,8,59,6,0,97,156
6070,Congo,2011,2011Congo,10,44,40,117,0,0,211,18,26,20,146,0,0,210,421
6071,Congo,2011,2011Congo,15,32,37,173,5,0,262,12,37,29,190,5,0,273,535
6072,Congo,2011,2011Congo,45,84,119,36,0,0,284,47,100,233,52,9,0,441,725
6073,Congo,2012,2012Congo,0,0,0,0,0,0,0,0,0,0,0,0,0,0,6103
6074,Congo,2012,2012Congo,0,0,0,0,0,0,0,0,0,0,0,0,5,5,5
6075,Congo,2012,2012Congo,0,0,0,0,0,0,0,0,0,0,5,0,0,5,25
6076,Congo,2012,2012Congo,0,0,0,0,0,0,0,0,0,0,6,0,0,6,6
6077,Congo,2012,2012Congo,0,0,0,0,0,0,0,0,0,0,7,0,0,7,7
6078,Congo,2012,2012Congo,0,0,0,0,0,0,0,0,0,0,8,0,0,8,8
6079,Congo,2012,2012Congo,0,0,0,0,0,5,5,0,0,0,0,0,16,16,21
6080,Congo,2012,2012Congo,0,0,0,0,0,14,14,0,0,0,0,0,17,17,31
6081,Congo,2012,2012Congo,0,0,0,0,0,1659,1659,0,0,0,0,0,1659,1659,3318
6082,Congo,2012,2012Congo,0,0,0,5,0,0,5,0,0,0,0,0,0,0,5
6083,Congo,2012,2012Congo,0,0,0,5,0,0,5,0,0,0,6,0,0,6,22
6084,Congo,2012,2012Congo,0,0,0,5,0,0,5,0,0,0,7,0,0,7,24
6085,Congo,2012,2012Congo,0,0,0,5,0,0,5,0,0,0,14,0,0,14,19
6086,Congo,2012,2012Congo,0,0,0,8,0,0,8,0,0,0,5,0,0,5,13
6087,Congo,2012,2012Congo,0,0,0,9,0,0,9,0,0,0,0,0,0,0,9
6088,Congo,2012,2012Congo,0,0,0,14,0,0,14,6,0,0,10,0,0,16,30
6089,Congo,2012,2012Congo,0,0,5,0,0,0,5,0,0,0,0,0,0,0,5
6090,Congo,2012,2012Congo,0,0,6,0,0,0,6,0,0,0,5,0,0,5,11
6091,Congo,2012,2012Congo,0,0,6,17,0,0,23,0,0,5,14,0,0,19,287
6092,Congo,2012,2012Congo,0,0,7,9,0,0,16,0,0,7,5,0,0,12,28
6093,Congo,2012,2012Congo,0,0,9,0,0,0,9,0,0,0,5,0,0,5,21
6094,Congo,2012,2012Congo,0,5,0,0,0,0,5,6,0,0,0,0,0,6,11
6095,Congo,2012,2012Congo,0,5,6,14,0,0,25,5,0,7,23,5,0,40,65
6096,Congo,2012,2012Congo,0,6,0,7,0,27,40,0,0,5,7,0,33,45,85
6097,Congo,2012,2012Congo,5,0,0,0,0,0,5,0,0,0,0,0,0,0,5
6098,Congo,2012,2012Congo,5,5,5,30,0,0,45,8,14,10,63,0,0,95,140
6099,Congo,2012,2012Congo,5,10,6,21,0,0,42,5,7,6,34,0,0,52,94
6100,Congo,2012,2012Congo,8,14,0,31,0,0,53,10,15,7,57,6,0,95,148
6101,Congo,2012,2012Congo,9,25,27,102,0,0,163,9,18,28,94,5,0,154,317
6102,Congo,2012,2012Congo,15,37,31,172,8,0,263,7,33,26,183,6,0,255,518
6103,Congo,2012,2012Congo,30,66,33,162,0,0,291,34,64,48,270,25,0,441,732
6104,Congo,2013,2013Congo,0,0,0,0,0,0,0,0,0,0,0,0,0,0,6089
6105,Congo,2013,2013Congo,0,0,0,0,0,0,0,0,0,0,5,0,0,5,25
6106,Congo,2013,2013Congo,0,0,0,0,0,0,0,0,0,0,6,0,0,6,6
6107,Congo,2013,2013Congo,0,0,0,0,0,0,0,0,0,0,7,0,0,7,7
6108,Congo,2013,2013Congo,0,0,0,0,0,0,0,0,0,0,8,0,0,8,16
6109,Congo,2013,2013Congo,0,0,0,0,0,0,0,0,0,0,9,0,0,9,9
6110,Congo,2013,2013Congo,0,0,0,0,0,11,11,0,0,0,0,0,16,16,27
6111,Congo,2013,2013Congo,0,0,0,0,0,1692,1692,0,0,0,0,0,1679,1679,3371
6112,Congo,2013,2013Congo,0,0,0,5,0,0,5,0,0,0,0,0,0,0,10
6113,Congo,2013,2013Congo,0,0,0,5,0,0,5,0,0,0,7,0,0,7,12
6114,Congo,2013,2013Congo,0,0,0,5,0,0,5,0,0,0,14,0,0,14,19
6115,Congo,2013,2013Congo,0,0,0,5,0,0,5,0,5,0,5,0,0,10,22
6116,Congo,2013,2013Congo,0,0,0,6,0,25,31,0,5,0,7,0,33,45,76
6117,Congo,2013,2013Congo,0,0,0,7,0,0,7,0,0,0,0,0,0,0,7
6118,Congo,2013,2013Congo,0,0,0,7,0,0,7,0,5,0,5,0,0,10,17
6119,Congo,2013,2013Congo,0,0,0,9,0,0,9,0,0,0,5,0,0,5,265
6120,Congo,2013,2013Congo,0,0,7,0,0,0,7,0,0,0,5,0,0,5,12
6121,Congo,2013,2013Congo,0,0,7,9,0,0,16,0,0,7,6,0,0,13,29
6122,Congo,2013,2013Congo,0,0,7,16,0,0,23,0,7,5,26,0,0,38,61
6123,Congo,2013,2013Congo,0,5,0,0,0,0,5,0,6,0,0,0,0,6,11
6124,Congo,2013,2013Congo,0,5,15,76,0,0,96,0,0,16,120,0,0,136,232
6125,Congo,2013,2013Congo,0,6,0,10,0,0,16,6,0,5,16,0,0,27,43
6126,Congo,2013,2013Congo,5,0,0,0,0,0,5,0,0,0,0,0,0,0,5
6127,Congo,2013,2013Congo,5,10,6,21,0,0,42,5,7,6,34,0,0,52,94
6128,Congo,2013,2013Congo,5,14,5,32,5,0,61,7,17,5,63,8,0,100,161
6129,Congo,2013,2013Congo,6,13,9,82,5,0,115,0,9,6,59,5,0,79,194
6130,Congo,2013,2013Congo,7,14,31,83,0,0,135,8,15,26,62,5,0,116,251
6131,Congo,2013,2013Congo,42,62,34,133,0,0,271,47,61,45,226,23,0,402,673
6132,Congo,2014,2014Congo,0,0,0,0,0,0,0,0,0,0,0,0,0,0,3299
6133,Congo,2014,2014Congo,0,0,0,0,0,0,0,0,0,0,5,0,0,5,30
6134,Congo,2014,2014Congo,0,0,0,0,0,0,0,0,0,0,9,0,0,9,18
6135,Congo,2014,2014Congo,0,0,0,0,0,0,0,0,0,0,10,0,0,10,10
6136,Congo,2014,2014Congo,0,0,0,0,0,6,6,0,0,0,0,0,0,0,6
6137,Congo,2014,2014Congo,0,0,0,0,0,1612,1612,0,0,0,0,0,1640,1640,3252
6138,Congo,2014,2014Congo,0,0,0,0,0,2672,2672,0,0,0,0,0,3363,3363,6035
6139,Congo,2014,2014Congo,0,0,0,5,0,0,5,0,0,0,5,0,0,5,20
6140,Congo,2014,2014Congo,0,0,0,5,0,0,5,0,0,0,6,0,0,6,11
6141,Congo,2014,2014Congo,0,0,0,5,0,0,5,0,0,0,7,0,0,7,12
6142,Congo,2014,2014Congo,0,0,0,5,0,0,5,0,0,0,14,0,0,14,19
6143,Congo,2014,2014Congo,0,0,0,6,0,25,31,0,5,0,8,0,31,44,75
6144,Congo,2014,2014Congo,0,0,0,7,0,0,7,0,5,0,5,0,0,10,17
6145,Congo,2014,2014Congo,0,0,0,8,0,0,8,0,6,0,0,0,0,6,14
6146,Congo,2014,2014Congo,0,0,5,0,0,0,5,0,0,0,0,0,0,0,5
6147,Congo,2014,2014Congo,0,0,6,0,0,0,6,0,0,0,0,0,0,0,6
6148,Congo,2014,2014Congo,0,0,7,0,0,0,7,0,0,0,0,0,0,0,7
6149,Congo,2014,2014Congo,0,0,7,0,0,0,7,0,0,0,5,0,0,5,12
6150,Congo,2014,2014Congo,0,0,7,9,0,0,16,0,0,7,6,0,0,13,29
6151,Congo,2014,2014Congo,0,5,0,0,0,0,5,0,0,0,6,0,0,6,11
6152,Congo,2014,2014Congo,0,5,0,11,0,0,16,0,5,5,16,0,0,26,42
6153,Congo,2014,2014Congo,0,7,0,0,0,0,7,0,0,0,6,0,0,6,13
6154,Congo,2014,2014Congo,0,9,6,9,0,0,24,0,7,5,26,0,0,38,62
6155,Congo,2014,2014Congo,0,16,15,84,5,0,120,0,9,9,51,5,0,74,194
6156,Congo,2014,2014Congo,5,0,0,0,0,0,5,0,0,0,0,0,0,0,5
6157,Congo,2014,2014Congo,5,6,0,6,0,0,17,5,6,0,11,0,0,22,39
6158,Congo,2014,2014Congo,5,16,5,32,5,0,63,6,19,5,65,8,0,103,166
6159,Congo,2014,2014Congo,8,0,0,14,0,0,22,0,5,0,14,5,0,24,229
6160,Congo,2014,2014Congo,9,13,12,62,0,0,96,7,11,19,51,5,0,93,189
6161,Congo,2014,2014Congo,42,62,34,133,0,0,271,47,61,45,224,23,0,400,671
6162,Congo,2015,2015Congo,0,0,0,0,0,0,0,0,0,0,0,0,0,0,9691
6163,Congo,2015,2015Congo,0,0,0,0,0,0,0,0,0,0,0,0,5,5,5
6164,Congo,2015,2015Congo,0,0,0,0,0,0,0,0,0,0,5,0,0,5,20
6165,Congo,2015,2015Congo,0,0,0,0,0,0,0,0,0,0,9,0,0,9,18
6166,Congo,2015,2015Congo,0,0,0,0,0,6,6,0,0,0,0,0,15,15,21
6167,Congo,2015,2015Congo,0,0,0,0,0,12,12,0,0,0,0,0,23,23,35
6168,Congo,2015,2015Congo,0,0,0,0,0,1579,1579,0,0,0,0,0,1646,1646,3225
6169,Congo,2015,2015Congo,0,0,0,5,0,0,5,0,0,0,0,0,0,0,5
6170,Congo,2015,2015Congo,0,0,0,5,0,0,5,0,0,0,5,0,0,5,10
6171,Congo,2015,2015Congo,0,0,0,5,0,0,5,0,0,0,6,0,0,6,11
6172,Congo,2015,2015Congo,0,0,0,5,0,0,5,0,0,0,12,0,0,12,17
6173,Congo,2015,2015Congo,0,0,0,5,0,0,5,0,0,0,14,0,0,14,19
6174,Congo,2015,2015Congo,0,0,0,6,0,0,6,0,0,0,6,0,0,6,12
6175,Congo,2015,2015Congo,0,0,0,9,0,0,9,6,0,0,0,0,0,6,15
6176,Congo,2015,2015Congo,0,0,0,10,0,25,35,0,7,0,8,0,21,36,71
6177,Congo,2015,2015Congo,0,0,6,0,0,0,6,0,0,0,5,0,0,5,11
6178,Congo,2015,2015Congo,0,0,7,0,0,0,7,0,0,0,5,0,0,5,12
6179,Congo,2015,2015Congo,0,0,7,6,0,0,13,0,5,0,7,0,0,12,25
6180,Congo,2015,2015Congo,0,0,8,0,0,0,8,0,0,0,0,0,0,0,8
6181,Congo,2015,2015Congo,0,5,0,0,0,0,5,0,0,0,0,0,0,0,5
6182,Congo,2015,2015Congo,0,5,0,0,0,0,5,0,0,0,6,0,0,6,11
6183,Congo,2015,2015Congo,0,5,0,9,0,0,14,0,0,8,12,0,0,20,34
6184,Congo,2015,2015Congo,0,5,8,71,0,0,84,0,0,13,107,0,0,120,204
6185,Congo,2015,2015Congo,0,6,0,5,0,0,11,0,5,0,8,0,0,13,24
6186,Congo,2015,2015Congo,5,0,0,0,0,0,5,0,0,0,0,0,0,0,5
6187,Congo,2015,2015Congo,5,0,5,14,0,0,24,0,5,19,10,0,0,34,58
6188,Congo,2015,2015Congo,5,6,0,6,0,0,17,5,6,0,14,0,0,25,42
6189,Congo,2015,2015Congo,5,6,17,39,0,0,67,5,8,5,27,0,0,45,112
6190,Congo,2015,2015Congo,5,9,13,69,8,0,104,0,7,9,52,6,0,74,178
6191,Congo,2015,2015Congo,5,16,6,32,5,0,64,5,20,6,65,9,0,105,169
6192,Congo,2015,2015Congo,44,50,37,140,0,0,271,49,63,43,244,29,0,428,699
6193,Congo,2016,2016Congo,0,0,0,0,0,0,0,0,0,0,0,0,0,0,2757
6194,Congo,2016,2016Congo,0,0,0,0,0,0,0,0,0,0,0,0,5,5,5
6195,Congo,2016,2016Congo,0,0,0,0,0,0,0,0,0,0,5,0,0,5,35
6196,Congo,2016,2016Congo,0,0,0,0,0,0,0,0,0,0,9,0,0,9,18
6197,Congo,2016,2016Congo,0,0,0,0,0,5,5,0,0,0,0,0,16,16,21
6198,Congo,2016,2016Congo,0,0,0,0,0,11,11,0,0,0,0,0,20,20,31
6199,Congo,2016,2016Congo,0,0,0,0,0,1582,1582,0,0,0,0,0,1669,1669,3251
6200,Congo,2016,2016Congo,0,0,0,0,0,2464,2464,0,0,0,0,0,2930,2930,5394
6201,Congo,2016,2016Congo,0,0,0,5,0,0,5,0,0,0,14,0,0,14,19
6202,Congo,2016,2016Congo,0,0,0,5,0,0,5,0,0,0,15,0,0,15,20
6203,Congo,2016,2016Congo,0,0,0,7,0,0,7,0,0,0,5,0,0,5,12
6204,Congo,2016,2016Congo,0,0,0,8,0,0,8,0,5,0,0,0,0,5,13
6205,Congo,2016,2016Congo,0,0,0,9,0,0,9,0,8,0,12,0,0,20,29
6206,Congo,2016,2016Congo,0,0,0,9,0,0,9,6,0,0,0,0,0,6,15
6207,Congo,2016,2016Congo,0,0,0,10,0,18,28,0,6,0,8,0,23,37,65
6208,Congo,2016,2016Congo,0,0,6,0,0,0,6,5,0,0,0,0,0,5,11
6209,Congo,2016,2016Congo,0,0,8,8,0,0,16,5,6,0,18,5,0,34,50
6210,Congo,2016,2016Congo,0,0,8,29,5,0,42,0,5,6,26,5,0,42,248
6211,Congo,2016,2016Congo,0,0,9,9,0,0,18,0,7,0,9,0,0,16,34
6212,Congo,2016,2016Congo,0,0,11,66,0,0,77,0,0,10,96,5,0,111,188
6213,Congo,2016,2016Congo,0,5,0,0,0,0,5,0,0,0,0,0,0,0,10
6214,Congo,2016,2016Congo,0,6,0,14,0,0,20,0,10,0,19,0,0,29,49
6215,Congo,2016,2016Congo,0,6,12,29,0,0,47,0,10,6,24,0,0,40,87
6216,Congo,2016,2016Congo,0,8,0,5,0,0,13,5,0,0,5,0,0,10,23
6217,Congo,2016,2016Congo,0,9,0,0,0,0,9,0,0,0,0,0,0,0,9
6218,Congo,2016,2016Congo,5,0,0,0,0,0,5,0,0,0,0,0,0,0,5
6219,Congo,2016,2016Congo,5,6,8,71,9,0,99,0,5,5,56,8,0,74,173
6220,Congo,2016,2016Congo,7,5,0,5,0,0,17,5,7,0,14,0,0,26,43
6221,Congo,2016,2016Congo,39,70,89,82,5,0,285,41,80,135,119,16,0,391,676
6222,Congo,2017,2017Congo,0,0,0,0,0,0,0,0,0,0,0,0,0,0,3075
6223,Congo,2017,2017Congo,0,0,0,0,0,0,0,0,0,0,0,0,5,5,5
6224,Congo,2017,2017Congo,0,0,0,0,0,0,0,0,0,0,5,0,0,5,35
6225,Congo,2017,2017Congo,0,0,0,0,0,0,0,0,0,0,6,0,0,6,6
6226,Congo,2017,2017Congo,0,0,0,0,0,0,0,0,0,0,7,0,0,7,7
6227,Congo,2017,2017Congo,0,0,0,0,0,0,0,0,0,0,9,0,0,9,9
6228,Congo,2017,2017Congo,0,0,0,0,0,0,0,0,5,0,0,0,0,5,5
6229,Congo,2017,2017Congo,0,0,0,0,0,0,0,0,9,0,0,0,0,9,9
6230,Congo,2017,2017Congo,0,0,0,0,0,5,5,0,0,0,0,0,15,15,20
6231,Congo,2017,2017Congo,0,0,0,0,0,1593,1593,0,0,0,0,0,1724,1724,3317
6232,Congo,2017,2017Congo,0,0,0,0,0,2407,2407,0,0,0,0,0,2854,2854,5261
6233,Congo,2017,2017Congo,0,0,0,5,0,0,5,0,0,0,14,0,0,14,19
6234,Congo,2017,2017Congo,0,0,0,8,0,0,8,0,5,0,0,0,0,5,13
6235,Congo,2017,2017Congo,0,0,0,9,0,0,9,0,0,0,0,0,0,0,9
6236,Congo,2017,2017Congo,0,0,0,10,0,0,10,0,0,6,0,0,0,6,16
6237,Congo,2017,2017Congo,0,0,0,12,0,23,35,0,6,0,9,0,17,32,67
6238,Congo,2017,2017Congo,0,0,6,10,0,0,16,0,8,0,0,0,0,8,24
6239,Congo,2017,2017Congo,0,0,7,0,0,0,7,6,0,0,0,0,0,6,13
6240,Congo,2017,2017Congo,0,0,7,5,0,0,12,0,0,0,0,0,0,0,12
6241,Congo,2017,2017Congo,0,0,8,5,0,0,13,7,0,0,6,0,0,13,26
6242,Congo,2017,2017Congo,0,0,9,67,0,0,76,0,0,6,99,5,0,110,186
6243,Congo,2017,2017Congo,0,5,0,0,0,0,5,0,0,0,0,0,0,0,10
6244,Congo,2017,2017Congo,0,5,0,6,0,0,11,0,6,0,10,0,0,16,27
6245,Congo,2017,2017Congo,0,5,6,35,0,0,46,0,9,5,26,0,0,40,86
6246,Congo,2017,2017Congo,0,7,0,9,0,0,16,5,6,0,19,5,0,35,51
6247,Congo,2017,2017Congo,5,0,0,5,0,0,10,0,6,0,10,0,0,16,26
6248,Congo,2017,2017Congo,5,0,5,12,0,0,22,0,10,0,19,0,0,29,51
6249,Congo,2017,2017Congo,14,8,11,105,8,0,146,6,8,5,76,8,0,103,249
6250,Congo,2017,2017Congo,45,50,45,113,5,0,258,42,76,63,194,28,0,403,661
6251,Congo,2018,2018Congo,0,0,0,0,0,0,0,0,0,0,0,0,0,0,8024
6252,Congo,2018,2018Congo,0,0,0,0,0,0,0,0,0,0,5,0,0,5,25
6253,Congo,2018,2018Congo,0,0,0,0,0,0,0,0,0,0,8,0,0,8,16
6254,Congo,2018,2018Congo,0,0,0,0,0,0,0,0,5,0,0,0,0,5,5
6255,Congo,2018,2018Congo,0,0,0,0,0,0,0,7,0,0,0,0,0,7,7
6256,Congo,2018,2018Congo,0,0,0,0,0,1692,1692,0,0,0,0,0,1827,1827,3519
6257,Congo,2018,2018Congo,0,0,0,5,0,0,5,0,0,0,0,0,0,0,5
6258,Congo,2018,2018Congo,0,0,0,5,0,0,5,0,0,0,9,0,0,9,14
6259,Congo,2018,2018Congo,0,0,0,6,0,0,6,0,0,0,0,0,0,0,6
6260,Congo,2018,2018Congo,0,0,0,7,0,0,7,0,0,0,5,0,0,5,12
6261,Congo,2018,2018Congo,0,0,0,7,0,0,7,0,0,0,9,0,0,9,16
6262,Congo,2018,2018Congo,0,0,0,8,0,0,8,0,5,0,0,0,0,5,13
6263,Congo,2018,2018Congo,0,0,0,10,0,0,10,5,0,0,0,0,0,5,15
6264,Congo,2018,2018Congo,0,0,0,12,0,15,27,0,6,0,7,0,18,31,58
6265,Congo,2018,2018Congo,0,0,0,13,0,0,13,0,0,7,0,0,0,7,20
6266,Congo,2018,2018Congo,0,0,5,8,0,0,13,0,7,0,9,0,0,16,29
6267,Congo,2018,2018Congo,0,0,6,10,0,0,16,0,8,0,0,0,0,8,24
6268,Congo,2018,2018Congo,0,0,7,0,0,0,7,0,0,0,0,0,0,0,7
6269,Congo,2018,2018Congo,0,0,7,9,0,0,16,5,7,0,20,5,0,37,53
6270,Congo,2018,2018Congo,0,0,12,35,0,0,47,0,5,5,28,0,0,38,85
6271,Congo,2018,2018Congo,0,5,0,0,0,0,5,0,0,0,0,0,0,0,5
6272,Congo,2018,2018Congo,0,5,0,17,0,0,22,0,10,0,22,0,0,32,54
6273,Congo,2018,2018Congo,0,6,0,0,0,0,6,0,0,0,0,0,0,0,6
6274,Congo,2018,2018Congo,0,6,0,0,0,0,6,0,0,0,5,0,0,5,11
6275,Congo,2018,2018Congo,5,0,0,0,0,0,5,0,0,0,0,0,0,0,5
6276,Congo,2018,2018Congo,5,0,0,5,0,0,10,0,0,5,13,0,0,18,28
6277,Congo,2018,2018Congo,7,0,12,9,0,0,28,9,0,0,22,0,0,31,59
6278,Congo,2018,2018Congo,9,13,14,60,0,0,96,0,17,5,43,0,0,65,300
6279,Congo,2018,2018Congo,19,11,10,112,9,0,161,9,9,10,78,9,0,115,276
6280,Congo,2018,2018Congo,45,48,46,111,5,0,255,42,72,62,195,31,0,402,657
6281,Congo,2019,2019Congo,0,0,0,0,0,0,0,0,0,0,0,0,0,0,7436
6282,Congo,2019,2019Congo,0,0,0,0,0,0,0,0,0,0,5,0,0,5,20
6283,Congo,2019,2019Congo,0,0,0,0,0,0,0,0,0,0,6,0,0,6,6
6284,Congo,2019,2019Congo,0,0,0,0,0,0,0,0,0,0,9,0,0,9,9
6285,Congo,2019,2019Congo,0,0,0,0,0,0,0,0,0,6,0,0,0,6,6
6286,Congo,2019,2019Congo,0,0,0,0,0,0,0,0,7,0,0,0,0,7,7
6287,Congo,2019,2019Congo,0,0,0,0,0,0,0,5,0,0,0,0,0,5,10
6288,Congo,2019,2019Congo,0,0,0,0,0,5,5,0,0,0,0,0,21,21,26
6289,Congo,2019,2019Congo,0,0,0,0,0,1777,1777,0,0,0,0,0,1901,1901,3678
6290,Congo,2019,2019Congo,0,0,0,5,0,0,5,0,0,0,0,0,0,0,5
6291,Congo,2019,2019Congo,0,0,0,5,0,0,5,0,5,0,5,0,0,10,15
6292,Congo,2019,2019Congo,0,0,0,6,0,0,6,8,0,6,0,0,0,14,20
6293,Congo,2019,2019Congo,0,0,0,7,0,0,7,0,0,0,7,0,0,7,14
6294,Congo,2019,2019Congo,0,0,0,10,0,0,10,0,5,0,5,0,0,10,51
6295,Congo,2019,2019Congo,0,0,0,11,0,0,11,0,0,7,0,0,0,7,18
6296,Congo,2019,2019Congo,0,0,6,0,0,0,6,0,0,0,5,0,0,5,11
6297,Congo,2019,2019Congo,0,0,7,0,0,0,7,0,0,0,0,0,0,0,7
6298,Congo,2019,2019Congo,0,0,8,0,0,0,8,0,0,0,0,0,0,0,8
6299,Congo,2019,2019Congo,0,0,9,0,0,0,9,0,0,0,5,0,0,5,14
6300,Congo,2019,2019Congo,0,0,11,19,0,0,30,0,0,14,23,0,0,37,67
6301,Congo,2019,2019Congo,0,5,0,0,0,0,5,0,0,0,0,0,0,0,10
6302,Congo,2019,2019Congo,0,5,0,5,0,0,10,0,0,5,13,0,0,18,28
6303,Congo,2019,2019Congo,0,5,0,5,0,0,10,0,5,0,0,0,0,5,15
6304,Congo,2019,2019Congo,0,5,0,7,0,0,12,0,6,0,12,0,0,18,30
6305,Congo,2019,2019Congo,0,5,0,15,0,0,20,0,5,10,19,0,0,34,54
6306,Congo,2019,2019Congo,0,6,0,0,0,0,6,0,0,7,0,0,0,7,13
6307,Congo,2019,2019Congo,0,6,0,13,0,0,19,0,5,0,6,0,0,11,30
6308,Congo,2019,2019Congo,5,0,0,0,0,0,5,0,0,0,0,0,0,0,5
6309,Congo,2019,2019Congo,5,5,0,0,0,0,10,0,0,0,9,0,0,9,19
6310,Congo,2019,2019Congo,5,8,0,11,0,0,24,0,13,10,26,5,0,54,78
6311,Congo,2019,2019Congo,9,0,0,0,0,0,9,0,7,0,7,0,0,14,23
6312,Congo,2019,2019Congo,9,5,0,21,0,0,35,8,0,0,36,0,0,44,79
6313,Congo,2019,2019Congo,18,10,7,116,11,0,162,7,12,11,79,11,0,120,282
6314,Congo,2019,2019Congo,27,51,51,120,8,0,257,26,58,45,223,40,0,392,649
6315,Congo,2020,2020Congo,0,0,0,0,0,0,0,0,0,0,0,0,0,0,6432
6316,Congo,2020,2020Congo,0,0,0,0,0,0,0,0,0,0,5,0,0,5,35
6317,Congo,2020,2020Congo,0,0,0,0,0,0,0,0,0,0,7,0,0,7,7
6318,Congo,2020,2020Congo,0,0,0,0,0,0,0,0,0,0,8,0,0,8,8
6319,Congo,2020,2020Congo,0,0,0,0,0,0,0,0,0,0,9,0,0,9,9
6320,Congo,2020,2020Congo,0,0,0,0,0,0,0,0,0,6,0,0,0,6,6
6321,Congo,2020,2020Congo,0,0,0,0,0,0,0,0,0,9,5,0,0,14,14
6322,Congo,2020,2020Congo,0,0,0,0,0,0,0,5,0,0,0,0,0,5,5
6323,Congo,2020,2020Congo,0,0,0,0,0,5,5,0,0,0,0,0,8,8,13
6324,Congo,2020,2020Congo,0,0,0,0,0,5,5,0,0,0,0,0,21,21,26
6325,Congo,2020,2020Congo,0,0,0,0,0,7,7,0,0,0,0,0,18,18,25
6326,Congo,2020,2020Congo,0,0,0,5,0,0,5,0,0,0,0,6,0,6,11
6327,Congo,2020,2020Congo,0,0,0,6,0,0,6,0,8,6,0,0,0,14,20
6328,Congo,2020,2020Congo,0,0,0,7,0,0,7,0,0,0,7,0,0,7,14
6329,Congo,2020,2020Congo,0,0,0,11,0,0,11,0,0,9,0,0,0,9,20
6330,Congo,2020,2020Congo,0,0,0,11,0,0,11,0,9,0,0,0,0,9,51
6331,Congo,2020,2020Congo,0,0,0,15,0,0,15,0,0,0,0,0,0,0,15
6332,Congo,2020,2020Congo,0,0,5,5,0,0,10,0,0,0,5,0,0,5,15
6333,Congo,2020,2020Congo,0,0,6,0,0,0,6,0,0,0,5,0,0,5,11
6334,Congo,2020,2020Congo,0,0,7,0,0,0,7,0,0,0,0,0,0,0,7
6335,Congo,2020,2020Congo,0,0,10,20,0,0,30,0,9,5,23,0,0,37,67
6336,Congo,2020,2020Congo,0,5,0,0,0,0,5,0,0,0,0,0,0,0,5
6337,Congo,2020,2020Congo,0,5,0,7,0,0,12,0,6,0,14,0,0,20,32
6338,Congo,2020,2020Congo,0,5,0,16,0,0,21,0,11,0,21,0,0,32,53
6339,Congo,2020,2020Congo,0,6,0,13,0,0,19,0,5,0,6,0,0,11,30
6340,Congo,2020,2020Congo,0,7,0,0,0,0,7,9,0,0,0,0,0,9,16
6341,Congo,2020,2020Congo,0,7,9,12,0,0,28,0,11,10,31,5,0,57,85
6342,Congo,2020,2020Congo,0,8,0,0,0,0,8,0,0,0,9,0,0,9,17
6343,Congo,2020,2020Congo,0,12,0,0,0,0,12,0,0,5,9,0,0,14,26
6344,Congo,2020,2020Congo,5,0,0,0,0,0,5,0,0,0,0,0,0,0,5
6345,Congo,2020,2020Congo,5,112,266,1633,41,0,2057,5,121,265,1989,26,0,2406,4463
6346,Congo,2020,2020Congo,6,0,0,0,0,0,6,5,0,0,11,0,0,16,22
6347,Congo,2020,2020Congo,9,0,0,0,0,0,9,0,6,0,8,0,0,14,23
6348,Congo,2020,2020Congo,9,7,6,16,0,0,38,0,9,0,40,0,0,49,87
6349,Congo,2020,2020Congo,15,14,9,113,9,0,160,8,9,9,80,12,0,118,278
6350,Congo,2020,2020Congo,22,43,45,130,11,0,251,16,62,42,216,50,0,386,637
6351,Congo,2021,2021Congo,0,0,0,0,0,0,0,0,0,0,0,0,0,0,7877
6352,Congo,2021,2021Congo,0,0,0,0,0,0,0,0,0,0,5,0,0,5,45
6353,Congo,2021,2021Congo,0,0,0,0,0,0,0,0,0,0,7,0,0,7,7
6354,Congo,2021,2021Congo,0,0,0,0,0,0,0,0,0,0,14,0,0,14,14
6355,Congo,2021,2021Congo,0,0,0,0,0,0,0,0,0,6,0,0,0,6,6
6356,Congo,2021,2021Congo,0,0,0,0,0,0,0,0,5,0,0,0,0,5,5
6357,Congo,2021,2021Congo,0,0,0,0,0,5,5,0,0,0,0,0,21,21,26
6358,Congo,2021,2021Congo,0,0,0,5,0,0,5,0,0,0,20,0,0,20,25
6359,Congo,2021,2021Congo,0,0,0,6,0,0,6,0,5,0,5,0,0,10,16
6360,Congo,2021,2021Congo,0,0,0,6,0,0,6,0,14,0,0,0,0,14,20
6361,Congo,2021,2021Congo,0,0,0,8,0,0,8,0,0,0,0,0,0,0,8
6362,Congo,2021,2021Congo,0,0,0,8,0,0,8,0,0,0,7,0,0,7,15
6363,Congo,2021,2021Congo,0,0,0,8,0,0,8,0,5,0,0,5,0,10,18
6364,Congo,2021,2021Congo,0,0,0,11,0,0,11,0,0,0,7,0,0,7,18
6365,Congo,2021,2021Congo,0,0,0,12,0,0,12,0,0,9,0,0,0,9,49
6366,Congo,2021,2021Congo,0,0,0,15,0,0,15,9,0,5,11,0,0,25,40
6367,Congo,2021,2021Congo,0,0,6,0,0,0,6,0,0,0,5,0,0,5,11
6368,Congo,2021,2021Congo,0,0,6,5,0,0,11,6,0,0,7,0,0,13,24
6369,Congo,2021,2021Congo,0,0,6,18,0,0,24,0,0,6,30,0,0,36,60
6370,Congo,2021,2021Congo,0,0,7,0,0,0,7,0,0,0,0,0,0,0,7
6371,Congo,2021,2021Congo,0,0,7,14,0,0,21,0,0,5,8,0,0,13,34
6372,Congo,2021,2021Congo,0,0,8,0,0,0,8,0,0,0,0,0,0,0,16
6373,Congo,2021,2021Congo,0,5,0,0,0,0,5,0,0,0,0,0,0,0,10
6374,Congo,2021,2021Congo,0,5,0,6,0,0,11,0,0,0,5,0,0,5,16
6375,Congo,2021,2021Congo,0,5,0,8,0,0,13,0,0,7,12,0,0,19,32
6376,Congo,2021,2021Congo,0,7,10,7,5,0,29,0,6,11,31,5,0,53,82
6377,Congo,2021,2021Congo,0,12,0,0,0,0,12,0,0,5,9,0,0,14,26
6378,Congo,2021,2021Congo,0,68,219,1678,53,0,2018,0,69,231,2017,50,0,2367,4385
6379,Congo,2021,2021Congo,5,0,0,0,0,0,5,0,0,0,0,0,0,0,5
6380,Congo,2021,2021Congo,5,0,0,21,0,0,26,0,7,0,23,0,0,30,300
6381,Congo,2021,2021Congo,6,7,0,0,0,0,13,7,0,11,0,0,0,18,31
6382,Congo,2021,2021Congo,9,9,9,13,0,0,40,0,8,0,45,0,0,53,93
6383,Congo,2021,2021Congo,13,20,10,116,9,0,168,7,11,7,81,11,0,117,285
6384,Congo,2021,2021Congo,22,43,46,134,11,0,256,17,64,42,218,50,0,391,647
6385,Cote d'Ivoire,2001,2001Cote d'Ivoire,0,0,0,0,0,0,0,0,0,0,0,0,0,0,809
6386,Cote d'Ivoire,2001,2001Cote d'Ivoire,0,0,0,0,0,5,5,0,0,0,0,0,0,0,5
6387,Cote d'Ivoire,2001,2001Cote d'Ivoire,0,0,0,0,0,12,12,0,0,0,0,0,30,30,42
6388,Cote d'Ivoire,2002,2002Cote d'Ivoire,0,0,0,0,0,0,0,0,0,0,0,0,0,0,1634
6389,Cote d'Ivoire,2002,2002Cote d'Ivoire,0,0,0,0,0,0,0,0,0,0,5,0,0,5,5
6390,Cote d'Ivoire,2002,2002Cote d'Ivoire,0,0,0,0,0,0,0,0,0,0,18,0,0,18,18
6391,Cote d'Ivoire,2002,2002Cote d'Ivoire,0,0,0,0,0,35,35,0,0,0,0,0,76,76,111
6392,Cote d'Ivoire,2002,2002Cote d'Ivoire,22,50,45,150,5,0,272,35,41,36,226,7,0,345,617
6393,Cote d'Ivoire,2002,2002Cote d'Ivoire,168,197,168,340,22,0,895,220,258,222,563,30,0,1293,2188
6394,Cote d'Ivoire,2002,2002Cote d'Ivoire,2329,1766,1513,3927,436,0,9971,1913,2198,1884,2873,319,0,9187,19158
6395,Cote d'Ivoire,2003,2003Cote d'Ivoire,0,0,0,0,0,0,0,0,0,0,0,0,0,0,22047
6396,Cote d'Ivoire,2003,2003Cote d'Ivoire,0,0,0,0,0,0,0,0,0,0,5,0,0,5,15
6397,Cote d'Ivoire,2003,2003Cote d'Ivoire,0,0,0,0,0,0,0,0,0,0,7,0,0,7,7
6398,Cote d'Ivoire,2003,2003Cote d'Ivoire,0,0,0,0,0,0,0,0,0,0,9,0,0,9,18
6399,Cote d'Ivoire,2003,2003Cote d'Ivoire,0,0,0,0,0,0,0,0,0,0,15,0,0,15,15
6400,Cote d'Ivoire,2003,2003Cote d'Ivoire,0,0,0,0,0,76,76,0,0,0,0,0,241,241,317
6401,Cote d'Ivoire,2003,2003Cote d'Ivoire,0,0,0,5,0,0,5,0,0,0,0,0,0,0,5
6402,Cote d'Ivoire,2003,2003Cote d'Ivoire,0,0,0,7,0,0,7,0,0,0,0,0,0,0,7
6403,Cote d'Ivoire,2003,2003Cote d'Ivoire,0,0,9,17,0,0,26,5,6,0,17,0,0,28,54
6404,Cote d'Ivoire,2003,2003Cote d'Ivoire,0,5,0,15,0,0,20,0,0,5,59,0,0,64,84
6405,Cote d'Ivoire,2003,2003Cote d'Ivoire,52,74,71,256,12,0,465,72,81,65,805,16,0,1039,1504
6406,Cote d'Ivoire,2003,2003Cote d'Ivoire,923,743,637,1218,24,1405,4950,826,797,683,915,33,1348,4602,9552
6407,Cote d'Ivoire,2004,2004Cote d'Ivoire,0,0,0,0,0,0,0,0,0,0,0,0,0,0,3373
6408,Cote d'Ivoire,2004,2004Cote d'Ivoire,0,0,0,0,0,0,0,0,0,0,5,0,0,5,10
6409,Cote d'Ivoire,2004,2004Cote d'Ivoire,0,0,0,0,0,0,0,0,0,0,12,0,0,12,12
6410,Cote d'Ivoire,2004,2004Cote d'Ivoire,0,0,0,0,0,0,0,0,0,0,20,0,0,20,20
6411,Cote d'Ivoire,2004,2004Cote d'Ivoire,0,0,0,0,0,0,0,0,0,0,25,0,0,25,25
6412,Cote d'Ivoire,2004,2004Cote d'Ivoire,0,0,0,0,0,0,0,0,0,5,8,0,0,13,13
6413,Cote d'Ivoire,2004,2004Cote d'Ivoire,0,0,0,0,0,0,0,0,0,6,0,0,0,6,6
6414,Cote d'Ivoire,2004,2004Cote d'Ivoire,0,0,0,0,0,0,0,0,5,0,10,0,0,15,15
6415,Cote d'Ivoire,2004,2004Cote d'Ivoire,0,0,0,0,0,0,0,5,0,0,0,0,0,5,10
6416,Cote d'Ivoire,2004,2004Cote d'Ivoire,0,0,0,5,0,0,5,0,0,0,5,0,0,5,10
6417,Cote d'Ivoire,2004,2004Cote d'Ivoire,0,0,0,6,0,7,13,0,0,0,10,0,8,18,31
6418,Cote d'Ivoire,2004,2004Cote d'Ivoire,0,0,0,9,0,0,9,0,0,0,13,0,0,13,22
6419,Cote d'Ivoire,2004,2004Cote d'Ivoire,0,0,0,16,0,0,16,0,0,5,33,0,0,38,54
6420,Cote d'Ivoire,2004,2004Cote d'Ivoire,0,0,6,19,0,0,25,0,7,0,71,0,0,78,103
6421,Cote d'Ivoire,2004,2004Cote d'Ivoire,0,8,0,0,0,0,8,0,7,0,0,0,0,7,15
6422,Cote d'Ivoire,2004,2004Cote d'Ivoire,5,5,5,22,0,0,37,8,0,6,32,0,0,46,83
6423,Cote d'Ivoire,2004,2004Cote d'Ivoire,50,68,59,115,23,0,315,65,46,40,130,28,0,309,12408
6424,Cote d'Ivoire,2004,2004Cote d'Ivoire,123,134,115,446,8,0,826,107,153,132,1473,13,0,1878,2704
6425,Cote d'Ivoire,2004,2004Cote d'Ivoire,401,625,537,905,76,0,2544,330,620,531,667,43,0,2191,4735
6426,Cote d'Ivoire,2005,2005Cote d'Ivoire,0,0,0,0,0,0,0,0,0,0,0,0,0,0,4168
6427,Cote d'Ivoire,2005,2005Cote d'Ivoire,0,0,0,0,0,0,0,0,0,0,5,0,0,5,15
6428,Cote d'Ivoire,2005,2005Cote d'Ivoire,0,0,0,0,0,0,0,0,0,0,13,0,0,13,13
6429,Cote d'Ivoire,2005,2005Cote d'Ivoire,0,0,0,0,0,0,0,0,0,0,52,0,0,52,52
6430,Cote d'Ivoire,2005,2005Cote d'Ivoire,0,0,0,0,0,0,0,0,5,0,10,0,0,15,15
6431,Cote d'Ivoire,2005,2005Cote d'Ivoire,0,0,0,0,0,0,0,5,0,0,0,0,0,5,10
6432,Cote d'Ivoire,2005,2005Cote d'Ivoire,0,0,0,0,0,299,299,0,0,0,0,0,776,776,1075
6433,Cote d'Ivoire,2005,2005Cote d'Ivoire,0,0,0,5,0,0,5,0,0,0,15,0,0,15,20
6434,Cote d'Ivoire,2005,2005Cote d'Ivoire,0,0,0,11,0,12,23,0,0,0,11,0,17,28,51
6435,Cote d'Ivoire,2005,2005Cote d'Ivoire,0,0,0,15,0,0,15,0,0,0,27,0,0,27,42
6436,Cote d'Ivoire,2005,2005Cote d'Ivoire,0,0,0,30,0,0,30,0,0,0,0,0,0,0,30
6437,Cote d'Ivoire,2005,2005Cote d'Ivoire,0,0,5,5,0,0,10,0,6,0,7,0,0,13,23
6438,Cote d'Ivoire,2005,2005Cote d'Ivoire,0,5,0,12,0,0,17,0,0,9,38,0,0,47,64
6439,Cote d'Ivoire,2005,2005Cote d'Ivoire,5,7,6,24,0,0,42,7,5,5,46,0,0,63,105
6440,Cote d'Ivoire,2005,2005Cote d'Ivoire,9,0,0,20,0,0,29,5,5,0,74,0,0,84,113
6441,Cote d'Ivoire,2005,2005Cote d'Ivoire,122,131,113,439,8,0,813,105,151,129,1468,13,0,1866,2712
6442,Cote d'Ivoire,2005,2005Cote d'Ivoire,234,418,357,624,51,0,1684,198,417,353,547,34,0,1549,3233
6443,Cote d'Ivoire,2005,2005Cote d'Ivoire,508,537,461,1489,149,0,3144,571,609,525,1564,179,0,3448,6592
6444,Cote d'Ivoire,2006,2006Cote d'Ivoire,0,0,0,0,0,0,0,0,0,0,0,0,0,0,4743
6445,Cote d'Ivoire,2006,2006Cote d'Ivoire,0,0,0,0,0,0,0,0,0,0,0,0,12,12,12
6446,Cote d'Ivoire,2006,2006Cote d'Ivoire,0,0,0,0,0,0,0,0,0,0,5,0,0,5,15
6447,Cote d'Ivoire,2006,2006Cote d'Ivoire,0,0,0,0,0,0,0,0,0,0,6,0,0,6,6
6448,Cote d'Ivoire,2006,2006Cote d'Ivoire,0,0,0,0,0,0,0,0,0,0,23,0,0,23,23
6449,Cote d'Ivoire,2006,2006Cote d'Ivoire,0,0,0,0,0,0,0,0,0,0,24,0,0,24,24
6450,Cote d'Ivoire,2006,2006Cote d'Ivoire,0,0,0,0,0,0,0,0,0,0,35,0,0,35,35
6451,Cote d'Ivoire,2006,2006Cote d'Ivoire,0,0,0,0,0,0,0,0,0,0,47,0,0,47,47
6452,Cote d'Ivoire,2006,2006Cote d'Ivoire,0,0,0,0,0,37,37,0,0,0,0,0,40,40,77
6453,Cote d'Ivoire,2006,2006Cote d'Ivoire,0,0,0,0,0,49,49,0,0,0,0,0,140,140,189
6454,Cote d'Ivoire,2006,2006Cote d'Ivoire,0,0,0,0,0,374,374,0,0,0,0,0,916,916,1290
6455,Cote d'Ivoire,2006,2006Cote d'Ivoire,0,0,0,5,0,0,5,0,0,0,9,0,0,9,14
6456,Cote d'Ivoire,2006,2006Cote d'Ivoire,0,0,0,7,0,0,7,0,0,0,92,0,0,92,99
6457,Cote d'Ivoire,2006,2006Cote d'Ivoire,0,0,0,8,0,0,8,0,0,0,35,0,0,35,43
6458,Cote d'Ivoire,2006,2006Cote d'Ivoire,0,0,0,24,0,0,24,0,0,0,46,0,0,46,70
6459,Cote d'Ivoire,2006,2006Cote d'Ivoire,0,0,5,5,0,0,10,0,0,5,11,0,0,16,26
6460,Cote d'Ivoire,2006,2006Cote d'Ivoire,0,0,5,12,0,0,17,0,0,8,39,0,0,47,64
6461,Cote d'Ivoire,2006,2006Cote d'Ivoire,0,0,7,11,0,0,18,0,5,5,17,0,0,27,45
6462,Cote d'Ivoire,2006,2006Cote d'Ivoire,0,5,0,6,0,0,11,0,7,0,26,0,0,33,44
6463,Cote d'Ivoire,2006,2006Cote d'Ivoire,0,7,7,0,0,0,14,0,0,0,8,0,0,8,22
6464,Cote d'Ivoire,2006,2006Cote d'Ivoire,5,6,0,18,0,0,29,5,5,0,39,0,0,49,78
6465,Cote d'Ivoire,2006,2006Cote d'Ivoire,6,0,8,12,0,0,26,0,0,6,11,0,0,17,43
6466,Cote d'Ivoire,2006,2006Cote d'Ivoire,7,5,0,37,0,0,49,10,5,7,97,0,0,119,168
6467,Cote d'Ivoire,2006,2006Cote d'Ivoire,7,14,0,30,0,0,51,9,0,12,64,0,0,85,136
6468,Cote d'Ivoire,2006,2006Cote d'Ivoire,75,68,79,339,0,0,561,52,123,53,1271,6,0,1505,2066
6469,Cote d'Ivoire,2006,2006Cote d'Ivoire,244,378,429,5112,138,0,6301,304,310,473,5024,178,0,6289,12590
6470,Cote d'Ivoire,2006,2006Cote d'Ivoire,276,536,366,866,54,0,2098,229,555,414,985,54,0,2237,4335
6471,Cote d'Ivoire,2007,2007Cote d'Ivoire,0,0,0,0,0,0,0,0,0,0,0,0,0,0,5466
6472,Cote d'Ivoire,2007,2007Cote d'Ivoire,0,0,0,0,0,0,0,0,0,0,5,0,0,5,15
6473,Cote d'Ivoire,2007,2007Cote d'Ivoire,0,0,0,0,0,0,0,0,0,0,6,0,0,6,6
6474,Cote d'Ivoire,2007,2007Cote d'Ivoire,0,0,0,0,0,0,0,0,0,0,7,0,0,7,7
6475,Cote d'Ivoire,2007,2007Cote d'Ivoire,0,0,0,0,0,0,0,0,0,0,10,0,0,10,10
6476,Cote d'Ivoire,2007,2007Cote d'Ivoire,0,0,0,0,0,0,0,0,0,0,13,0,0,13,13
6477,Cote d'Ivoire,2007,2007Cote d'Ivoire,0,0,0,0,0,0,0,0,0,0,21,0,0,21,21
6478,Cote d'Ivoire,2007,2007Cote d'Ivoire,0,0,0,0,0,0,0,0,0,0,26,0,0,26,311
6479,Cote d'Ivoire,2007,2007Cote d'Ivoire,0,0,0,0,0,0,0,0,0,0,51,0,0,51,51
6480,Cote d'Ivoire,2007,2007Cote d'Ivoire,0,0,0,0,0,62,62,0,0,0,0,0,184,184,246
6481,Cote d'Ivoire,2007,2007Cote d'Ivoire,0,0,0,0,0,510,510,0,0,0,0,0,957,957,1467
6482,Cote d'Ivoire,2007,2007Cote d'Ivoire,0,0,0,5,0,0,5,0,0,0,0,0,0,0,5
6483,Cote d'Ivoire,2007,2007Cote d'Ivoire,0,0,0,5,0,0,5,0,0,0,14,0,0,14,19
6484,Cote d'Ivoire,2007,2007Cote d'Ivoire,0,0,0,5,0,0,5,0,0,0,15,0,0,15,20
6485,Cote d'Ivoire,2007,2007Cote d'Ivoire,0,0,0,5,0,0,5,0,0,0,32,0,0,32,37
6486,Cote d'Ivoire,2007,2007Cote d'Ivoire,0,0,0,8,0,0,8,0,5,0,13,0,0,18,26
6487,Cote d'Ivoire,2007,2007Cote d'Ivoire,0,0,0,10,0,0,10,0,0,0,6,0,0,6,16
6488,Cote d'Ivoire,2007,2007Cote d'Ivoire,0,0,0,13,0,0,13,0,0,6,35,0,0,41,59
6489,Cote d'Ivoire,2007,2007Cote d'Ivoire,0,0,0,14,0,0,14,0,0,0,25,0,0,25,39
6490,Cote d'Ivoire,2007,2007Cote d'Ivoire,0,0,0,24,0,0,24,0,0,0,46,0,0,46,70
6491,Cote d'Ivoire,2007,2007Cote d'Ivoire,0,0,7,13,0,0,20,0,5,5,19,0,0,29,49
6492,Cote d'Ivoire,2007,2007Cote d'Ivoire,0,6,6,14,0,0,26,0,6,5,32,0,0,43,69
6493,Cote d'Ivoire,2007,2007Cote d'Ivoire,0,7,6,0,0,0,13,0,0,0,8,0,0,8,21
6494,Cote d'Ivoire,2007,2007Cote d'Ivoire,5,0,0,40,0,0,45,5,5,0,222,0,0,232,277
6495,Cote d'Ivoire,2007,2007Cote d'Ivoire,6,0,0,13,0,27,46,0,5,0,11,0,23,39,85
6496,Cote d'Ivoire,2007,2007Cote d'Ivoire,6,0,7,12,0,0,25,0,0,5,16,0,0,21,46
6497,Cote d'Ivoire,2007,2007Cote d'Ivoire,7,8,0,27,0,0,42,10,5,0,76,0,0,91,133
6498,Cote d'Ivoire,2007,2007Cote d'Ivoire,7,14,0,28,0,0,49,10,0,10,65,0,0,85,134
6499,Cote d'Ivoire,2007,2007Cote d'Ivoire,15,9,6,54,0,0,84,17,19,10,144,0,0,190,274
6500,Cote d'Ivoire,2007,2007Cote d'Ivoire,75,68,79,345,0,0,567,52,123,53,1287,6,0,1521,2088
6501,Cote d'Ivoire,2007,2007Cote d'Ivoire,126,305,357,2473,112,0,3373,205,241,370,2537,139,0,3492,6865
6502,Cote d'Ivoire,2007,2007Cote d'Ivoire,233,528,369,880,53,0,2063,195,552,433,978,56,0,2214,4277
6503,Cote d'Ivoire,2008,2008Cote d'Ivoire,0,0,0,0,0,0,0,0,0,0,0,0,0,0,6258
6504,Cote d'Ivoire,2008,2008Cote d'Ivoire,0,0,0,0,0,0,0,0,0,0,5,0,0,5,20
6505,Cote d'Ivoire,2008,2008Cote d'Ivoire,0,0,0,0,0,0,0,0,0,0,6,0,0,6,6
6506,Cote d'Ivoire,2008,2008Cote d'Ivoire,0,0,0,0,0,0,0,0,0,0,8,0,0,8,8
6507,Cote d'Ivoire,2008,2008Cote d'Ivoire,0,0,0,0,0,0,0,0,0,0,13,0,0,13,13
6508,Cote d'Ivoire,2008,2008Cote d'Ivoire,0,0,0,0,0,0,0,0,0,0,26,0,0,26,26
6509,Cote d'Ivoire,2008,2008Cote d'Ivoire,0,0,0,0,0,0,0,0,0,5,15,0,0,20,20
6510,Cote d'Ivoire,2008,2008Cote d'Ivoire,0,0,0,0,0,0,0,0,5,0,8,0,0,13,13
6511,Cote d'Ivoire,2008,2008Cote d'Ivoire,0,0,0,0,0,515,515,0,0,0,0,0,1088,1088,1603
6512,Cote d'Ivoire,2008,2008Cote d'Ivoire,0,0,0,5,0,0,5,0,0,0,0,0,0,0,5
6513,Cote d'Ivoire,2008,2008Cote d'Ivoire,0,0,0,5,0,0,5,0,0,0,46,0,0,46,51
6514,Cote d'Ivoire,2008,2008Cote d'Ivoire,0,0,0,7,0,0,7,0,0,0,5,0,0,5,12
6515,Cote d'Ivoire,2008,2008Cote d'Ivoire,0,0,0,7,0,0,7,0,0,0,29,0,0,29,36
6516,Cote d'Ivoire,2008,2008Cote d'Ivoire,0,0,0,9,0,0,9,0,0,6,220,0,0,226,235
6517,Cote d'Ivoire,2008,2008Cote d'Ivoire,0,0,0,9,0,0,9,0,5,0,13,0,0,18,27
6518,Cote d'Ivoire,2008,2008Cote d'Ivoire,0,0,0,13,0,0,13,0,0,6,35,0,0,41,59
6519,Cote d'Ivoire,2008,2008Cote d'Ivoire,0,0,0,21,0,0,21,0,0,0,38,0,0,38,59
6520,Cote d'Ivoire,2008,2008Cote d'Ivoire,0,0,7,14,0,0,21,0,5,5,23,0,0,33,54
6521,Cote d'Ivoire,2008,2008Cote d'Ivoire,0,5,0,0,0,0,5,0,0,0,16,0,0,16,21
6522,Cote d'Ivoire,2008,2008Cote d'Ivoire,0,5,5,6,0,0,16,0,0,5,21,0,0,26,42
6523,Cote d'Ivoire,2008,2008Cote d'Ivoire,0,6,6,14,0,0,26,0,6,5,31,0,0,42,68
6524,Cote d'Ivoire,2008,2008Cote d'Ivoire,0,13,6,15,0,0,34,0,0,5,18,0,0,23,57
6525,Cote d'Ivoire,2008,2008Cote d'Ivoire,5,0,5,19,0,28,57,0,8,0,14,0,25,47,104
6526,Cote d'Ivoire,2008,2008Cote d'Ivoire,6,6,5,30,0,0,47,9,6,0,85,0,0,100,147
6527,Cote d'Ivoire,2008,2008Cote d'Ivoire,7,5,0,36,0,0,48,11,5,5,213,0,0,234,282
6528,Cote d'Ivoire,2008,2008Cote d'Ivoire,8,0,0,0,0,0,8,0,0,0,0,0,0,0,8
6529,Cote d'Ivoire,2008,2008Cote d'Ivoire,8,15,0,32,0,0,55,9,0,12,64,0,0,85,140
6530,Cote d'Ivoire,2008,2008Cote d'Ivoire,17,11,7,59,0,0,94,22,21,11,147,0,0,201,295
6531,Cote d'Ivoire,2008,2008Cote d'Ivoire,74,68,76,342,0,0,560,52,119,53,1288,6,0,1518,2078
6532,Cote d'Ivoire,2008,2008Cote d'Ivoire,99,274,340,2408,108,0,3229,144,260,380,2454,140,0,3378,6607
6533,Cote d'Ivoire,2008,2008Cote d'Ivoire,224,530,349,829,49,0,1981,175,490,383,796,39,0,1883,3864
6534,Cote d'Ivoire,2009,2009Cote d'Ivoire,0,0,0,0,0,0,0,0,0,0,0,0,0,0,8163
6535,Cote d'Ivoire,2009,2009Cote d'Ivoire,0,0,0,0,0,0,0,0,0,0,5,0,0,5,20
6536,Cote d'Ivoire,2009,2009Cote d'Ivoire,0,0,0,0,0,0,0,0,0,0,6,0,0,6,6
6537,Cote d'Ivoire,2009,2009Cote d'Ivoire,0,0,0,0,0,0,0,0,0,0,16,0,0,16,16
6538,Cote d'Ivoire,2009,2009Cote d'Ivoire,0,0,0,0,0,0,0,0,0,0,25,0,0,25,25
6539,Cote d'Ivoire,2009,2009Cote d'Ivoire,0,0,0,0,0,0,0,0,0,5,15,0,0,20,20
6540,Cote d'Ivoire,2009,2009Cote d'Ivoire,0,0,0,0,0,0,0,0,5,0,8,0,0,13,13
6541,Cote d'Ivoire,2009,2009Cote d'Ivoire,0,0,0,0,0,0,0,0,8,0,0,0,0,8,8
6542,Cote d'Ivoire,2009,2009Cote d'Ivoire,0,0,0,0,0,13,13,0,0,0,0,0,174,174,187
6543,Cote d'Ivoire,2009,2009Cote d'Ivoire,0,0,0,0,0,59,59,0,0,0,0,0,142,142,201
6544,Cote d'Ivoire,2009,2009Cote d'Ivoire,0,0,0,5,0,0,5,0,0,0,0,0,0,0,5
6545,Cote d'Ivoire,2009,2009Cote d'Ivoire,0,0,0,5,0,0,5,0,0,0,47,0,0,47,52
6546,Cote d'Ivoire,2009,2009Cote d'Ivoire,0,0,0,8,0,0,8,0,0,0,0,0,0,0,8
6547,Cote d'Ivoire,2009,2009Cote d'Ivoire,0,0,0,8,0,0,8,0,0,0,9,0,0,9,17
6548,Cote d'Ivoire,2009,2009Cote d'Ivoire,0,0,0,8,0,0,8,0,0,5,189,0,0,194,202
6549,Cote d'Ivoire,2009,2009Cote d'Ivoire,0,0,0,9,0,0,9,0,0,0,6,0,0,6,15
6550,Cote d'Ivoire,2009,2009Cote d'Ivoire,0,0,0,15,0,0,15,0,0,0,29,0,0,29,44
6551,Cote d'Ivoire,2009,2009Cote d'Ivoire,0,0,0,15,0,0,15,0,0,7,37,0,0,44,59
6552,Cote d'Ivoire,2009,2009Cote d'Ivoire,0,0,7,14,0,0,21,0,5,5,23,0,0,33,54
6553,Cote d'Ivoire,2009,2009Cote d'Ivoire,0,0,9,17,0,0,26,5,6,0,34,0,0,45,71
6554,Cote d'Ivoire,2009,2009Cote d'Ivoire,0,5,0,0,0,0,5,0,0,0,16,0,0,16,21
6555,Cote d'Ivoire,2009,2009Cote d'Ivoire,0,5,0,5,0,0,10,0,5,0,13,0,0,18,28
6556,Cote d'Ivoire,2009,2009Cote d'Ivoire,0,5,7,0,0,0,12,0,0,5,19,0,0,24,36
6557,Cote d'Ivoire,2009,2009Cote d'Ivoire,0,6,5,10,0,0,21,0,6,5,27,0,0,38,59
6558,Cote d'Ivoire,2009,2009Cote d'Ivoire,0,14,9,0,0,0,23,0,0,9,18,0,0,27,50
6559,Cote d'Ivoire,2009,2009Cote d'Ivoire,5,5,0,25,0,28,63,0,8,0,18,0,25,51,114
6560,Cote d'Ivoire,2009,2009Cote d'Ivoire,6,6,5,26,0,0,43,5,8,0,84,0,0,97,140
6561,Cote d'Ivoire,2009,2009Cote d'Ivoire,9,5,0,34,0,0,48,14,0,9,209,0,0,232,280
6562,Cote d'Ivoire,2009,2009Cote d'Ivoire,12,14,30,126,0,0,182,12,13,13,269,5,0,312,494
6563,Cote d'Ivoire,2009,2009Cote d'Ivoire,19,11,9,66,0,0,105,23,22,13,167,0,0,225,330
6564,Cote d'Ivoire,2009,2009Cote d'Ivoire,75,69,78,325,0,0,547,53,120,55,1247,6,0,1481,2028
6565,Cote d'Ivoire,2009,2009Cote d'Ivoire,231,503,370,875,58,0,2037,177,447,428,840,39,0,1931,3968
6566,Cote d'Ivoire,2009,2009Cote d'Ivoire,602,624,425,1388,140,0,3179,596,681,441,1429,88,0,3235,6414
6567,Cote d'Ivoire,2010,2010Cote d'Ivoire,0,0,0,0,0,0,0,0,0,0,0,0,0,0,6714
6568,Cote d'Ivoire,2010,2010Cote d'Ivoire,0,0,0,0,0,0,0,0,0,0,5,0,0,5,25
6569,Cote d'Ivoire,2010,2010Cote d'Ivoire,0,0,0,0,0,0,0,0,0,0,6,0,0,6,6
6570,Cote d'Ivoire,2010,2010Cote d'Ivoire,0,0,0,0,0,0,0,0,0,0,16,0,0,16,16
6571,Cote d'Ivoire,2010,2010Cote d'Ivoire,0,0,0,0,0,0,0,0,0,5,15,0,0,20,20
6572,Cote d'Ivoire,2010,2010Cote d'Ivoire,0,0,0,0,0,27,27,0,0,0,0,0,184,184,211
6573,Cote d'Ivoire,2010,2010Cote d'Ivoire,0,0,0,0,0,56,56,0,0,0,0,0,129,129,185
6574,Cote d'Ivoire,2010,2010Cote d'Ivoire,0,0,0,0,0,717,717,0,0,0,0,0,1203,1203,1920
6575,Cote d'Ivoire,2010,2010Cote d'Ivoire,0,0,0,5,0,0,5,0,0,0,0,0,0,0,5
6576,Cote d'Ivoire,2010,2010Cote d'Ivoire,0,0,0,5,0,0,5,0,0,0,8,0,0,8,13
6577,Cote d'Ivoire,2010,2010Cote d'Ivoire,0,0,0,5,0,0,5,0,0,0,10,0,0,10,15
6578,Cote d'Ivoire,2010,2010Cote d'Ivoire,0,0,0,9,0,0,9,0,0,0,6,0,0,6,15
6579,Cote d'Ivoire,2010,2010Cote d'Ivoire,0,0,0,9,0,0,9,0,0,0,7,0,0,7,16
6580,Cote d'Ivoire,2010,2010Cote d'Ivoire,0,0,0,14,0,0,14,0,0,7,37,0,0,44,58
6581,Cote d'Ivoire,2010,2010Cote d'Ivoire,0,0,5,5,0,0,10,0,0,0,10,0,0,10,20
6582,Cote d'Ivoire,2010,2010Cote d'Ivoire,0,0,7,14,0,0,21,0,5,5,22,0,0,32,53
6583,Cote d'Ivoire,2010,2010Cote d'Ivoire,0,0,7,17,0,0,24,5,5,0,32,0,0,42,66
6584,Cote d'Ivoire,2010,2010Cote d'Ivoire,0,5,0,0,0,0,5,0,0,0,16,0,0,16,21
6585,Cote d'Ivoire,2010,2010Cote d'Ivoire,0,5,7,0,0,0,12,0,0,5,19,0,0,24,36
6586,Cote d'Ivoire,2010,2010Cote d'Ivoire,0,6,0,0,0,0,6,5,0,0,12,0,0,17,23
6587,Cote d'Ivoire,2010,2010Cote d'Ivoire,0,6,5,9,0,0,20,0,6,5,26,0,0,37,57
6588,Cote d'Ivoire,2010,2010Cote d'Ivoire,5,0,0,0,0,0,5,0,0,5,48,0,0,53,58
6589,Cote d'Ivoire,2010,2010Cote d'Ivoire,5,5,0,27,0,26,63,0,0,9,17,0,25,51,114
6590,Cote d'Ivoire,2010,2010Cote d'Ivoire,5,15,0,5,0,0,25,0,0,7,23,0,0,30,55
6591,Cote d'Ivoire,2010,2010Cote d'Ivoire,7,7,7,27,0,0,48,7,9,0,85,0,0,101,149
6592,Cote d'Ivoire,2010,2010Cote d'Ivoire,10,14,22,132,0,0,178,9,13,10,278,5,0,315,493
6593,Cote d'Ivoire,2010,2010Cote d'Ivoire,11,17,6,19,0,0,53,13,12,8,44,0,0,77,130
6594,Cote d'Ivoire,2010,2010Cote d'Ivoire,13,0,5,30,0,0,48,17,5,13,189,0,0,224,272
6595,Cote d'Ivoire,2010,2010Cote d'Ivoire,23,11,9,67,0,0,110,27,22,13,167,0,0,229,339
6596,Cote d'Ivoire,2010,2010Cote d'Ivoire,79,63,78,333,0,0,553,55,120,55,1244,6,0,1480,2033
6597,Cote d'Ivoire,2010,2010Cote d'Ivoire,267,725,659,406,33,0,2090,211,686,732,323,31,0,1983,4073
6598,Cote d'Ivoire,2010,2010Cote d'Ivoire,2765,3040,1295,5461,645,0,13206,2727,3279,1425,3593,306,0,11330,24536
6599,Cote d'Ivoire,2011,2011Cote d'Ivoire,0,0,0,0,0,0,0,0,0,0,0,0,0,0,7889
6600,Cote d'Ivoire,2011,2011Cote d'Ivoire,0,0,0,0,0,0,0,0,0,0,5,0,0,5,30
6601,Cote d'Ivoire,2011,2011Cote d'Ivoire,0,0,0,0,0,0,0,0,0,0,8,0,0,8,16
6602,Cote d'Ivoire,2011,2011Cote d'Ivoire,0,0,0,0,0,0,0,0,0,5,0,0,0,5,5
6603,Cote d'Ivoire,2011,2011Cote d'Ivoire,0,0,0,0,0,0,0,0,0,6,31,0,0,37,37
6604,Cote d'Ivoire,2011,2011Cote d'Ivoire,0,0,0,0,0,0,0,0,5,0,16,0,0,21,21
6605,Cote d'Ivoire,2011,2011Cote d'Ivoire,0,0,0,0,0,59,59,0,0,0,0,0,120,120,186
6606,Cote d'Ivoire,2011,2011Cote d'Ivoire,0,0,0,0,0,800,800,0,0,0,0,0,1251,1251,2051
6607,Cote d'Ivoire,2011,2011Cote d'Ivoire,0,0,0,5,0,0,5,0,0,0,0,0,0,0,15
6608,Cote d'Ivoire,2011,2011Cote d'Ivoire,0,0,0,5,0,0,5,0,0,0,10,0,0,10,15
6609,Cote d'Ivoire,2011,2011Cote d'Ivoire,0,0,0,5,0,0,5,0,0,0,13,0,0,13,18
6610,Cote d'Ivoire,2011,2011Cote d'Ivoire,0,0,0,5,0,0,5,0,0,0,19,0,0,19,29
6611,Cote d'Ivoire,2011,2011Cote d'Ivoire,0,0,0,6,0,0,6,0,0,0,11,0,0,11,17
6612,Cote d'Ivoire,2011,2011Cote d'Ivoire,0,0,0,10,0,0,10,5,0,0,79,0,0,84,94
6613,Cote d'Ivoire,2011,2011Cote d'Ivoire,0,0,0,14,0,0,14,0,0,7,37,0,0,44,58
6614,Cote d'Ivoire,2011,2011Cote d'Ivoire,0,0,5,0,0,0,5,0,0,0,6,0,0,6,11
6615,Cote d'Ivoire,2011,2011Cote d'Ivoire,0,0,5,0,0,0,5,0,0,0,14,0,0,14,19
6616,Cote d'Ivoire,2011,2011Cote d'Ivoire,0,0,14,0,0,0,14,0,0,6,13,0,0,19,33
6617,Cote d'Ivoire,2011,2011Cote d'Ivoire,0,5,0,0,0,0,5,0,0,0,14,0,0,14,19
6618,Cote d'Ivoire,2011,2011Cote d'Ivoire,0,5,7,0,0,0,12,0,0,5,20,0,0,25,37
6619,Cote d'Ivoire,2011,2011Cote d'Ivoire,0,8,0,0,0,0,8,0,0,5,17,0,0,22,30
6620,Cote d'Ivoire,2011,2011Cote d'Ivoire,6,5,0,29,0,27,67,0,9,0,20,0,25,54,121
6621,Cote d'Ivoire,2011,2011Cote d'Ivoire,6,7,6,39,0,0,58,6,11,8,37,0,0,62,427
6622,Cote d'Ivoire,2011,2011Cote d'Ivoire,8,11,17,119,0,0,155,8,9,10,278,5,0,310,465
6623,Cote d'Ivoire,2011,2011Cote d'Ivoire,11,9,0,5,0,0,25,5,0,7,21,0,0,33,58
6624,Cote d'Ivoire,2011,2011Cote d'Ivoire,11,17,6,117,0,0,151,13,12,8,100,0,0,133,284
6625,Cote d'Ivoire,2011,2011Cote d'Ivoire,12,9,5,50,0,0,76,8,20,5,87,0,0,120,196
6626,Cote d'Ivoire,2011,2011Cote d'Ivoire,15,7,0,29,0,0,51,11,6,5,181,0,0,203,254
6627,Cote d'Ivoire,2011,2011Cote d'Ivoire,15,20,10,58,0,0,103,14,22,0,167,0,0,203,306
6628,Cote d'Ivoire,2011,2011Cote d'Ivoire,23,30,14,40,0,0,107,22,21,17,106,0,0,166,273
6629,Cote d'Ivoire,2011,2011Cote d'Ivoire,84,67,83,377,0,0,611,66,132,60,1329,8,0,1595,2206
6630,Cote d'Ivoire,2011,2011Cote d'Ivoire,288,345,234,1516,36,0,2419,324,321,251,1817,19,0,2732,5151
6631,Cote d'Ivoire,2011,2011Cote d'Ivoire,379,716,615,1491,80,0,3281,334,640,640,1425,60,0,3099,6380
6632,Cote d'Ivoire,2011,2011Cote d'Ivoire,13053,15856,8546,26523,2828,0,66806,12850,17579,9629,19610,1593,0,61261,128067
6633,Cote d'Ivoire,2012,2012Cote d'Ivoire,0,0,0,0,0,0,0,0,0,0,0,0,0,0,7777
6634,Cote d'Ivoire,2012,2012Cote d'Ivoire,0,0,0,0,0,0,0,0,0,0,5,0,0,5,30
6635,Cote d'Ivoire,2012,2012Cote d'Ivoire,0,0,0,0,0,0,0,0,0,0,6,0,0,6,12
6636,Cote d'Ivoire,2012,2012Cote d'Ivoire,0,0,0,0,0,0,0,0,0,0,7,0,0,7,7
6637,Cote d'Ivoire,2012,2012Cote d'Ivoire,0,0,0,0,0,0,0,0,0,0,12,0,0,12,12
6638,Cote d'Ivoire,2012,2012Cote d'Ivoire,0,0,0,0,0,0,0,0,0,5,32,0,0,37,37
6639,Cote d'Ivoire,2012,2012Cote d'Ivoire,0,0,0,0,0,0,0,5,0,0,0,0,0,5,5
6640,Cote d'Ivoire,2012,2012Cote d'Ivoire,0,0,0,0,0,55,55,0,0,0,0,0,100,100,155
6641,Cote d'Ivoire,2012,2012Cote d'Ivoire,0,0,0,0,0,904,904,0,0,0,0,0,1300,1300,2204
6642,Cote d'Ivoire,2012,2012Cote d'Ivoire,0,0,0,5,0,0,5,0,0,0,10,0,0,10,15
6643,Cote d'Ivoire,2012,2012Cote d'Ivoire,0,0,0,5,0,0,5,0,0,0,12,0,0,12,17
6644,Cote d'Ivoire,2012,2012Cote d'Ivoire,0,0,0,5,0,0,5,0,0,0,20,0,0,20,25
6645,Cote d'Ivoire,2012,2012Cote d'Ivoire,0,0,0,7,0,0,7,0,0,5,11,0,0,16,23
6646,Cote d'Ivoire,2012,2012Cote d'Ivoire,0,0,0,7,0,0,7,0,0,6,0,0,0,6,13
6647,Cote d'Ivoire,2012,2012Cote d'Ivoire,0,0,0,9,0,0,9,0,5,0,11,0,0,16,25
6648,Cote d'Ivoire,2012,2012Cote d'Ivoire,0,0,0,10,0,0,10,0,0,7,31,0,0,38,48
6649,Cote d'Ivoire,2012,2012Cote d'Ivoire,0,0,0,12,0,0,12,5,0,0,91,0,0,96,108
6650,Cote d'Ivoire,2012,2012Cote d'Ivoire,0,0,5,0,0,0,5,0,0,0,6,0,0,6,11
6651,Cote d'Ivoire,2012,2012Cote d'Ivoire,0,0,5,18,0,0,23,0,0,5,14,0,0,19,420
6652,Cote d'Ivoire,2012,2012Cote d'Ivoire,0,0,14,0,0,0,14,0,0,6,13,0,0,19,33
6653,Cote d'Ivoire,2012,2012Cote d'Ivoire,0,5,0,0,0,0,5,0,0,0,16,0,0,16,21
6654,Cote d'Ivoire,2012,2012Cote d'Ivoire,0,7,0,0,0,0,7,0,0,5,16,0,0,21,28
6655,Cote d'Ivoire,2012,2012Cote d'Ivoire,5,0,0,0,0,0,5,0,0,0,0,0,0,0,5
6656,Cote d'Ivoire,2012,2012Cote d'Ivoire,5,17,8,63,5,0,98,13,10,10,70,0,0,103,201
6657,Cote d'Ivoire,2012,2012Cote d'Ivoire,6,6,0,33,0,28,73,5,5,0,21,0,22,53,126
6658,Cote d'Ivoire,2012,2012Cote d'Ivoire,8,0,6,30,0,0,44,5,8,10,81,0,0,104,148
6659,Cote d'Ivoire,2012,2012Cote d'Ivoire,9,13,20,129,0,0,171,5,17,8,285,5,0,320,491
6660,Cote d'Ivoire,2012,2012Cote d'Ivoire,12,10,5,78,0,0,105,10,9,6,182,0,0,207,312
6661,Cote d'Ivoire,2012,2012Cote d'Ivoire,13,20,6,121,0,0,160,13,13,10,103,0,0,139,299
6662,Cote d'Ivoire,2012,2012Cote d'Ivoire,13,21,9,61,0,0,104,14,14,6,167,0,0,201,305
6663,Cote d'Ivoire,2012,2012Cote d'Ivoire,17,28,13,49,0,0,107,22,19,18,110,0,0,169,276
6664,Cote d'Ivoire,2012,2012Cote d'Ivoire,98,112,79,250,5,0,544,91,117,64,300,0,0,572,1116
6665,Cote d'Ivoire,2012,2012Cote d'Ivoire,319,377,266,1643,40,0,2645,349,345,275,1957,22,0,2948,5593
6666,Cote d'Ivoire,2012,2012Cote d'Ivoire,382,701,641,1568,86,0,3378,314,631,655,1502,72,0,3174,6552
6667,Cote d'Ivoire,2012,2012Cote d'Ivoire,538,666,572,2585,89,0,4450,559,627,524,2472,67,0,4249,8699
6668,Cote d'Ivoire,2012,2012Cote d'Ivoire,6634,7880,3000,16090,1504,0,35108,6516,8145,3530,11271,990,0,30452,65560
6669,Cote d'Ivoire,2013,2013Cote d'Ivoire,0,0,0,0,0,0,0,0,0,0,0,0,0,0,8006
6670,Cote d'Ivoire,2013,2013Cote d'Ivoire,0,0,0,0,0,0,0,0,0,0,5,0,0,5,30
6671,Cote d'Ivoire,2013,2013Cote d'Ivoire,0,0,0,0,0,0,0,0,0,0,6,0,0,6,6
6672,Cote d'Ivoire,2013,2013Cote d'Ivoire,0,0,0,0,0,0,0,0,0,0,7,0,0,7,7
6673,Cote d'Ivoire,2013,2013Cote d'Ivoire,0,0,0,0,0,0,0,0,0,0,12,0,0,12,12
6674,Cote d'Ivoire,2013,2013Cote d'Ivoire,0,0,0,0,0,0,0,0,0,0,36,0,0,36,36
6675,Cote d'Ivoire,2013,2013Cote d'Ivoire,0,0,0,0,0,0,0,0,5,0,0,0,0,5,5
6676,Cote d'Ivoire,2013,2013Cote d'Ivoire,0,0,0,0,0,48,48,0,0,0,0,0,85,85,190
6677,Cote d'Ivoire,2013,2013Cote d'Ivoire,0,0,0,0,0,1021,1021,0,0,0,0,0,1389,1389,2410
6678,Cote d'Ivoire,2013,2013Cote d'Ivoire,0,0,0,5,0,0,5,0,0,0,13,0,0,13,18
6679,Cote d'Ivoire,2013,2013Cote d'Ivoire,0,0,0,6,0,0,6,0,0,0,0,8,0,8,14
6680,Cote d'Ivoire,2013,2013Cote d'Ivoire,0,0,0,7,0,0,7,0,0,0,8,0,0,8,15
6681,Cote d'Ivoire,2013,2013Cote d'Ivoire,0,0,0,9,0,0,9,0,0,7,0,0,0,7,16
6682,Cote d'Ivoire,2013,2013Cote d'Ivoire,0,0,0,10,0,0,10,0,0,7,31,0,0,38,48
6683,Cote d'Ivoire,2013,2013Cote d'Ivoire,0,0,0,11,0,0,11,0,0,0,14,0,0,14,25
6684,Cote d'Ivoire,2013,2013Cote d'Ivoire,0,0,0,12,0,0,12,0,0,6,12,0,0,18,30
6685,Cote d'Ivoire,2013,2013Cote d'Ivoire,0,0,0,14,0,0,14,5,0,0,90,0,0,95,109
6686,Cote d'Ivoire,2013,2013Cote d'Ivoire,0,0,5,0,0,0,5,0,0,0,23,0,0,23,28
6687,Cote d'Ivoire,2013,2013Cote d'Ivoire,0,5,0,5,0,0,10,0,5,0,12,0,0,17,27
6688,Cote d'Ivoire,2013,2013Cote d'Ivoire,0,5,0,10,0,0,15,0,0,6,12,0,0,18,33
6689,Cote d'Ivoire,2013,2013Cote d'Ivoire,0,6,0,0,0,0,6,0,0,0,0,0,0,0,6
6690,Cote d'Ivoire,2013,2013Cote d'Ivoire,0,6,0,0,0,0,6,0,0,0,16,0,0,16,22
6691,Cote d'Ivoire,2013,2013Cote d'Ivoire,0,6,0,18,0,0,24,0,9,0,14,0,0,23,423
6692,Cote d'Ivoire,2013,2013Cote d'Ivoire,5,0,0,0,0,0,5,0,0,0,0,0,0,0,5
6693,Cote d'Ivoire,2013,2013Cote d'Ivoire,5,8,6,50,7,0,76,7,13,7,51,5,0,83,159
6694,Cote d'Ivoire,2013,2013Cote d'Ivoire,5,28,12,63,0,0,108,17,15,10,162,0,0,204,312
6695,Cote d'Ivoire,2013,2013Cote d'Ivoire,6,0,0,0,0,0,6,0,0,0,0,0,0,0,6
6696,Cote d'Ivoire,2013,2013Cote d'Ivoire,6,6,0,19,0,0,31,5,7,10,52,0,0,74,105
6697,Cote d'Ivoire,2013,2013Cote d'Ivoire,6,6,0,34,0,29,75,5,5,0,22,0,27,59,134
6698,Cote d'Ivoire,2013,2013Cote d'Ivoire,6,8,6,57,0,0,77,0,9,6,93,0,0,108,185
6699,Cote d'Ivoire,2013,2013Cote d'Ivoire,7,0,6,10,0,0,23,0,7,7,17,0,0,31,54
6700,Cote d'Ivoire,2013,2013Cote d'Ivoire,11,18,5,116,0,0,150,11,8,8,91,0,0,118,268
6701,Cote d'Ivoire,2013,2013Cote d'Ivoire,12,23,16,44,0,0,95,18,17,23,73,0,0,131,226
6702,Cote d'Ivoire,2013,2013Cote d'Ivoire,14,12,8,96,0,0,130,20,8,6,127,0,0,161,291
6703,Cote d'Ivoire,2013,2013Cote d'Ivoire,95,113,80,249,5,0,542,91,116,64,297,0,0,568,1110
6704,Cote d'Ivoire,2013,2013Cote d'Ivoire,148,172,112,681,11,0,1124,155,167,115,860,12,0,1309,2433
6705,Cote d'Ivoire,2013,2013Cote d'Ivoire,403,626,638,1572,86,0,3325,345,580,616,1562,65,0,3168,6493
6706,Cote d'Ivoire,2013,2013Cote d'Ivoire,588,751,566,2895,95,0,4895,637,670,536,2762,67,0,4672,9567
6707,Cote d'Ivoire,2013,2013Cote d'Ivoire,4744,6662,2760,12789,1269,0,28224,4500,6719,3278,9345,720,0,24562,52786
6708,Cote d'Ivoire,2014,2014Cote d'Ivoire,0,0,0,0,0,0,0,0,0,0,0,0,0,0,8651
6709,Cote d'Ivoire,2014,2014Cote d'Ivoire,0,0,0,0,0,0,0,0,0,0,5,0,0,5,20
6710,Cote d'Ivoire,2014,2014Cote d'Ivoire,0,0,0,0,0,0,0,0,0,0,6,0,0,6,12
6711,Cote d'Ivoire,2014,2014Cote d'Ivoire,0,0,0,0,0,0,0,0,0,0,7,0,0,7,14
6712,Cote d'Ivoire,2014,2014Cote d'Ivoire,0,0,0,0,0,0,0,0,0,0,9,0,0,9,9
6713,Cote d'Ivoire,2014,2014Cote d'Ivoire,0,0,0,0,0,0,0,0,0,0,36,0,0,36,36
6714,Cote d'Ivoire,2014,2014Cote d'Ivoire,0,0,0,0,0,0,0,0,0,5,0,0,0,5,5
6715,Cote d'Ivoire,2014,2014Cote d'Ivoire,0,0,0,0,0,7,7,0,0,0,0,0,0,0,7
6716,Cote d'Ivoire,2014,2014Cote d'Ivoire,0,0,0,0,0,16,16,0,0,0,0,0,32,32,48
6717,Cote d'Ivoire,2014,2014Cote d'Ivoire,0,0,0,0,0,1140,1140,0,0,0,0,0,1376,1376,2516
6718,Cote d'Ivoire,2014,2014Cote d'Ivoire,0,0,0,5,0,0,5,0,0,0,0,6,0,6,11
6719,Cote d'Ivoire,2014,2014Cote d'Ivoire,0,0,0,5,0,0,5,0,0,0,30,0,0,30,35
6720,Cote d'Ivoire,2014,2014Cote d'Ivoire,0,0,0,5,0,0,5,0,5,0,10,0,0,15,20
6721,Cote d'Ivoire,2014,2014Cote d'Ivoire,0,0,0,9,0,0,9,0,0,0,14,0,0,14,23
6722,Cote d'Ivoire,2014,2014Cote d'Ivoire,0,0,0,9,0,0,9,5,0,0,9,0,0,14,23
6723,Cote d'Ivoire,2014,2014Cote d'Ivoire,0,0,0,10,0,0,10,0,0,7,31,0,0,38,48
6724,Cote d'Ivoire,2014,2014Cote d'Ivoire,0,0,0,17,0,0,17,0,0,0,15,0,0,15,431
6725,Cote d'Ivoire,2014,2014Cote d'Ivoire,0,5,0,0,0,0,5,0,0,0,12,0,0,12,17
6726,Cote d'Ivoire,2014,2014Cote d'Ivoire,0,5,0,5,0,0,10,0,5,0,12,0,0,17,27
6727,Cote d'Ivoire,2014,2014Cote d'Ivoire,0,5,6,14,0,0,25,0,0,0,13,0,0,13,38
6728,Cote d'Ivoire,2014,2014Cote d'Ivoire,0,8,0,0,0,0,8,0,0,0,0,0,0,0,8
6729,Cote d'Ivoire,2014,2014Cote d'Ivoire,0,9,8,52,6,0,75,5,10,9,51,5,0,80,155
6730,Cote d'Ivoire,2014,2014Cote d'Ivoire,5,0,0,0,0,0,5,0,0,0,0,0,0,0,5
6731,Cote d'Ivoire,2014,2014Cote d'Ivoire,5,0,0,0,0,0,5,0,0,0,9,0,0,9,14
6732,Cote d'Ivoire,2014,2014Cote d'Ivoire,5,0,0,11,0,0,16,0,5,0,91,0,0,96,112
6733,Cote d'Ivoire,2014,2014Cote d'Ivoire,5,6,8,53,0,0,72,0,8,6,85,0,0,99,171
6734,Cote d'Ivoire,2014,2014Cote d'Ivoire,5,8,0,18,0,0,31,5,9,8,55,0,0,77,108
6735,Cote d'Ivoire,2014,2014Cote d'Ivoire,6,7,0,35,0,33,81,0,6,6,27,0,31,70,151
6736,Cote d'Ivoire,2014,2014Cote d'Ivoire,7,0,6,10,0,0,23,5,5,5,17,0,0,32,55
6737,Cote d'Ivoire,2014,2014Cote d'Ivoire,9,0,0,0,0,0,9,0,0,0,0,0,0,0,9
6738,Cote d'Ivoire,2014,2014Cote d'Ivoire,10,10,57,19,0,0,96,19,7,159,17,0,0,202,298
6739,Cote d'Ivoire,2014,2014Cote d'Ivoire,10,11,5,84,0,0,110,15,6,6,117,0,0,144,254
6740,Cote d'Ivoire,2014,2014Cote d'Ivoire,13,26,16,56,0,0,111,19,23,22,93,0,0,157,268
6741,Cote d'Ivoire,2014,2014Cote d'Ivoire,21,22,18,36,0,0,97,17,24,51,54,0,0,146,243
6742,Cote d'Ivoire,2014,2014Cote d'Ivoire,95,109,80,243,5,0,532,91,114,62,289,0,0,556,1088
6743,Cote d'Ivoire,2014,2014Cote d'Ivoire,180,188,112,717,11,0,1208,165,210,113,850,12,0,1350,2558
6744,Cote d'Ivoire,2014,2014Cote d'Ivoire,462,628,637,1569,84,0,3380,384,580,615,1556,65,0,3200,6580
6745,Cote d'Ivoire,2014,2014Cote d'Ivoire,495,748,580,3050,130,0,5003,538,767,521,2855,95,0,4776,9779
6746,Cote d'Ivoire,2014,2014Cote d'Ivoire,3382,4819,2211,8744,799,0,19955,3271,4916,2503,6981,483,0,18154,38109
6747,Cote d'Ivoire,2015,2015Cote d'Ivoire,0,0,0,0,0,0,0,0,0,0,0,0,0,0,9135
6748,Cote d'Ivoire,2015,2015Cote d'Ivoire,0,0,0,0,0,0,0,0,0,0,0,0,5,5,5
6749,Cote d'Ivoire,2015,2015Cote d'Ivoire,0,0,0,0,0,0,0,0,0,0,5,0,0,5,20
6750,Cote d'Ivoire,2015,2015Cote d'Ivoire,0,0,0,0,0,0,0,0,0,0,6,0,0,6,6
6751,Cote d'Ivoire,2015,2015Cote d'Ivoire,0,0,0,0,0,0,0,0,0,0,7,0,0,7,7
6752,Cote d'Ivoire,2015,2015Cote d'Ivoire,0,0,0,0,0,0,0,0,0,0,9,0,0,9,9
6753,Cote d'Ivoire,2015,2015Cote d'Ivoire,0,0,0,0,0,0,0,0,0,0,21,0,0,21,21
6754,Cote d'Ivoire,2015,2015Cote d'Ivoire,0,0,0,0,0,0,0,5,0,0,0,0,0,5,10
6755,Cote d'Ivoire,2015,2015Cote d'Ivoire,0,0,0,0,0,6,6,0,0,0,0,0,0,0,6
6756,Cote d'Ivoire,2015,2015Cote d'Ivoire,0,0,0,0,0,68,68,0,0,0,0,0,97,97,165
6757,Cote d'Ivoire,2015,2015Cote d'Ivoire,0,0,0,0,0,1263,1263,0,0,0,0,0,1391,1391,2654
6758,Cote d'Ivoire,2015,2015Cote d'Ivoire,0,0,0,5,0,0,5,0,0,0,0,0,0,0,5
6759,Cote d'Ivoire,2015,2015Cote d'Ivoire,0,0,0,5,0,0,5,0,5,0,9,0,0,14,19
6760,Cote d'Ivoire,2015,2015Cote d'Ivoire,0,0,0,8,0,0,8,0,0,0,14,0,0,14,22
6761,Cote d'Ivoire,2015,2015Cote d'Ivoire,0,0,0,9,0,0,9,0,0,0,12,0,0,12,21
6762,Cote d'Ivoire,2015,2015Cote d'Ivoire,0,0,0,10,0,0,10,0,0,7,28,0,0,35,45
6763,Cote d'Ivoire,2015,2015Cote d'Ivoire,0,0,8,0,0,0,8,0,0,0,0,0,0,0,8
6764,Cote d'Ivoire,2015,2015Cote d'Ivoire,0,5,0,8,0,0,13,0,5,0,26,0,0,31,44
6765,Cote d'Ivoire,2015,2015Cote d'Ivoire,0,6,0,6,0,0,12,0,0,0,11,0,0,11,23
6766,Cote d'Ivoire,2015,2015Cote d'Ivoire,0,8,9,53,6,0,76,5,8,12,51,5,0,81,157
6767,Cote d'Ivoire,2015,2015Cote d'Ivoire,0,9,0,0,0,0,9,0,0,0,0,0,0,0,9
6768,Cote d'Ivoire,2015,2015Cote d'Ivoire,5,0,0,0,0,0,5,0,0,0,5,0,0,5,10
6769,Cote d'Ivoire,2015,2015Cote d'Ivoire,5,0,0,0,0,0,5,0,0,0,9,0,0,9,14
6770,Cote d'Ivoire,2015,2015Cote d'Ivoire,5,0,0,6,0,0,11,0,0,5,11,0,0,16,27
6771,Cote d'Ivoire,2015,2015Cote d'Ivoire,5,0,0,6,0,42,53,0,0,5,30,0,45,80,178
6772,Cote d'Ivoire,2015,2015Cote d'Ivoire,5,0,5,6,0,0,16,0,0,0,6,0,0,6,22
6773,Cote d'Ivoire,2015,2015Cote d'Ivoire,5,5,5,19,0,0,34,7,8,9,59,0,0,83,117
6774,Cote d'Ivoire,2015,2015Cote d'Ivoire,6,7,8,51,0,0,72,0,7,6,96,0,0,109,181
6775,Cote d'Ivoire,2015,2015Cote d'Ivoire,7,0,6,10,0,0,23,5,5,5,17,0,0,32,55
6776,Cote d'Ivoire,2015,2015Cote d'Ivoire,10,0,11,0,0,0,21,0,5,6,89,0,0,100,121
6777,Cote d'Ivoire,2015,2015Cote d'Ivoire,10,20,6,53,0,0,89,15,18,5,122,0,0,160,249
6778,Cote d'Ivoire,2015,2015Cote d'Ivoire,12,27,18,57,0,0,114,13,25,20,90,5,0,153,267
6779,Cote d'Ivoire,2015,2015Cote d'Ivoire,14,12,5,83,0,0,114,17,7,10,128,0,0,162,276
6780,Cote d'Ivoire,2015,2015Cote d'Ivoire,18,20,13,41,0,0,92,16,13,15,56,0,0,100,192
6781,Cote d'Ivoire,2015,2015Cote d'Ivoire,60,105,75,249,5,0,494,51,103,61,266,0,0,481,975
6782,Cote d'Ivoire,2015,2015Cote d'Ivoire,178,188,112,703,11,0,1192,146,210,113,843,12,0,1324,2516
6783,Cote d'Ivoire,2015,2015Cote d'Ivoire,380,621,655,1633,87,0,3376,337,573,615,1706,61,0,3292,6668
6784,Cote d'Ivoire,2015,2015Cote d'Ivoire,560,904,901,2992,140,0,5497,590,877,979,2765,99,0,5310,10807
6785,Cote d'Ivoire,2015,2015Cote d'Ivoire,2870,4901,2321,8038,751,0,18881,2797,4909,2596,6395,463,0,17160,36041
6786,Cote d'Ivoire,2016,2016Cote d'Ivoire,0,0,0,0,0,0,0,0,0,0,0,0,0,0,8914
6787,Cote d'Ivoire,2016,2016Cote d'Ivoire,0,0,0,0,0,0,0,0,0,0,0,0,5,5,5
6788,Cote d'Ivoire,2016,2016Cote d'Ivoire,0,0,0,0,0,0,0,0,0,0,0,6,0,6,6
6789,Cote d'Ivoire,2016,2016Cote d'Ivoire,0,0,0,0,0,0,0,0,0,0,5,0,0,5,20
6790,Cote d'Ivoire,2016,2016Cote d'Ivoire,0,0,0,0,0,0,0,0,0,0,7,0,0,7,7
6791,Cote d'Ivoire,2016,2016Cote d'Ivoire,0,0,0,0,0,0,0,0,0,0,9,0,0,9,9
6792,Cote d'Ivoire,2016,2016Cote d'Ivoire,0,0,0,0,0,0,0,0,0,0,20,0,0,20,20
6793,Cote d'Ivoire,2016,2016Cote d'Ivoire,0,0,0,0,0,0,0,0,5,0,0,0,0,5,5
6794,Cote d'Ivoire,2016,2016Cote d'Ivoire,0,0,0,0,0,0,0,5,0,0,0,0,0,5,10
6795,Cote d'Ivoire,2016,2016Cote d'Ivoire,0,0,0,0,0,6,6,0,0,0,0,0,0,0,6
6796,Cote d'Ivoire,2016,2016Cote d'Ivoire,0,0,0,0,0,13,13,0,0,0,0,0,27,27,40
6797,Cote d'Ivoire,2016,2016Cote d'Ivoire,0,0,0,0,0,66,66,0,0,0,0,0,87,87,153
6798,Cote d'Ivoire,2016,2016Cote d'Ivoire,0,0,0,0,0,1454,1454,0,0,0,0,0,1432,1432,2886
6799,Cote d'Ivoire,2016,2016Cote d'Ivoire,0,0,0,5,0,0,5,0,5,0,6,0,0,11,16
6800,Cote d'Ivoire,2016,2016Cote d'Ivoire,0,0,0,6,0,0,6,0,0,0,12,0,0,12,18
6801,Cote d'Ivoire,2016,2016Cote d'Ivoire,0,0,0,9,0,0,9,0,0,0,9,0,0,9,18
6802,Cote d'Ivoire,2016,2016Cote d'Ivoire,0,0,0,10,0,0,10,0,0,7,28,0,0,35,45
6803,Cote d'Ivoire,2016,2016Cote d'Ivoire,0,0,5,11,0,0,16,0,5,0,16,0,0,21,254
6804,Cote d'Ivoire,2016,2016Cote d'Ivoire,0,0,6,0,0,0,6,0,0,0,5,0,0,5,11
6805,Cote d'Ivoire,2016,2016Cote d'Ivoire,0,0,7,7,0,0,14,5,0,0,17,0,0,22,36
6806,Cote d'Ivoire,2016,2016Cote d'Ivoire,0,0,8,9,0,0,17,0,5,0,43,0,0,48,65
6807,Cote d'Ivoire,2016,2016Cote d'Ivoire,0,5,0,0,0,0,5,0,0,0,11,0,0,11,16
6808,Cote d'Ivoire,2016,2016Cote d'Ivoire,0,5,0,0,0,0,5,5,0,0,0,0,0,5,10
6809,Cote d'Ivoire,2016,2016Cote d'Ivoire,0,5,0,9,0,0,14,0,5,0,29,0,0,34,48
6810,Cote d'Ivoire,2016,2016Cote d'Ivoire,0,6,5,15,0,0,26,6,9,8,69,0,0,92,118
6811,Cote d'Ivoire,2016,2016Cote d'Ivoire,0,7,6,10,0,0,23,0,7,7,18,0,0,32,55
6812,Cote d'Ivoire,2016,2016Cote d'Ivoire,0,7,6,59,0,0,72,0,5,5,100,0,0,110,182
6813,Cote d'Ivoire,2016,2016Cote d'Ivoire,0,10,6,58,6,0,80,5,10,11,54,5,0,85,165
6814,Cote d'Ivoire,2016,2016Cote d'Ivoire,5,0,0,7,0,0,12,0,0,6,11,0,0,17,29
6815,Cote d'Ivoire,2016,2016Cote d'Ivoire,5,0,5,5,0,0,15,0,0,0,6,0,0,6,21
6816,Cote d'Ivoire,2016,2016Cote d'Ivoire,5,5,0,24,0,44,78,0,5,6,34,0,48,93,171
6817,Cote d'Ivoire,2016,2016Cote d'Ivoire,7,0,0,0,0,0,7,0,0,0,0,0,0,0,7
6818,Cote d'Ivoire,2016,2016Cote d'Ivoire,12,26,22,52,0,0,112,14,25,16,89,5,0,149,261
6819,Cote d'Ivoire,2016,2016Cote d'Ivoire,14,6,5,38,0,0,63,5,14,6,51,0,0,76,139
6820,Cote d'Ivoire,2016,2016Cote d'Ivoire,15,22,14,42,0,0,93,10,19,13,57,0,0,99,192
6821,Cote d'Ivoire,2016,2016Cote d'Ivoire,20,9,6,83,0,0,118,23,9,7,135,0,0,174,292
6822,Cote d'Ivoire,2016,2016Cote d'Ivoire,90,111,58,195,10,0,464,83,85,56,235,0,0,459,923
6823,Cote d'Ivoire,2016,2016Cote d'Ivoire,128,185,116,558,21,0,1008,137,165,108,694,17,0,1121,2129
6824,Cote d'Ivoire,2016,2016Cote d'Ivoire,339,381,365,1146,56,0,2287,313,385,337,1137,45,0,2217,4504
6825,Cote d'Ivoire,2016,2016Cote d'Ivoire,430,510,405,1874,76,0,3295,413,563,371,1745,66,0,3158,6453
6826,Cote d'Ivoire,2016,2016Cote d'Ivoire,1122,2483,1367,4091,337,0,9400,1174,2470,1452,3791,265,0,9152,18552
6827,Cote d'Ivoire,2017,2017Cote d'Ivoire,0,0,0,0,0,0,0,0,0,0,0,0,0,0,9204
6828,Cote d'Ivoire,2017,2017Cote d'Ivoire,0,0,0,0,0,0,0,0,0,0,0,0,510,510,510
6829,Cote d'Ivoire,2017,2017Cote d'Ivoire,0,0,0,0,0,0,0,0,0,0,5,0,0,5,25
6830,Cote d'Ivoire,2017,2017Cote d'Ivoire,0,0,0,0,0,0,0,0,0,0,6,0,0,6,6
6831,Cote d'Ivoire,2017,2017Cote d'Ivoire,0,0,0,0,0,0,0,0,0,0,9,0,0,9,9
6832,Cote d'Ivoire,2017,2017Cote d'Ivoire,0,0,0,0,0,0,0,0,0,0,15,0,0,15,15
6833,Cote d'Ivoire,2017,2017Cote d'Ivoire,0,0,0,0,0,0,0,0,0,0,20,0,0,20,20
6834,Cote d'Ivoire,2017,2017Cote d'Ivoire,0,0,0,0,0,0,0,0,0,5,0,0,0,5,5
6835,Cote d'Ivoire,2017,2017Cote d'Ivoire,0,0,0,0,0,0,0,0,5,0,0,0,0,5,5
6836,Cote d'Ivoire,2017,2017Cote d'Ivoire,0,0,0,0,0,0,0,5,0,0,0,0,0,5,5
6837,Cote d'Ivoire,2017,2017Cote d'Ivoire,0,0,0,0,0,0,0,7,0,0,0,0,0,7,7
6838,Cote d'Ivoire,2017,2017Cote d'Ivoire,0,0,0,0,0,14,14,0,0,0,0,0,27,27,41
6839,Cote d'Ivoire,2017,2017Cote d'Ivoire,0,0,0,0,0,1776,1776,0,0,0,0,0,1487,1487,3263
6840,Cote d'Ivoire,2017,2017Cote d'Ivoire,0,0,0,5,0,0,5,0,0,0,0,0,0,0,5
6841,Cote d'Ivoire,2017,2017Cote d'Ivoire,0,0,0,6,0,0,6,0,0,6,27,0,0,33,39
6842,Cote d'Ivoire,2017,2017Cote d'Ivoire,0,0,0,7,0,0,7,0,0,0,12,0,0,12,19
6843,Cote d'Ivoire,2017,2017Cote d'Ivoire,0,0,0,8,0,0,8,5,0,0,5,0,0,10,18
6844,Cote d'Ivoire,2017,2017Cote d'Ivoire,0,0,5,0,0,0,5,0,0,0,10,0,0,10,15
6845,Cote d'Ivoire,2017,2017Cote d'Ivoire,0,0,8,10,0,0,18,5,0,0,16,0,0,21,39
6846,Cote d'Ivoire,2017,2017Cote d'Ivoire,0,5,0,0,0,0,5,5,0,0,0,0,0,5,10
6847,Cote d'Ivoire,2017,2017Cote d'Ivoire,0,5,5,12,0,0,22,0,5,7,17,0,0,29,51
6848,Cote d'Ivoire,2017,2017Cote d'Ivoire,0,6,0,5,0,0,11,0,0,0,6,0,0,6,17
6849,Cote d'Ivoire,2017,2017Cote d'Ivoire,0,7,13,27,0,0,47,5,10,6,45,0,0,66,113
6850,Cote d'Ivoire,2017,2017Cote d'Ivoire,0,8,6,24,0,0,38,6,8,9,61,0,0,84,122
6851,Cote d'Ivoire,2017,2017Cote d'Ivoire,5,0,0,8,0,0,13,0,0,6,11,0,0,17,30
6852,Cote d'Ivoire,2017,2017Cote d'Ivoire,5,7,6,54,6,0,78,5,9,11,54,5,0,84,162
6853,Cote d'Ivoire,2017,2017Cote d'Ivoire,6,0,0,0,0,0,6,0,5,0,5,0,0,10,16
6854,Cote d'Ivoire,2017,2017Cote d'Ivoire,6,0,5,25,0,46,82,0,5,8,29,0,45,87,169
6855,Cote d'Ivoire,2017,2017Cote d'Ivoire,9,0,0,8,0,0,17,0,5,0,46,0,0,51,68
6856,Cote d'Ivoire,2017,2017Cote d'Ivoire,12,23,16,41,0,0,92,12,18,13,53,0,0,96,188
6857,Cote d'Ivoire,2017,2017Cote d'Ivoire,14,26,20,58,0,0,118,10,29,16,91,5,0,151,269
6858,Cote d'Ivoire,2017,2017Cote d'Ivoire,16,9,5,129,0,0,159,20,5,11,144,0,0,180,339
6859,Cote d'Ivoire,2017,2017Cote d'Ivoire,21,11,5,92,0,0,129,22,14,8,138,0,0,182,311
6860,Cote d'Ivoire,2017,2017Cote d'Ivoire,55,66,36,138,5,0,300,47,61,45,161,0,0,314,614
6861,Cote d'Ivoire,2017,2017Cote d'Ivoire,106,165,115,532,16,0,934,138,151,104,647,17,0,1057,1991
6862,Cote d'Ivoire,2017,2017Cote d'Ivoire,328,399,381,1137,54,0,2299,314,414,338,1132,42,0,2240,4539
6863,Cote d'Ivoire,2017,2017Cote d'Ivoire,380,527,436,1962,98,0,3403,344,595,406,1866,73,0,3284,6687
6864,Cote d'Ivoire,2017,2017Cote d'Ivoire,647,1366,810,2397,214,0,5434,695,1300,902,2563,169,0,5629,11063
6865,Cote d'Ivoire,2018,2018Cote d'Ivoire,0,0,0,0,0,0,0,0,0,0,0,0,0,0,10100
6866,Cote d'Ivoire,2018,2018Cote d'Ivoire,0,0,0,0,0,0,0,0,0,0,5,0,0,5,25
6867,Cote d'Ivoire,2018,2018Cote d'Ivoire,0,0,0,0,0,0,0,0,0,0,6,0,0,6,6
6868,Cote d'Ivoire,2018,2018Cote d'Ivoire,0,0,0,0,0,0,0,0,0,0,9,0,0,9,9
6869,Cote d'Ivoire,2018,2018Cote d'Ivoire,0,0,0,0,0,0,0,0,0,0,10,0,0,10,10
6870,Cote d'Ivoire,2018,2018Cote d'Ivoire,0,0,0,0,0,0,0,0,0,0,20,0,0,20,20
6871,Cote d'Ivoire,2018,2018Cote d'Ivoire,0,0,0,0,0,0,0,0,0,5,0,0,0,5,10
6872,Cote d'Ivoire,2018,2018Cote d'Ivoire,0,0,0,0,0,0,0,0,5,0,0,0,0,5,10
6873,Cote d'Ivoire,2018,2018Cote d'Ivoire,0,0,0,0,0,2565,2565,0,0,0,0,0,1634,1634,4199
6874,Cote d'Ivoire,2018,2018Cote d'Ivoire,0,0,0,5,0,0,5,0,0,0,0,0,0,0,5
6875,Cote d'Ivoire,2018,2018Cote d'Ivoire,0,0,0,7,0,0,7,0,0,0,7,0,0,7,14
6876,Cote d'Ivoire,2018,2018Cote d'Ivoire,0,0,0,10,0,0,10,0,0,0,14,0,0,14,24
6877,Cote d'Ivoire,2018,2018Cote d'Ivoire,0,0,5,6,0,0,11,0,0,0,6,0,0,6,17
6878,Cote d'Ivoire,2018,2018Cote d'Ivoire,0,0,7,16,0,0,23,5,0,0,12,0,0,17,40
6879,Cote d'Ivoire,2018,2018Cote d'Ivoire,0,6,0,9,0,0,15,0,0,0,21,0,0,21,36
6880,Cote d'Ivoire,2018,2018Cote d'Ivoire,0,8,6,24,0,0,38,6,8,9,62,0,0,85,123
6881,Cote d'Ivoire,2018,2018Cote d'Ivoire,0,9,0,23,0,43,75,0,0,9,40,0,43,92,167
6882,Cote d'Ivoire,2018,2018Cote d'Ivoire,0,14,0,5,0,0,19,0,10,0,41,0,0,51,70
6883,Cote d'Ivoire,2018,2018Cote d'Ivoire,5,0,0,0,0,0,5,0,6,0,0,0,0,6,11
6884,Cote d'Ivoire,2018,2018Cote d'Ivoire,5,6,8,55,6,0,80,0,12,13,56,5,0,86,166
6885,Cote d'Ivoire,2018,2018Cote d'Ivoire,6,0,0,0,0,0,6,0,0,0,9,0,0,9,15
6886,Cote d'Ivoire,2018,2018Cote d'Ivoire,6,12,12,43,0,0,73,0,9,9,26,0,0,44,251
6887,Cote d'Ivoire,2018,2018Cote d'Ivoire,7,6,5,28,0,0,46,0,9,9,45,0,0,63,109
6888,Cote d'Ivoire,2018,2018Cote d'Ivoire,7,15,8,35,0,0,65,14,15,11,33,0,0,73,138
6889,Cote d'Ivoire,2018,2018Cote d'Ivoire,10,0,0,7,0,0,17,0,5,0,11,0,0,16,33
6890,Cote d'Ivoire,2018,2018Cote d'Ivoire,14,22,22,55,0,0,113,14,27,18,82,5,0,146,259
6891,Cote d'Ivoire,2018,2018Cote d'Ivoire,23,10,9,89,0,0,131,17,20,8,144,0,0,189,320
6892,Cote d'Ivoire,2018,2018Cote d'Ivoire,38,19,5,186,5,0,253,41,16,21,189,0,0,267,520
6893,Cote d'Ivoire,2018,2018Cote d'Ivoire,51,68,30,141,5,0,295,44,50,42,152,0,0,288,583
6894,Cote d'Ivoire,2018,2018Cote d'Ivoire,111,150,108,482,18,0,869,104,158,93,553,16,0,924,1793
6895,Cote d'Ivoire,2018,2018Cote d'Ivoire,293,317,264,881,45,0,1800,284,286,262,922,43,0,1797,3597
6896,Cote d'Ivoire,2018,2018Cote d'Ivoire,314,524,423,1970,109,0,3340,296,578,410,1883,78,0,3245,6585
6897,Cote d'Ivoire,2018,2018Cote d'Ivoire,410,1045,749,2018,197,0,4419,459,1054,735,2223,161,0,4632,9051
6898,Cote d'Ivoire,2019,2019Cote d'Ivoire,0,0,0,0,0,0,0,0,0,0,0,0,0,0,10715
6899,Cote d'Ivoire,2019,2019Cote d'Ivoire,0,0,0,0,0,0,0,0,0,0,5,0,0,5,30
6900,Cote d'Ivoire,2019,2019Cote d'Ivoire,0,0,0,0,0,0,0,0,0,0,6,0,0,6,12
6901,Cote d'Ivoire,2019,2019Cote d'Ivoire,0,0,0,0,0,0,0,0,0,0,7,0,0,7,7
6902,Cote d'Ivoire,2019,2019Cote d'Ivoire,0,0,0,0,0,0,0,0,0,0,15,0,0,15,15
6903,Cote d'Ivoire,2019,2019Cote d'Ivoire,0,0,0,0,0,0,0,0,0,0,20,0,0,20,20
6904,Cote d'Ivoire,2019,2019Cote d'Ivoire,0,0,0,0,0,0,0,0,5,0,0,0,0,5,5
6905,Cote d'Ivoire,2019,2019Cote d'Ivoire,0,0,0,0,0,3626,3626,0,0,0,0,0,2026,2026,5652
6906,Cote d'Ivoire,2019,2019Cote d'Ivoire,0,0,0,5,0,0,5,0,0,0,0,0,0,0,5
6907,Cote d'Ivoire,2019,2019Cote d'Ivoire,0,0,0,5,0,0,5,0,0,0,22,0,0,22,27
6908,Cote d'Ivoire,2019,2019Cote d'Ivoire,0,0,0,7,0,0,7,0,0,0,7,0,0,7,14
6909,Cote d'Ivoire,2019,2019Cote d'Ivoire,0,0,5,6,0,0,11,0,0,0,5,0,0,5,16
6910,Cote d'Ivoire,2019,2019Cote d'Ivoire,0,0,5,9,0,0,14,0,0,0,8,0,0,8,22
6911,Cote d'Ivoire,2019,2019Cote d'Ivoire,0,6,0,11,0,0,17,0,0,6,15,0,0,21,38
6912,Cote d'Ivoire,2019,2019Cote d'Ivoire,0,7,0,0,0,0,7,0,5,0,0,0,0,5,12
6913,Cote d'Ivoire,2019,2019Cote d'Ivoire,0,7,0,0,0,0,7,0,5,0,5,0,0,10,17
6914,Cote d'Ivoire,2019,2019Cote d'Ivoire,0,7,9,26,0,0,42,0,9,7,41,0,0,57,99
6915,Cote d'Ivoire,2019,2019Cote d'Ivoire,0,12,19,35,5,0,71,8,19,12,39,0,0,78,149
6916,Cote d'Ivoire,2019,2019Cote d'Ivoire,0,14,0,5,0,0,19,0,10,0,41,0,0,51,70
6917,Cote d'Ivoire,2019,2019Cote d'Ivoire,5,0,0,0,0,0,5,0,0,0,7,0,0,7,12
6918,Cote d'Ivoire,2019,2019Cote d'Ivoire,5,0,5,24,0,0,34,6,0,0,23,0,0,29,63
6919,Cote d'Ivoire,2019,2019Cote d'Ivoire,5,5,5,59,7,0,81,0,9,11,56,7,0,83,164
6920,Cote d'Ivoire,2019,2019Cote d'Ivoire,6,7,5,24,0,0,42,0,12,7,67,0,0,86,128
6921,Cote d'Ivoire,2019,2019Cote d'Ivoire,8,6,0,30,0,0,44,5,0,10,42,0,0,57,180
6922,Cote d'Ivoire,2019,2019Cote d'Ivoire,17,22,22,58,0,0,119,16,26,17,81,5,0,145,264
6923,Cote d'Ivoire,2019,2019Cote d'Ivoire,22,68,29,124,11,0,254,27,53,30,146,5,0,261,515
6924,Cote d'Ivoire,2019,2019Cote d'Ivoire,30,14,7,96,0,0,147,22,18,5,143,0,0,188,335
6925,Cote d'Ivoire,2019,2019Cote d'Ivoire,49,27,6,216,0,0,298,59,19,17,217,0,0,312,610
6926,Cote d'Ivoire,2019,2019Cote d'Ivoire,76,131,97,409,19,0,732,75,146,82,495,14,0,812,1544
6927,Cote d'Ivoire,2019,2019Cote d'Ivoire,208,339,249,1122,50,0,1968,206,298,238,1183,42,0,1967,3935
6928,Cote d'Ivoire,2019,2019Cote d'Ivoire,278,553,424,1967,111,0,3333,270,567,401,1880,73,0,3191,6524
6929,Cote d'Ivoire,2019,2019Cote d'Ivoire,467,772,788,1797,180,0,4004,479,819,684,2007,159,0,4148,8152
6930,Cote d'Ivoire,2020,2020Cote d'Ivoire,0,0,0,0,0,0,0,0,0,0,0,0,0,0,13941
6931,Cote d'Ivoire,2020,2020Cote d'Ivoire,0,0,0,0,0,0,0,0,0,0,5,0,0,5,30
6932,Cote d'Ivoire,2020,2020Cote d'Ivoire,0,0,0,0,0,0,0,0,0,0,6,0,0,6,12
6933,Cote d'Ivoire,2020,2020Cote d'Ivoire,0,0,0,0,0,0,0,0,0,0,20,0,0,20,20
6934,Cote d'Ivoire,2020,2020Cote d'Ivoire,0,0,0,0,0,0,0,0,5,0,0,0,0,5,5
6935,Cote d'Ivoire,2020,2020Cote d'Ivoire,0,0,0,0,0,5,5,0,0,0,0,0,0,0,5
6936,Cote d'Ivoire,2020,2020Cote d'Ivoire,0,0,0,0,0,7,7,0,0,0,0,0,8,8,15
6937,Cote d'Ivoire,2020,2020Cote d'Ivoire,0,0,0,0,0,17,17,0,0,0,0,0,21,21,38
6938,Cote d'Ivoire,2020,2020Cote d'Ivoire,0,0,0,0,0,112,112,0,0,0,0,0,96,96,208
6939,Cote d'Ivoire,2020,2020Cote d'Ivoire,0,0,0,5,0,0,5,0,0,0,0,0,0,0,5
6940,Cote d'Ivoire,2020,2020Cote d'Ivoire,0,0,0,6,0,0,6,0,0,0,0,0,0,0,6
6941,Cote d'Ivoire,2020,2020Cote d'Ivoire,0,0,0,7,0,0,7,0,0,0,8,0,0,8,15
6942,Cote d'Ivoire,2020,2020Cote d'Ivoire,0,0,5,0,0,0,5,0,5,0,0,0,0,5,10
6943,Cote d'Ivoire,2020,2020Cote d'Ivoire,0,0,5,5,0,0,10,0,0,5,12,0,0,17,27
6944,Cote d'Ivoire,2020,2020Cote d'Ivoire,0,0,5,10,0,0,15,0,0,0,13,0,0,13,28
6945,Cote d'Ivoire,2020,2020Cote d'Ivoire,0,0,5,10,0,0,15,0,0,0,18,0,0,18,33
6946,Cote d'Ivoire,2020,2020Cote d'Ivoire,0,0,5,12,0,0,17,0,0,0,8,0,0,8,25
6947,Cote d'Ivoire,2020,2020Cote d'Ivoire,0,0,14,26,0,0,40,0,8,5,40,0,0,53,93
6948,Cote d'Ivoire,2020,2020Cote d'Ivoire,0,5,0,0,0,0,5,0,0,0,7,0,0,7,12
6949,Cote d'Ivoire,2020,2020Cote d'Ivoire,0,7,0,0,0,0,7,0,0,0,0,0,0,0,7
6950,Cote d'Ivoire,2020,2020Cote d'Ivoire,0,7,0,11,0,0,18,0,6,0,16,0,0,22,40
6951,Cote d'Ivoire,2020,2020Cote d'Ivoire,0,8,0,0,0,0,8,0,0,5,5,0,0,10,18
6952,Cote d'Ivoire,2020,2020Cote d'Ivoire,0,14,0,5,0,0,19,0,10,0,44,0,0,54,73
6953,Cote d'Ivoire,2020,2020Cote d'Ivoire,0,22,5,38,5,0,70,5,20,11,43,0,0,79,149
6954,Cote d'Ivoire,2020,2020Cote d'Ivoire,5,5,5,56,10,0,81,5,7,11,58,5,0,86,167
6955,Cote d'Ivoire,2020,2020Cote d'Ivoire,7,5,5,31,0,0,48,6,0,0,25,0,0,31,79
6956,Cote d'Ivoire,2020,2020Cote d'Ivoire,7,5,5,35,0,0,52,5,0,6,49,0,0,60,194
6957,Cote d'Ivoire,2020,2020Cote d'Ivoire,8,7,10,24,0,0,49,0,10,13,64,0,0,87,136
6958,Cote d'Ivoire,2020,2020Cote d'Ivoire,16,25,23,66,0,0,130,16,27,17,83,5,0,148,278
6959,Cote d'Ivoire,2020,2020Cote d'Ivoire,22,68,29,125,11,0,255,28,53,30,149,5,0,265,520
6960,Cote d'Ivoire,2020,2020Cote d'Ivoire,26,17,10,101,0,0,154,18,23,5,159,0,0,205,359
6961,Cote d'Ivoire,2020,2020Cote d'Ivoire,60,35,6,226,0,0,327,63,21,12,235,0,0,331,658
6962,Cote d'Ivoire,2020,2020Cote d'Ivoire,82,144,98,411,21,0,756,86,148,84,497,18,0,833,1589
6963,Cote d'Ivoire,2020,2020Cote d'Ivoire,252,533,405,1960,131,0,3281,216,561,407,1872,80,0,3136,6417
6964,Cote d'Ivoire,2020,2020Cote d'Ivoire,272,380,249,1149,67,0,2117,256,330,258,1198,42,0,2084,4201
6965,Cote d'Ivoire,2020,2020Cote d'Ivoire,426,753,751,1834,198,0,3962,438,776,723,2044,169,0,4150,8112
6966,Cote d'Ivoire,2021,2021Cote d'Ivoire,0,0,0,0,0,0,0,0,0,0,0,0,0,0,17708
6967,Cote d'Ivoire,2021,2021Cote d'Ivoire,0,0,0,0,0,0,0,0,0,0,5,0,0,5,25
6968,Cote d'Ivoire,2021,2021Cote d'Ivoire,0,0,0,0,0,0,0,0,0,0,6,0,0,6,18
6969,Cote d'Ivoire,2021,2021Cote d'Ivoire,0,0,0,0,0,0,0,0,0,0,7,0,0,7,7
6970,Cote d'Ivoire,2021,2021Cote d'Ivoire,0,0,0,0,0,0,0,0,0,0,20,0,0,20,20
6971,Cote d'Ivoire,2021,2021Cote d'Ivoire,0,0,0,0,0,0,0,0,0,5,0,0,0,5,5
6972,Cote d'Ivoire,2021,2021Cote d'Ivoire,0,0,0,0,0,0,0,0,5,0,0,0,0,5,5
6973,Cote d'Ivoire,2021,2021Cote d'Ivoire,0,0,0,5,0,0,5,0,0,0,0,0,0,0,5
6974,Cote d'Ivoire,2021,2021Cote d'Ivoire,0,0,0,7,0,0,7,0,0,0,8,0,0,8,15
6975,Cote d'Ivoire,2021,2021Cote d'Ivoire,0,0,0,9,0,0,9,0,0,0,17,0,0,17,26
6976,Cote d'Ivoire,2021,2021Cote d'Ivoire,0,0,0,13,0,0,13,0,0,0,15,0,0,15,28
6977,Cote d'Ivoire,2021,2021Cote d'Ivoire,0,0,0,15,0,0,15,0,0,0,45,0,0,45,60
6978,Cote d'Ivoire,2021,2021Cote d'Ivoire,0,0,5,0,0,0,5,0,5,0,0,0,0,5,10
6979,Cote d'Ivoire,2021,2021Cote d'Ivoire,0,0,5,10,0,0,15,0,0,0,8,0,0,8,23
6980,Cote d'Ivoire,2021,2021Cote d'Ivoire,0,0,5,27,0,0,32,0,5,0,46,0,0,51,211
6981,Cote d'Ivoire,2021,2021Cote d'Ivoire,0,5,0,0,0,0,5,0,0,0,7,0,0,7,12
6982,Cote d'Ivoire,2021,2021Cote d'Ivoire,0,6,0,5,0,0,11,0,6,0,8,0,0,14,25
6983,Cote d'Ivoire,2021,2021Cote d'Ivoire,0,7,0,0,0,0,7,5,0,0,0,0,0,5,12
6984,Cote d'Ivoire,2021,2021Cote d'Ivoire,0,7,7,52,10,0,76,5,8,10,56,5,0,84,160
6985,Cote d'Ivoire,2021,2021Cote d'Ivoire,0,8,0,0,0,0,8,0,5,0,5,0,0,10,18
6986,Cote d'Ivoire,2021,2021Cote d'Ivoire,0,9,7,25,0,0,41,6,9,0,40,0,0,55,96
6987,Cote d'Ivoire,2021,2021Cote d'Ivoire,0,12,0,5,0,0,17,0,10,0,30,0,0,40,57
6988,Cote d'Ivoire,2021,2021Cote d'Ivoire,0,21,5,39,5,0,70,0,23,11,46,0,0,80,150
6989,Cote d'Ivoire,2021,2021Cote d'Ivoire,7,5,5,31,0,0,48,6,0,0,27,0,0,33,81
6990,Cote d'Ivoire,2021,2021Cote d'Ivoire,7,46,33,99,12,0,197,14,36,35,140,5,0,230,427
6991,Cote d'Ivoire,2021,2021Cote d'Ivoire,8,6,5,30,0,0,49,0,10,12,66,0,0,88,137
6992,Cote d'Ivoire,2021,2021Cote d'Ivoire,10,8,0,35,0,0,53,0,0,9,48,0,0,57,198
6993,Cote d'Ivoire,2021,2021Cote d'Ivoire,11,20,27,69,0,0,127,18,22,19,86,5,0,150,277
6994,Cote d'Ivoire,2021,2021Cote d'Ivoire,21,24,8,112,0,0,165,17,25,8,176,0,0,226,391
6995,Cote d'Ivoire,2021,2021Cote d'Ivoire,61,129,100,392,18,0,700,65,134,66,449,14,0,728,1428
6996,Cote d'Ivoire,2021,2021Cote d'Ivoire,73,45,5,253,5,0,381,68,41,11,259,0,0,379,760
6997,Cote d'Ivoire,2021,2021Cote d'Ivoire,192,333,206,1002,58,0,1791,184,279,203,1065,37,0,1768,3559
6998,Cote d'Ivoire,2021,2021Cote d'Ivoire,198,461,385,1875,140,0,3059,191,475,415,1753,75,0,2909,5968
6999,Cote d'Ivoire,2021,2021Cote d'Ivoire,393,607,779,1893,222,0,3894,398,693,714,2135,184,0,4124,8018
7000,Croatia,2001,2001Croatia,0,0,0,0,0,0,0,0,0,0,0,0,0,0,44836
7001,Croatia,2001,2001Croatia,0,0,0,0,0,0,0,0,0,5,0,0,0,5,5
7002,Croatia,2001,2001Croatia,0,0,0,0,0,6,6,0,0,0,0,0,10,10,16
7003,Croatia,2001,2001Croatia,0,0,0,0,0,31,31,0,0,0,0,0,27,27,58
7004,Croatia,2001,2001Croatia,0,0,0,0,0,68,68,0,0,0,0,0,48,48,116
7005,Croatia,2001,2001Croatia,2785,10622,9105,72883,29816,0,125211,2984,11197,9598,74761,21119,0,119659,245252
7006,Croatia,2002,2002Croatia,0,0,0,0,0,0,0,0,0,0,0,0,0,0,23992
7007,Croatia,2002,2002Croatia,0,0,0,0,0,0,0,0,0,5,0,0,0,5,5
7008,Croatia,2002,2002Croatia,0,0,0,0,0,17,17,0,0,0,0,0,16,16,89
7009,Croatia,2002,2002Croatia,0,0,0,0,0,33,33,0,0,0,0,0,32,32,65
7010,Croatia,2002,2002Croatia,6,15,13,112,60,0,206,6,13,12,158,48,0,237,228655
7011,Croatia,2002,2002Croatia,143,1072,918,7196,1696,0,11025,173,1149,984,7211,1474,0,10991,22016
7012,Croatia,2003,2003Croatia,0,0,0,0,0,0,0,0,0,0,0,0,0,0,20829
7013,Croatia,2003,2003Croatia,0,0,0,0,0,0,0,0,0,5,0,0,0,5,5
7014,Croatia,2003,2003Croatia,0,0,0,0,0,18,18,0,0,0,0,0,17,17,78
7015,Croatia,2003,2003Croatia,0,0,0,0,0,31,31,0,0,0,0,0,27,27,58
7016,Croatia,2003,2003Croatia,0,12,13,95,52,0,172,0,12,12,134,54,0,212,189746
7017,Croatia,2003,2003Croatia,44,917,786,6544,1426,0,9717,59,988,846,6605,1262,0,9760,19477
7018,Croatia,2004,2004Croatia,0,0,0,0,0,0,0,0,0,0,0,0,0,0,16054
7019,Croatia,2004,2004Croatia,0,0,0,0,0,0,0,0,0,0,5,0,0,5,5
7020,Croatia,2004,2004Croatia,0,0,0,0,0,0,0,0,0,5,0,0,0,5,5
7021,Croatia,2004,2004Croatia,0,0,0,7,0,0,7,0,0,0,11,0,0,11,18
7022,Croatia,2004,2004Croatia,0,7,0,6,5,18,36,0,7,0,10,0,15,32,68
7023,Croatia,2004,2004Croatia,0,9,5,99,40,0,153,0,10,10,117,33,0,170,180117
7024,Croatia,2004,2004Croatia,43,905,775,6456,1406,0,9585,58,974,835,6515,1246,0,9628,19213
7025,Croatia,2005,2005Croatia,0,0,0,0,0,0,0,0,0,0,0,0,0,0,111551
7026,Croatia,2005,2005Croatia,0,0,0,0,0,0,0,0,0,0,5,0,0,5,10
7027,Croatia,2005,2005Croatia,0,0,0,0,0,33,33,0,0,0,0,0,30,30,63
7028,Croatia,2005,2005Croatia,0,5,5,5,5,21,41,0,0,6,8,0,17,31,72
7029,Croatia,2005,2005Croatia,98,298,261,2609,481,0,3747,67,329,278,2628,409,0,3711,7458
7030,Croatia,2006,2006Croatia,0,0,0,0,0,0,0,0,0,0,0,0,0,0,13300
7031,Croatia,2006,2006Croatia,0,0,0,0,0,0,0,0,0,0,0,0,5,5,5
7032,Croatia,2006,2006Croatia,0,0,0,0,0,0,0,0,0,0,5,0,0,5,10
7033,Croatia,2006,2006Croatia,0,0,0,0,0,5,5,0,0,0,0,0,5,5,10
7034,Croatia,2006,2006Croatia,0,0,0,0,0,35,35,0,0,0,0,0,31,31,66
7035,Croatia,2006,2006Croatia,0,0,0,0,0,42,42,0,0,0,0,0,34,34,76
7036,Croatia,2006,2006Croatia,5,42,96,659,180,0,982,5,49,105,644,136,0,939,1921
7037,Croatia,2006,2006Croatia,93,260,283,2546,471,0,3653,66,290,301,2560,399,0,3616,7269
7038,Croatia,2006,2006Croatia,200,1546,2275,19298,12477,85,35881,209,1633,2450,23474,7360,104,35230,71111
7039,Croatia,2007,2007Croatia,0,0,0,0,0,0,0,0,0,0,0,0,0,0,20576
7040,Croatia,2007,2007Croatia,0,0,0,0,0,0,0,0,0,0,5,0,0,5,15
7041,Croatia,2007,2007Croatia,0,0,0,0,0,8,8,0,0,0,0,0,0,0,8
7042,Croatia,2007,2007Croatia,0,0,0,0,0,37,37,0,0,0,0,0,33,33,70
7043,Croatia,2007,2007Croatia,0,0,5,9,5,19,38,0,0,8,7,0,14,29,67
7044,Croatia,2007,2007Croatia,0,48,120,792,261,0,1221,5,49,126,766,194,0,1140,2361
7045,Croatia,2007,2007Croatia,91,1260,2215,18947,12827,85,35425,97,1313,2361,23145,7729,99,34744,70169
7046,Croatia,2007,2007Croatia,92,256,279,2509,464,0,3600,65,286,297,2522,393,0,3563,7163
7047,Croatia,2008,2008Croatia,0,0,0,0,0,0,0,0,0,0,0,0,0,0,17933
7048,Croatia,2008,2008Croatia,0,0,0,0,0,0,0,0,0,0,0,0,7,7,7
7049,Croatia,2008,2008Croatia,0,0,0,0,0,0,0,0,0,0,5,0,0,5,10
7050,Croatia,2008,2008Croatia,0,0,0,0,0,38,38,0,0,0,0,0,34,34,72
7051,Croatia,2008,2008Croatia,0,0,5,7,5,17,34,0,0,5,6,0,13,24,58
7052,Croatia,2008,2008Croatia,0,53,91,793,274,0,1211,5,49,106,781,209,0,1150,2361
7053,Croatia,2008,2008Croatia,13,187,261,2508,584,0,3553,10,165,277,2530,535,0,3517,7070
7054,Croatia,2008,2008Croatia,30,1020,2079,18770,13205,0,35104,34,1078,2152,23032,8105,0,34401,69505
7055,Croatia,2009,2009Croatia,0,0,0,0,0,0,0,0,0,0,0,0,0,0,1036
7056,Croatia,2009,2009Croatia,0,0,0,0,0,0,0,0,0,0,5,0,0,5,10
7057,Croatia,2009,2009Croatia,0,0,0,0,0,5,5,0,0,0,0,0,5,5,10
7058,Croatia,2009,2009Croatia,0,0,5,6,5,17,33,0,0,5,5,0,10,20,53
7059,Croatia,2009,2009Croatia,0,44,75,726,278,0,1123,0,45,84,727,205,0,1061,2184
7060,Croatia,2009,2009Croatia,0,135,278,2445,595,0,3453,0,172,225,2455,636,0,3488,6941
7061,Croatia,2009,2009Croatia,15,87,154,1511,178,0,1945,13,73,189,1574,306,0,2155,4100
7062,Croatia,2009,2009Croatia,28,913,1856,16783,11805,0,31385,31,965,1925,20596,7243,0,30760,62145
7063,Croatia,2010,2010Croatia,0,0,0,0,0,0,0,0,0,0,0,0,0,0,710
7064,Croatia,2010,2010Croatia,0,0,0,0,0,0,0,0,0,0,5,0,0,5,10
7065,Croatia,2010,2010Croatia,0,0,0,0,0,8,8,0,0,0,0,0,0,0,8
7066,Croatia,2010,2010Croatia,0,0,0,7,5,20,32,0,0,5,5,0,8,18,50
7067,Croatia,2010,2010Croatia,0,8,49,542,187,0,786,0,6,67,565,133,0,771,1557
7068,Croatia,2010,2010Croatia,0,133,275,2411,593,0,3412,0,164,223,2403,634,0,3424,6836
7069,Croatia,2010,2010Croatia,0,371,1637,13893,10942,0,26843,0,413,1690,17284,6253,0,25640,52483
7070,Croatia,2010,2010Croatia,11,77,135,1579,197,0,1999,14,67,154,1632,343,0,2210,4209
7071,Croatia,2011,2011Croatia,0,0,0,0,0,0,0,0,0,0,0,0,0,0,1451
7072,Croatia,2011,2011Croatia,0,0,0,0,0,0,0,0,0,0,0,0,7,7,7
7073,Croatia,2011,2011Croatia,0,0,0,0,0,0,0,0,0,0,5,0,0,5,10
7074,Croatia,2011,2011Croatia,0,0,0,0,0,38,38,0,0,0,0,0,37,37,75
7075,Croatia,2011,2011Croatia,0,0,0,5,0,0,5,0,5,0,8,0,0,13,61
7076,Croatia,2011,2011Croatia,0,0,0,12,0,23,35,0,0,5,5,0,9,19,54
7077,Croatia,2011,2011Croatia,0,129,269,2399,587,0,3384,0,161,215,2382,627,0,3385,6769
7078,Croatia,2011,2011Croatia,0,292,1310,13198,10796,0,25596,0,332,1380,16387,6251,0,24350,49946
7079,Croatia,2011,2011Croatia,12,52,126,1632,215,0,2037,9,42,141,1678,373,0,2243,4280
7080,Croatia,2012,2012Croatia,0,0,0,0,0,0,0,0,0,0,0,0,0,0,1132
7081,Croatia,2012,2012Croatia,0,0,0,0,0,0,0,0,0,0,0,0,7,7,7
7082,Croatia,2012,2012Croatia,0,0,0,0,0,0,0,0,0,0,5,0,0,5,10
7083,Croatia,2012,2012Croatia,0,0,0,0,0,39,39,0,0,0,0,0,38,38,77
7084,Croatia,2012,2012Croatia,0,0,0,6,0,0,6,0,0,0,17,0,0,17,57
7085,Croatia,2012,2012Croatia,0,0,0,10,0,20,30,0,0,5,5,0,5,15,45
7086,Croatia,2012,2012Croatia,0,128,267,2387,582,0,3364,0,159,213,2373,624,0,3369,6733
7087,Croatia,2012,2012Croatia,0,292,1310,13198,10796,0,25596,0,332,1380,16384,6239,0,24335,49931
7088,Croatia,2012,2012Croatia,12,52,131,1777,239,0,2211,12,45,128,1822,396,0,2403,4614
7089,Croatia,2013,2013Croatia,0,0,0,0,0,0,0,0,0,0,0,0,0,0,638
7090,Croatia,2013,2013Croatia,0,0,0,0,0,0,0,0,0,0,0,0,7,7,7
7091,Croatia,2013,2013Croatia,0,0,0,0,0,0,0,0,0,0,5,0,0,5,10
7092,Croatia,2013,2013Croatia,0,0,0,0,0,39,39,0,0,0,0,0,38,38,77
7093,Croatia,2013,2013Croatia,0,0,0,11,0,19,30,0,0,0,9,0,7,16,46
7094,Croatia,2013,2013Croatia,0,0,6,26,0,0,32,0,0,6,33,6,0,45,77
7095,Croatia,2013,2013Croatia,0,11,36,61,32,0,140,0,6,36,61,116,0,219,359
7096,Croatia,2013,2013Croatia,0,123,263,2383,581,0,3350,0,155,215,2370,619,0,3359,6709
7097,Croatia,2013,2013Croatia,0,258,1153,11612,9498,0,22521,0,264,1090,12950,4937,0,19241,41762
7098,Croatia,2013,2013Croatia,5,7,0,14,0,0,26,8,0,0,18,0,0,26,70
7099,Croatia,2014,2014Croatia,0,0,0,0,0,0,0,0,0,0,0,0,0,0,236
7100,Croatia,2014,2014Croatia,0,0,0,0,0,0,0,0,0,0,5,0,0,5,10
7101,Croatia,2014,2014Croatia,0,0,0,0,0,36,36,0,0,0,0,0,35,35,71
7102,Croatia,2014,2014Croatia,0,0,0,10,0,18,28,0,0,0,9,0,9,18,46
7103,Croatia,2014,2014Croatia,0,0,10,64,30,0,104,0,5,0,87,18,0,110,214
7104,Croatia,2014,2014Croatia,0,10,33,59,33,0,135,0,5,30,60,115,0,210,345
7105,Croatia,2014,2014Croatia,0,121,256,2369,580,15,3341,0,153,222,2351,620,16,3362,6703
7106,Croatia,2014,2014Croatia,0,200,895,9012,7371,0,17478,0,205,845,10049,3831,0,14930,32408
7107,Croatia,2014,2014Croatia,7,0,0,12,0,0,19,5,0,0,16,0,0,21,88
7108,Croatia,2015,2015Croatia,0,0,0,0,0,0,0,0,0,0,0,0,0,0,219
7109,Croatia,2015,2015Croatia,0,0,0,0,0,0,0,0,0,0,5,0,0,5,10
7110,Croatia,2015,2015Croatia,0,0,0,0,0,6,6,0,0,0,0,0,0,0,6
7111,Croatia,2015,2015Croatia,0,0,0,0,0,9,9,0,0,0,0,5,13,18,43
7112,Croatia,2015,2015Croatia,0,0,0,0,0,34,34,0,0,0,0,0,32,32,66
7113,Croatia,2015,2015Croatia,0,0,0,16,5,0,21,0,0,0,15,0,0,15,36
7114,Croatia,2015,2015Croatia,0,0,5,25,0,0,30,0,0,0,33,6,0,39,69
7115,Croatia,2015,2015Croatia,0,6,28,61,34,0,129,0,0,25,64,110,0,199,328
7116,Croatia,2015,2015Croatia,0,162,721,7271,5948,0,14102,0,166,682,8016,3030,0,11894,25996
7117,Croatia,2015,2015Croatia,80,174,324,2352,432,0,3362,62,188,348,2359,360,0,3317,6679
7118,Croatia,2016,2016Croatia,0,0,0,0,0,0,0,0,0,0,0,0,0,0,257
7119,Croatia,2016,2016Croatia,0,0,0,0,0,0,0,0,0,0,5,0,0,5,10
7120,Croatia,2016,2016Croatia,0,0,0,0,0,5,5,0,0,0,0,0,0,0,5
7121,Croatia,2016,2016Croatia,0,0,0,0,0,33,33,0,0,0,0,0,30,30,63
7122,Croatia,2016,2016Croatia,0,0,0,6,0,0,6,0,0,0,13,5,0,18,24
7123,Croatia,2016,2016Croatia,0,0,0,7,0,14,21,0,0,0,5,0,9,14,35
7124,Croatia,2016,2016Croatia,0,5,21,68,33,0,127,0,0,19,66,115,0,200,327
7125,Croatia,2016,2016Croatia,0,9,148,2002,825,0,2984,0,0,134,1695,351,0,2180,5164
7126,Croatia,2016,2016Croatia,0,123,570,5717,4670,0,11080,0,130,529,6248,2359,0,9266,20346
7127,Croatia,2017,2017Croatia,0,0,0,0,0,0,0,0,0,0,0,0,0,0,281
7128,Croatia,2017,2017Croatia,0,0,0,0,0,0,0,0,0,0,5,0,0,5,5
7129,Croatia,2017,2017Croatia,0,0,0,0,0,32,32,0,0,0,0,0,30,30,62
7130,Croatia,2017,2017Croatia,0,0,0,5,0,0,5,0,0,0,9,0,0,9,14
7131,Croatia,2017,2017Croatia,0,0,0,5,0,9,14,0,0,0,5,0,14,19,33
7132,Croatia,2017,2017Croatia,0,5,14,69,33,0,121,0,0,8,68,114,0,190,311
7133,Croatia,2017,2017Croatia,0,9,148,1980,825,0,2962,0,0,134,1673,351,0,2158,5120
7134,Croatia,2017,2017Croatia,0,117,531,5346,4372,0,10366,0,121,496,5850,2210,0,8677,19043
7135,Croatia,2018,2018Croatia,0,0,0,0,0,0,0,0,0,0,0,0,0,0,70
7136,Croatia,2018,2018Croatia,0,0,0,0,0,30,30,0,0,0,0,0,29,29,59
7137,Croatia,2018,2018Croatia,0,0,0,5,0,0,5,0,0,0,5,0,0,5,10
7138,Croatia,2018,2018Croatia,0,0,0,9,0,12,21,0,0,0,0,0,7,7,28
7139,Croatia,2018,2018Croatia,0,0,15,69,34,0,118,0,0,8,60,113,0,181,299
7140,Croatia,2018,2018Croatia,0,0,28,3457,7090,0,10575,0,0,121,3629,3912,0,7662,18237
7141,Croatia,2018,2018Croatia,0,5,0,11,0,0,16,0,0,0,10,0,0,10,282
7142,Croatia,2018,2018Croatia,0,9,148,1980,825,0,2962,0,0,134,1673,351,0,2158,5120
7143,Croatia,2019,2019Croatia,0,0,0,0,0,0,0,0,0,0,0,0,0,0,332
7144,Croatia,2019,2019Croatia,0,0,0,0,0,0,0,0,0,0,5,0,0,5,17972
7145,Croatia,2019,2019Croatia,0,0,0,0,0,30,30,0,0,0,0,0,26,26,56
7146,Croatia,2019,2019Croatia,0,0,0,5,0,0,5,0,0,0,0,0,0,0,21
7147,Croatia,2019,2019Croatia,0,0,0,5,0,0,5,0,0,0,5,0,0,5,10
7148,Croatia,2019,2019Croatia,0,0,10,73,35,0,118,0,0,5,60,103,0,168,286
7149,Croatia,2019,2019Croatia,0,9,148,1977,825,0,2959,0,0,134,1672,351,0,2157,5116
7150,Croatia,2020,2020Croatia,0,0,0,0,0,0,0,0,0,0,0,0,0,0,374
7151,Croatia,2020,2020Croatia,0,0,0,0,0,0,0,0,0,0,5,0,0,5,17680
7152,Croatia,2020,2020Croatia,0,0,0,0,0,5,5,0,0,0,0,0,0,0,5
7153,Croatia,2020,2020Croatia,0,0,0,0,0,2957,2957,0,0,0,0,0,2155,2155,5112
7154,Croatia,2020,2020Croatia,0,0,9,77,34,0,120,0,0,5,58,97,0,160,280
7155,Croatia,2021,2021Croatia,0,0,0,0,0,0,0,0,0,0,0,0,0,0,17699
7156,Croatia,2021,2021Croatia,0,0,0,0,0,0,0,0,0,0,5,0,0,5,5
7157,Croatia,2021,2021Croatia,0,0,0,18,14,0,32,0,0,0,23,8,0,31,114
7158,Croatia,2021,2021Croatia,0,0,7,76,35,0,118,0,0,0,54,93,0,147,265
7159,Cuba,2001,2001Cuba,0,0,0,0,0,0,0,0,0,0,0,0,0,0,18116
7160,Cuba,2001,2001Cuba,0,0,0,0,0,0,0,0,0,0,0,0,10,10,10
7161,Cuba,2001,2001Cuba,0,0,0,0,0,0,0,0,0,0,5,0,0,5,10
7162,Cuba,2001,2001Cuba,0,0,0,0,0,0,0,0,0,0,7,0,0,7,50
7163,Cuba,2001,2001Cuba,0,0,0,0,0,0,0,0,0,0,8,0,0,8,8
7164,Cuba,2001,2001Cuba,0,0,0,0,0,0,0,0,5,0,0,0,0,5,18
7165,Cuba,2001,2001Cuba,0,0,0,0,0,25,25,0,0,0,0,0,32,32,57
7166,Cuba,2001,2001Cuba,0,0,0,0,0,32,32,0,0,0,0,0,54,54,86
7167,Cuba,2001,2001Cuba,0,0,0,5,0,0,5,0,0,0,0,0,0,0,5
7168,Cuba,2001,2001Cuba,0,0,0,11,0,0,11,0,0,0,10,0,0,10,21
7169,Cuba,2001,2001Cuba,0,0,5,13,0,0,18,6,0,0,17,0,0,23,41
7170,Cuba,2001,2001Cuba,0,5,0,0,0,0,5,0,0,0,0,0,0,0,5
7171,Cuba,2001,2001Cuba,0,7,0,21,0,0,28,0,0,5,37,0,0,42,70
7172,Cuba,2001,2001Cuba,0,22,19,249,10,0,300,0,22,20,89,22,0,153,453
7173,Cuba,2002,2002Cuba,0,0,0,0,0,0,0,0,0,0,0,0,0,0,16154
7174,Cuba,2002,2002Cuba,0,0,0,0,0,0,0,0,0,0,5,0,0,5,5
7175,Cuba,2002,2002Cuba,0,0,0,0,0,0,0,0,0,0,8,0,0,8,8
7176,Cuba,2002,2002Cuba,0,0,0,0,0,0,0,0,0,0,10,0,0,10,10
7177,Cuba,2002,2002Cuba,0,0,0,0,0,0,0,0,5,0,0,0,0,5,18
7178,Cuba,2002,2002Cuba,0,0,0,0,0,23,23,0,0,0,0,0,24,24,57
7179,Cuba,2002,2002Cuba,0,0,0,0,0,34,34,0,0,0,0,0,56,56,90
7180,Cuba,2002,2002Cuba,0,0,0,5,5,0,10,0,0,0,18,0,0,18,28
7181,Cuba,2002,2002Cuba,0,0,0,6,0,0,6,0,0,0,0,0,0,0,6
7182,Cuba,2002,2002Cuba,0,0,0,11,0,0,11,0,0,0,10,0,0,10,21
7183,Cuba,2002,2002Cuba,0,5,6,25,0,0,36,0,0,5,31,0,0,36,72
7184,Cuba,2002,2002Cuba,0,10,9,113,0,0,132,0,12,11,158,14,0,195,1107
7185,Cuba,2002,2002Cuba,0,23,21,150,10,0,204,0,23,20,190,22,0,255,459
7186,Cuba,2003,2003Cuba,0,0,0,0,0,0,0,0,0,0,0,0,0,0,15349
7187,Cuba,2003,2003Cuba,0,0,0,0,0,0,0,0,0,0,5,0,0,5,10
7188,Cuba,2003,2003Cuba,0,0,0,0,0,0,0,0,0,0,9,0,0,9,9
7189,Cuba,2003,2003Cuba,0,0,0,0,0,20,20,0,0,0,0,0,21,21,53
7190,Cuba,2003,2003Cuba,0,0,0,0,0,34,34,0,0,0,0,0,53,53,87
7191,Cuba,2003,2003Cuba,0,0,0,5,0,0,5,0,0,0,8,0,0,8,13
7192,Cuba,2003,2003Cuba,0,0,0,11,0,0,11,0,5,0,10,0,0,15,26
7193,Cuba,2003,2003Cuba,0,5,5,26,0,0,36,0,0,5,26,0,0,31,72
7194,Cuba,2003,2003Cuba,0,24,21,150,10,0,205,5,21,19,193,22,0,260,465
7195,Cuba,2004,2004Cuba,0,0,0,0,0,0,0,0,0,0,0,0,0,0,14553
7196,Cuba,2004,2004Cuba,0,0,0,0,0,0,0,0,0,0,5,0,0,5,10
7197,Cuba,2004,2004Cuba,0,0,0,0,0,0,0,0,0,0,6,0,0,6,6
7198,Cuba,2004,2004Cuba,0,0,0,0,0,0,0,0,0,0,7,0,0,7,7
7199,Cuba,2004,2004Cuba,0,0,0,5,0,21,26,0,0,0,9,0,19,28,54
7200,Cuba,2004,2004Cuba,0,0,0,6,0,0,6,0,0,0,0,0,0,0,83
7201,Cuba,2004,2004Cuba,0,0,0,8,0,0,8,0,0,0,13,0,0,13,21
7202,Cuba,2004,2004Cuba,0,0,0,12,0,0,12,0,0,0,15,0,0,15,27
7203,Cuba,2004,2004Cuba,0,0,0,16,0,0,16,0,0,0,32,0,0,32,48
7204,Cuba,2004,2004Cuba,0,5,0,9,0,0,14,0,0,5,16,0,0,21,35
7205,Cuba,2004,2004Cuba,0,5,0,24,5,0,34,0,0,5,54,0,0,59,93
7206,Cuba,2004,2004Cuba,0,6,6,57,5,0,74,0,6,5,140,7,0,158,232
7207,Cuba,2004,2004Cuba,0,24,21,154,10,0,209,5,21,19,205,20,0,270,479
7208,Cuba,2004,2004Cuba,5,0,0,7,0,0,12,0,0,0,11,0,0,11,23
7209,Cuba,2005,2005Cuba,0,0,0,0,0,0,0,0,0,0,0,0,0,0,17789
7210,Cuba,2005,2005Cuba,0,0,0,0,0,0,0,0,0,0,5,0,0,5,5
7211,Cuba,2005,2005Cuba,0,0,0,0,0,0,0,0,0,0,7,0,0,7,7
7212,Cuba,2005,2005Cuba,0,0,0,0,0,0,0,0,0,0,8,0,0,8,16
7213,Cuba,2005,2005Cuba,0,0,0,0,0,0,0,0,0,0,9,0,0,9,37
7214,Cuba,2005,2005Cuba,0,0,0,0,0,39,39,0,0,0,0,0,62,62,101
7215,Cuba,2005,2005Cuba,0,0,0,6,0,0,6,0,0,0,0,0,0,0,6
7216,Cuba,2005,2005Cuba,0,0,0,7,0,0,7,0,0,0,31,0,0,31,38
7217,Cuba,2005,2005Cuba,0,0,0,10,0,0,10,0,0,0,17,0,0,17,27
7218,Cuba,2005,2005Cuba,0,0,0,12,0,0,12,0,0,0,15,0,0,15,27
7219,Cuba,2005,2005Cuba,0,0,0,15,0,0,15,0,0,0,32,0,0,32,47
7220,Cuba,2005,2005Cuba,0,5,0,5,0,19,29,0,0,0,9,0,18,27,56
7221,Cuba,2005,2005Cuba,0,6,6,70,5,0,87,0,6,7,153,7,0,173,260
7222,Cuba,2005,2005Cuba,0,25,21,164,10,0,220,5,22,20,217,20,0,284,504
7223,Cuba,2005,2005Cuba,6,0,0,23,0,0,29,9,0,0,40,5,0,54,83
7224,Cuba,2006,2006Cuba,0,0,0,0,0,0,0,0,0,0,0,0,0,0,32190
7225,Cuba,2006,2006Cuba,0,0,0,0,0,0,0,0,0,0,5,0,0,5,5
7226,Cuba,2006,2006Cuba,0,0,0,0,0,0,0,0,0,0,7,0,0,7,7
7227,Cuba,2006,2006Cuba,0,0,0,0,0,0,0,0,0,0,9,0,0,9,46
7228,Cuba,2006,2006Cuba,0,0,0,0,0,0,0,0,5,0,7,0,0,12,12
7229,Cuba,2006,2006Cuba,0,0,0,0,0,26,26,0,0,0,0,0,30,30,56
7230,Cuba,2006,2006Cuba,0,0,0,0,0,37,37,0,0,0,0,0,68,68,105
7231,Cuba,2006,2006Cuba,0,0,0,0,0,42,42,0,0,0,0,0,70,70,112
7232,Cuba,2006,2006Cuba,0,0,0,6,0,0,6,0,0,0,0,0,0,0,6
7233,Cuba,2006,2006Cuba,0,0,0,7,0,0,7,0,0,0,33,0,0,33,40
7234,Cuba,2006,2006Cuba,0,0,0,12,0,0,12,0,0,5,19,0,0,24,36
7235,Cuba,2006,2006Cuba,0,0,0,13,0,0,13,0,0,0,17,0,0,17,30
7236,Cuba,2006,2006Cuba,0,0,0,15,0,0,15,0,0,0,33,0,0,33,48
7237,Cuba,2006,2006Cuba,0,0,8,24,0,0,32,9,0,0,41,5,0,55,87
7238,Cuba,2006,2006Cuba,0,5,6,73,5,0,89,0,5,7,157,7,0,176,265
7239,Cuba,2006,2006Cuba,0,13,13,190,12,0,228,0,18,19,250,20,0,307,535
7240,Cuba,2007,2007Cuba,0,0,0,0,0,0,0,0,0,0,0,0,0,0,4936
7241,Cuba,2007,2007Cuba,0,0,0,0,0,0,0,0,0,0,7,0,0,7,7
7242,Cuba,2007,2007Cuba,0,0,0,0,0,0,0,0,0,0,9,0,0,9,9
7243,Cuba,2007,2007Cuba,0,0,0,0,0,0,0,0,0,5,5,0,0,10,10
7244,Cuba,2007,2007Cuba,0,0,0,0,0,43,43,0,0,0,0,0,75,75,118
7245,Cuba,2007,2007Cuba,0,0,0,6,0,0,6,0,0,0,0,0,0,0,6
7246,Cuba,2007,2007Cuba,0,0,0,7,0,0,7,0,0,0,43,0,0,43,50
7247,Cuba,2007,2007Cuba,0,0,0,7,0,19,26,0,0,0,57,5,0,62,468
7248,Cuba,2007,2007Cuba,0,0,0,7,0,20,27,0,5,0,5,0,16,26,53
7249,Cuba,2007,2007Cuba,0,0,0,8,0,0,8,0,0,0,12,0,0,12,20
7250,Cuba,2007,2007Cuba,0,0,0,15,0,0,15,0,0,5,15,0,0,20,35
7251,Cuba,2007,2007Cuba,0,0,0,16,0,0,16,0,0,0,35,0,0,35,51
7252,Cuba,2007,2007Cuba,0,0,5,18,5,0,28,5,8,11,61,6,0,91,119
7253,Cuba,2007,2007Cuba,0,0,7,47,8,0,62,0,0,5,98,13,0,116,188
7254,Cuba,2007,2007Cuba,0,0,9,0,0,0,9,0,0,0,0,0,0,0,9
7255,Cuba,2007,2007Cuba,0,5,7,76,5,0,93,0,5,7,160,7,0,179,272
7256,Cuba,2007,2007Cuba,0,9,17,192,12,0,230,0,9,28,261,18,0,316,546
7257,Cuba,2007,2007Cuba,12,26,26,185,5,0,254,17,34,34,243,17,0,345,599
7258,Cuba,2008,2008Cuba,0,0,0,0,0,0,0,0,0,0,0,0,0,0,4914
7259,Cuba,2008,2008Cuba,0,0,0,0,0,0,0,0,0,0,0,7,0,7,7
7260,Cuba,2008,2008Cuba,0,0,0,0,0,0,0,0,0,0,9,0,0,9,17
7261,Cuba,2008,2008Cuba,0,0,0,0,0,0,0,0,0,5,0,0,0,5,5
7262,Cuba,2008,2008Cuba,0,0,0,0,0,41,41,0,0,0,0,0,75,75,116
7263,Cuba,2008,2008Cuba,0,0,0,6,0,0,6,0,0,0,0,0,0,0,6
7264,Cuba,2008,2008Cuba,0,0,0,6,0,0,6,0,0,0,44,0,0,44,50
7265,Cuba,2008,2008Cuba,0,0,0,6,0,19,25,6,0,0,6,0,19,31,56
7266,Cuba,2008,2008Cuba,0,0,0,8,0,0,8,0,0,0,12,0,0,12,20
7267,Cuba,2008,2008Cuba,0,0,0,17,0,0,17,0,0,5,20,0,0,25,42
7268,Cuba,2008,2008Cuba,0,0,0,24,5,0,29,0,0,0,50,9,0,59,1088
7269,Cuba,2008,2008Cuba,0,0,5,19,5,0,29,5,8,11,65,6,0,95,124
7270,Cuba,2008,2008Cuba,0,0,7,65,8,0,80,0,0,5,129,14,0,148,237
7271,Cuba,2008,2008Cuba,0,0,9,0,0,0,9,0,0,0,0,0,0,0,9
7272,Cuba,2008,2008Cuba,0,5,21,204,12,0,242,0,9,29,289,18,0,345,587
7273,Cuba,2008,2008Cuba,12,29,29,200,6,0,276,18,37,37,264,18,0,374,650
7274,Cuba,2009,2009Cuba,0,0,0,0,0,0,0,0,0,0,0,0,0,0,4210
7275,Cuba,2009,2009Cuba,0,0,0,0,0,0,0,0,0,0,6,0,0,6,6
7276,Cuba,2009,2009Cuba,0,0,0,5,0,15,20,0,0,0,6,0,17,23,43
7277,Cuba,2009,2009Cuba,0,0,0,6,0,0,6,0,0,0,0,0,0,0,6
7278,Cuba,2009,2009Cuba,0,0,0,6,0,0,6,0,0,0,44,0,0,44,50
7279,Cuba,2009,2009Cuba,0,0,0,10,0,0,10,0,0,0,12,0,0,12,22
7280,Cuba,2009,2009Cuba,0,0,0,17,0,0,17,0,0,5,25,0,0,30,47
7281,Cuba,2009,2009Cuba,0,0,0,25,5,0,30,0,0,5,50,7,0,62,1092
7282,Cuba,2009,2009Cuba,0,0,5,20,5,0,30,5,8,11,68,6,0,98,128
7283,Cuba,2009,2009Cuba,0,0,5,71,9,0,85,0,0,5,154,14,0,173,258
7284,Cuba,2009,2009Cuba,0,0,9,0,0,0,9,0,0,0,0,0,0,0,9
7285,Cuba,2009,2009Cuba,0,5,8,107,13,0,133,5,6,8,222,7,0,248,381
7286,Cuba,2009,2009Cuba,0,5,21,207,12,0,245,0,9,29,291,18,0,347,592
7287,Cuba,2009,2009Cuba,13,31,31,213,6,0,294,19,40,40,281,19,0,399,693
7288,Cuba,2010,2010Cuba,0,0,0,0,0,0,0,0,0,0,0,0,0,0,3940
7289,Cuba,2010,2010Cuba,0,0,0,0,0,0,0,0,0,0,6,0,0,6,6
7290,Cuba,2010,2010Cuba,0,0,0,0,0,41,41,0,0,0,0,0,79,79,120
7291,Cuba,2010,2010Cuba,0,0,0,5,0,14,19,0,0,0,7,0,18,25,44
7292,Cuba,2010,2010Cuba,0,0,0,6,0,0,6,0,0,0,0,0,0,0,6
7293,Cuba,2010,2010Cuba,0,0,0,9,0,0,9,0,5,0,6,0,0,11,27
7294,Cuba,2010,2010Cuba,0,0,0,10,0,0,10,0,0,0,20,0,0,20,30
7295,Cuba,2010,2010Cuba,0,0,0,19,0,0,19,0,0,5,28,0,0,33,52
7296,Cuba,2010,2010Cuba,0,0,0,26,5,0,31,0,0,5,50,7,0,62,1093
7297,Cuba,2010,2010Cuba,0,0,0,44,8,0,52,0,0,0,68,13,0,81,133
7298,Cuba,2010,2010Cuba,0,0,5,6,0,0,11,0,0,5,42,0,0,47,58
7299,Cuba,2010,2010Cuba,0,0,5,69,8,0,82,0,0,5,142,15,0,162,244
7300,Cuba,2010,2010Cuba,0,0,9,0,0,0,9,0,0,0,0,0,0,0,9
7301,Cuba,2010,2010Cuba,0,5,7,108,14,0,134,0,8,11,223,7,0,249,383
7302,Cuba,2010,2010Cuba,0,5,21,207,12,0,245,0,9,29,292,18,0,348,593
7303,Cuba,2010,2010Cuba,14,31,31,218,7,0,301,20,40,40,297,24,0,421,722
7304,Cuba,2011,2011Cuba,0,0,0,0,0,0,0,0,0,0,0,0,0,0,2170
7305,Cuba,2011,2011Cuba,0,0,0,0,0,0,0,0,0,0,5,0,0,5,25
7306,Cuba,2011,2011Cuba,0,0,0,0,0,0,0,0,0,0,6,0,0,6,6
7307,Cuba,2011,2011Cuba,0,0,0,0,0,17,17,0,0,0,7,0,14,21,38
7308,Cuba,2011,2011Cuba,0,0,0,0,0,42,42,0,0,0,0,0,79,79,121
7309,Cuba,2011,2011Cuba,0,0,0,6,0,0,6,0,0,0,0,0,0,0,6
7310,Cuba,2011,2011Cuba,0,0,0,9,0,0,9,0,0,0,19,0,0,19,33
7311,Cuba,2011,2011Cuba,0,0,0,9,0,0,9,0,5,0,6,0,0,11,27
7312,Cuba,2011,2011Cuba,0,0,0,19,0,0,19,0,0,5,30,0,0,35,54
7313,Cuba,2011,2011Cuba,0,0,0,28,5,0,33,0,0,5,53,8,0,66,1099
7314,Cuba,2011,2011Cuba,0,0,0,44,8,0,52,0,0,0,68,13,0,81,133
7315,Cuba,2011,2011Cuba,0,0,5,6,0,0,11,0,0,5,42,0,0,47,58
7316,Cuba,2011,2011Cuba,0,0,5,71,9,0,85,0,0,5,134,16,0,155,240
7317,Cuba,2011,2011Cuba,0,0,7,97,21,0,125,0,6,0,117,12,0,135,1739
7318,Cuba,2011,2011Cuba,0,0,9,0,0,0,9,0,0,0,0,0,0,0,9
7319,Cuba,2011,2011Cuba,0,0,9,100,13,0,122,0,6,8,224,9,0,247,369
7320,Cuba,2011,2011Cuba,0,5,0,0,0,0,5,0,0,0,0,0,0,0,5
7321,Cuba,2011,2011Cuba,0,5,0,34,5,0,44,0,0,5,87,5,0,97,340
7322,Cuba,2011,2011Cuba,0,5,21,207,12,0,245,0,9,29,295,18,0,351,596
7323,Cuba,2011,2011Cuba,14,31,31,237,9,0,322,20,40,41,325,29,0,455,777
7324,Cuba,2012,2012Cuba,0,0,0,0,0,0,0,0,0,0,0,0,0,0,2025
7325,Cuba,2012,2012Cuba,0,0,0,0,0,0,0,0,0,0,5,0,0,5,5
7326,Cuba,2012,2012Cuba,0,0,0,0,0,0,0,0,0,0,6,0,0,6,38
7327,Cuba,2012,2012Cuba,0,0,0,0,0,0,0,0,5,0,24,0,0,29,36
7328,Cuba,2012,2012Cuba,0,0,0,0,0,28,28,0,0,0,0,0,81,81,109
7329,Cuba,2012,2012Cuba,0,0,0,0,0,43,43,0,0,0,0,0,79,79,122
7330,Cuba,2012,2012Cuba,0,0,0,6,0,0,6,0,0,0,0,0,0,0,6
7331,Cuba,2012,2012Cuba,0,0,0,6,0,12,18,0,0,0,8,0,12,20,38
7332,Cuba,2012,2012Cuba,0,0,0,24,7,0,31,0,5,0,37,6,0,48,1708
7333,Cuba,2012,2012Cuba,0,0,0,32,6,0,38,0,0,5,62,9,0,76,1114
7334,Cuba,2012,2012Cuba,0,0,0,45,8,0,53,0,0,0,68,13,0,81,134
7335,Cuba,2012,2012Cuba,0,0,0,70,11,0,81,0,0,0,132,17,0,149,230
7336,Cuba,2012,2012Cuba,0,0,5,6,0,0,11,0,0,5,44,0,0,49,60
7337,Cuba,2012,2012Cuba,0,0,5,10,0,0,15,0,5,0,21,0,0,26,41
7338,Cuba,2012,2012Cuba,0,0,5,16,0,0,21,0,0,5,30,0,0,35,56
7339,Cuba,2012,2012Cuba,0,0,5,106,13,0,124,0,8,8,212,12,0,240,364
7340,Cuba,2012,2012Cuba,0,0,9,0,0,0,9,0,0,0,0,0,0,0,9
7341,Cuba,2012,2012Cuba,0,5,0,31,7,0,43,0,0,0,83,6,0,89,340
7342,Cuba,2012,2012Cuba,0,5,17,187,10,0,219,0,7,36,193,14,0,250,469
7343,Cuba,2012,2012Cuba,14,34,31,250,9,0,338,20,40,46,345,29,0,480,818
7344,Cuba,2013,2013Cuba,0,0,0,0,0,0,0,0,0,0,0,0,0,0,2097
7345,Cuba,2013,2013Cuba,0,0,0,0,0,0,0,0,0,0,5,0,0,5,5
7346,Cuba,2013,2013Cuba,0,0,0,0,0,46,46,0,0,0,0,0,92,92,138
7347,Cuba,2013,2013Cuba,0,0,0,0,7,0,7,0,0,0,9,6,0,15,22
7348,Cuba,2013,2013Cuba,0,0,0,5,0,0,5,0,0,0,6,0,0,6,11
7349,Cuba,2013,2013Cuba,0,0,0,6,0,0,6,0,0,0,0,0,0,0,6
7350,Cuba,2013,2013Cuba,0,0,0,6,0,0,6,0,0,0,8,0,0,8,14
7351,Cuba,2013,2013Cuba,0,0,0,6,0,11,17,0,0,0,8,0,13,21,38
7352,Cuba,2013,2013Cuba,0,0,0,9,0,0,9,0,0,0,0,0,0,0,9
7353,Cuba,2013,2013Cuba,0,0,0,15,0,0,15,0,5,0,23,0,0,28,43
7354,Cuba,2013,2013Cuba,0,0,0,33,6,0,39,0,0,5,63,9,0,77,1116
7355,Cuba,2013,2013Cuba,0,0,0,45,8,0,53,0,0,0,69,13,0,82,135
7356,Cuba,2013,2013Cuba,0,0,0,69,12,0,81,0,0,0,128,19,0,147,228
7357,Cuba,2013,2013Cuba,0,0,5,8,0,0,13,0,0,5,44,0,0,49,62
7358,Cuba,2013,2013Cuba,0,0,5,33,0,0,38,0,5,0,78,5,0,88,126
7359,Cuba,2013,2013Cuba,0,0,6,19,0,0,25,0,0,5,29,0,0,34,59
7360,Cuba,2013,2013Cuba,0,5,0,73,25,0,103,0,0,0,201,41,0,242,345
7361,Cuba,2013,2013Cuba,0,5,190,28,0,0,223,0,8,36,213,0,0,257,480
7362,Cuba,2013,2013Cuba,0,8,7,61,5,0,81,0,7,5,64,0,0,76,1674
7363,Cuba,2013,2013Cuba,14,34,32,258,9,0,347,20,40,50,356,32,0,498,845
7364,Cuba,2014,2014Cuba,0,0,0,0,0,0,0,0,0,0,0,0,0,0,3225
7365,Cuba,2014,2014Cuba,0,0,0,0,0,0,0,0,0,0,5,0,0,5,5
7366,Cuba,2014,2014Cuba,0,0,0,0,0,0,0,0,5,0,0,0,0,5,5
7367,Cuba,2014,2014Cuba,0,0,0,0,0,49,49,0,0,0,0,0,91,91,140
7368,Cuba,2014,2014Cuba,0,0,0,5,0,0,5,0,0,0,7,0,0,7,12
7369,Cuba,2014,2014Cuba,0,0,0,5,0,0,5,0,0,6,5,0,0,11,16
7370,Cuba,2014,2014Cuba,0,0,0,6,0,0,6,0,0,0,0,0,0,0,6
7371,Cuba,2014,2014Cuba,0,0,0,6,0,14,20,0,0,0,8,0,12,20,40
7372,Cuba,2014,2014Cuba,0,0,0,15,0,0,15,0,0,0,0,0,0,0,43
7373,Cuba,2014,2014Cuba,0,0,0,33,6,0,39,0,0,5,64,10,0,79,1118
7374,Cuba,2014,2014Cuba,0,0,5,8,0,0,13,0,0,5,44,0,0,49,62
7375,Cuba,2014,2014Cuba,0,0,5,9,0,0,14,0,5,0,17,0,0,22,36
7376,Cuba,2014,2014Cuba,0,0,5,27,0,0,32,0,6,0,70,5,0,81,113
7377,Cuba,2014,2014Cuba,0,0,7,23,0,0,30,0,0,5,31,0,0,36,66
7378,Cuba,2014,2014Cuba,0,0,8,45,5,0,58,0,7,0,55,0,0,62,1618
7379,Cuba,2014,2014Cuba,0,0,9,0,0,0,9,0,0,0,0,0,0,0,9
7380,Cuba,2014,2014Cuba,0,5,0,0,0,0,5,0,0,0,0,0,0,0,5
7381,Cuba,2014,2014Cuba,0,5,0,72,25,0,102,0,0,0,199,41,0,240,342
7382,Cuba,2014,2014Cuba,0,5,201,45,0,0,251,0,5,41,204,0,0,250,501
7383,Cuba,2014,2014Cuba,5,0,0,21,0,0,26,0,9,0,100,0,0,109,135
7384,Cuba,2015,2015Cuba,0,0,0,0,0,0,0,0,0,0,0,0,0,0,4519
7385,Cuba,2015,2015Cuba,0,0,0,0,0,0,0,0,0,0,0,0,5,5,10
7386,Cuba,2015,2015Cuba,0,0,0,0,0,0,0,0,0,0,5,0,0,5,5
7387,Cuba,2015,2015Cuba,0,0,0,0,0,0,0,0,0,0,8,0,0,8,8
7388,Cuba,2015,2015Cuba,0,0,0,0,0,12,12,0,0,0,5,0,10,15,42
7389,Cuba,2015,2015Cuba,0,0,0,0,0,52,52,0,0,0,0,0,98,98,150
7390,Cuba,2015,2015Cuba,0,0,0,5,0,0,5,0,0,0,0,0,0,0,10
7391,Cuba,2015,2015Cuba,0,0,0,5,0,0,5,0,0,0,10,0,0,10,15
7392,Cuba,2015,2015Cuba,0,0,0,7,0,0,7,0,0,0,0,0,0,0,7
7393,Cuba,2015,2015Cuba,0,0,0,7,0,0,7,0,0,0,10,5,0,15,22
7394,Cuba,2015,2015Cuba,0,0,0,23,5,0,28,0,5,0,62,7,0,74,102
7395,Cuba,2015,2015Cuba,0,0,0,28,0,0,28,0,0,5,110,0,0,115,143
7396,Cuba,2015,2015Cuba,0,0,0,33,6,0,39,0,0,5,64,10,0,79,1118
7397,Cuba,2015,2015Cuba,0,0,5,8,0,0,13,0,0,5,44,0,0,49,62
7398,Cuba,2015,2015Cuba,0,0,5,62,27,0,94,0,0,0,134,37,0,171,265
7399,Cuba,2015,2015Cuba,0,0,6,15,0,0,21,0,0,5,14,0,0,19,40
7400,Cuba,2015,2015Cuba,0,0,7,23,0,0,30,0,0,5,31,0,0,36,66
7401,Cuba,2015,2015Cuba,0,0,7,60,10,0,77,0,0,13,115,14,0,142,229
7402,Cuba,2015,2015Cuba,0,0,9,0,0,0,9,0,0,0,0,0,0,0,9
7403,Cuba,2015,2015Cuba,0,5,0,0,0,0,5,0,0,0,0,0,0,0,5
7404,Cuba,2016,2016Cuba,0,0,0,0,0,0,0,0,0,0,0,0,0,0,2665
7405,Cuba,2016,2016Cuba,0,0,0,0,0,0,0,0,0,0,5,0,0,5,10
7406,Cuba,2016,2016Cuba,0,0,0,0,0,8,8,0,0,0,0,0,0,0,8
7407,Cuba,2016,2016Cuba,0,0,0,0,0,59,59,0,0,0,0,0,101,101,160
7408,Cuba,2016,2016Cuba,0,0,0,0,0,150,150,0,0,0,0,0,227,227,377
7409,Cuba,2016,2016Cuba,0,0,0,5,0,0,5,0,0,0,0,0,0,0,5
7410,Cuba,2016,2016Cuba,0,0,0,5,0,0,5,0,0,0,7,0,0,7,12
7411,Cuba,2016,2016Cuba,0,0,0,5,0,0,5,0,0,0,8,0,0,8,13
7412,Cuba,2016,2016Cuba,0,0,0,5,0,0,5,0,0,0,9,0,8,17,22
7413,Cuba,2016,2016Cuba,0,0,0,5,0,0,5,0,0,0,10,0,0,10,15
7414,Cuba,2016,2016Cuba,0,0,0,6,0,0,6,0,0,0,0,0,0,0,6
7415,Cuba,2016,2016Cuba,0,0,0,8,0,11,19,0,0,0,12,0,12,24,43
7416,Cuba,2016,2016Cuba,0,0,0,9,0,0,9,0,0,0,0,0,0,0,9
7417,Cuba,2016,2016Cuba,0,0,0,13,0,0,13,0,0,5,13,0,0,18,31
7418,Cuba,2016,2016Cuba,0,0,0,19,5,0,24,0,5,0,60,6,0,71,95
7419,Cuba,2016,2016Cuba,0,0,0,29,0,0,29,0,0,5,113,0,0,118,147
7420,Cuba,2016,2016Cuba,0,0,0,33,6,0,39,0,0,5,64,10,0,79,1118
7421,Cuba,2016,2016Cuba,0,0,5,62,26,0,93,0,0,0,139,25,0,164,257
7422,Cuba,2016,2016Cuba,0,0,6,10,0,0,16,0,0,8,47,0,0,55,71
7423,Cuba,2016,2016Cuba,0,0,7,0,0,0,7,0,0,0,0,0,0,0,7
7424,Cuba,2016,2016Cuba,0,0,7,25,0,0,32,0,6,5,22,0,0,33,869
7425,Cuba,2017,2017Cuba,0,0,0,0,0,0,0,0,0,0,0,0,0,0,3532
7426,Cuba,2017,2017Cuba,0,0,0,0,0,0,0,0,0,0,5,0,0,5,10
7427,Cuba,2017,2017Cuba,0,0,0,0,0,0,0,0,0,0,7,0,0,7,7
7428,Cuba,2017,2017Cuba,0,0,0,0,0,61,61,0,0,0,0,0,106,106,167
7429,Cuba,2017,2017Cuba,0,0,0,0,0,152,152,0,0,0,0,0,227,227,379
7430,Cuba,2017,2017Cuba,0,0,0,5,0,0,5,0,0,0,0,0,0,0,158
7431,Cuba,2017,2017Cuba,0,0,0,5,0,0,5,0,0,0,7,0,0,7,12
7432,Cuba,2017,2017Cuba,0,0,0,5,0,0,5,0,0,0,9,0,0,9,22
7433,Cuba,2017,2017Cuba,0,0,0,5,0,0,5,0,0,0,10,0,0,10,15
7434,Cuba,2017,2017Cuba,0,0,0,7,0,0,7,0,0,0,17,0,0,17,24
7435,Cuba,2017,2017Cuba,0,0,0,8,0,0,8,0,0,0,0,0,0,0,8
7436,Cuba,2017,2017Cuba,0,0,0,9,0,9,18,0,0,0,11,0,11,22,40
7437,Cuba,2017,2017Cuba,0,0,0,19,5,0,24,0,5,0,62,6,0,73,97
7438,Cuba,2017,2017Cuba,0,0,0,60,15,0,75,0,0,0,112,25,0,137,212
7439,Cuba,2017,2017Cuba,0,0,5,8,0,0,13,0,0,5,11,0,0,16,29
7440,Cuba,2017,2017Cuba,0,0,5,60,27,0,92,0,0,0,138,25,0,163,255
7441,Cuba,2017,2017Cuba,0,0,7,26,0,0,33,0,6,0,26,0,0,32,65
7442,Cuba,2017,2017Cuba,0,0,8,33,0,0,41,9,0,0,65,5,0,79,120
7443,Cuba,2017,2017Cuba,0,5,5,41,0,0,51,0,6,7,39,0,0,52,108
7444,Cuba,2017,2017Cuba,5,0,6,15,0,0,26,0,0,7,38,0,0,45,71
7445,Cuba,2018,2018Cuba,0,0,0,0,0,0,0,0,0,0,0,0,0,0,4021
7446,Cuba,2018,2018Cuba,0,0,0,0,0,0,0,0,0,0,5,0,0,5,10
7447,Cuba,2018,2018Cuba,0,0,0,0,0,0,0,0,0,0,8,0,0,8,8
7448,Cuba,2018,2018Cuba,0,0,0,0,0,0,0,0,0,0,9,0,0,9,9
7449,Cuba,2018,2018Cuba,0,0,0,0,0,0,0,5,0,0,0,0,0,5,5
7450,Cuba,2018,2018Cuba,0,0,0,0,0,64,64,0,0,0,0,0,115,115,179
7451,Cuba,2018,2018Cuba,0,0,0,5,0,0,5,0,0,0,0,0,0,0,5
7452,Cuba,2018,2018Cuba,0,0,0,5,0,0,5,0,0,0,10,0,0,10,30
7453,Cuba,2018,2018Cuba,0,0,0,18,6,0,24,0,5,0,57,7,0,69,93
7454,Cuba,2018,2018Cuba,0,0,5,58,29,0,92,0,0,0,133,28,0,161,253
7455,Cuba,2018,2018Cuba,0,0,6,0,0,10,16,0,0,0,10,0,9,19,35
7456,Cuba,2018,2018Cuba,0,5,5,25,0,0,35,0,0,7,29,0,0,36,767
7457,Cuba,2018,2018Cuba,5,5,6,10,0,0,26,0,0,8,39,0,0,47,73
7458,Cuba,2019,2019Cuba,0,0,0,0,0,0,0,0,0,0,0,0,0,0,5861
7459,Cuba,2019,2019Cuba,0,0,0,0,0,0,0,0,0,0,0,0,34,34,34
7460,Cuba,2019,2019Cuba,0,0,0,0,0,0,0,0,0,0,5,0,0,5,34
7461,Cuba,2019,2019Cuba,0,0,0,0,0,0,0,0,5,0,0,0,0,5,5
7462,Cuba,2019,2019Cuba,0,0,0,0,0,67,67,0,0,0,0,0,129,129,196
7463,Cuba,2019,2019Cuba,0,0,0,5,0,0,5,0,0,0,0,0,0,0,5
7464,Cuba,2019,2019Cuba,0,0,0,5,0,0,5,0,0,0,10,0,0,10,15
7465,Cuba,2019,2019Cuba,0,0,0,5,5,0,10,0,0,0,10,5,0,15,25
7466,Cuba,2019,2019Cuba,0,0,0,6,0,0,6,0,0,0,10,0,0,10,34
7467,Cuba,2019,2019Cuba,0,0,0,6,0,9,15,0,0,0,15,5,38,58,73
7468,Cuba,2019,2019Cuba,0,0,0,15,5,0,20,0,0,0,57,9,0,66,86
7469,Cuba,2019,2019Cuba,0,0,5,60,29,0,94,0,0,5,130,28,0,163,257
7470,Cuba,2020,2020Cuba,0,0,0,0,0,0,0,0,0,0,0,0,0,0,7826
7471,Cuba,2020,2020Cuba,0,0,0,0,0,0,0,0,0,0,5,0,0,5,10
7472,Cuba,2020,2020Cuba,0,0,0,0,0,5,5,0,0,0,0,0,5,5,10
7473,Cuba,2020,2020Cuba,0,0,0,0,0,27,27,0,0,0,0,0,51,51,78
7474,Cuba,2020,2020Cuba,0,0,0,5,0,0,5,0,0,0,0,0,0,0,5
7475,Cuba,2020,2020Cuba,0,0,0,5,0,0,5,0,0,0,9,0,0,9,14
7476,Cuba,2020,2020Cuba,0,0,0,6,5,0,11,0,0,0,9,6,0,15,26
7477,Cuba,2020,2020Cuba,0,0,0,8,0,0,8,0,0,0,8,0,0,8,35
7478,Cuba,2020,2020Cuba,0,0,0,13,6,0,19,0,0,0,48,11,0,59,78
7479,Cuba,2020,2020Cuba,0,0,0,22,5,0,27,0,0,0,45,5,0,50,77
7480,Cuba,2020,2020Cuba,0,0,0,61,15,0,76,0,0,0,105,33,0,138,214
7481,Cuba,2020,2020Cuba,0,0,5,60,29,0,94,0,0,0,130,35,0,165,259
7482,Cuba,2020,2020Cuba,5,8,8,96,5,0,122,0,8,11,36,0,0,55,280
7483,Cuba,2021,2021Cuba,0,0,0,0,0,0,0,0,0,0,0,0,0,0,5604
7484,Cuba,2021,2021Cuba,0,0,0,0,0,0,0,0,0,0,5,0,0,5,15
7485,Cuba,2021,2021Cuba,0,0,0,0,0,0,0,0,0,0,8,0,0,8,8
7486,Cuba,2021,2021Cuba,0,0,0,0,0,17,17,0,0,0,0,0,19,19,36
7487,Cuba,2021,2021Cuba,0,0,0,5,0,0,5,0,0,0,0,0,0,0,5
7488,Cuba,2021,2021Cuba,0,0,0,6,5,0,11,0,0,0,12,5,0,17,28
7489,Cuba,2021,2021Cuba,0,0,0,8,0,0,8,0,0,0,10,0,0,10,41
7490,Cuba,2021,2021Cuba,0,0,0,9,0,0,9,0,0,0,8,0,0,8,17
7491,Cuba,2021,2021Cuba,0,0,0,13,7,0,20,0,0,5,46,13,0,64,84
7492,Cuba,2021,2021Cuba,0,0,0,17,8,0,25,0,5,0,53,5,0,63,88
7493,Cuba,2021,2021Cuba,0,0,0,61,17,0,78,0,0,0,103,38,0,141,219
7494,Cuba,2021,2021Cuba,0,0,5,5,0,0,10,0,0,0,9,0,0,9,19
7495,Cuba,2021,2021Cuba,0,0,5,60,31,0,96,0,0,0,128,39,0,167,263
7496,Cuba,2021,2021Cuba,0,0,8,28,0,0,36,0,6,0,40,0,0,46,458
7497,Cuba,2021,2021Cuba,10,22,10,262,6,0,310,5,9,12,503,5,0,534,927
7498,Cuba,2021,2021Cuba,28,68,27,1283,24,0,1430,24,59,54,2136,19,0,2292,3722
7499,Dem. Rep. of the Congo,2001,2001Dem. Rep. of the Congo,0,0,0,0,0,0,0,0,0,0,0,0,0,0,15186
7500,Dem. Rep. of the Congo,2001,2001Dem. Rep. of the Congo,0,0,0,0,0,0,0,0,0,0,5,0,0,5,20
7501,Dem. Rep. of the Congo,2001,2001Dem. Rep. of the Congo,0,0,0,0,0,0,0,0,0,0,9,0,0,9,9
7502,Dem. Rep. of the Congo,2001,2001Dem. Rep. of the Congo,0,0,0,0,0,0,0,0,0,0,14,0,0,14,14
7503,Dem. Rep. of the Congo,2001,2001Dem. Rep. of the Congo,0,0,0,0,0,0,0,0,0,5,7,0,0,12,21
7504,Dem. Rep. of the Congo,2001,2001Dem. Rep. of the Congo,0,0,0,0,0,314,314,0,0,0,0,0,444,444,1432
7505,Dem. Rep. of the Congo,2001,2001Dem. Rep. of the Congo,0,0,0,0,0,413,413,0,0,0,0,0,343,343,756
7506,Dem. Rep. of the Congo,2001,2001Dem. Rep. of the Congo,0,0,0,0,0,2377,2377,0,0,0,0,0,3165,3165,5542
7507,Dem. Rep. of the Congo,2001,2001Dem. Rep. of the Congo,0,0,0,5,0,0,5,0,0,0,0,0,0,0,23
7508,Dem. Rep. of the Congo,2001,2001Dem. Rep. of the Congo,0,0,0,5,0,0,5,0,0,0,6,0,0,6,11
7509,Dem. Rep. of the Congo,2001,2001Dem. Rep. of the Congo,0,0,0,5,0,0,5,0,0,0,8,0,0,8,13
7510,Dem. Rep. of the Congo,2001,2001Dem. Rep. of the Congo,0,0,0,8,0,0,8,0,0,0,15,0,0,15,23
7511,Dem. Rep. of the Congo,2001,2001Dem. Rep. of the Congo,0,0,5,15,0,0,20,0,7,7,14,0,0,28,48
7512,Dem. Rep. of the Congo,2001,2001Dem. Rep. of the Congo,0,0,8,5,0,6,19,0,0,5,6,0,9,20,39
7513,Dem. Rep. of the Congo,2001,2001Dem. Rep. of the Congo,0,5,0,0,0,0,5,0,0,0,0,0,0,0,5
7514,Dem. Rep. of the Congo,2001,2001Dem. Rep. of the Congo,0,6,7,14,0,0,27,0,7,0,19,0,0,26,53
7515,Dem. Rep. of the Congo,2001,2001Dem. Rep. of the Congo,5,10,8,48,0,0,71,0,6,6,57,0,0,69,140
7516,Dem. Rep. of the Congo,2001,2001Dem. Rep. of the Congo,6,9,7,25,0,0,47,13,13,11,31,0,0,68,115
7517,Dem. Rep. of the Congo,2001,2001Dem. Rep. of the Congo,26,171,147,251,5,0,600,31,119,102,431,14,0,697,1297
7518,Dem. Rep. of the Congo,2001,2001Dem. Rep. of the Congo,36,96,82,348,0,22631,23193,44,115,99,482,0,24842,25582,56132
7519,Dem. Rep. of the Congo,2001,2001Dem. Rep. of the Congo,55,69,59,152,0,0,335,53,76,65,282,0,0,476,811
7520,Dem. Rep. of the Congo,2001,2001Dem. Rep. of the Congo,100,204,175,1236,0,0,1715,78,205,176,2814,5,0,3278,4993
7521,Dem. Rep. of the Congo,2001,2001Dem. Rep. of the Congo,177,109,94,303,0,0,683,165,111,95,424,0,0,795,1478
7522,Dem. Rep. of the Congo,2001,2001Dem. Rep. of the Congo,205,196,168,330,15,2265,3179,220,163,139,340,14,2285,3161,92778
7523,Dem. Rep. of the Congo,2001,2001Dem. Rep. of the Congo,255,98,85,1137,0,0,1575,166,255,219,1967,0,0,2607,4182
7524,Dem. Rep. of the Congo,2001,2001Dem. Rep. of the Congo,811,1104,947,2159,19,0,5040,625,1112,952,2476,15,0,5180,10225
7525,Dem. Rep. of the Congo,2001,2001Dem. Rep. of the Congo,817,728,623,1479,88,0,3735,786,787,677,1531,97,0,3878,7613
7526,Dem. Rep. of the Congo,2001,2001Dem. Rep. of the Congo,833,1586,1360,2433,80,0,6292,976,1569,1344,1631,121,0,5641,11933
7527,Dem. Rep. of the Congo,2001,2001Dem. Rep. of the Congo,3205,2810,2408,6273,149,0,14845,3139,2691,2306,3569,120,0,11825,26670
7528,Dem. Rep. of the Congo,2001,2001Dem. Rep. of the Congo,3828,3739,3206,6199,933,0,17905,3455,3346,2867,4743,748,0,15159,33064
7529,Dem. Rep. of the Congo,2001,2001Dem. Rep. of the Congo,10389,12164,10421,25365,1524,0,59863,10106,12832,10999,22541,1175,0,57653,117516
7530,Dem. Rep. of the Congo,2002,2002Dem. Rep. of the Congo,0,0,0,0,0,0,0,0,0,0,0,0,0,0,25741
7531,Dem. Rep. of the Congo,2002,2002Dem. Rep. of the Congo,0,0,0,0,0,0,0,0,0,0,5,0,0,5,10
7532,Dem. Rep. of the Congo,2002,2002Dem. Rep. of the Congo,0,0,0,0,0,0,0,0,0,0,6,0,0,6,6
7533,Dem. Rep. of the Congo,2002,2002Dem. Rep. of the Congo,0,0,0,0,0,0,0,0,0,0,8,0,0,8,8
7534,Dem. Rep. of the Congo,2002,2002Dem. Rep. of the Congo,0,0,0,0,0,0,0,0,0,0,14,0,0,14,28
7535,Dem. Rep. of the Congo,2002,2002Dem. Rep. of the Congo,0,0,0,0,0,101,101,0,0,0,0,0,139,139,906
7536,Dem. Rep. of the Congo,2002,2002Dem. Rep. of the Congo,0,0,0,0,0,2816,2816,0,0,0,0,0,3523,3523,6339
7537,Dem. Rep. of the Congo,2002,2002Dem. Rep. of the Congo,0,0,0,6,0,0,6,0,0,0,0,0,0,0,6
7538,Dem. Rep. of the Congo,2002,2002Dem. Rep. of the Congo,0,0,0,7,0,0,7,0,0,0,16,0,0,16,23
7539,Dem. Rep. of the Congo,2002,2002Dem. Rep. of the Congo,0,0,5,17,0,0,22,0,7,7,20,0,0,34,56
7540,Dem. Rep. of the Congo,2002,2002Dem. Rep. of the Congo,0,7,0,11,0,0,18,0,0,5,19,0,0,24,42
7541,Dem. Rep. of the Congo,2002,2002Dem. Rep. of the Congo,0,7,6,19,0,0,32,5,0,5,18,0,0,28,60
7542,Dem. Rep. of the Congo,2002,2002Dem. Rep. of the Congo,0,8,0,0,0,0,8,0,0,0,0,0,0,0,8
7543,Dem. Rep. of the Congo,2002,2002Dem. Rep. of the Congo,5,0,0,5,0,0,10,0,0,6,30,0,0,36,46
7544,Dem. Rep. of the Congo,2002,2002Dem. Rep. of the Congo,5,9,7,26,0,0,47,6,10,9,19,0,0,44,91
7545,Dem. Rep. of the Congo,2002,2002Dem. Rep. of the Congo,5,10,9,53,0,0,77,0,9,7,57,0,0,73,150
7546,Dem. Rep. of the Congo,2002,2002Dem. Rep. of the Congo,5,11,9,20,0,0,45,7,0,6,20,0,0,33,78
7547,Dem. Rep. of the Congo,2002,2002Dem. Rep. of the Congo,5,19,16,48,0,0,88,7,25,22,54,0,0,108,196
7548,Dem. Rep. of the Congo,2002,2002Dem. Rep. of the Congo,9,0,0,0,0,0,9,0,0,0,0,0,0,0,22
7549,Dem. Rep. of the Congo,2002,2002Dem. Rep. of the Congo,34,143,122,215,5,0,519,43,104,89,367,12,0,615,1134
7550,Dem. Rep. of the Congo,2002,2002Dem. Rep. of the Congo,58,71,62,171,0,0,362,58,76,64,312,0,0,510,872
7551,Dem. Rep. of the Congo,2002,2002Dem. Rep. of the Congo,111,315,270,871,0,0,1567,154,228,196,1399,0,0,1977,7243
7552,Dem. Rep. of the Congo,2002,2002Dem. Rep. of the Congo,340,117,101,1218,0,0,1776,208,282,241,2188,0,0,2919,4695
7553,Dem. Rep. of the Congo,2002,2002Dem. Rep. of the Congo,833,1587,1361,2433,80,0,6294,976,1568,1343,1628,121,0,5636,11930
7554,Dem. Rep. of the Congo,2002,2002Dem. Rep. of the Congo,859,1230,1049,2196,22,0,5356,896,1159,995,2374,18,0,5442,10798
7555,Dem. Rep. of the Congo,2002,2002Dem. Rep. of the Congo,1109,754,648,1528,148,0,4187,1043,829,712,1578,187,0,4349,8848
7556,Dem. Rep. of the Congo,2002,2002Dem. Rep. of the Congo,3424,3485,2986,6132,897,0,16924,2747,2938,2518,3498,656,0,12357,29281
7557,Dem. Rep. of the Congo,2002,2002Dem. Rep. of the Congo,4174,4099,3513,8793,520,759,21858,4105,3880,3326,8378,473,719,20881,49160
7558,Dem. Rep. of the Congo,2002,2002Dem. Rep. of the Congo,4529,4353,3732,9007,300,0,21921,4221,3383,2898,7100,239,0,17841,39762
7559,Dem. Rep. of the Congo,2002,2002Dem. Rep. of the Congo,8256,9299,7970,16090,1237,0,42852,7810,9457,8106,14353,937,0,40663,83515
7560,Dem. Rep. of the Congo,2002,2002Dem. Rep. of the Congo,12162,14637,12555,30052,2147,0,71553,11959,15250,13078,26814,1647,0,68748,140301
7561,Dem. Rep. of the Congo,2003,2003Dem. Rep. of the Congo,0,0,0,0,0,0,0,0,0,0,0,0,0,0,31664
7562,Dem. Rep. of the Congo,2003,2003Dem. Rep. of the Congo,0,0,0,0,0,0,0,0,0,0,5,0,0,5,38
7563,Dem. Rep. of the Congo,2003,2003Dem. Rep. of the Congo,0,0,0,0,0,0,0,0,0,0,8,0,0,8,16
7564,Dem. Rep. of the Congo,2003,2003Dem. Rep. of the Congo,0,0,0,0,0,0,0,0,0,0,9,0,0,9,9
7565,Dem. Rep. of the Congo,2003,2003Dem. Rep. of the Congo,0,0,0,0,0,117,117,0,0,0,0,0,148,148,1076
7566,Dem. Rep. of the Congo,2003,2003Dem. Rep. of the Congo,0,0,0,0,0,3042,3042,0,0,0,0,0,3715,3715,6757
7567,Dem. Rep. of the Congo,2003,2003Dem. Rep. of the Congo,0,0,0,5,0,0,5,0,0,0,0,0,0,0,5
7568,Dem. Rep. of the Congo,2003,2003Dem. Rep. of the Congo,0,0,0,5,0,0,5,0,0,0,9,0,0,9,14
7569,Dem. Rep. of the Congo,2003,2003Dem. Rep. of the Congo,0,0,0,7,0,0,7,0,0,0,14,0,0,14,21
7570,Dem. Rep. of the Congo,2003,2003Dem. Rep. of the Congo,0,0,0,9,0,0,9,0,0,0,0,0,0,0,9
7571,Dem. Rep. of the Congo,2003,2003Dem. Rep. of the Congo,0,0,7,21,0,0,28,0,7,7,31,0,0,45,73
7572,Dem. Rep. of the Congo,2003,2003Dem. Rep. of the Congo,0,5,0,0,0,0,5,0,0,0,0,0,0,0,10
7573,Dem. Rep. of the Congo,2003,2003Dem. Rep. of the Congo,6,6,0,26,0,0,38,0,9,0,29,0,0,38,76
7574,Dem. Rep. of the Congo,2003,2003Dem. Rep. of the Congo,6,6,6,23,0,0,41,8,5,5,30,0,0,48,89
7575,Dem. Rep. of the Congo,2003,2003Dem. Rep. of the Congo,6,14,12,63,0,0,95,5,10,8,63,0,0,86,181
7576,Dem. Rep. of the Congo,2003,2003Dem. Rep. of the Congo,7,8,0,19,0,0,34,5,0,5,28,0,0,38,72
7577,Dem. Rep. of the Congo,2003,2003Dem. Rep. of the Congo,7,11,10,21,0,0,49,5,5,5,20,0,0,35,84
7578,Dem. Rep. of the Congo,2003,2003Dem. Rep. of the Congo,10,6,6,27,0,0,49,6,14,8,17,0,0,45,94
7579,Dem. Rep. of the Congo,2003,2003Dem. Rep. of the Congo,12,5,5,21,0,0,43,7,5,0,50,0,0,62,105
7580,Dem. Rep. of the Congo,2003,2003Dem. Rep. of the Congo,31,141,120,227,5,0,524,34,113,92,384,6,0,629,1153
7581,Dem. Rep. of the Congo,2003,2003Dem. Rep. of the Congo,57,65,61,172,0,0,355,56,72,62,307,0,0,497,852
7582,Dem. Rep. of the Congo,2003,2003Dem. Rep. of the Congo,111,315,270,871,0,0,1567,154,228,196,1399,0,0,1977,8890
7583,Dem. Rep. of the Congo,2003,2003Dem. Rep. of the Congo,411,167,144,1482,0,0,2204,292,326,278,3022,0,0,3918,6122
7584,Dem. Rep. of the Congo,2003,2003Dem. Rep. of the Congo,707,566,479,1255,27,0,3034,704,674,579,1484,23,0,3464,6498
7585,Dem. Rep. of the Congo,2003,2003Dem. Rep. of the Congo,904,1804,1555,2820,105,0,7188,859,1727,1481,1661,99,0,5827,13015
7586,Dem. Rep. of the Congo,2003,2003Dem. Rep. of the Congo,1551,1019,884,2061,134,0,5649,1516,1091,938,2194,152,0,5891,11680
7587,Dem. Rep. of the Congo,2003,2003Dem. Rep. of the Congo,3427,4331,3712,6760,744,0,18974,3224,4119,3531,4246,631,0,15751,34725
7588,Dem. Rep. of the Congo,2003,2003Dem. Rep. of the Congo,5310,4637,3976,9093,421,0,23437,4476,3166,2713,6482,294,0,17131,40568
7589,Dem. Rep. of the Congo,2003,2003Dem. Rep. of the Congo,7190,4843,4154,10036,1254,0,27477,6982,4609,3952,10032,1197,0,26772,58405
7590,Dem. Rep. of the Congo,2003,2003Dem. Rep. of the Congo,8326,8743,7496,15642,1034,0,41241,8283,8797,7542,14207,934,0,39763,81004
7591,Dem. Rep. of the Congo,2003,2003Dem. Rep. of the Congo,13634,15598,13372,32018,2292,0,76914,12733,16255,13934,28570,1754,0,73246,150160
7592,Dem. Rep. of the Congo,2004,2004Dem. Rep. of the Congo,0,0,0,0,0,0,0,0,0,0,0,0,0,0,46927
7593,Dem. Rep. of the Congo,2004,2004Dem. Rep. of the Congo,0,0,0,0,0,0,0,0,0,0,5,0,0,5,37
7594,Dem. Rep. of the Congo,2004,2004Dem. Rep. of the Congo,0,0,0,0,0,0,0,0,0,0,9,0,0,9,9
7595,Dem. Rep. of the Congo,2004,2004Dem. Rep. of the Congo,0,0,0,0,0,15,15,0,0,0,0,0,23,23,1632
7596,Dem. Rep. of the Congo,2004,2004Dem. Rep. of the Congo,0,0,0,5,0,0,5,0,0,0,0,0,0,0,5
7597,Dem. Rep. of the Congo,2004,2004Dem. Rep. of the Congo,0,0,0,5,0,0,5,0,0,0,6,0,0,6,11
7598,Dem. Rep. of the Congo,2004,2004Dem. Rep. of the Congo,0,0,0,5,0,0,5,0,0,0,8,0,0,8,13
7599,Dem. Rep. of the Congo,2004,2004Dem. Rep. of the Congo,0,0,0,6,0,0,6,0,0,0,15,0,0,15,21
7600,Dem. Rep. of the Congo,2004,2004Dem. Rep. of the Congo,0,0,0,7,0,0,7,0,0,5,5,0,0,10,17
7601,Dem. Rep. of the Congo,2004,2004Dem. Rep. of the Congo,0,0,0,9,0,0,9,0,0,0,0,0,0,0,9
7602,Dem. Rep. of the Congo,2004,2004Dem. Rep. of the Congo,0,0,5,0,0,0,5,0,0,0,0,0,0,0,10
7603,Dem. Rep. of the Congo,2004,2004Dem. Rep. of the Congo,0,5,0,0,0,0,5,0,0,0,0,0,0,0,5
7604,Dem. Rep. of the Congo,2004,2004Dem. Rep. of the Congo,0,7,7,29,0,0,43,5,9,8,44,0,0,66,109
7605,Dem. Rep. of the Congo,2004,2004Dem. Rep. of the Congo,0,7,7,62,5,0,81,5,6,5,95,0,0,111,192
7606,Dem. Rep. of the Congo,2004,2004Dem. Rep. of the Congo,0,9,0,10,0,0,19,5,9,8,9,0,0,31,50
7607,Dem. Rep. of the Congo,2004,2004Dem. Rep. of the Congo,0,18,0,19,0,0,37,6,6,5,29,0,0,46,83
7608,Dem. Rep. of the Congo,2004,2004Dem. Rep. of the Congo,6,0,5,7,0,0,18,5,0,0,36,0,0,41,185
7609,Dem. Rep. of the Congo,2004,2004Dem. Rep. of the Congo,7,9,7,27,0,0,50,10,5,5,36,0,0,56,106
7610,Dem. Rep. of the Congo,2004,2004Dem. Rep. of the Congo,8,13,11,24,0,0,56,6,6,6,22,0,0,40,96
7611,Dem. Rep. of the Congo,2004,2004Dem. Rep. of the Congo,10,7,6,24,0,0,47,7,16,8,18,0,0,49,96
7612,Dem. Rep. of the Congo,2004,2004Dem. Rep. of the Congo,11,5,5,26,0,0,47,5,8,0,73,0,0,86,133
7613,Dem. Rep. of the Congo,2004,2004Dem. Rep. of the Congo,12,6,0,26,0,0,44,0,9,0,29,0,0,38,82
7614,Dem. Rep. of the Congo,2004,2004Dem. Rep. of the Congo,59,61,58,170,0,0,348,59,68,60,307,0,0,494,842
7615,Dem. Rep. of the Congo,2004,2004Dem. Rep. of the Congo,88,66,57,309,12,119,651,92,63,54,138,6,152,505,1156
7616,Dem. Rep. of the Congo,2004,2004Dem. Rep. of the Congo,105,287,247,303,5,0,947,125,418,357,510,10,0,1420,2367
7617,Dem. Rep. of the Congo,2004,2004Dem. Rep. of the Congo,182,166,144,425,0,0,917,260,533,457,1447,0,0,2697,3614
7618,Dem. Rep. of the Congo,2004,2004Dem. Rep. of the Congo,318,318,267,720,10,0,1633,337,343,295,829,10,0,1814,3447
7619,Dem. Rep. of the Congo,2004,2004Dem. Rep. of the Congo,914,1813,1563,3021,117,0,7428,873,1742,1494,1867,106,0,6082,13510
7620,Dem. Rep. of the Congo,2004,2004Dem. Rep. of the Congo,1103,913,783,1797,194,21391,26181,847,764,654,1540,216,18222,22243,48424
7621,Dem. Rep. of the Congo,2004,2004Dem. Rep. of the Congo,2034,1335,1144,2594,179,0,7286,1983,1405,1206,2691,191,0,7476,14982
7622,Dem. Rep. of the Congo,2004,2004Dem. Rep. of the Congo,4678,5586,4787,8827,874,0,24752,4509,5336,4575,5572,716,0,20708,45460
7623,Dem. Rep. of the Congo,2004,2004Dem. Rep. of the Congo,5046,5026,4309,10629,563,7644,33217,5113,4968,4264,10799,543,7344,33031,66248
7624,Dem. Rep. of the Congo,2004,2004Dem. Rep. of the Congo,5430,6241,5349,12094,1066,0,30180,5458,6399,5484,10486,827,0,28654,58834
7625,Dem. Rep. of the Congo,2004,2004Dem. Rep. of the Congo,15233,14513,12436,34550,1850,0,78582,14985,15133,12972,30400,1402,0,74892,153474
7626,Dem. Rep. of the Congo,2005,2005Dem. Rep. of the Congo,0,0,0,0,0,0,0,0,0,0,0,0,0,0,47966
7627,Dem. Rep. of the Congo,2005,2005Dem. Rep. of the Congo,0,0,0,0,0,0,0,0,0,0,5,0,0,5,46
7628,Dem. Rep. of the Congo,2005,2005Dem. Rep. of the Congo,0,0,0,0,0,0,0,0,0,0,7,0,0,7,7
7629,Dem. Rep. of the Congo,2005,2005Dem. Rep. of the Congo,0,0,0,0,0,0,0,0,5,0,0,0,0,5,5
7630,Dem. Rep. of the Congo,2005,2005Dem. Rep. of the Congo,0,0,0,0,0,8,8,0,0,0,0,0,0,0,8
7631,Dem. Rep. of the Congo,2005,2005Dem. Rep. of the Congo,0,0,0,0,0,514,514,0,0,0,0,0,565,565,1079
7632,Dem. Rep. of the Congo,2005,2005Dem. Rep. of the Congo,0,0,0,0,0,3872,3872,0,0,0,0,0,4665,4665,8537
7633,Dem. Rep. of the Congo,2005,2005Dem. Rep. of the Congo,0,0,0,5,0,0,5,0,0,0,0,0,0,0,10
7634,Dem. Rep. of the Congo,2005,2005Dem. Rep. of the Congo,0,0,0,5,0,0,5,0,0,0,7,0,0,7,12
7635,Dem. Rep. of the Congo,2005,2005Dem. Rep. of the Congo,0,0,0,5,0,0,5,0,0,0,8,0,0,8,13
7636,Dem. Rep. of the Congo,2005,2005Dem. Rep. of the Congo,0,0,0,6,0,0,6,0,0,0,15,0,0,15,21
7637,Dem. Rep. of the Congo,2005,2005Dem. Rep. of the Congo,0,0,0,7,0,0,7,0,7,0,0,0,0,7,14
7638,Dem. Rep. of the Congo,2005,2005Dem. Rep. of the Congo,0,0,0,8,0,0,8,0,0,0,0,0,0,0,8
7639,Dem. Rep. of the Congo,2005,2005Dem. Rep. of the Congo,0,0,9,0,0,0,9,0,0,0,0,0,0,0,27
7640,Dem. Rep. of the Congo,2005,2005Dem. Rep. of the Congo,0,5,0,0,0,0,5,0,0,0,0,0,0,0,5
7641,Dem. Rep. of the Congo,2005,2005Dem. Rep. of the Congo,0,5,0,9,0,0,14,0,7,0,15,0,0,22,36
7642,Dem. Rep. of the Congo,2005,2005Dem. Rep. of the Congo,0,7,0,0,0,0,7,0,0,0,0,0,0,0,7
7643,Dem. Rep. of the Congo,2005,2005Dem. Rep. of the Congo,0,8,0,12,0,0,20,0,6,0,23,0,0,29,49
7644,Dem. Rep. of the Congo,2005,2005Dem. Rep. of the Congo,0,8,7,31,0,0,46,5,10,9,50,0,0,74,120
7645,Dem. Rep. of the Congo,2005,2005Dem. Rep. of the Congo,0,9,0,7,0,0,16,0,5,0,9,0,0,14,30
7646,Dem. Rep. of the Congo,2005,2005Dem. Rep. of the Congo,0,9,16,34,0,0,59,8,7,7,41,0,0,63,122
7647,Dem. Rep. of the Congo,2005,2005Dem. Rep. of the Congo,5,5,5,11,0,0,26,6,0,0,15,0,0,21,47
7648,Dem. Rep. of the Congo,2005,2005Dem. Rep. of the Congo,7,9,7,30,0,0,53,10,5,5,36,0,0,56,116
7649,Dem. Rep. of the Congo,2005,2005Dem. Rep. of the Congo,7,13,7,34,0,0,61,13,16,10,20,0,0,59,120
7650,Dem. Rep. of the Congo,2005,2005Dem. Rep. of the Congo,7,18,16,63,0,0,104,5,16,15,67,0,0,103,207
7651,Dem. Rep. of the Congo,2005,2005Dem. Rep. of the Congo,8,11,10,24,0,0,53,8,12,10,78,0,0,108,161
7652,Dem. Rep. of the Congo,2005,2005Dem. Rep. of the Congo,8,12,10,20,0,0,50,6,5,5,20,0,0,36,86
7653,Dem. Rep. of the Congo,2005,2005Dem. Rep. of the Congo,10,8,0,5,0,0,23,0,23,6,38,0,0,67,90
7654,Dem. Rep. of the Congo,2005,2005Dem. Rep. of the Congo,46,40,33,129,0,0,248,44,28,24,359,0,0,455,703
7655,Dem. Rep. of the Congo,2005,2005Dem. Rep. of the Congo,58,62,60,175,0,0,355,61,70,61,309,0,0,501,856
7656,Dem. Rep. of the Congo,2005,2005Dem. Rep. of the Congo,64,92,89,726,5,0,976,68,121,108,1026,7,0,1330,2306
7657,Dem. Rep. of the Congo,2005,2005Dem. Rep. of the Congo,111,79,68,348,18,120,744,101,85,73,152,7,151,569,1313
7658,Dem. Rep. of the Congo,2005,2005Dem. Rep. of the Congo,453,227,188,596,18,0,1482,433,320,275,734,23,0,1785,3267
7659,Dem. Rep. of the Congo,2005,2005Dem. Rep. of the Congo,904,1792,1546,3043,112,0,7397,870,1727,1481,1889,100,0,6067,13464
7660,Dem. Rep. of the Congo,2005,2005Dem. Rep. of the Congo,1103,1140,976,1518,92,0,4829,849,1140,976,1311,92,0,4368,20359
7661,Dem. Rep. of the Congo,2005,2005Dem. Rep. of the Congo,2213,1946,1659,4022,268,131,10239,2088,2049,1767,4052,238,131,10325,20564
7662,Dem. Rep. of the Congo,2005,2005Dem. Rep. of the Congo,3917,4939,4233,8972,835,0,22896,3782,4591,3937,5625,572,0,18507,41403
7663,Dem. Rep. of the Congo,2005,2005Dem. Rep. of the Congo,4790,3994,3424,9605,828,0,22641,5011,4634,3977,9421,559,0,23602,61243
7664,Dem. Rep. of the Congo,2005,2005Dem. Rep. of the Congo,5057,6057,5186,11484,1006,0,28790,5129,6147,5274,10152,860,0,27562,56380
7665,Dem. Rep. of the Congo,2005,2005Dem. Rep. of the Congo,14753,14464,12398,31448,1714,0,74777,17665,14861,12739,28831,1239,0,75335,150112
7666,Dem. Rep. of the Congo,2006,2006Dem. Rep. of the Congo,0,0,0,0,0,0,0,0,0,0,0,0,0,0,39374
7667,Dem. Rep. of the Congo,2006,2006Dem. Rep. of the Congo,0,0,0,0,0,0,0,0,0,0,5,0,0,5,10
7668,Dem. Rep. of the Congo,2006,2006Dem. Rep. of the Congo,0,0,0,0,0,0,0,0,0,0,6,0,0,6,6
7669,Dem. Rep. of the Congo,2006,2006Dem. Rep. of the Congo,0,0,0,0,0,0,0,0,0,0,8,0,0,8,22
7670,Dem. Rep. of the Congo,2006,2006Dem. Rep. of the Congo,0,0,0,0,0,0,0,0,0,7,0,0,0,7,7
7671,Dem. Rep. of the Congo,2006,2006Dem. Rep. of the Congo,0,0,0,0,0,0,0,5,0,0,0,0,0,5,5
7672,Dem. Rep. of the Congo,2006,2006Dem. Rep. of the Congo,0,0,0,0,0,5,5,0,0,0,0,0,5,5,10
7673,Dem. Rep. of the Congo,2006,2006Dem. Rep. of the Congo,0,0,0,0,0,8,8,0,0,0,0,0,0,0,8
7674,Dem. Rep. of the Congo,2006,2006Dem. Rep. of the Congo,0,0,0,0,0,66,66,0,0,0,0,0,202,202,268
7675,Dem. Rep. of the Congo,2006,2006Dem. Rep. of the Congo,0,0,0,0,0,433,433,0,0,0,0,0,451,451,884
7676,Dem. Rep. of the Congo,2006,2006Dem. Rep. of the Congo,0,0,0,0,0,756,756,0,0,0,0,0,597,597,1353
7677,Dem. Rep. of the Congo,2006,2006Dem. Rep. of the Congo,0,0,0,0,0,898,898,0,0,0,0,0,1029,1029,2203
7678,Dem. Rep. of the Congo,2006,2006Dem. Rep. of the Congo,0,0,0,0,0,1367,1367,0,0,0,0,0,1366,1366,2733
7679,Dem. Rep. of the Congo,2006,2006Dem. Rep. of the Congo,0,0,0,0,0,4073,4073,0,0,0,0,0,4851,4851,8924
7680,Dem. Rep. of the Congo,2006,2006Dem. Rep. of the Congo,0,0,0,5,0,0,5,0,0,0,0,0,0,0,10
7681,Dem. Rep. of the Congo,2006,2006Dem. Rep. of the Congo,0,0,0,5,0,0,5,0,0,0,9,0,0,9,14
7682,Dem. Rep. of the Congo,2006,2006Dem. Rep. of the Congo,0,0,0,6,0,0,6,0,0,0,15,0,0,15,21
7683,Dem. Rep. of the Congo,2006,2006Dem. Rep. of the Congo,0,0,0,8,0,0,8,0,0,0,0,0,0,0,8
7684,Dem. Rep. of the Congo,2006,2006Dem. Rep. of the Congo,0,0,5,9,0,0,14,0,0,7,15,0,0,22,36
7685,Dem. Rep. of the Congo,2006,2006Dem. Rep. of the Congo,0,0,6,0,0,0,6,0,0,0,0,0,0,0,6
7686,Dem. Rep. of the Congo,2006,2006Dem. Rep. of the Congo,0,0,6,11,0,0,17,0,5,0,28,0,0,33,50
7687,Dem. Rep. of the Congo,2006,2006Dem. Rep. of the Congo,0,0,7,0,0,0,7,0,0,0,0,0,0,0,7
7688,Dem. Rep. of the Congo,2006,2006Dem. Rep. of the Congo,0,0,8,0,0,0,8,0,0,0,0,0,0,0,8
7689,Dem. Rep. of the Congo,2006,2006Dem. Rep. of the Congo,0,5,0,0,0,0,5,0,0,0,0,0,0,0,5
7690,Dem. Rep. of the Congo,2006,2006Dem. Rep. of the Congo,0,6,0,14,0,0,20,0,6,0,64,0,0,70,90
7691,Dem. Rep. of the Congo,2006,2006Dem. Rep. of the Congo,0,7,0,0,0,0,7,0,6,0,7,0,0,13,20
7692,Dem. Rep. of the Congo,2006,2006Dem. Rep. of the Congo,0,7,9,33,0,0,49,6,8,11,50,0,0,75,124
7693,Dem. Rep. of the Congo,2006,2006Dem. Rep. of the Congo,0,8,0,0,0,0,8,0,5,0,6,0,0,11,19
7694,Dem. Rep. of the Congo,2006,2006Dem. Rep. of the Congo,5,0,0,5,0,0,10,0,0,0,15,0,0,15,25
7695,Dem. Rep. of the Congo,2006,2006Dem. Rep. of the Congo,5,5,0,6,0,0,16,0,0,5,24,0,0,29,45
7696,Dem. Rep. of the Congo,2006,2006Dem. Rep. of the Congo,5,8,12,25,0,0,50,5,5,5,22,0,0,37,87
7697,Dem. Rep. of the Congo,2006,2006Dem. Rep. of the Congo,5,14,14,67,0,0,100,5,16,12,71,0,0,104,204
7698,Dem. Rep. of the Congo,2006,2006Dem. Rep. of the Congo,6,0,0,0,0,0,6,5,0,0,9,0,0,14,20
7699,Dem. Rep. of the Congo,2006,2006Dem. Rep. of the Congo,6,0,13,5,0,0,24,0,5,6,41,0,0,52,76
7700,Dem. Rep. of the Congo,2006,2006Dem. Rep. of the Congo,7,11,5,37,0,0,60,9,5,6,44,0,0,64,124
7701,Dem. Rep. of the Congo,2006,2006Dem. Rep. of the Congo,7,18,11,49,0,0,85,8,6,11,68,0,0,93,178
7702,Dem. Rep. of the Congo,2006,2006Dem. Rep. of the Congo,13,6,8,31,0,0,58,13,10,16,20,0,0,59,117
7703,Dem. Rep. of the Congo,2006,2006Dem. Rep. of the Congo,15,32,27,134,0,0,208,21,62,44,167,0,0,294,502
7704,Dem. Rep. of the Congo,2006,2006Dem. Rep. of the Congo,28,63,56,162,0,0,309,27,69,47,204,5,0,352,661
7705,Dem. Rep. of the Congo,2006,2006Dem. Rep. of the Congo,32,19,22,157,0,0,230,23,18,11,468,0,0,520,750
7706,Dem. Rep. of the Congo,2006,2006Dem. Rep. of the Congo,44,12,11,111,0,0,178,47,19,17,172,0,0,255,638
7707,Dem. Rep. of the Congo,2006,2006Dem. Rep. of the Congo,71,103,86,740,11,0,1011,76,162,74,1050,12,0,1374,2385
7708,Dem. Rep. of the Congo,2006,2006Dem. Rep. of the Congo,144,204,82,221,0,0,651,145,189,82,313,0,0,729,1380
7709,Dem. Rep. of the Congo,2006,2006Dem. Rep. of the Congo,339,287,218,544,18,0,1406,357,316,220,705,23,0,1621,3027
7710,Dem. Rep. of the Congo,2006,2006Dem. Rep. of the Congo,904,1179,1859,2893,112,0,6947,870,983,1925,1790,100,0,5668,12615
7711,Dem. Rep. of the Congo,2006,2006Dem. Rep. of the Congo,1209,1484,1331,2282,134,0,6440,1061,1559,1243,2225,95,0,6183,12623
7712,Dem. Rep. of the Congo,2006,2006Dem. Rep. of the Congo,2674,2655,2641,5906,330,0,14206,2628,2584,2893,6141,314,0,14560,28766
7713,Dem. Rep. of the Congo,2006,2006Dem. Rep. of the Congo,3948,4240,5282,9429,856,0,23755,3856,4832,4894,8322,682,0,22586,46341
7714,Dem. Rep. of the Congo,2006,2006Dem. Rep. of the Congo,4510,3183,5096,9498,441,0,22728,4682,3063,5360,9592,449,0,23146,60874
7715,Dem. Rep. of the Congo,2006,2006Dem. Rep. of the Congo,4829,5500,4607,9831,879,0,25646,4647,5379,3962,6036,602,0,20626,46272
7716,Dem. Rep. of the Congo,2006,2006Dem. Rep. of the Congo,11424,12937,12509,29699,1425,0,67994,10971,11704,13356,23018,930,0,59979,127973
7717,Dem. Rep. of the Congo,2007,2007Dem. Rep. of the Congo,0,0,0,0,0,0,0,0,0,0,0,0,0,0,46278
7718,Dem. Rep. of the Congo,2007,2007Dem. Rep. of the Congo,0,0,0,0,0,0,0,0,0,0,5,0,0,5,20
7719,Dem. Rep. of the Congo,2007,2007Dem. Rep. of the Congo,0,0,0,0,0,0,0,0,5,0,0,0,0,5,10
7720,Dem. Rep. of the Congo,2007,2007Dem. Rep. of the Congo,0,0,0,0,0,5,5,0,0,0,0,0,6,6,11
7721,Dem. Rep. of the Congo,2007,2007Dem. Rep. of the Congo,0,0,0,0,0,486,486,0,0,0,0,0,607,607,1093
7722,Dem. Rep. of the Congo,2007,2007Dem. Rep. of the Congo,0,0,0,0,0,1197,1197,0,0,0,0,0,1086,1086,2733
7723,Dem. Rep. of the Congo,2007,2007Dem. Rep. of the Congo,0,0,0,0,0,4291,4291,0,0,0,0,0,5038,5038,9329
7724,Dem. Rep. of the Congo,2007,2007Dem. Rep. of the Congo,0,0,0,5,0,0,5,0,0,0,0,0,0,0,5
7725,Dem. Rep. of the Congo,2007,2007Dem. Rep. of the Congo,0,0,0,5,0,0,5,0,0,0,11,0,0,11,32
7726,Dem. Rep. of the Congo,2007,2007Dem. Rep. of the Congo,0,0,0,5,0,0,5,0,6,0,0,0,0,6,11
7727,Dem. Rep. of the Congo,2007,2007Dem. Rep. of the Congo,0,0,0,6,0,0,6,0,0,0,9,0,0,9,15
7728,Dem. Rep. of the Congo,2007,2007Dem. Rep. of the Congo,0,0,0,7,0,0,7,0,5,0,10,0,0,15,125
7729,Dem. Rep. of the Congo,2007,2007Dem. Rep. of the Congo,0,0,0,8,0,0,8,0,0,0,0,0,0,0,8
7730,Dem. Rep. of the Congo,2007,2007Dem. Rep. of the Congo,0,0,5,0,0,0,5,0,0,0,0,0,0,0,5
7731,Dem. Rep. of the Congo,2007,2007Dem. Rep. of the Congo,0,0,5,8,0,0,13,0,0,10,15,0,0,25,38
7732,Dem. Rep. of the Congo,2007,2007Dem. Rep. of the Congo,0,0,6,0,0,0,6,0,0,0,0,0,0,0,6
7733,Dem. Rep. of the Congo,2007,2007Dem. Rep. of the Congo,0,0,6,12,0,0,18,0,0,5,30,0,0,35,53
7734,Dem. Rep. of the Congo,2007,2007Dem. Rep. of the Congo,0,0,8,0,0,0,8,0,0,0,0,0,0,0,8
7735,Dem. Rep. of the Congo,2007,2007Dem. Rep. of the Congo,0,0,14,6,0,0,20,0,8,6,44,0,0,58,78
7736,Dem. Rep. of the Congo,2007,2007Dem. Rep. of the Congo,0,6,0,5,0,0,11,0,0,0,15,0,0,15,26
7737,Dem. Rep. of the Congo,2007,2007Dem. Rep. of the Congo,0,8,0,0,0,0,8,0,0,0,5,0,0,5,13
7738,Dem. Rep. of the Congo,2007,2007Dem. Rep. of the Congo,0,8,0,0,0,0,8,0,8,0,7,0,0,15,23
7739,Dem. Rep. of the Congo,2007,2007Dem. Rep. of the Congo,5,5,7,33,0,0,50,6,8,11,52,0,0,77,127
7740,Dem. Rep. of the Congo,2007,2007Dem. Rep. of the Congo,5,8,6,64,0,0,83,0,5,21,183,0,0,209,292
7741,Dem. Rep. of the Congo,2007,2007Dem. Rep. of the Congo,5,11,9,27,0,0,52,0,8,6,24,0,0,38,90
7742,Dem. Rep. of the Congo,2007,2007Dem. Rep. of the Congo,5,16,6,34,0,0,61,5,18,11,36,0,0,70,131
7743,Dem. Rep. of the Congo,2007,2007Dem. Rep. of the Congo,6,6,0,9,0,0,21,0,0,6,28,0,0,34,55
7744,Dem. Rep. of the Congo,2007,2007Dem. Rep. of the Congo,7,11,5,40,0,0,63,9,5,6,74,0,0,94,157
7745,Dem. Rep. of the Congo,2007,2007Dem. Rep. of the Congo,8,0,0,0,0,0,8,5,0,0,12,0,0,17,25
7746,Dem. Rep. of the Congo,2007,2007Dem. Rep. of the Congo,12,7,8,35,0,0,62,7,10,21,34,0,0,72,134
7747,Dem. Rep. of the Congo,2007,2007Dem. Rep. of the Congo,13,8,18,52,0,0,91,10,5,20,92,0,0,127,218
7748,Dem. Rep. of the Congo,2007,2007Dem. Rep. of the Congo,13,15,9,60,0,0,97,14,9,24,86,0,0,133,230
7749,Dem. Rep. of the Congo,2007,2007Dem. Rep. of the Congo,16,33,32,115,0,0,196,19,43,34,162,0,0,258,454
7750,Dem. Rep. of the Congo,2007,2007Dem. Rep. of the Congo,24,62,59,177,0,0,322,31,58,53,222,5,0,369,691
7751,Dem. Rep. of the Congo,2007,2007Dem. Rep. of the Congo,32,30,22,149,0,0,233,26,48,15,439,0,0,528,761
7752,Dem. Rep. of the Congo,2007,2007Dem. Rep. of the Congo,48,57,46,122,0,0,273,59,65,38,207,0,0,369,642
7753,Dem. Rep. of the Congo,2007,2007Dem. Rep. of the Congo,76,136,113,823,10,0,1158,80,186,108,1129,13,0,1516,2674
7754,Dem. Rep. of the Congo,2007,2007Dem. Rep. of the Congo,96,113,46,374,26,133,788,117,117,40,145,11,159,589,1377
7755,Dem. Rep. of the Congo,2007,2007Dem. Rep. of the Congo,108,200,102,220,0,0,630,115,175,99,321,0,0,710,1340
7756,Dem. Rep. of the Congo,2007,2007Dem. Rep. of the Congo,196,162,147,402,5,0,912,177,180,165,452,7,0,981,1893
7757,Dem. Rep. of the Congo,2007,2007Dem. Rep. of the Congo,214,239,134,518,12,0,1117,214,262,150,841,12,0,1479,2596
7758,Dem. Rep. of the Congo,2007,2007Dem. Rep. of the Congo,2267,2568,2855,6269,539,0,14498,2035,2116,2680,5678,598,0,13107,27605
7759,Dem. Rep. of the Congo,2007,2007Dem. Rep. of the Congo,2275,2621,2317,4445,224,0,11882,2097,2940,2245,4608,142,0,12032,23914
7760,Dem. Rep. of the Congo,2007,2007Dem. Rep. of the Congo,3484,2793,5040,8154,405,0,19876,3638,2813,4748,8922,437,0,20558,55434
7761,Dem. Rep. of the Congo,2007,2007Dem. Rep. of the Congo,4233,4685,2787,8558,425,0,20688,4174,4647,3049,8828,396,0,21094,41782
7762,Dem. Rep. of the Congo,2007,2007Dem. Rep. of the Congo,5536,6061,4937,10711,850,0,28095,5297,5916,4324,6523,576,0,22636,50731
7763,Dem. Rep. of the Congo,2007,2007Dem. Rep. of the Congo,8011,9014,10896,21495,977,0,50393,7823,9300,10972,17878,733,0,46706,97099
7764,Dem. Rep. of the Congo,2008,2008Dem. Rep. of the Congo,0,0,0,0,0,0,0,0,0,0,0,0,0,0,45006
7765,Dem. Rep. of the Congo,2008,2008Dem. Rep. of the Congo,0,0,0,0,0,0,0,0,0,0,5,0,0,5,5
7766,Dem. Rep. of the Congo,2008,2008Dem. Rep. of the Congo,0,0,0,0,0,0,0,0,0,0,7,0,0,7,7
7767,Dem. Rep. of the Congo,2008,2008Dem. Rep. of the Congo,0,0,0,0,0,0,0,0,5,0,0,0,0,5,10
7768,Dem. Rep. of the Congo,2008,2008Dem. Rep. of the Congo,0,0,0,0,0,376,376,0,0,0,0,0,408,408,784
7769,Dem. Rep. of the Congo,2008,2008Dem. Rep. of the Congo,0,0,0,0,0,4573,4573,0,0,0,0,0,5379,5379,9952
7770,Dem. Rep. of the Congo,2008,2008Dem. Rep. of the Congo,0,0,0,5,0,0,5,0,0,0,0,0,0,0,10
7771,Dem. Rep. of the Congo,2008,2008Dem. Rep. of the Congo,0,0,0,5,0,0,5,0,0,0,11,0,0,11,16
7772,Dem. Rep. of the Congo,2008,2008Dem. Rep. of the Congo,0,0,0,5,0,0,5,0,5,0,7,0,0,12,17
7773,Dem. Rep. of the Congo,2008,2008Dem. Rep. of the Congo,0,0,0,7,0,0,7,0,0,0,0,0,0,0,7
7774,Dem. Rep. of the Congo,2008,2008Dem. Rep. of the Congo,0,0,0,11,0,0,11,0,5,0,16,0,0,21,32
7775,Dem. Rep. of the Congo,2008,2008Dem. Rep. of the Congo,0,0,5,9,0,0,14,0,0,5,23,0,0,28,42
7776,Dem. Rep. of the Congo,2008,2008Dem. Rep. of the Congo,0,0,6,0,0,0,6,0,0,0,0,0,0,0,6
7777,Dem. Rep. of the Congo,2008,2008Dem. Rep. of the Congo,0,0,7,0,0,0,7,0,0,0,0,0,0,0,7
7778,Dem. Rep. of the Congo,2008,2008Dem. Rep. of the Congo,0,0,7,0,0,0,7,0,0,0,6,0,0,6,13
7779,Dem. Rep. of the Congo,2008,2008Dem. Rep. of the Congo,0,0,8,10,0,0,18,0,5,5,12,0,0,22,40
7780,Dem. Rep. of the Congo,2008,2008Dem. Rep. of the Congo,0,0,8,11,0,0,19,0,0,5,31,0,0,36,55
7781,Dem. Rep. of the Congo,2008,2008Dem. Rep. of the Congo,0,0,11,0,0,0,11,0,0,0,0,0,0,0,11
7782,Dem. Rep. of the Congo,2008,2008Dem. Rep. of the Congo,0,0,15,5,0,0,20,0,5,16,37,0,0,58,78
7783,Dem. Rep. of the Congo,2008,2008Dem. Rep. of the Congo,0,5,0,0,0,0,5,0,0,0,0,0,0,0,5
7784,Dem. Rep. of the Congo,2008,2008Dem. Rep. of the Congo,0,5,0,6,0,0,11,0,5,0,8,0,0,13,24
7785,Dem. Rep. of the Congo,2008,2008Dem. Rep. of the Congo,0,5,8,26,0,0,39,7,6,11,49,0,0,73,112
7786,Dem. Rep. of the Congo,2008,2008Dem. Rep. of the Congo,0,9,0,0,0,0,9,0,5,0,5,0,0,10,19
7787,Dem. Rep. of the Congo,2008,2008Dem. Rep. of the Congo,0,12,13,27,0,0,52,0,7,6,24,0,0,37,89
7788,Dem. Rep. of the Congo,2008,2008Dem. Rep. of the Congo,0,19,11,38,0,0,68,5,14,8,43,0,0,70,138
7789,Dem. Rep. of the Congo,2008,2008Dem. Rep. of the Congo,5,0,0,0,0,0,5,0,0,0,12,0,0,12,17
7790,Dem. Rep. of the Congo,2008,2008Dem. Rep. of the Congo,5,0,0,31,0,0,36,9,0,0,45,0,0,54,90
7791,Dem. Rep. of the Congo,2008,2008Dem. Rep. of the Congo,5,7,5,13,0,0,30,5,12,0,55,0,0,72,102
7792,Dem. Rep. of the Congo,2008,2008Dem. Rep. of the Congo,5,9,5,18,0,0,37,8,5,5,67,0,0,85,131
7793,Dem. Rep. of the Congo,2008,2008Dem. Rep. of the Congo,5,10,8,79,0,0,102,0,7,25,219,0,0,251,353
7794,Dem. Rep. of the Congo,2008,2008Dem. Rep. of the Congo,6,5,5,15,0,0,31,0,0,9,33,0,0,42,73
7795,Dem. Rep. of the Congo,2008,2008Dem. Rep. of the Congo,8,0,0,0,0,0,8,0,5,0,13,0,0,18,26
7796,Dem. Rep. of the Congo,2008,2008Dem. Rep. of the Congo,8,0,0,18,0,0,26,5,0,0,33,0,0,38,64
7797,Dem. Rep. of the Congo,2008,2008Dem. Rep. of the Congo,11,11,19,63,0,0,104,21,16,6,78,0,0,121,225
7798,Dem. Rep. of the Congo,2008,2008Dem. Rep. of the Congo,12,5,10,35,0,0,62,8,8,24,31,0,0,71,133
7799,Dem. Rep. of the Congo,2008,2008Dem. Rep. of the Congo,13,13,10,47,0,0,83,9,6,11,104,0,0,130,213
7800,Dem. Rep. of the Congo,2008,2008Dem. Rep. of the Congo,18,28,21,102,0,0,169,30,32,30,149,0,0,241,410
7801,Dem. Rep. of the Congo,2008,2008Dem. Rep. of the Congo,26,64,55,174,0,0,319,29,55,50,226,5,0,365,684
7802,Dem. Rep. of the Congo,2008,2008Dem. Rep. of the Congo,29,33,22,223,0,0,307,24,46,15,381,0,0,466,773
7803,Dem. Rep. of the Congo,2008,2008Dem. Rep. of the Congo,49,64,48,128,0,0,289,54,71,41,220,0,0,386,675
7804,Dem. Rep. of the Congo,2008,2008Dem. Rep. of the Congo,104,120,54,389,30,133,830,118,122,46,164,12,159,621,1451
7805,Dem. Rep. of the Congo,2008,2008Dem. Rep. of the Congo,116,122,115,346,5,0,704,117,170,112,426,7,0,832,1536
7806,Dem. Rep. of the Congo,2008,2008Dem. Rep. of the Congo,116,158,123,281,66,0,744,75,193,164,401,0,0,833,1577
7807,Dem. Rep. of the Congo,2008,2008Dem. Rep. of the Congo,127,222,127,278,5,0,759,149,234,110,415,0,0,908,1677
7808,Dem. Rep. of the Congo,2008,2008Dem. Rep. of the Congo,132,280,272,646,22,0,1352,101,276,241,938,19,0,1575,2927
7809,Dem. Rep. of the Congo,2008,2008Dem. Rep. of the Congo,214,240,158,442,10,0,1064,191,291,132,559,13,0,1186,2250
7810,Dem. Rep. of the Congo,2008,2008Dem. Rep. of the Congo,305,0,644,1197,70,488,2704,307,0,646,1266,73,451,2743,5447
7811,Dem. Rep. of the Congo,2008,2008Dem. Rep. of the Congo,907,1420,1545,3044,418,0,7334,824,1118,1602,2683,412,0,6639,13973
7812,Dem. Rep. of the Congo,2008,2008Dem. Rep. of the Congo,1830,2499,1717,4501,224,0,10771,1737,2634,1760,3700,155,0,9986,20757
7813,Dem. Rep. of the Congo,2008,2008Dem. Rep. of the Congo,2979,3936,2129,6749,238,0,16031,3020,3704,2120,7182,272,0,16298,47329
7814,Dem. Rep. of the Congo,2008,2008Dem. Rep. of the Congo,4181,6599,5192,11885,992,0,28849,4092,6336,4681,7789,662,0,23560,52409
7815,Dem. Rep. of the Congo,2008,2008Dem. Rep. of the Congo,6500,6577,3850,12699,669,0,30295,6418,6417,4131,12597,640,0,30203,76498
7816,Dem. Rep. of the Congo,2008,2008Dem. Rep. of the Congo,7190,7971,8364,17244,731,0,41500,7118,7405,9179,13943,561,0,38206,79706
7817,Dem. Rep. of the Congo,2009,2009Dem. Rep. of the Congo,0,0,0,0,0,0,0,0,0,0,0,0,0,0,38450
7818,Dem. Rep. of the Congo,2009,2009Dem. Rep. of the Congo,0,0,0,0,0,0,0,0,0,0,5,0,0,5,10
7819,Dem. Rep. of the Congo,2009,2009Dem. Rep. of the Congo,0,0,0,0,0,0,0,0,0,0,8,0,0,8,8
7820,Dem. Rep. of the Congo,2009,2009Dem. Rep. of the Congo,0,0,0,0,0,0,0,0,5,0,0,0,0,5,10
7821,Dem. Rep. of the Congo,2009,2009Dem. Rep. of the Congo,0,0,0,0,0,362,362,0,0,0,0,0,386,386,748
7822,Dem. Rep. of the Congo,2009,2009Dem. Rep. of the Congo,0,0,0,0,0,6857,6857,0,0,0,0,0,6507,6507,13364
7823,Dem. Rep. of the Congo,2009,2009Dem. Rep. of the Congo,0,0,0,5,0,0,5,0,0,0,0,0,0,0,15
7824,Dem. Rep. of the Congo,2009,2009Dem. Rep. of the Congo,0,0,0,5,0,0,5,0,0,0,5,0,0,5,10
7825,Dem. Rep. of the Congo,2009,2009Dem. Rep. of the Congo,0,0,0,5,0,0,5,0,0,5,13,0,0,18,23
7826,Dem. Rep. of the Congo,2009,2009Dem. Rep. of the Congo,0,0,0,7,0,0,7,0,0,0,0,0,0,0,7
7827,Dem. Rep. of the Congo,2009,2009Dem. Rep. of the Congo,0,0,0,10,0,0,10,0,0,8,16,0,0,24,34
7828,Dem. Rep. of the Congo,2009,2009Dem. Rep. of the Congo,0,0,5,0,0,0,5,0,0,0,0,0,0,0,5
7829,Dem. Rep. of the Congo,2009,2009Dem. Rep. of the Congo,0,0,7,0,0,0,7,0,0,0,0,0,0,0,7
7830,Dem. Rep. of the Congo,2009,2009Dem. Rep. of the Congo,0,0,7,10,0,0,17,0,0,5,29,0,0,34,51
7831,Dem. Rep. of the Congo,2009,2009Dem. Rep. of the Congo,0,0,8,10,0,0,18,0,0,7,31,0,0,38,56
7832,Dem. Rep. of the Congo,2009,2009Dem. Rep. of the Congo,0,0,9,0,0,0,9,0,5,0,5,0,0,10,19
7833,Dem. Rep. of the Congo,2009,2009Dem. Rep. of the Congo,0,0,9,12,0,0,21,0,5,6,20,0,0,31,52
7834,Dem. Rep. of the Congo,2009,2009Dem. Rep. of the Congo,0,0,15,5,0,0,20,0,5,17,37,0,0,59,79
7835,Dem. Rep. of the Congo,2009,2009Dem. Rep. of the Congo,0,5,0,7,0,0,12,0,5,0,8,0,0,13,25
7836,Dem. Rep. of the Congo,2009,2009Dem. Rep. of the Congo,0,5,5,23,0,0,33,6,5,0,29,0,0,40,73
7837,Dem. Rep. of the Congo,2009,2009Dem. Rep. of the Congo,0,6,0,5,0,0,11,0,0,5,8,0,0,13,24
7838,Dem. Rep. of the Congo,2009,2009Dem. Rep. of the Congo,0,7,0,0,0,0,7,0,0,0,9,0,0,9,16
7839,Dem. Rep. of the Congo,2009,2009Dem. Rep. of the Congo,0,9,13,30,0,0,52,0,7,6,26,0,0,39,91
7840,Dem. Rep. of the Congo,2009,2009Dem. Rep. of the Congo,0,14,15,39,0,0,68,0,16,11,42,0,0,69,137
7841,Dem. Rep. of the Congo,2009,2009Dem. Rep. of the Congo,5,0,0,5,0,0,10,0,5,0,14,0,0,19,29
7842,Dem. Rep. of the Congo,2009,2009Dem. Rep. of the Congo,5,0,7,19,0,0,31,5,5,0,32,0,0,42,73
7843,Dem. Rep. of the Congo,2009,2009Dem. Rep. of the Congo,5,5,0,30,0,0,40,7,7,0,29,0,0,43,83
7844,Dem. Rep. of the Congo,2009,2009Dem. Rep. of the Congo,5,8,6,13,0,0,32,10,10,5,54,0,0,79,111
7845,Dem. Rep. of the Congo,2009,2009Dem. Rep. of the Congo,7,10,6,31,0,0,54,9,5,6,52,0,0,72,126
7846,Dem. Rep. of the Congo,2009,2009Dem. Rep. of the Congo,8,15,7,101,0,0,131,5,5,21,221,0,0,252,383
7847,Dem. Rep. of the Congo,2009,2009Dem. Rep. of the Congo,10,5,5,18,0,0,38,0,6,7,35,0,0,48,86
7848,Dem. Rep. of the Congo,2009,2009Dem. Rep. of the Congo,12,5,10,34,0,0,61,5,7,23,30,0,0,65,126
7849,Dem. Rep. of the Congo,2009,2009Dem. Rep. of the Congo,12,10,19,40,0,0,81,12,0,12,104,0,0,128,209
7850,Dem. Rep. of the Congo,2009,2009Dem. Rep. of the Congo,18,12,19,84,0,0,133,17,21,6,118,0,0,162,295
7851,Dem. Rep. of the Congo,2009,2009Dem. Rep. of the Congo,20,25,20,102,0,0,167,33,32,28,142,0,0,235,402
7852,Dem. Rep. of the Congo,2009,2009Dem. Rep. of the Congo,27,63,52,184,5,0,331,28,45,62,242,6,0,383,714
7853,Dem. Rep. of the Congo,2009,2009Dem. Rep. of the Congo,51,28,44,181,5,0,309,33,26,48,344,0,0,451,760
7854,Dem. Rep. of the Congo,2009,2009Dem. Rep. of the Congo,67,96,76,190,5,0,434,70,98,60,297,5,0,530,964
7855,Dem. Rep. of the Congo,2009,2009Dem. Rep. of the Congo,106,113,54,390,38,140,841,111,114,46,170,10,157,608,1449
7856,Dem. Rep. of the Congo,2009,2009Dem. Rep. of the Congo,126,385,463,1998,57,0,3029,110,425,435,2059,35,0,3064,6093
7857,Dem. Rep. of the Congo,2009,2009Dem. Rep. of the Congo,134,250,143,353,9,0,889,164,245,143,491,0,0,1043,1932
7858,Dem. Rep. of the Congo,2009,2009Dem. Rep. of the Congo,164,326,331,800,25,0,1646,162,300,298,1186,16,0,1962,3608
7859,Dem. Rep. of the Congo,2009,2009Dem. Rep. of the Congo,171,219,157,338,5,0,890,192,238,144,478,8,0,1060,1950
7860,Dem. Rep. of the Congo,2009,2009Dem. Rep. of the Congo,230,297,155,529,10,0,1221,244,298,193,678,14,0,1427,2648
7861,Dem. Rep. of the Congo,2009,2009Dem. Rep. of the Congo,417,910,693,2000,204,0,4224,521,924,810,2309,342,0,4906,103213
7862,Dem. Rep. of the Congo,2009,2009Dem. Rep. of the Congo,1084,1867,1487,2861,193,0,7492,1225,1804,1765,2929,215,0,7938,21965
7863,Dem. Rep. of the Congo,2009,2009Dem. Rep. of the Congo,1881,2059,1071,4764,319,0,10094,1787,2006,1118,4443,261,0,9615,19709
7864,Dem. Rep. of the Congo,2009,2009Dem. Rep. of the Congo,1984,2452,1398,3952,244,0,10030,2158,2320,1247,4835,309,0,10869,20899
7865,Dem. Rep. of the Congo,2009,2009Dem. Rep. of the Congo,2407,2911,1975,5217,279,0,12789,2349,3015,1985,4297,179,0,11825,24614
7866,Dem. Rep. of the Congo,2009,2009Dem. Rep. of the Congo,4781,6589,5191,11936,900,0,29397,4624,6346,4681,7861,738,0,24250,53647
7867,Dem. Rep. of the Congo,2009,2009Dem. Rep. of the Congo,5999,7802,4734,13745,689,0,32969,6080,7600,4841,11185,600,0,30306,63275
7868,Dem. Rep. of the Congo,2009,2009Dem. Rep. of the Congo,7125,8334,4894,15397,805,0,36555,7027,8233,5021,15568,771,0,36620,73175
7869,Dem. Rep. of the Congo,2010,2010Dem. Rep. of the Congo,0,0,0,0,0,0,0,0,0,0,0,0,0,0,29721
7870,Dem. Rep. of the Congo,2010,2010Dem. Rep. of the Congo,0,0,0,0,0,0,0,0,0,5,0,0,0,5,5
7871,Dem. Rep. of the Congo,2010,2010Dem. Rep. of the Congo,0,0,0,0,0,0,0,0,5,0,0,0,0,5,5
7872,Dem. Rep. of the Congo,2010,2010Dem. Rep. of the Congo,0,0,0,0,0,0,0,5,0,0,0,0,0,5,5
7873,Dem. Rep. of the Congo,2010,2010Dem. Rep. of the Congo,0,0,0,0,0,22,22,0,0,0,0,0,42,42,64
7874,Dem. Rep. of the Congo,2010,2010Dem. Rep. of the Congo,0,0,0,0,0,327,327,0,0,0,0,0,362,362,689
7875,Dem. Rep. of the Congo,2010,2010Dem. Rep. of the Congo,0,0,0,0,0,5293,5293,0,0,0,0,0,6076,6076,11369
7876,Dem. Rep. of the Congo,2010,2010Dem. Rep. of the Congo,0,0,0,0,0,6973,6973,0,0,0,0,0,6675,6675,13648
7877,Dem. Rep. of the Congo,2010,2010Dem. Rep. of the Congo,0,0,0,5,0,0,5,0,0,0,0,0,0,0,15
7878,Dem. Rep. of the Congo,2010,2010Dem. Rep. of the Congo,0,0,0,5,0,0,5,0,0,0,6,0,0,6,11
7879,Dem. Rep. of the Congo,2010,2010Dem. Rep. of the Congo,0,0,0,5,0,0,5,0,0,0,15,0,0,15,20
7880,Dem. Rep. of the Congo,2010,2010Dem. Rep. of the Congo,0,0,0,7,0,0,7,0,0,0,0,0,0,0,7
7881,Dem. Rep. of the Congo,2010,2010Dem. Rep. of the Congo,0,0,0,8,0,0,8,0,0,8,13,0,0,21,29
7882,Dem. Rep. of the Congo,2010,2010Dem. Rep. of the Congo,0,0,0,9,0,0,9,0,0,0,0,0,0,0,9
7883,Dem. Rep. of the Congo,2010,2010Dem. Rep. of the Congo,0,0,0,25,0,0,25,0,8,0,0,0,0,8,33
7884,Dem. Rep. of the Congo,2010,2010Dem. Rep. of the Congo,0,0,5,0,0,0,5,0,0,0,0,0,0,0,5
7885,Dem. Rep. of the Congo,2010,2010Dem. Rep. of the Congo,0,0,6,10,0,0,16,0,0,0,26,0,0,26,42
7886,Dem. Rep. of the Congo,2010,2010Dem. Rep. of the Congo,0,0,7,14,0,0,21,0,0,10,22,0,0,32,53
7887,Dem. Rep. of the Congo,2010,2010Dem. Rep. of the Congo,0,0,18,0,0,0,18,5,10,0,44,0,0,59,77
7888,Dem. Rep. of the Congo,2010,2010Dem. Rep. of the Congo,0,5,0,0,0,0,5,5,0,0,5,0,0,10,15
7889,Dem. Rep. of the Congo,2010,2010Dem. Rep. of the Congo,0,6,0,0,0,0,6,0,5,0,0,0,0,5,11
7890,Dem. Rep. of the Congo,2010,2010Dem. Rep. of the Congo,0,6,0,5,0,0,11,0,0,5,7,0,0,12,23
7891,Dem. Rep. of the Congo,2010,2010Dem. Rep. of the Congo,0,6,5,0,0,0,11,0,7,0,5,0,0,12,23
7892,Dem. Rep. of the Congo,2010,2010Dem. Rep. of the Congo,0,8,0,0,0,0,8,0,0,0,16,0,0,16,24
7893,Dem. Rep. of the Congo,2010,2010Dem. Rep. of the Congo,0,8,10,27,0,0,45,0,6,6,28,0,0,40,85
7894,Dem. Rep. of the Congo,2010,2010Dem. Rep. of the Congo,0,13,14,45,0,0,72,6,15,12,42,0,0,75,166
7895,Dem. Rep. of the Congo,2010,2010Dem. Rep. of the Congo,5,0,0,0,0,0,5,0,0,0,7,0,0,7,12
7896,Dem. Rep. of the Congo,2010,2010Dem. Rep. of the Congo,5,0,7,21,0,0,33,5,5,0,33,0,0,43,76
7897,Dem. Rep. of the Congo,2010,2010Dem. Rep. of the Congo,5,12,15,128,0,0,160,10,5,16,252,0,0,283,443
7898,Dem. Rep. of the Congo,2010,2010Dem. Rep. of the Congo,6,0,0,0,0,0,6,0,0,0,0,0,0,0,31
7899,Dem. Rep. of the Congo,2010,2010Dem. Rep. of the Congo,6,0,6,20,0,0,32,7,5,0,22,0,0,34,66
7900,Dem. Rep. of the Congo,2010,2010Dem. Rep. of the Congo,6,9,8,31,0,0,54,7,5,5,59,0,0,76,130
7901,Dem. Rep. of the Congo,2010,2010Dem. Rep. of the Congo,10,5,5,28,0,0,48,0,6,8,41,0,0,55,103
7902,Dem. Rep. of the Congo,2010,2010Dem. Rep. of the Congo,12,16,5,43,0,0,76,11,15,7,93,5,0,131,207
7903,Dem. Rep. of the Congo,2010,2010Dem. Rep. of the Congo,13,10,22,44,0,0,89,16,5,7,95,0,0,123,212
7904,Dem. Rep. of the Congo,2010,2010Dem. Rep. of the Congo,20,23,21,91,0,0,155,35,26,27,137,0,0,225,380
7905,Dem. Rep. of the Congo,2010,2010Dem. Rep. of the Congo,22,14,32,86,0,0,154,14,27,8,180,0,0,229,383
7906,Dem. Rep. of the Congo,2010,2010Dem. Rep. of the Congo,28,47,49,188,0,0,312,20,46,62,240,5,0,373,685
7907,Dem. Rep. of the Congo,2010,2010Dem. Rep. of the Congo,51,27,44,174,5,0,301,32,25,53,309,0,0,419,720
7908,Dem. Rep. of the Congo,2010,2010Dem. Rep. of the Congo,80,341,409,1850,66,0,2746,85,361,405,1949,41,0,2841,5587
7909,Dem. Rep. of the Congo,2010,2010Dem. Rep. of the Congo,81,95,88,202,6,0,472,75,110,50,323,5,0,563,1035
7910,Dem. Rep. of the Congo,2010,2010Dem. Rep. of the Congo,98,114,51,375,37,142,817,95,109,55,170,9,161,599,1416
7911,Dem. Rep. of the Congo,2010,2010Dem. Rep. of the Congo,161,265,166,430,11,0,1033,174,287,155,608,5,0,1229,2262
7912,Dem. Rep. of the Congo,2010,2010Dem. Rep. of the Congo,242,330,199,626,15,0,1412,276,352,229,785,16,0,1658,3070
7913,Dem. Rep. of the Congo,2010,2010Dem. Rep. of the Congo,243,412,344,1137,33,0,2169,241,383,341,1727,18,0,2710,4879
7914,Dem. Rep. of the Congo,2010,2010Dem. Rep. of the Congo,870,1405,930,2691,102,0,5998,895,1332,932,2980,180,0,6319,12342
7915,Dem. Rep. of the Congo,2010,2010Dem. Rep. of the Congo,1141,1365,1008,2962,213,0,6689,1181,1351,932,3232,263,0,6959,15300
7916,Dem. Rep. of the Congo,2010,2010Dem. Rep. of the Congo,1941,2150,1110,5032,368,0,10601,1898,2134,1149,4870,328,0,10379,20980
7917,Dem. Rep. of the Congo,2010,2010Dem. Rep. of the Congo,2541,3427,2322,6274,326,0,14890,2556,3527,2386,5376,222,0,14067,28957
7918,Dem. Rep. of the Congo,2010,2010Dem. Rep. of the Congo,5120,6574,5065,12429,1033,0,30221,4886,6290,4681,8260,689,0,24806,55027
7919,Dem. Rep. of the Congo,2010,2010Dem. Rep. of the Congo,6227,7467,4422,12796,649,0,31561,6264,7316,4508,9943,594,0,28625,60186
7920,Dem. Rep. of the Congo,2010,2010Dem. Rep. of the Congo,8099,9243,5423,17152,930,0,40847,8078,9138,5520,17370,851,0,40957,81804
7921,Dem. Rep. of the Congo,2010,2010Dem. Rep. of the Congo,13267,15241,7666,25953,2268,0,64395,13278,15557,7534,22033,1447,0,59849,124244
7922,Dem. Rep. of the Congo,2011,2011Dem. Rep. of the Congo,0,0,0,0,0,0,0,0,0,0,0,0,0,0,35686
7923,Dem. Rep. of the Congo,2011,2011Dem. Rep. of the Congo,0,0,0,0,0,0,0,0,0,0,5,0,0,5,5
7924,Dem. Rep. of the Congo,2011,2011Dem. Rep. of the Congo,0,0,0,0,0,0,0,0,0,0,8,0,0,8,8
7925,Dem. Rep. of the Congo,2011,2011Dem. Rep. of the Congo,0,0,0,0,0,0,0,0,0,0,9,0,0,9,9
7926,Dem. Rep. of the Congo,2011,2011Dem. Rep. of the Congo,0,0,0,0,0,0,0,0,0,5,0,0,0,5,5
7927,Dem. Rep. of the Congo,2011,2011Dem. Rep. of the Congo,0,0,0,0,0,0,0,0,0,6,0,0,0,6,6
7928,Dem. Rep. of the Congo,2011,2011Dem. Rep. of the Congo,0,0,0,0,0,0,0,0,5,0,0,0,0,5,5
7929,Dem. Rep. of the Congo,2011,2011Dem. Rep. of the Congo,0,0,0,0,0,343,343,0,0,0,0,0,368,368,711
7930,Dem. Rep. of the Congo,2011,2011Dem. Rep. of the Congo,0,0,0,0,0,5608,5608,0,0,0,0,0,6323,6323,11931
7931,Dem. Rep. of the Congo,2011,2011Dem. Rep. of the Congo,0,0,0,5,0,0,5,0,0,0,0,0,0,0,15
7932,Dem. Rep. of the Congo,2011,2011Dem. Rep. of the Congo,0,0,0,5,0,0,5,0,0,0,6,0,0,6,11
7933,Dem. Rep. of the Congo,2011,2011Dem. Rep. of the Congo,0,0,0,5,0,0,5,0,0,0,9,0,0,9,14
7934,Dem. Rep. of the Congo,2011,2011Dem. Rep. of the Congo,0,0,0,5,0,0,5,0,0,0,15,0,0,15,20
7935,Dem. Rep. of the Congo,2011,2011Dem. Rep. of the Congo,0,0,0,6,0,0,6,0,0,0,0,0,0,0,6
7936,Dem. Rep. of the Congo,2011,2011Dem. Rep. of the Congo,0,0,0,6,0,0,6,0,0,0,6,0,0,6,69
7937,Dem. Rep. of the Congo,2011,2011Dem. Rep. of the Congo,0,0,0,7,0,0,7,0,0,0,0,0,0,0,7
7938,Dem. Rep. of the Congo,2011,2011Dem. Rep. of the Congo,0,0,0,8,0,0,8,0,0,8,13,0,0,21,29
7939,Dem. Rep. of the Congo,2011,2011Dem. Rep. of the Congo,0,0,0,18,0,0,18,0,14,0,42,5,0,61,79
7940,Dem. Rep. of the Congo,2011,2011Dem. Rep. of the Congo,0,0,5,0,0,0,5,0,0,0,0,0,0,0,5
7941,Dem. Rep. of the Congo,2011,2011Dem. Rep. of the Congo,0,0,7,14,0,0,21,0,0,10,22,0,0,32,60
7942,Dem. Rep. of the Congo,2011,2011Dem. Rep. of the Congo,0,0,9,6,0,0,15,0,0,7,12,0,0,19,34
7943,Dem. Rep. of the Congo,2011,2011Dem. Rep. of the Congo,0,5,0,0,0,0,5,0,0,0,7,0,0,7,12
7944,Dem. Rep. of the Congo,2011,2011Dem. Rep. of the Congo,0,5,0,6,0,0,11,0,5,0,13,0,0,18,37
7945,Dem. Rep. of the Congo,2011,2011Dem. Rep. of the Congo,0,6,0,0,0,0,6,0,5,0,0,0,0,5,11
7946,Dem. Rep. of the Congo,2011,2011Dem. Rep. of the Congo,0,6,0,5,0,0,11,5,0,8,0,0,0,13,24
7947,Dem. Rep. of the Congo,2011,2011Dem. Rep. of the Congo,0,7,0,6,0,0,13,0,5,0,14,0,0,19,32
7948,Dem. Rep. of the Congo,2011,2011Dem. Rep. of the Congo,0,7,0,21,0,0,28,0,8,6,25,0,0,39,67
7949,Dem. Rep. of the Congo,2011,2011Dem. Rep. of the Congo,0,10,16,51,0,0,77,5,12,13,45,5,0,80,157
7950,Dem. Rep. of the Congo,2011,2011Dem. Rep. of the Congo,5,0,7,27,0,0,39,5,5,0,40,0,0,50,89
7951,Dem. Rep. of the Congo,2011,2011Dem. Rep. of the Congo,5,0,10,10,0,0,25,0,0,7,6,0,0,13,38
7952,Dem. Rep. of the Congo,2011,2011Dem. Rep. of the Congo,6,0,5,17,0,0,28,12,0,0,21,0,0,33,61
7953,Dem. Rep. of the Congo,2011,2011Dem. Rep. of the Congo,7,5,0,26,0,0,38,0,0,8,22,0,0,30,68
7954,Dem. Rep. of the Congo,2011,2011Dem. Rep. of the Congo,7,12,9,35,0,0,63,10,6,6,61,0,0,83,146
7955,Dem. Rep. of the Congo,2011,2011Dem. Rep. of the Congo,10,12,18,47,0,0,87,11,10,5,89,0,0,115,202
7956,Dem. Rep. of the Congo,2011,2011Dem. Rep. of the Congo,10,13,14,135,0,0,172,12,5,16,265,0,0,298,470
7957,Dem. Rep. of the Congo,2011,2011Dem. Rep. of the Congo,12,19,5,44,0,0,80,12,17,8,94,5,0,136,216
7958,Dem. Rep. of the Congo,2011,2011Dem. Rep. of the Congo,14,13,11,18,0,0,56,8,20,8,68,0,0,104,160
7959,Dem. Rep. of the Congo,2011,2011Dem. Rep. of the Congo,21,23,18,89,0,0,151,35,22,26,131,0,0,214,365
7960,Dem. Rep. of the Congo,2011,2011Dem. Rep. of the Congo,23,35,32,128,0,0,218,18,35,39,150,0,0,242,460
7961,Dem. Rep. of the Congo,2011,2011Dem. Rep. of the Congo,35,35,35,121,0,0,226,32,35,35,206,0,0,308,534
7962,Dem. Rep. of the Congo,2011,2011Dem. Rep. of the Congo,44,59,61,318,7,0,489,17,69,59,277,8,0,430,4381
7963,Dem. Rep. of the Congo,2011,2011Dem. Rep. of the Congo,53,289,349,1762,64,0,2517,64,287,342,1891,45,0,2629,5146
7964,Dem. Rep. of the Congo,2011,2011Dem. Rep. of the Congo,58,31,50,183,5,0,327,37,25,57,352,0,0,471,798
7965,Dem. Rep. of the Congo,2011,2011Dem. Rep. of the Congo,100,106,48,366,37,145,802,89,112,48,172,9,163,593,1395
7966,Dem. Rep. of the Congo,2011,2011Dem. Rep. of the Congo,109,143,95,309,6,0,662,85,161,99,357,5,0,707,1369
7967,Dem. Rep. of the Congo,2011,2011Dem. Rep. of the Congo,157,251,177,440,15,0,1040,162,269,171,616,5,0,1223,2263
7968,Dem. Rep. of the Congo,2011,2011Dem. Rep. of the Congo,208,401,482,1233,33,0,2357,180,385,482,1728,23,0,2798,5155
7969,Dem. Rep. of the Congo,2011,2011Dem. Rep. of the Congo,237,352,267,565,9,0,1430,256,403,296,782,14,0,1751,3203
7970,Dem. Rep. of the Congo,2011,2011Dem. Rep. of the Congo,254,274,176,467,8,0,1179,269,275,210,615,10,0,1379,2558
7971,Dem. Rep. of the Congo,2011,2011Dem. Rep. of the Congo,934,1540,1010,2514,88,0,6086,955,1427,1094,2779,168,0,6423,12509
7972,Dem. Rep. of the Congo,2011,2011Dem. Rep. of the Congo,1323,1500,856,2822,450,0,6951,1365,1509,792,2501,309,0,6476,13427
7973,Dem. Rep. of the Congo,2011,2011Dem. Rep. of the Congo,2196,2321,1253,5223,381,0,11374,2196,2255,1237,4832,292,0,10812,22186
7974,Dem. Rep. of the Congo,2011,2011Dem. Rep. of the Congo,2799,4290,2867,7858,416,0,18230,2806,4297,2920,6691,269,0,16983,35213
7975,Dem. Rep. of the Congo,2011,2011Dem. Rep. of the Congo,3443,6574,5093,13864,1148,0,30122,3261,6401,4858,9519,794,0,24833,54955
7976,Dem. Rep. of the Congo,2011,2011Dem. Rep. of the Congo,5554,6967,5198,13842,886,0,32447,5683,6844,5154,11047,738,0,29466,61913
7977,Dem. Rep. of the Congo,2011,2011Dem. Rep. of the Congo,7587,9966,6506,16078,876,0,41013,7640,9785,6560,15603,886,0,40474,81487
7978,Dem. Rep. of the Congo,2011,2011Dem. Rep. of the Congo,11905,17120,9130,27814,2388,0,68357,11996,17125,9109,23520,1541,0,63291,131648
7979,Dem. Rep. of the Congo,2012,2012Dem. Rep. of the Congo,0,0,0,0,0,0,0,0,0,0,0,0,0,0,41650
7980,Dem. Rep. of the Congo,2012,2012Dem. Rep. of the Congo,0,0,0,0,0,0,0,0,0,0,5,0,0,5,5
7981,Dem. Rep. of the Congo,2012,2012Dem. Rep. of the Congo,0,0,0,0,0,0,0,0,0,0,6,0,0,6,6
7982,Dem. Rep. of the Congo,2012,2012Dem. Rep. of the Congo,0,0,0,0,0,0,0,0,0,5,0,0,0,5,5
7983,Dem. Rep. of the Congo,2012,2012Dem. Rep. of the Congo,0,0,0,0,0,0,0,0,0,6,0,0,0,6,12
7984,Dem. Rep. of the Congo,2012,2012Dem. Rep. of the Congo,0,0,0,0,0,0,0,0,0,8,0,0,0,8,8
7985,Dem. Rep. of the Congo,2012,2012Dem. Rep. of the Congo,0,0,0,0,0,0,0,0,6,0,0,0,0,6,6
7986,Dem. Rep. of the Congo,2012,2012Dem. Rep. of the Congo,0,0,0,0,0,21,21,0,0,0,0,0,10,10,48
7987,Dem. Rep. of the Congo,2012,2012Dem. Rep. of the Congo,0,0,0,0,0,22,22,0,0,0,0,0,43,43,65
7988,Dem. Rep. of the Congo,2012,2012Dem. Rep. of the Congo,0,0,0,0,0,336,336,0,0,0,0,0,341,341,677
7989,Dem. Rep. of the Congo,2012,2012Dem. Rep. of the Congo,0,0,0,0,0,5915,5915,0,0,0,0,0,6670,6670,12585
7990,Dem. Rep. of the Congo,2012,2012Dem. Rep. of the Congo,0,0,0,5,0,0,5,0,0,0,0,0,0,0,5
7991,Dem. Rep. of the Congo,2012,2012Dem. Rep. of the Congo,0,0,0,5,0,0,5,0,0,0,5,0,0,5,10
7992,Dem. Rep. of the Congo,2012,2012Dem. Rep. of the Congo,0,0,0,5,0,0,5,0,0,0,8,0,0,8,13
7993,Dem. Rep. of the Congo,2012,2012Dem. Rep. of the Congo,0,0,0,5,0,0,5,0,0,0,15,0,0,15,20
7994,Dem. Rep. of the Congo,2012,2012Dem. Rep. of the Congo,0,0,0,5,0,0,5,5,0,0,19,0,0,24,29
7995,Dem. Rep. of the Congo,2012,2012Dem. Rep. of the Congo,0,0,0,6,0,0,6,0,0,0,0,0,0,0,6
7996,Dem. Rep. of the Congo,2012,2012Dem. Rep. of the Congo,0,0,0,7,0,0,7,0,0,0,0,0,0,0,7
7997,Dem. Rep. of the Congo,2012,2012Dem. Rep. of the Congo,0,0,0,9,0,0,9,0,5,0,5,0,0,10,19
7998,Dem. Rep. of the Congo,2012,2012Dem. Rep. of the Congo,0,0,0,12,0,0,12,0,0,0,16,0,0,16,28
7999,Dem. Rep. of the Congo,2012,2012Dem. Rep. of the Congo,0,0,0,15,0,0,15,0,0,7,13,0,0,20,35
8000,Dem. Rep. of the Congo,2012,2012Dem. Rep. of the Congo,0,0,0,18,0,0,18,0,9,5,42,5,0,61,79
8001,Dem. Rep. of the Congo,2012,2012Dem. Rep. of the Congo,0,0,5,10,0,0,15,5,7,0,12,0,0,24,39
8002,Dem. Rep. of the Congo,2012,2012Dem. Rep. of the Congo,0,0,5,12,0,0,17,0,0,7,25,0,0,32,58
8003,Dem. Rep. of the Congo,2012,2012Dem. Rep. of the Congo,0,0,7,9,0,0,16,0,0,0,30,0,0,30,46
8004,Dem. Rep. of the Congo,2012,2012Dem. Rep. of the Congo,0,5,0,5,0,0,10,0,5,0,0,0,0,5,15
8005,Dem. Rep. of the Congo,2012,2012Dem. Rep. of the Congo,0,5,5,6,0,0,16,0,5,6,13,0,0,24,40
8006,Dem. Rep. of the Congo,2012,2012Dem. Rep. of the Congo,0,7,0,5,0,0,12,0,0,10,5,0,0,15,27
8007,Dem. Rep. of the Congo,2012,2012Dem. Rep. of the Congo,0,7,0,21,0,0,28,0,8,7,25,0,0,40,68
8008,Dem. Rep. of the Congo,2012,2012Dem. Rep. of the Congo,0,7,5,10,0,0,22,0,6,0,15,0,0,21,43
8009,Dem. Rep. of the Congo,2012,2012Dem. Rep. of the Congo,0,7,14,52,0,0,73,5,11,12,46,5,0,79,152
8010,Dem. Rep. of the Congo,2012,2012Dem. Rep. of the Congo,0,8,0,0,0,0,8,0,0,0,6,0,0,6,14
8011,Dem. Rep. of the Congo,2012,2012Dem. Rep. of the Congo,0,11,0,7,0,0,18,0,5,5,15,0,0,25,43
8012,Dem. Rep. of the Congo,2012,2012Dem. Rep. of the Congo,5,0,7,30,0,0,42,5,5,0,49,0,0,59,101
8013,Dem. Rep. of the Congo,2012,2012Dem. Rep. of the Congo,6,12,13,47,0,0,78,9,10,10,48,0,0,77,155
8014,Dem. Rep. of the Congo,2012,2012Dem. Rep. of the Congo,7,5,0,28,0,0,40,7,0,0,23,0,0,30,70
8015,Dem. Rep. of the Congo,2012,2012Dem. Rep. of the Congo,7,15,16,46,0,0,84,11,11,0,75,0,0,97,181
8016,Dem. Rep. of the Congo,2012,2012Dem. Rep. of the Congo,7,17,11,47,0,0,82,14,18,9,67,0,0,108,190
8017,Dem. Rep. of the Congo,2012,2012Dem. Rep. of the Congo,8,12,11,118,5,0,154,12,13,12,94,5,0,136,4211
8018,Dem. Rep. of the Congo,2012,2012Dem. Rep. of the Congo,10,15,14,156,0,0,195,8,8,26,273,0,0,315,510
8019,Dem. Rep. of the Congo,2012,2012Dem. Rep. of the Congo,11,20,20,65,0,0,116,11,27,22,79,0,0,139,255
8020,Dem. Rep. of the Congo,2012,2012Dem. Rep. of the Congo,14,23,12,52,0,0,101,15,22,12,107,5,0,161,262
8021,Dem. Rep. of the Congo,2012,2012Dem. Rep. of the Congo,15,19,15,26,0,0,75,9,27,11,72,0,0,119,194
8022,Dem. Rep. of the Congo,2012,2012Dem. Rep. of the Congo,17,32,28,131,0,0,208,17,26,38,167,0,0,248,456
8023,Dem. Rep. of the Congo,2012,2012Dem. Rep. of the Congo,35,40,35,137,0,0,247,37,44,31,223,0,0,335,582
8024,Dem. Rep. of the Congo,2012,2012Dem. Rep. of the Congo,38,55,31,198,5,0,327,27,64,38,399,5,0,533,860
8025,Dem. Rep. of the Congo,2012,2012Dem. Rep. of the Congo,53,278,332,1838,71,0,2572,61,275,356,1888,54,0,2634,5206
8026,Dem. Rep. of the Congo,2012,2012Dem. Rep. of the Congo,86,149,105,335,9,0,684,66,167,117,396,6,0,752,1436
8027,Dem. Rep. of the Congo,2012,2012Dem. Rep. of the Congo,89,108,48,349,40,140,774,85,108,51,172,10,157,583,1357
8028,Dem. Rep. of the Congo,2012,2012Dem. Rep. of the Congo,215,267,206,487,19,0,1194,191,306,214,617,5,0,1333,2527
8029,Dem. Rep. of the Congo,2012,2012Dem. Rep. of the Congo,225,314,212,580,10,0,1341,269,352,261,738,17,0,1637,2978
8030,Dem. Rep. of the Congo,2012,2012Dem. Rep. of the Congo,297,324,206,492,9,0,1328,280,317,241,648,13,0,1499,2827
8031,Dem. Rep. of the Congo,2012,2012Dem. Rep. of the Congo,395,560,528,1431,44,0,2958,347,544,527,1836,32,0,3286,6244
8032,Dem. Rep. of the Congo,2012,2012Dem. Rep. of the Congo,932,1659,1131,3313,118,0,7153,985,1585,1127,3713,221,0,7631,14871
8033,Dem. Rep. of the Congo,2012,2012Dem. Rep. of the Congo,992,1197,685,2325,235,0,5434,1035,1285,715,2002,191,0,5228,10662
8034,Dem. Rep. of the Congo,2012,2012Dem. Rep. of the Congo,1306,2020,1119,4506,365,0,9316,1315,1904,1122,4338,301,0,8980,18296
8035,Dem. Rep. of the Congo,2012,2012Dem. Rep. of the Congo,3340,5112,3405,9155,470,0,21482,3387,5138,3436,7583,323,0,19867,41349
8036,Dem. Rep. of the Congo,2012,2012Dem. Rep. of the Congo,4456,6725,5248,14571,1330,0,32330,4362,6577,4879,8778,931,0,25527,57857
8037,Dem. Rep. of the Congo,2012,2012Dem. Rep. of the Congo,6112,6892,5321,14120,1000,0,33445,5876,6335,5404,11789,481,0,29885,63330
8038,Dem. Rep. of the Congo,2012,2012Dem. Rep. of the Congo,6563,11953,6815,19003,1766,0,46100,6606,11827,6641,17128,1122,0,43324,89424
8039,Dem. Rep. of the Congo,2012,2012Dem. Rep. of the Congo,12955,18306,16373,15394,753,0,63781,12988,18058,16634,14813,747,0,63240,127021
8040,Dem. Rep. of the Congo,2013,2013Dem. Rep. of the Congo,0,0,0,0,0,0,0,0,0,0,0,0,0,0,52939
8041,Dem. Rep. of the Congo,2013,2013Dem. Rep. of the Congo,0,0,0,0,0,0,0,0,0,0,5,0,0,5,5
8042,Dem. Rep. of the Congo,2013,2013Dem. Rep. of the Congo,0,0,0,0,0,0,0,0,0,0,6,0,0,6,6
8043,Dem. Rep. of the Congo,2013,2013Dem. Rep. of the Congo,0,0,0,0,0,0,0,0,0,5,0,0,0,5,5
8044,Dem. Rep. of the Congo,2013,2013Dem. Rep. of the Congo,0,0,0,0,0,0,0,0,0,5,5,0,0,10,10
8045,Dem. Rep. of the Congo,2013,2013Dem. Rep. of the Congo,0,0,0,0,0,0,0,0,0,8,0,0,0,8,8
8046,Dem. Rep. of the Congo,2013,2013Dem. Rep. of the Congo,0,0,0,0,0,0,0,5,0,0,0,0,0,5,5
8047,Dem. Rep. of the Congo,2013,2013Dem. Rep. of the Congo,0,0,0,0,0,0,0,7,0,0,0,0,0,7,7
8048,Dem. Rep. of the Congo,2013,2013Dem. Rep. of the Congo,0,0,0,0,0,404,404,0,0,0,0,0,456,456,916
8049,Dem. Rep. of the Congo,2013,2013Dem. Rep. of the Congo,0,0,0,0,0,6343,6343,0,0,0,0,0,7170,7170,13513
8050,Dem. Rep. of the Congo,2013,2013Dem. Rep. of the Congo,0,0,0,5,0,0,5,0,0,0,0,0,0,0,20
8051,Dem. Rep. of the Congo,2013,2013Dem. Rep. of the Congo,0,0,0,5,0,0,5,0,0,0,5,0,0,5,10
8052,Dem. Rep. of the Congo,2013,2013Dem. Rep. of the Congo,0,0,0,5,0,0,5,0,0,0,6,5,0,11,16
8053,Dem. Rep. of the Congo,2013,2013Dem. Rep. of the Congo,0,0,0,5,0,0,5,0,0,0,15,0,0,15,20
8054,Dem. Rep. of the Congo,2013,2013Dem. Rep. of the Congo,0,0,0,6,0,0,6,0,0,0,0,0,0,0,6
8055,Dem. Rep. of the Congo,2013,2013Dem. Rep. of the Congo,0,0,0,7,0,0,7,0,0,0,0,0,0,0,7
8056,Dem. Rep. of the Congo,2013,2013Dem. Rep. of the Congo,0,0,0,9,0,0,9,0,5,0,0,0,0,5,14
8057,Dem. Rep. of the Congo,2013,2013Dem. Rep. of the Congo,0,0,0,10,0,0,10,0,0,9,23,0,0,32,42
8058,Dem. Rep. of the Congo,2013,2013Dem. Rep. of the Congo,0,0,0,12,0,0,12,0,0,0,33,0,0,33,45
8059,Dem. Rep. of the Congo,2013,2013Dem. Rep. of the Congo,0,0,5,0,0,0,5,0,0,0,0,0,0,0,5
8060,Dem. Rep. of the Congo,2013,2013Dem. Rep. of the Congo,0,0,5,16,0,0,21,0,5,11,42,5,0,63,84
8061,Dem. Rep. of the Congo,2013,2013Dem. Rep. of the Congo,0,0,6,16,0,0,22,0,0,8,29,0,0,37,59
8062,Dem. Rep. of the Congo,2013,2013Dem. Rep. of the Congo,0,0,7,6,0,0,13,0,0,6,0,0,0,6,19
8063,Dem. Rep. of the Congo,2013,2013Dem. Rep. of the Congo,0,0,9,7,0,0,16,0,5,5,15,0,0,25,41
8064,Dem. Rep. of the Congo,2013,2013Dem. Rep. of the Congo,0,0,11,92,5,0,108,0,0,13,139,0,0,152,260
8065,Dem. Rep. of the Congo,2013,2013Dem. Rep. of the Congo,0,5,0,7,0,0,12,0,7,0,7,0,0,14,26
8066,Dem. Rep. of the Congo,2013,2013Dem. Rep. of the Congo,0,5,0,12,0,0,17,7,7,0,12,0,0,26,43
8067,Dem. Rep. of the Congo,2013,2013Dem. Rep. of the Congo,0,5,5,8,0,0,18,0,0,0,29,0,0,29,47
8068,Dem. Rep. of the Congo,2013,2013Dem. Rep. of the Congo,0,5,6,10,0,0,21,0,5,7,10,5,0,27,48
8069,Dem. Rep. of the Congo,2013,2013Dem. Rep. of the Congo,0,5,7,24,0,0,36,0,9,0,24,0,0,33,69
8070,Dem. Rep. of the Congo,2013,2013Dem. Rep. of the Congo,0,6,0,7,0,0,13,0,0,0,8,0,0,8,21
8071,Dem. Rep. of the Congo,2013,2013Dem. Rep. of the Congo,0,9,0,0,0,0,9,0,0,8,0,0,0,8,31
8072,Dem. Rep. of the Congo,2013,2013Dem. Rep. of the Congo,0,9,10,52,5,0,76,5,7,17,49,5,0,83,159
8073,Dem. Rep. of the Congo,2013,2013Dem. Rep. of the Congo,0,13,0,7,0,0,20,0,5,5,15,0,0,25,45
8074,Dem. Rep. of the Congo,2013,2013Dem. Rep. of the Congo,0,13,5,11,0,0,29,0,5,0,9,0,0,14,43
8075,Dem. Rep. of the Congo,2013,2013Dem. Rep. of the Congo,5,22,22,69,0,0,118,5,30,24,81,0,0,140,258
8076,Dem. Rep. of the Congo,2013,2013Dem. Rep. of the Congo,6,7,5,35,0,0,53,5,8,5,55,0,0,73,126
8077,Dem. Rep. of the Congo,2013,2013Dem. Rep. of the Congo,7,0,10,20,0,0,37,7,0,0,29,0,0,36,73
8078,Dem. Rep. of the Congo,2013,2013Dem. Rep. of the Congo,7,5,0,16,0,0,28,5,0,0,15,0,0,20,48
8079,Dem. Rep. of the Congo,2013,2013Dem. Rep. of the Congo,7,13,14,68,0,0,102,10,11,12,60,0,0,93,195
8080,Dem. Rep. of the Congo,2013,2013Dem. Rep. of the Congo,9,18,29,102,5,0,163,8,12,18,85,5,0,128,3874
8081,Dem. Rep. of the Congo,2013,2013Dem. Rep. of the Congo,13,22,20,188,0,0,243,18,20,20,316,0,0,374,617
8082,Dem. Rep. of the Congo,2013,2013Dem. Rep. of the Congo,14,17,14,23,0,0,68,7,22,11,66,0,0,106,174
8083,Dem. Rep. of the Congo,2013,2013Dem. Rep. of the Congo,18,26,38,132,0,0,214,17,31,33,169,0,0,250,464
8084,Dem. Rep. of the Congo,2013,2013Dem. Rep. of the Congo,19,27,23,55,0,0,124,25,30,19,110,5,0,189,313
8085,Dem. Rep. of the Congo,2013,2013Dem. Rep. of the Congo,25,81,82,612,56,0,856,22,85,96,573,40,0,816,1672
8086,Dem. Rep. of the Congo,2013,2013Dem. Rep. of the Congo,26,42,25,135,0,0,228,29,56,32,255,0,0,372,600
8087,Dem. Rep. of the Congo,2013,2013Dem. Rep. of the Congo,29,35,26,133,0,0,223,35,40,19,199,0,0,293,516
8088,Dem. Rep. of the Congo,2013,2013Dem. Rep. of the Congo,73,103,49,322,41,134,722,76,112,42,167,13,155,565,1287
8089,Dem. Rep. of the Congo,2013,2013Dem. Rep. of the Congo,93,192,166,451,17,0,919,112,192,186,484,7,0,981,1900
8090,Dem. Rep. of the Congo,2013,2013Dem. Rep. of the Congo,206,269,223,488,22,0,1208,178,284,242,661,5,0,1370,2578
8091,Dem. Rep. of the Congo,2013,2013Dem. Rep. of the Congo,227,299,180,425,7,0,1138,235,303,207,589,13,0,1347,2485
8092,Dem. Rep. of the Congo,2013,2013Dem. Rep. of the Congo,404,537,361,852,15,0,2169,423,567,476,1066,24,0,2556,4725
8093,Dem. Rep. of the Congo,2013,2013Dem. Rep. of the Congo,523,742,642,1830,45,0,3782,502,708,642,2415,27,0,4294,8076
8094,Dem. Rep. of the Congo,2013,2013Dem. Rep. of the Congo,1020,1801,1309,3763,124,0,8017,1061,1753,1295,4317,241,0,8667,16684
8095,Dem. Rep. of the Congo,2013,2013Dem. Rep. of the Congo,1501,1610,863,3248,265,0,7487,1440,1573,887,2344,202,0,6446,13933
8096,Dem. Rep. of the Congo,2013,2013Dem. Rep. of the Congo,1642,4246,2536,6719,672,0,15815,1663,4166,2541,7303,448,0,16121,31936
8097,Dem. Rep. of the Congo,2013,2013Dem. Rep. of the Congo,3671,5584,3571,10018,502,0,23346,3764,5647,3770,8231,366,0,21778,45124
8098,Dem. Rep. of the Congo,2013,2013Dem. Rep. of the Congo,4327,7077,5813,15227,808,0,33252,4823,6866,5966,12826,836,0,31317,64569
8099,Dem. Rep. of the Congo,2013,2013Dem. Rep. of the Congo,5881,8317,6624,18086,1688,0,40596,5837,8171,6053,11112,1219,0,32392,72988
8100,Dem. Rep. of the Congo,2013,2013Dem. Rep. of the Congo,18523,21600,22190,15082,775,0,78170,18293,22180,21726,14737,636,0,77572,155742
8101,Dem. Rep. of the Congo,2014,2014Dem. Rep. of the Congo,0,0,0,0,0,0,0,0,0,0,0,0,0,0,20277
8102,Dem. Rep. of the Congo,2014,2014Dem. Rep. of the Congo,0,0,0,0,0,0,0,0,0,0,5,0,0,5,5
8103,Dem. Rep. of the Congo,2014,2014Dem. Rep. of the Congo,0,0,0,0,0,0,0,0,0,0,6,0,0,6,6
8104,Dem. Rep. of the Congo,2014,2014Dem. Rep. of the Congo,0,0,0,0,0,0,0,0,0,5,5,0,0,10,10
8105,Dem. Rep. of the Congo,2014,2014Dem. Rep. of the Congo,0,0,0,0,0,0,0,0,0,8,0,0,0,8,8
8106,Dem. Rep. of the Congo,2014,2014Dem. Rep. of the Congo,0,0,0,0,0,0,0,0,5,0,0,0,0,5,5
8107,Dem. Rep. of the Congo,2014,2014Dem. Rep. of the Congo,0,0,0,0,0,0,0,7,0,0,0,0,0,7,7
8108,Dem. Rep. of the Congo,2014,2014Dem. Rep. of the Congo,0,0,0,0,0,13,13,0,0,0,0,0,14,14,27
8109,Dem. Rep. of the Congo,2014,2014Dem. Rep. of the Congo,0,0,0,0,0,6434,6434,0,0,0,0,0,7293,7293,13727
8110,Dem. Rep. of the Congo,2014,2014Dem. Rep. of the Congo,0,0,0,0,0,12839,12839,0,0,0,0,0,17286,17286,30125
8111,Dem. Rep. of the Congo,2014,2014Dem. Rep. of the Congo,0,0,0,5,0,0,5,0,0,0,0,0,0,0,10
8112,Dem. Rep. of the Congo,2014,2014Dem. Rep. of the Congo,0,0,0,5,0,0,5,0,0,0,17,0,0,17,22
8113,Dem. Rep. of the Congo,2014,2014Dem. Rep. of the Congo,0,0,0,7,0,0,7,0,0,0,0,0,0,0,7
8114,Dem. Rep. of the Congo,2014,2014Dem. Rep. of the Congo,0,0,0,9,0,0,9,5,0,0,0,0,0,5,14
8115,Dem. Rep. of the Congo,2014,2014Dem. Rep. of the Congo,0,0,0,11,0,0,11,0,0,5,8,0,0,13,24
8116,Dem. Rep. of the Congo,2014,2014Dem. Rep. of the Congo,0,0,0,12,0,0,12,0,7,0,27,0,0,34,46
8117,Dem. Rep. of the Congo,2014,2014Dem. Rep. of the Congo,0,0,5,0,0,0,5,0,0,0,0,0,0,0,5
8118,Dem. Rep. of the Congo,2014,2014Dem. Rep. of the Congo,0,0,5,5,0,0,10,0,0,0,0,0,0,0,10
8119,Dem. Rep. of the Congo,2014,2014Dem. Rep. of the Congo,0,0,5,8,0,0,13,0,5,10,10,0,0,25,38
8120,Dem. Rep. of the Congo,2014,2014Dem. Rep. of the Congo,0,0,6,5,0,0,11,0,0,5,9,0,0,14,25
8121,Dem. Rep. of the Congo,2014,2014Dem. Rep. of the Congo,0,0,6,5,0,0,11,0,5,0,10,0,0,15,26
8122,Dem. Rep. of the Congo,2014,2014Dem. Rep. of the Congo,0,0,9,0,0,0,9,0,0,0,7,0,0,7,16
8123,Dem. Rep. of the Congo,2014,2014Dem. Rep. of the Congo,0,5,0,0,0,0,5,0,0,0,0,0,0,0,5
8124,Dem. Rep. of the Congo,2014,2014Dem. Rep. of the Congo,0,5,6,10,0,0,21,0,5,8,17,0,0,30,51
8125,Dem. Rep. of the Congo,2014,2014Dem. Rep. of the Congo,0,5,7,24,0,0,36,0,9,0,24,0,0,33,69
8126,Dem. Rep. of the Congo,2014,2014Dem. Rep. of the Congo,0,5,9,25,0,0,39,0,12,5,8,0,0,25,64
8127,Dem. Rep. of the Congo,2014,2014Dem. Rep. of the Congo,0,6,7,12,0,0,25,0,9,9,13,5,0,36,61
8128,Dem. Rep. of the Congo,2014,2014Dem. Rep. of the Congo,0,8,0,5,0,0,13,0,6,0,15,0,0,21,34
8129,Dem. Rep. of the Congo,2014,2014Dem. Rep. of the Congo,0,9,0,0,0,0,9,0,0,0,0,8,0,8,17
8130,Dem. Rep. of the Congo,2014,2014Dem. Rep. of the Congo,0,14,0,8,0,0,22,0,5,5,16,0,0,26,48
8131,Dem. Rep. of the Congo,2014,2014Dem. Rep. of the Congo,5,0,0,11,0,0,16,7,6,0,11,0,0,24,40
8132,Dem. Rep. of the Congo,2014,2014Dem. Rep. of the Congo,5,0,0,26,0,0,31,0,0,0,31,0,0,31,62
8133,Dem. Rep. of the Congo,2014,2014Dem. Rep. of the Congo,5,0,17,6,0,0,28,0,0,17,0,0,0,17,45
8134,Dem. Rep. of the Congo,2014,2014Dem. Rep. of the Congo,5,5,5,51,5,0,71,0,5,8,53,5,0,71,3544
8135,Dem. Rep. of the Congo,2014,2014Dem. Rep. of the Congo,5,5,13,51,5,0,79,5,10,18,51,5,0,89,168
8136,Dem. Rep. of the Congo,2014,2014Dem. Rep. of the Congo,5,7,6,31,0,0,49,5,9,5,55,0,0,74,123
8137,Dem. Rep. of the Congo,2014,2014Dem. Rep. of the Congo,5,31,17,253,5,0,311,17,39,9,415,0,0,480,791
8138,Dem. Rep. of the Congo,2014,2014Dem. Rep. of the Congo,7,6,0,18,0,0,31,7,0,0,18,0,0,25,56
8139,Dem. Rep. of the Congo,2014,2014Dem. Rep. of the Congo,9,0,0,0,0,0,9,0,5,0,6,0,0,11,20
8140,Dem. Rep. of the Congo,2014,2014Dem. Rep. of the Congo,9,5,11,26,0,0,51,6,0,5,39,0,0,50,101
8141,Dem. Rep. of the Congo,2014,2014Dem. Rep. of the Congo,9,17,15,72,0,0,113,12,13,13,62,0,0,100,213
8142,Dem. Rep. of the Congo,2014,2014Dem. Rep. of the Congo,9,19,15,66,0,0,109,5,23,19,76,0,0,123,232
8143,Dem. Rep. of the Congo,2014,2014Dem. Rep. of the Congo,15,17,9,24,0,0,65,6,21,9,64,0,0,100,165
8144,Dem. Rep. of the Congo,2014,2014Dem. Rep. of the Congo,17,30,43,123,0,0,213,24,29,36,170,0,0,259,472
8145,Dem. Rep. of the Congo,2014,2014Dem. Rep. of the Congo,19,26,27,63,0,0,135,26,33,21,117,5,0,202,337
8146,Dem. Rep. of the Congo,2014,2014Dem. Rep. of the Congo,24,26,19,116,0,0,185,26,34,18,164,0,0,242,427
8147,Dem. Rep. of the Congo,2014,2014Dem. Rep. of the Congo,27,41,20,109,0,0,197,30,44,23,232,5,0,334,531
8148,Dem. Rep. of the Congo,2014,2014Dem. Rep. of the Congo,27,79,77,609,61,0,853,16,91,87,551,48,0,793,1646
8149,Dem. Rep. of the Congo,2014,2014Dem. Rep. of the Congo,63,113,60,347,44,144,771,81,102,48,173,14,148,566,1337
8150,Dem. Rep. of the Congo,2014,2014Dem. Rep. of the Congo,87,113,89,341,8,0,638,103,126,115,393,9,0,746,1384
8151,Dem. Rep. of the Congo,2014,2014Dem. Rep. of the Congo,191,271,238,525,22,0,1247,165,275,249,710,5,0,1404,2651
8152,Dem. Rep. of the Congo,2014,2014Dem. Rep. of the Congo,227,283,183,435,9,0,1137,215,310,201,635,13,0,1374,2511
8153,Dem. Rep. of the Congo,2014,2014Dem. Rep. of the Congo,412,492,320,954,19,0,2197,424,559,433,1235,18,0,2669,4866
8154,Dem. Rep. of the Congo,2014,2014Dem. Rep. of the Congo,464,537,308,1308,108,0,2725,578,567,301,1084,87,0,2617,5342
8155,Dem. Rep. of the Congo,2014,2014Dem. Rep. of the Congo,549,879,708,2178,64,0,4378,591,833,761,2724,37,0,4946,9324
8156,Dem. Rep. of the Congo,2014,2014Dem. Rep. of the Congo,1014,1998,1418,4287,144,0,8861,1075,1955,1465,4966,276,0,9737,18598
8157,Dem. Rep. of the Congo,2014,2014Dem. Rep. of the Congo,1080,3029,2158,4539,468,0,11274,1080,3033,2304,5348,337,0,12102,23376
8158,Dem. Rep. of the Congo,2014,2014Dem. Rep. of the Congo,1427,1871,969,3663,345,0,8275,1410,1768,1056,2723,253,0,7210,15485
8159,Dem. Rep. of the Congo,2014,2014Dem. Rep. of the Congo,4002,5501,4321,11542,872,0,26238,4190,6512,5231,10870,840,0,27643,53881
8160,Dem. Rep. of the Congo,2014,2014Dem. Rep. of the Congo,4094,6477,4243,11794,608,0,27216,4165,6483,4349,9977,441,0,25415,52631
8161,Dem. Rep. of the Congo,2014,2014Dem. Rep. of the Congo,5696,8058,6512,18472,1732,0,40470,5639,7923,6062,12070,1236,0,32930,73400
8162,Dem. Rep. of the Congo,2014,2014Dem. Rep. of the Congo,18529,21782,13898,33523,1648,0,89380,18351,21910,14081,33033,1462,0,88837,178217
8163,Dem. Rep. of the Congo,2015,2015Dem. Rep. of the Congo,0,0,0,0,0,0,0,0,0,0,0,0,0,0,54075
8164,Dem. Rep. of the Congo,2015,2015Dem. Rep. of the Congo,0,0,0,0,0,0,0,0,0,0,0,0,5,5,5
8165,Dem. Rep. of the Congo,2015,2015Dem. Rep. of the Congo,0,0,0,0,0,0,0,0,0,0,5,0,0,5,5
8166,Dem. Rep. of the Congo,2015,2015Dem. Rep. of the Congo,0,0,0,0,0,0,0,0,0,0,9,0,0,9,9
8167,Dem. Rep. of the Congo,2015,2015Dem. Rep. of the Congo,0,0,0,0,0,0,0,0,5,0,0,0,0,5,5
8168,Dem. Rep. of the Congo,2015,2015Dem. Rep. of the Congo,0,0,0,0,0,15,15,0,0,0,0,0,17,17,32
8169,Dem. Rep. of the Congo,2015,2015Dem. Rep. of the Congo,0,0,0,0,0,22,22,0,0,0,0,0,47,47,69
8170,Dem. Rep. of the Congo,2015,2015Dem. Rep. of the Congo,0,0,0,0,0,496,496,0,0,0,0,0,512,512,1008
8171,Dem. Rep. of the Congo,2015,2015Dem. Rep. of the Congo,0,0,0,0,0,6675,6675,0,0,0,0,0,7507,7507,14182
8172,Dem. Rep. of the Congo,2015,2015Dem. Rep. of the Congo,0,0,0,5,0,0,5,0,0,0,0,0,0,0,10
8173,Dem. Rep. of the Congo,2015,2015Dem. Rep. of the Congo,0,0,0,5,0,0,5,0,0,0,17,0,0,17,22
8174,Dem. Rep. of the Congo,2015,2015Dem. Rep. of the Congo,0,0,0,5,0,0,5,0,5,0,0,0,0,5,10
8175,Dem. Rep. of the Congo,2015,2015Dem. Rep. of the Congo,0,0,0,7,0,0,7,0,0,0,0,0,0,0,7
8176,Dem. Rep. of the Congo,2015,2015Dem. Rep. of the Congo,0,0,0,9,0,0,9,0,0,0,11,0,0,11,20
8177,Dem. Rep. of the Congo,2015,2015Dem. Rep. of the Congo,0,0,0,11,0,0,11,0,6,0,26,0,0,32,43
8178,Dem. Rep. of the Congo,2015,2015Dem. Rep. of the Congo,0,0,5,0,0,0,5,0,0,0,0,0,0,0,10
8179,Dem. Rep. of the Congo,2015,2015Dem. Rep. of the Congo,0,0,5,6,0,0,11,0,5,0,9,0,0,14,25
8180,Dem. Rep. of the Congo,2015,2015Dem. Rep. of the Congo,0,0,5,17,0,0,22,0,0,8,21,0,0,29,51
8181,Dem. Rep. of the Congo,2015,2015Dem. Rep. of the Congo,0,0,6,5,0,0,11,0,0,5,7,0,0,12,23
8182,Dem. Rep. of the Congo,2015,2015Dem. Rep. of the Congo,0,0,7,0,0,0,7,0,0,0,7,0,0,7,14
8183,Dem. Rep. of the Congo,2015,2015Dem. Rep. of the Congo,0,0,9,0,0,0,9,0,0,0,6,0,0,6,15
8184,Dem. Rep. of the Congo,2015,2015Dem. Rep. of the Congo,0,0,9,16,0,0,25,0,0,9,6,0,0,15,40
8185,Dem. Rep. of the Congo,2015,2015Dem. Rep. of the Congo,0,0,11,8,0,0,19,0,5,9,10,0,0,24,43
8186,Dem. Rep. of the Congo,2015,2015Dem. Rep. of the Congo,0,5,0,12,0,0,17,7,6,0,12,0,0,25,42
8187,Dem. Rep. of the Congo,2015,2015Dem. Rep. of the Congo,0,5,5,0,0,0,10,0,6,16,13,0,0,35,45
8188,Dem. Rep. of the Congo,2015,2015Dem. Rep. of the Congo,0,5,7,14,0,0,26,0,9,9,15,5,0,38,64
8189,Dem. Rep. of the Congo,2015,2015Dem. Rep. of the Congo,0,5,7,24,0,0,36,0,9,0,24,0,0,33,69
8190,Dem. Rep. of the Congo,2015,2015Dem. Rep. of the Congo,0,6,0,5,0,0,11,0,5,0,7,0,0,12,23
8191,Dem. Rep. of the Congo,2015,2015Dem. Rep. of the Congo,0,7,0,0,0,0,7,0,0,0,0,0,0,0,7
8192,Dem. Rep. of the Congo,2015,2015Dem. Rep. of the Congo,0,14,0,9,0,0,23,0,5,5,16,0,0,26,49
8193,Dem. Rep. of the Congo,2015,2015Dem. Rep. of the Congo,0,72,23,297,0,0,392,0,80,28,545,0,0,653,1045
8194,Dem. Rep. of the Congo,2015,2015Dem. Rep. of the Congo,5,0,9,11,0,0,25,0,8,0,8,0,0,16,41
8195,Dem. Rep. of the Congo,2015,2015Dem. Rep. of the Congo,5,5,8,137,0,0,155,5,5,10,171,5,0,196,351
8196,Dem. Rep. of the Congo,2015,2015Dem. Rep. of the Congo,5,5,10,50,5,0,75,5,10,13,49,5,0,82,157
8197,Dem. Rep. of the Congo,2015,2015Dem. Rep. of the Congo,5,8,0,19,0,0,32,7,0,0,19,0,0,26,58
8198,Dem. Rep. of the Congo,2015,2015Dem. Rep. of the Congo,5,12,19,35,0,0,71,5,17,16,71,5,0,114,185
8199,Dem. Rep. of the Congo,2015,2015Dem. Rep. of the Congo,7,5,5,12,0,0,29,5,8,5,33,0,0,51,80
8200,Dem. Rep. of the Congo,2015,2015Dem. Rep. of the Congo,8,7,8,41,0,0,64,5,11,5,58,0,0,79,143
8201,Dem. Rep. of the Congo,2015,2015Dem. Rep. of the Congo,10,5,11,26,0,0,52,6,0,5,39,0,0,50,109
8202,Dem. Rep. of the Congo,2015,2015Dem. Rep. of the Congo,10,17,17,81,6,0,131,8,22,12,69,0,0,111,242
8203,Dem. Rep. of the Congo,2015,2015Dem. Rep. of the Congo,11,0,0,22,0,0,33,0,6,0,12,0,0,18,51
8204,Dem. Rep. of the Congo,2015,2015Dem. Rep. of the Congo,17,27,15,87,0,0,146,13,31,22,108,0,0,174,320
8205,Dem. Rep. of the Congo,2015,2015Dem. Rep. of the Congo,18,70,68,569,60,0,785,8,77,67,549,51,0,752,1537
8206,Dem. Rep. of the Congo,2015,2015Dem. Rep. of the Congo,21,40,42,133,0,0,236,36,34,28,173,5,0,276,512
8207,Dem. Rep. of the Congo,2015,2015Dem. Rep. of the Congo,24,49,22,118,0,0,213,32,45,26,240,5,0,348,561
8208,Dem. Rep. of the Congo,2015,2015Dem. Rep. of the Congo,26,24,19,110,0,0,179,33,34,16,164,0,0,247,426
8209,Dem. Rep. of the Congo,2015,2015Dem. Rep. of the Congo,75,103,66,416,47,0,707,71,101,47,231,16,0,466,1346
8210,Dem. Rep. of the Congo,2015,2015Dem. Rep. of the Congo,78,108,87,314,6,0,593,90,99,127,393,11,0,720,1313
8211,Dem. Rep. of the Congo,2015,2015Dem. Rep. of the Congo,233,373,296,694,29,0,1625,214,361,300,901,14,0,1790,3415
8212,Dem. Rep. of the Congo,2015,2015Dem. Rep. of the Congo,348,463,285,1222,119,0,2437,413,515,274,1066,93,0,2361,4798
8213,Dem. Rep. of the Congo,2015,2015Dem. Rep. of the Congo,435,578,353,1044,27,0,2437,455,618,466,1415,23,0,2977,5414
8214,Dem. Rep. of the Congo,2015,2015Dem. Rep. of the Congo,457,1386,959,2872,239,0,5913,521,1478,957,3191,207,0,6354,12267
8215,Dem. Rep. of the Congo,2015,2015Dem. Rep. of the Congo,485,601,403,954,20,0,2463,493,696,444,1247,18,0,2898,5361
8216,Dem. Rep. of the Congo,2015,2015Dem. Rep. of the Congo,763,1184,944,2656,83,0,5630,828,1168,1035,3330,55,0,6416,12046
8217,Dem. Rep. of the Congo,2015,2015Dem. Rep. of the Congo,1070,2000,1510,4477,155,0,9212,1076,1982,1515,5211,297,0,10081,19293
8218,Dem. Rep. of the Congo,2015,2015Dem. Rep. of the Congo,1445,1864,1069,3766,373,0,8517,1406,1818,1129,2780,266,0,7399,15916
8219,Dem. Rep. of the Congo,2015,2015Dem. Rep. of the Congo,3602,5512,5187,11321,886,0,26508,4640,6622,5522,11704,807,0,29295,55803
8220,Dem. Rep. of the Congo,2015,2015Dem. Rep. of the Congo,4095,6203,4189,12233,628,0,27348,4170,6357,4272,10407,475,0,25681,53029
8221,Dem. Rep. of the Congo,2015,2015Dem. Rep. of the Congo,5495,7728,7016,18659,1797,0,40695,5607,7515,6590,12202,1255,0,33169,73864
8222,Dem. Rep. of the Congo,2015,2015Dem. Rep. of the Congo,17294,24041,13954,42961,2465,0,100715,17119,24120,14174,43417,2237,0,101067,201782
8223,Dem. Rep. of the Congo,2016,2016Dem. Rep. of the Congo,0,0,0,0,0,0,0,0,0,0,0,0,0,0,17878
8224,Dem. Rep. of the Congo,2016,2016Dem. Rep. of the Congo,0,0,0,0,0,0,0,0,0,0,5,0,0,5,5
8225,Dem. Rep. of the Congo,2016,2016Dem. Rep. of the Congo,0,0,0,0,0,0,0,0,0,0,6,0,0,6,6
8226,Dem. Rep. of the Congo,2016,2016Dem. Rep. of the Congo,0,0,0,0,0,0,0,0,0,0,8,0,0,8,8
8227,Dem. Rep. of the Congo,2016,2016Dem. Rep. of the Congo,0,0,0,0,0,0,0,0,0,5,0,0,0,5,5
8228,Dem. Rep. of the Congo,2016,2016Dem. Rep. of the Congo,0,0,0,0,0,0,0,0,5,0,0,0,0,5,5
8229,Dem. Rep. of the Congo,2016,2016Dem. Rep. of the Congo,0,0,0,0,0,0,0,5,0,0,0,0,0,5,5
8230,Dem. Rep. of the Congo,2016,2016Dem. Rep. of the Congo,0,0,0,0,0,18,18,0,0,0,0,0,20,20,38
8231,Dem. Rep. of the Congo,2016,2016Dem. Rep. of the Congo,0,0,0,0,0,26,26,0,0,0,0,0,46,46,72
8232,Dem. Rep. of the Congo,2016,2016Dem. Rep. of the Congo,0,0,0,0,0,507,507,0,0,0,0,0,508,508,1015
8233,Dem. Rep. of the Congo,2016,2016Dem. Rep. of the Congo,0,0,0,0,0,7077,7077,0,0,0,0,0,7960,7960,15037
8234,Dem. Rep. of the Congo,2016,2016Dem. Rep. of the Congo,0,0,0,0,0,11624,11624,0,0,0,0,0,14532,14532,26156
8235,Dem. Rep. of the Congo,2016,2016Dem. Rep. of the Congo,0,0,0,5,0,0,5,0,0,0,0,0,0,0,15
8236,Dem. Rep. of the Congo,2016,2016Dem. Rep. of the Congo,0,0,0,5,0,0,5,0,5,0,0,0,0,5,10
8237,Dem. Rep. of the Congo,2016,2016Dem. Rep. of the Congo,0,0,0,6,0,0,6,0,0,0,5,0,0,5,11
8238,Dem. Rep. of the Congo,2016,2016Dem. Rep. of the Congo,0,0,0,7,0,0,7,0,0,0,0,0,0,0,7
8239,Dem. Rep. of the Congo,2016,2016Dem. Rep. of the Congo,0,0,0,7,0,0,7,0,0,7,0,0,0,7,14
8240,Dem. Rep. of the Congo,2016,2016Dem. Rep. of the Congo,0,0,0,8,0,0,8,0,0,0,12,0,0,12,20
8241,Dem. Rep. of the Congo,2016,2016Dem. Rep. of the Congo,0,0,0,8,0,0,8,0,5,5,5,0,0,15,23
8242,Dem. Rep. of the Congo,2016,2016Dem. Rep. of the Congo,0,0,5,0,0,0,5,0,0,0,0,0,0,0,5
8243,Dem. Rep. of the Congo,2016,2016Dem. Rep. of the Congo,0,0,5,5,0,0,10,0,5,5,9,0,0,19,29
8244,Dem. Rep. of the Congo,2016,2016Dem. Rep. of the Congo,0,0,5,6,0,0,11,0,0,5,14,0,0,19,30
8245,Dem. Rep. of the Congo,2016,2016Dem. Rep. of the Congo,0,0,5,10,0,0,15,0,6,9,18,0,0,33,48
8246,Dem. Rep. of the Congo,2016,2016Dem. Rep. of the Congo,0,0,6,12,0,0,18,0,11,8,18,5,0,42,60
8247,Dem. Rep. of the Congo,2016,2016Dem. Rep. of the Congo,0,0,7,16,5,0,28,5,5,0,18,0,0,28,56
8248,Dem. Rep. of the Congo,2016,2016Dem. Rep. of the Congo,0,0,8,30,0,0,38,0,0,8,27,0,0,35,73
8249,Dem. Rep. of the Congo,2016,2016Dem. Rep. of the Congo,0,0,9,0,0,0,9,0,0,5,9,0,0,14,23
8250,Dem. Rep. of the Congo,2016,2016Dem. Rep. of the Congo,0,0,10,15,0,0,25,0,0,9,7,0,0,16,41
8251,Dem. Rep. of the Congo,2016,2016Dem. Rep. of the Congo,0,5,9,10,0,0,24,5,0,6,15,0,0,26,50
8252,Dem. Rep. of the Congo,2016,2016Dem. Rep. of the Congo,0,7,0,10,0,0,17,5,5,5,25,0,0,40,57
8253,Dem. Rep. of the Congo,2016,2016Dem. Rep. of the Congo,0,9,0,9,0,0,18,0,7,0,18,0,0,25,43
8254,Dem. Rep. of the Congo,2016,2016Dem. Rep. of the Congo,0,14,0,9,0,0,23,0,5,5,16,0,0,26,49
8255,Dem. Rep. of the Congo,2016,2016Dem. Rep. of the Congo,0,25,21,98,5,0,149,5,16,24,78,5,0,128,1837
8256,Dem. Rep. of the Congo,2016,2016Dem. Rep. of the Congo,0,81,26,365,5,0,477,0,86,41,658,0,0,785,1262
8257,Dem. Rep. of the Congo,2016,2016Dem. Rep. of the Congo,5,0,0,0,0,0,5,0,0,0,0,0,0,0,5
8258,Dem. Rep. of the Congo,2016,2016Dem. Rep. of the Congo,5,0,0,10,0,0,15,8,0,6,11,0,0,25,40
8259,Dem. Rep. of the Congo,2016,2016Dem. Rep. of the Congo,5,0,7,11,0,0,23,0,0,0,15,0,0,15,38
8260,Dem. Rep. of the Congo,2016,2016Dem. Rep. of the Congo,5,5,5,26,5,0,46,5,6,11,32,5,0,59,105
8261,Dem. Rep. of the Congo,2016,2016Dem. Rep. of the Congo,5,7,7,153,0,0,172,5,7,14,182,5,0,213,385
8262,Dem. Rep. of the Congo,2016,2016Dem. Rep. of the Congo,6,0,0,9,0,0,15,0,6,0,6,0,0,12,27
8263,Dem. Rep. of the Congo,2016,2016Dem. Rep. of the Congo,6,0,0,14,0,0,20,0,6,0,24,0,0,30,50
8264,Dem. Rep. of the Congo,2016,2016Dem. Rep. of the Congo,8,8,7,32,0,0,55,5,0,6,29,0,0,40,95
8265,Dem. Rep. of the Congo,2016,2016Dem. Rep. of the Congo,12,9,12,48,0,0,81,8,11,12,64,0,0,95,176
8266,Dem. Rep. of the Congo,2016,2016Dem. Rep. of the Congo,12,33,14,92,0,0,151,15,30,29,113,0,0,187,338
8267,Dem. Rep. of the Congo,2016,2016Dem. Rep. of the Congo,14,7,21,67,5,0,114,9,16,13,47,5,0,90,204
8268,Dem. Rep. of the Congo,2016,2016Dem. Rep. of the Congo,17,54,65,530,67,0,733,8,56,55,533,67,0,719,1452
8269,Dem. Rep. of the Congo,2016,2016Dem. Rep. of the Congo,20,18,17,41,0,0,96,21,28,16,90,6,0,161,257
8270,Dem. Rep. of the Congo,2016,2016Dem. Rep. of the Congo,22,48,28,129,0,0,227,27,47,31,239,0,0,344,571
8271,Dem. Rep. of the Congo,2016,2016Dem. Rep. of the Congo,23,28,15,118,0,0,184,39,33,25,163,0,0,260,444
8272,Dem. Rep. of the Congo,2016,2016Dem. Rep. of the Congo,32,40,43,134,0,0,249,32,32,39,165,0,0,268,517
8273,Dem. Rep. of the Congo,2016,2016Dem. Rep. of the Congo,62,95,56,346,44,174,777,58,96,40,182,14,167,557,1334
8274,Dem. Rep. of the Congo,2016,2016Dem. Rep. of the Congo,86,91,75,338,5,0,595,83,99,105,431,9,0,727,1322
8275,Dem. Rep. of the Congo,2016,2016Dem. Rep. of the Congo,192,323,225,544,26,0,1310,197,292,256,668,6,0,1419,2729
8276,Dem. Rep. of the Congo,2016,2016Dem. Rep. of the Congo,372,464,275,1173,121,0,2405,421,504,286,994,98,0,2303,4708
8277,Dem. Rep. of the Congo,2016,2016Dem. Rep. of the Congo,447,1389,950,2893,244,0,5923,496,1469,965,3215,216,0,6361,12284
8278,Dem. Rep. of the Congo,2016,2016Dem. Rep. of the Congo,503,608,417,976,24,0,2528,517,683,464,1235,17,0,2916,5444
8279,Dem. Rep. of the Congo,2016,2016Dem. Rep. of the Congo,517,620,417,1133,41,0,2728,464,687,500,1521,25,0,3197,5925
8280,Dem. Rep. of the Congo,2016,2016Dem. Rep. of the Congo,1030,1373,929,2922,95,0,6349,1097,1376,1038,3447,21,0,6979,13328
8281,Dem. Rep. of the Congo,2016,2016Dem. Rep. of the Congo,1239,2191,1609,4931,175,0,10145,1221,2181,1694,5778,319,0,11193,21338
8282,Dem. Rep. of the Congo,2016,2016Dem. Rep. of the Congo,1282,1720,1034,3393,339,0,7768,1261,1663,1063,2495,226,0,6708,14476
8283,Dem. Rep. of the Congo,2016,2016Dem. Rep. of the Congo,4212,5696,4104,10584,1001,0,25597,4296,5875,4030,9703,823,0,24727,50324
8284,Dem. Rep. of the Congo,2016,2016Dem. Rep. of the Congo,4346,6883,4667,12775,663,0,29334,4487,7058,4805,10852,519,0,27721,57055
8285,Dem. Rep. of the Congo,2016,2016Dem. Rep. of the Congo,5176,7635,6500,19092,1880,0,40283,5216,7517,6151,12695,1285,0,32864,73147
8286,Dem. Rep. of the Congo,2016,2016Dem. Rep. of the Congo,17099,25749,14505,43506,2485,218,103562,17273,25650,14628,41821,2296,133,101801,205363
8287,Dem. Rep. of the Congo,2017,2017Dem. Rep. of the Congo,0,0,0,0,0,0,0,0,0,0,0,0,0,0,7804
8288,Dem. Rep. of the Congo,2017,2017Dem. Rep. of the Congo,0,0,0,0,0,0,0,0,0,0,0,0,5,5,5
8289,Dem. Rep. of the Congo,2017,2017Dem. Rep. of the Congo,0,0,0,0,0,0,0,0,0,0,5,0,0,5,15
8290,Dem. Rep. of the Congo,2017,2017Dem. Rep. of the Congo,0,0,0,0,0,0,0,0,0,0,8,0,0,8,8
8291,Dem. Rep. of the Congo,2017,2017Dem. Rep. of the Congo,0,0,0,0,0,0,0,0,0,7,0,0,0,7,7
8292,Dem. Rep. of the Congo,2017,2017Dem. Rep. of the Congo,0,0,0,0,0,0,0,5,0,0,0,0,0,5,5
8293,Dem. Rep. of the Congo,2017,2017Dem. Rep. of the Congo,0,0,0,0,0,23,23,0,0,0,0,0,45,45,68
8294,Dem. Rep. of the Congo,2017,2017Dem. Rep. of the Congo,0,0,0,0,0,7464,7464,0,0,0,0,0,8233,8233,15697
8295,Dem. Rep. of the Congo,2017,2017Dem. Rep. of the Congo,0,0,0,0,0,11656,11656,0,0,0,0,0,14387,14387,26043
8296,Dem. Rep. of the Congo,2017,2017Dem. Rep. of the Congo,0,0,0,5,0,0,5,0,0,0,0,0,0,0,15
8297,Dem. Rep. of the Congo,2017,2017Dem. Rep. of the Congo,0,0,0,5,0,0,5,0,5,0,0,0,0,5,10
8298,Dem. Rep. of the Congo,2017,2017Dem. Rep. of the Congo,0,0,0,7,0,0,7,0,0,0,0,0,0,0,7
8299,Dem. Rep. of the Congo,2017,2017Dem. Rep. of the Congo,0,0,0,7,0,0,7,0,0,0,7,0,0,7,14
8300,Dem. Rep. of the Congo,2017,2017Dem. Rep. of the Congo,0,0,0,10,0,0,10,0,0,0,17,0,0,17,27
8301,Dem. Rep. of the Congo,2017,2017Dem. Rep. of the Congo,0,0,5,0,0,0,5,0,0,0,0,0,0,0,5
8302,Dem. Rep. of the Congo,2017,2017Dem. Rep. of the Congo,0,0,5,6,0,0,11,0,0,5,14,0,0,19,30
8303,Dem. Rep. of the Congo,2017,2017Dem. Rep. of the Congo,0,0,5,9,0,0,14,0,5,5,6,0,0,16,30
8304,Dem. Rep. of the Congo,2017,2017Dem. Rep. of the Congo,0,0,5,18,0,0,23,0,5,13,12,6,0,36,59
8305,Dem. Rep. of the Congo,2017,2017Dem. Rep. of the Congo,0,0,5,19,5,0,29,5,0,0,17,0,0,22,51
8306,Dem. Rep. of the Congo,2017,2017Dem. Rep. of the Congo,0,0,7,31,0,0,38,0,0,7,25,5,0,37,75
8307,Dem. Rep. of the Congo,2017,2017Dem. Rep. of the Congo,0,0,9,0,0,0,9,0,0,5,8,0,0,13,22
8308,Dem. Rep. of the Congo,2017,2017Dem. Rep. of the Congo,0,6,0,6,0,0,12,0,5,5,11,0,0,21,33
8309,Dem. Rep. of the Congo,2017,2017Dem. Rep. of the Congo,0,6,5,18,0,0,29,0,10,9,26,0,0,45,74
8310,Dem. Rep. of the Congo,2017,2017Dem. Rep. of the Congo,0,7,0,6,0,0,13,0,0,0,10,0,0,10,23
8311,Dem. Rep. of the Congo,2017,2017Dem. Rep. of the Congo,0,8,0,8,0,0,16,0,0,6,19,0,0,25,41
8312,Dem. Rep. of the Congo,2017,2017Dem. Rep. of the Congo,0,8,0,11,0,0,19,0,8,0,6,0,0,14,33
8313,Dem. Rep. of the Congo,2017,2017Dem. Rep. of the Congo,0,9,5,9,0,0,23,0,9,0,17,0,0,26,49
8314,Dem. Rep. of the Congo,2017,2017Dem. Rep. of the Congo,0,11,0,14,0,0,25,0,6,0,16,0,0,22,47
8315,Dem. Rep. of the Congo,2017,2017Dem. Rep. of the Congo,0,12,8,152,5,0,177,5,11,12,186,5,0,219,396
8316,Dem. Rep. of the Congo,2017,2017Dem. Rep. of the Congo,5,0,7,21,0,0,33,5,5,8,8,0,0,26,59
8317,Dem. Rep. of the Congo,2017,2017Dem. Rep. of the Congo,5,5,0,13,0,0,23,5,9,0,10,0,0,24,47
8318,Dem. Rep. of the Congo,2017,2017Dem. Rep. of the Congo,5,5,5,29,5,0,49,0,7,13,38,5,0,63,112
8319,Dem. Rep. of the Congo,2017,2017Dem. Rep. of the Congo,6,5,5,22,0,0,38,15,5,5,43,0,0,68,1368
8320,Dem. Rep. of the Congo,2017,2017Dem. Rep. of the Congo,6,10,5,36,0,0,57,0,0,9,33,0,0,42,99
8321,Dem. Rep. of the Congo,2017,2017Dem. Rep. of the Congo,6,13,0,15,0,0,34,7,13,7,23,0,0,50,84
8322,Dem. Rep. of the Congo,2017,2017Dem. Rep. of the Congo,9,0,0,14,0,0,23,0,6,0,20,0,0,26,49
8323,Dem. Rep. of the Congo,2017,2017Dem. Rep. of the Congo,9,0,0,16,0,0,25,7,0,0,8,0,0,15,40
8324,Dem. Rep. of the Congo,2017,2017Dem. Rep. of the Congo,9,38,12,99,0,0,158,16,32,25,124,0,0,197,355
8325,Dem. Rep. of the Congo,2017,2017Dem. Rep. of the Congo,10,12,8,50,0,0,80,9,8,13,68,0,0,98,178
8326,Dem. Rep. of the Congo,2017,2017Dem. Rep. of the Congo,11,8,21,73,8,0,121,11,19,11,71,0,0,112,233
8327,Dem. Rep. of the Congo,2017,2017Dem. Rep. of the Congo,18,53,30,140,0,0,241,27,44,40,242,5,0,358,599
8328,Dem. Rep. of the Congo,2017,2017Dem. Rep. of the Congo,21,63,69,579,82,0,814,21,64,60,556,79,0,780,1594
8329,Dem. Rep. of the Congo,2017,2017Dem. Rep. of the Congo,22,16,59,31,0,0,128,17,26,98,40,7,0,188,316
8330,Dem. Rep. of the Congo,2017,2017Dem. Rep. of the Congo,23,43,44,138,0,0,248,30,42,36,162,5,0,275,523
8331,Dem. Rep. of the Congo,2017,2017Dem. Rep. of the Congo,37,31,22,141,0,0,231,54,40,25,180,0,0,299,530
8332,Dem. Rep. of the Congo,2017,2017Dem. Rep. of the Congo,50,94,54,335,49,162,744,52,84,40,181,13,174,544,1288
8333,Dem. Rep. of the Congo,2017,2017Dem. Rep. of the Congo,116,139,116,358,7,0,736,124,137,188,472,9,0,930,1666
8334,Dem. Rep. of the Congo,2017,2017Dem. Rep. of the Congo,203,323,224,616,28,0,1394,192,324,262,752,16,0,1546,2940
8335,Dem. Rep. of the Congo,2017,2017Dem. Rep. of the Congo,310,1227,1028,3093,282,0,5940,343,1285,1081,3419,248,0,6376,12316
8336,Dem. Rep. of the Congo,2017,2017Dem. Rep. of the Congo,319,387,227,1005,99,0,2037,357,430,241,871,89,0,1988,4025
8337,Dem. Rep. of the Congo,2017,2017Dem. Rep. of the Congo,494,597,406,948,28,0,2473,532,647,440,1226,16,0,2861,5334
8338,Dem. Rep. of the Congo,2017,2017Dem. Rep. of the Congo,520,629,482,1277,58,0,2966,479,766,492,1568,25,0,3330,6296
8339,Dem. Rep. of the Congo,2017,2017Dem. Rep. of the Congo,1075,1400,1012,2982,106,0,6575,1161,1426,1096,3615,68,0,7366,13941
8340,Dem. Rep. of the Congo,2017,2017Dem. Rep. of the Congo,1076,1856,1132,3618,356,0,8038,1083,1828,1096,2663,253,0,6923,14961
8341,Dem. Rep. of the Congo,2017,2017Dem. Rep. of the Congo,2851,2918,1496,5415,175,0,12855,2768,2782,1360,5544,263,12944,25661,38516
8342,Dem. Rep. of the Congo,2017,2017Dem. Rep. of the Congo,2964,3937,2572,7343,350,0,17166,2902,3915,2708,7804,433,0,17762,34928
8343,Dem. Rep. of the Congo,2017,2017Dem. Rep. of the Congo,4474,7305,5149,14001,736,0,31665,4683,7449,5287,12184,599,0,30202,61867
8344,Dem. Rep. of the Congo,2017,2017Dem. Rep. of the Congo,4759,7569,6531,19136,1798,0,39793,4828,7506,6403,14236,1257,0,34230,82750
8345,Dem. Rep. of the Congo,2017,2017Dem. Rep. of the Congo,4780,5201,5539,11450,524,0,27494,4296,5663,6658,12084,711,0,29412,56906
8346,Dem. Rep. of the Congo,2017,2017Dem. Rep. of the Congo,19588,26239,15883,46282,2651,3901,114544,19654,26235,15853,45437,2370,2099,111648,226192
8347,Dem. Rep. of the Congo,2018,2018Dem. Rep. of the Congo,0,0,0,0,0,0,0,0,0,0,0,0,0,0,35051
8348,Dem. Rep. of the Congo,2018,2018Dem. Rep. of the Congo,0,0,0,0,0,0,0,0,0,0,0,0,5,5,5
8349,Dem. Rep. of the Congo,2018,2018Dem. Rep. of the Congo,0,0,0,0,0,0,0,0,0,0,5,0,0,5,5
8350,Dem. Rep. of the Congo,2018,2018Dem. Rep. of the Congo,0,0,0,0,0,0,0,0,0,0,6,0,0,6,6
8351,Dem. Rep. of the Congo,2018,2018Dem. Rep. of the Congo,0,0,0,0,0,0,0,0,0,0,8,0,0,8,8
8352,Dem. Rep. of the Congo,2018,2018Dem. Rep. of the Congo,0,0,0,0,0,7872,7872,0,0,0,0,0,8612,8612,16484
8353,Dem. Rep. of the Congo,2018,2018Dem. Rep. of the Congo,0,0,0,5,0,0,5,0,0,0,0,0,0,0,5
8354,Dem. Rep. of the Congo,2018,2018Dem. Rep. of the Congo,0,0,0,5,0,0,5,0,0,0,5,0,0,5,10
8355,Dem. Rep. of the Congo,2018,2018Dem. Rep. of the Congo,0,0,0,5,0,0,5,0,0,5,0,0,0,5,10
8356,Dem. Rep. of the Congo,2018,2018Dem. Rep. of the Congo,0,0,0,5,0,0,5,0,0,6,0,0,0,6,11
8357,Dem. Rep. of the Congo,2018,2018Dem. Rep. of the Congo,0,0,0,6,0,0,6,0,0,0,5,0,0,5,11
8358,Dem. Rep. of the Congo,2018,2018Dem. Rep. of the Congo,0,0,5,0,0,0,5,0,0,0,5,0,0,5,10
8359,Dem. Rep. of the Congo,2018,2018Dem. Rep. of the Congo,0,0,5,6,0,0,11,0,5,5,12,0,0,22,33
8360,Dem. Rep. of the Congo,2018,2018Dem. Rep. of the Congo,0,0,5,13,0,0,18,0,5,5,13,0,0,23,41
8361,Dem. Rep. of the Congo,2018,2018Dem. Rep. of the Congo,0,0,6,32,0,0,38,0,0,5,31,0,0,36,74
8362,Dem. Rep. of the Congo,2018,2018Dem. Rep. of the Congo,0,0,7,18,0,0,25,5,6,7,5,0,0,23,48
8363,Dem. Rep. of the Congo,2018,2018Dem. Rep. of the Congo,0,0,8,13,0,0,21,5,0,5,15,0,0,25,46
8364,Dem. Rep. of the Congo,2018,2018Dem. Rep. of the Congo,0,0,9,0,0,0,9,0,5,0,7,0,0,12,21
8365,Dem. Rep. of the Congo,2018,2018Dem. Rep. of the Congo,0,5,0,7,0,0,12,0,9,0,0,0,0,9,21
8366,Dem. Rep. of the Congo,2018,2018Dem. Rep. of the Congo,0,5,0,12,0,0,17,0,0,11,10,0,0,21,38
8367,Dem. Rep. of the Congo,2018,2018Dem. Rep. of the Congo,0,5,0,16,5,0,26,0,0,0,19,0,0,19,45
8368,Dem. Rep. of the Congo,2018,2018Dem. Rep. of the Congo,0,5,6,19,0,0,30,0,5,9,25,5,0,44,74
8369,Dem. Rep. of the Congo,2018,2018Dem. Rep. of the Congo,0,6,9,13,0,0,28,6,0,0,11,0,0,17,45
8370,Dem. Rep. of the Congo,2018,2018Dem. Rep. of the Congo,0,7,0,0,0,0,7,0,0,0,8,0,0,8,15
8371,Dem. Rep. of the Congo,2018,2018Dem. Rep. of the Congo,0,7,5,15,0,0,27,0,9,0,21,0,0,30,57
8372,Dem. Rep. of the Congo,2018,2018Dem. Rep. of the Congo,0,11,0,15,0,0,26,0,5,0,12,0,0,17,43
8373,Dem. Rep. of the Congo,2018,2018Dem. Rep. of the Congo,0,17,15,107,0,0,139,5,13,11,134,0,0,163,302
8374,Dem. Rep. of the Congo,2018,2018Dem. Rep. of the Congo,5,5,5,33,5,0,53,5,5,10,42,5,0,67,120
8375,Dem. Rep. of the Congo,2018,2018Dem. Rep. of the Congo,5,13,5,37,0,0,60,7,0,0,40,0,0,47,107
8376,Dem. Rep. of the Congo,2018,2018Dem. Rep. of the Congo,8,6,0,19,0,0,33,5,7,5,9,0,0,26,59
8377,Dem. Rep. of the Congo,2018,2018Dem. Rep. of the Congo,8,12,19,73,8,0,120,8,22,12,72,0,0,114,234
8378,Dem. Rep. of the Congo,2018,2018Dem. Rep. of the Congo,9,0,0,13,0,0,22,5,0,0,16,0,0,21,43
8379,Dem. Rep. of the Congo,2018,2018Dem. Rep. of the Congo,9,14,10,48,0,0,81,7,8,12,75,0,0,102,183
8380,Dem. Rep. of the Congo,2018,2018Dem. Rep. of the Congo,9,42,13,103,0,0,167,11,38,20,136,0,0,205,372
8381,Dem. Rep. of the Congo,2018,2018Dem. Rep. of the Congo,11,18,13,23,0,0,65,5,16,10,41,0,0,72,137
8382,Dem. Rep. of the Congo,2018,2018Dem. Rep. of the Congo,15,46,16,54,0,0,131,17,36,20,98,5,0,176,307
8383,Dem. Rep. of the Congo,2018,2018Dem. Rep. of the Congo,20,74,65,617,84,0,860,35,58,55,548,94,0,790,1650
8384,Dem. Rep. of the Congo,2018,2018Dem. Rep. of the Congo,28,49,43,155,0,0,275,25,41,36,247,0,0,349,624
8385,Dem. Rep. of the Congo,2018,2018Dem. Rep. of the Congo,29,42,40,142,0,0,253,28,41,35,167,10,0,281,534
8386,Dem. Rep. of the Congo,2018,2018Dem. Rep. of the Congo,40,42,31,149,0,0,262,39,55,42,154,0,0,290,552
8387,Dem. Rep. of the Congo,2018,2018Dem. Rep. of the Congo,45,87,45,339,47,175,738,46,85,38,176,13,154,512,1250
8388,Dem. Rep. of the Congo,2018,2018Dem. Rep. of the Congo,80,161,125,423,22,0,811,64,152,149,344,27,0,736,1547
8389,Dem. Rep. of the Congo,2018,2018Dem. Rep. of the Congo,113,155,152,482,19,0,921,103,175,159,472,16,0,925,1846
8390,Dem. Rep. of the Congo,2018,2018Dem. Rep. of the Congo,154,178,114,442,8,0,896,151,178,143,563,11,0,1046,1942
8391,Dem. Rep. of the Congo,2018,2018Dem. Rep. of the Congo,199,316,227,631,28,0,1401,179,310,246,752,19,0,1506,2907
8392,Dem. Rep. of the Congo,2018,2018Dem. Rep. of the Congo,534,683,485,1293,37,0,3032,530,721,546,1633,27,0,3457,6489
8393,Dem. Rep. of the Congo,2018,2018Dem. Rep. of the Congo,741,783,554,3207,312,0,5597,704,618,542,3542,282,0,5688,11285
8394,Dem. Rep. of the Congo,2018,2018Dem. Rep. of the Congo,810,1034,658,1695,69,0,4266,836,1153,779,2127,26,0,4921,9187
8395,Dem. Rep. of the Congo,2018,2018Dem. Rep. of the Congo,920,1938,1175,3922,399,0,8354,1026,1879,1128,2940,290,0,7263,15617
8396,Dem. Rep. of the Congo,2018,2018Dem. Rep. of the Congo,1711,2128,1781,5756,198,0,11574,1777,2243,1794,7069,129,0,13012,24586
8397,Dem. Rep. of the Congo,2018,2018Dem. Rep. of the Congo,2558,2824,1468,4910,174,0,11934,2442,2682,1428,4915,274,0,11741,37077
8398,Dem. Rep. of the Congo,2018,2018Dem. Rep. of the Congo,3299,4626,3046,8739,406,0,20116,3245,4531,3198,9876,524,0,21374,41490
8399,Dem. Rep. of the Congo,2018,2018Dem. Rep. of the Congo,5145,8183,5794,15983,883,0,35988,5351,8323,6048,14491,740,0,34953,70941
8400,Dem. Rep. of the Congo,2018,2018Dem. Rep. of the Congo,5203,5835,4360,12924,1046,0,29368,5365,5823,4380,10678,947,0,27193,56561
8401,Dem. Rep. of the Congo,2018,2018Dem. Rep. of the Congo,5284,8053,6603,20317,2056,0,42313,5334,8035,6432,13511,1419,0,34731,77044
8402,Dem. Rep. of the Congo,2018,2018Dem. Rep. of the Congo,30078,36510,20184,64897,4236,0,155905,29959,36904,20185,56797,3342,0,147187,303092
8403,Dem. Rep. of the Congo,2019,2019Dem. Rep. of the Congo,0,0,0,0,0,0,0,0,0,0,0,0,0,0,33672
8404,Dem. Rep. of the Congo,2019,2019Dem. Rep. of the Congo,0,0,0,0,0,0,0,0,0,0,5,0,0,5,5
8405,Dem. Rep. of the Congo,2019,2019Dem. Rep. of the Congo,0,0,0,0,0,0,0,0,0,0,9,0,0,9,9
8406,Dem. Rep. of the Congo,2019,2019Dem. Rep. of the Congo,0,0,0,0,0,8,8,0,0,0,0,0,18,18,26
8407,Dem. Rep. of the Congo,2019,2019Dem. Rep. of the Congo,0,0,0,0,0,8394,8394,0,0,0,0,0,9118,9118,17512
8408,Dem. Rep. of the Congo,2019,2019Dem. Rep. of the Congo,0,0,0,5,0,0,5,0,0,0,5,0,0,5,10
8409,Dem. Rep. of the Congo,2019,2019Dem. Rep. of the Congo,0,0,0,5,0,0,5,0,0,0,8,0,0,8,13
8410,Dem. Rep. of the Congo,2019,2019Dem. Rep. of the Congo,0,0,0,5,0,0,5,0,0,6,0,0,0,6,22
8411,Dem. Rep. of the Congo,2019,2019Dem. Rep. of the Congo,0,0,5,0,0,0,5,0,0,0,5,0,0,5,10
8412,Dem. Rep. of the Congo,2019,2019Dem. Rep. of the Congo,0,0,5,5,0,0,10,0,0,0,0,0,0,0,10
8413,Dem. Rep. of the Congo,2019,2019Dem. Rep. of the Congo,0,0,5,6,0,0,11,0,0,0,10,0,0,10,21
8414,Dem. Rep. of the Congo,2019,2019Dem. Rep. of the Congo,0,0,5,6,0,0,11,0,5,5,12,0,0,22,33
8415,Dem. Rep. of the Congo,2019,2019Dem. Rep. of the Congo,0,0,5,7,0,0,12,0,5,0,8,0,0,13,25
8416,Dem. Rep. of the Congo,2019,2019Dem. Rep. of the Congo,0,0,5,12,0,0,17,0,0,12,10,0,0,22,39
8417,Dem. Rep. of the Congo,2019,2019Dem. Rep. of the Congo,0,0,7,14,0,0,21,5,0,5,15,0,0,25,46
8418,Dem. Rep. of the Congo,2019,2019Dem. Rep. of the Congo,0,0,7,33,0,0,40,0,0,7,33,0,0,40,80
8419,Dem. Rep. of the Congo,2019,2019Dem. Rep. of the Congo,0,5,0,0,0,0,5,0,0,0,0,0,0,0,5
8420,Dem. Rep. of the Congo,2019,2019Dem. Rep. of the Congo,0,5,0,6,0,0,11,0,0,0,8,0,0,8,19
8421,Dem. Rep. of the Congo,2019,2019Dem. Rep. of the Congo,0,5,0,7,0,0,12,0,0,0,8,0,0,8,20
8422,Dem. Rep. of the Congo,2019,2019Dem. Rep. of the Congo,0,6,7,28,0,0,41,5,6,6,34,0,0,51,92
8423,Dem. Rep. of the Congo,2019,2019Dem. Rep. of the Congo,0,7,0,12,0,0,19,0,5,0,8,0,0,13,32
8424,Dem. Rep. of the Congo,2019,2019Dem. Rep. of the Congo,0,7,6,13,0,0,26,0,0,6,20,0,0,26,52
8425,Dem. Rep. of the Congo,2019,2019Dem. Rep. of the Congo,0,20,5,34,0,0,59,0,6,0,36,0,0,42,101
8426,Dem. Rep. of the Congo,2019,2019Dem. Rep. of the Congo,5,0,0,20,0,0,25,6,0,16,5,0,0,27,52
8427,Dem. Rep. of the Congo,2019,2019Dem. Rep. of the Congo,5,6,0,13,0,0,24,0,0,0,18,0,0,18,42
8428,Dem. Rep. of the Congo,2019,2019Dem. Rep. of the Congo,5,8,6,35,6,0,60,6,5,8,50,5,0,74,134
8429,Dem. Rep. of the Congo,2019,2019Dem. Rep. of the Congo,6,7,5,18,0,0,36,5,5,5,8,0,0,23,59
8430,Dem. Rep. of the Congo,2019,2019Dem. Rep. of the Congo,6,10,8,46,0,0,70,7,8,11,76,0,0,102,172
8431,Dem. Rep. of the Congo,2019,2019Dem. Rep. of the Congo,6,13,13,18,0,0,50,5,10,5,50,0,0,70,120
8432,Dem. Rep. of the Congo,2019,2019Dem. Rep. of the Congo,8,9,0,17,0,0,34,0,6,6,21,5,0,38,72
8433,Dem. Rep. of the Congo,2019,2019Dem. Rep. of the Congo,10,19,13,129,5,0,176,5,24,15,151,5,0,200,376
8434,Dem. Rep. of the Congo,2019,2019Dem. Rep. of the Congo,11,18,15,90,7,0,141,11,26,9,84,0,0,130,271
8435,Dem. Rep. of the Congo,2019,2019Dem. Rep. of the Congo,11,29,17,41,0,0,98,15,23,20,77,6,0,141,239
8436,Dem. Rep. of the Congo,2019,2019Dem. Rep. of the Congo,14,45,35,146,5,0,245,33,37,35,155,16,0,276,521
8437,Dem. Rep. of the Congo,2019,2019Dem. Rep. of the Congo,16,38,21,108,0,0,183,17,36,24,141,0,0,218,401
8438,Dem. Rep. of the Congo,2019,2019Dem. Rep. of the Congo,17,67,66,601,92,0,843,39,55,66,532,115,0,807,1650
8439,Dem. Rep. of the Congo,2019,2019Dem. Rep. of the Congo,28,49,43,158,0,0,278,28,43,37,249,0,0,357,635
8440,Dem. Rep. of the Congo,2019,2019Dem. Rep. of the Congo,42,78,48,334,46,0,548,39,82,47,165,16,0,349,1231
8441,Dem. Rep. of the Congo,2019,2019Dem. Rep. of the Congo,59,63,36,179,0,0,337,60,67,53,214,0,0,394,731
8442,Dem. Rep. of the Congo,2019,2019Dem. Rep. of the Congo,196,323,210,639,33,0,1401,199,295,238,776,25,0,1533,2934
8443,Dem. Rep. of the Congo,2019,2019Dem. Rep. of the Congo,208,273,185,622,54,0,1342,194,255,196,488,54,0,1187,2529
8444,Dem. Rep. of the Congo,2019,2019Dem. Rep. of the Congo,213,265,168,585,15,0,1246,201,278,178,768,14,0,1439,2685
8445,Dem. Rep. of the Congo,2019,2019Dem. Rep. of the Congo,601,766,550,1494,47,0,3458,604,796,619,1973,33,0,4025,7483
8446,Dem. Rep. of the Congo,2019,2019Dem. Rep. of the Congo,773,2153,1229,4127,418,0,8700,845,2109,1215,3163,311,0,7643,16343
8447,Dem. Rep. of the Congo,2019,2019Dem. Rep. of the Congo,858,1004,691,1709,71,0,4333,866,1113,780,2146,26,0,4931,9264
8448,Dem. Rep. of the Congo,2019,2019Dem. Rep. of the Congo,941,1183,673,1944,81,0,4822,963,1111,593,1856,126,0,4649,22905
8449,Dem. Rep. of the Congo,2019,2019Dem. Rep. of the Congo,960,966,786,1880,124,0,4716,896,869,740,2294,179,0,4978,9694
8450,Dem. Rep. of the Congo,2019,2019Dem. Rep. of the Congo,1890,2264,2040,6696,250,0,13140,1955,2436,1980,8394,180,0,14945,28085
8451,Dem. Rep. of the Congo,2019,2019Dem. Rep. of the Congo,3524,5184,3690,9993,478,0,22869,3460,5147,3843,11655,594,0,24699,47568
8452,Dem. Rep. of the Congo,2019,2019Dem. Rep. of the Congo,4814,5091,4138,10907,934,0,25884,4927,5060,4040,8947,814,0,23788,49672
8453,Dem. Rep. of the Congo,2019,2019Dem. Rep. of the Congo,5095,7241,6241,19495,2052,0,40124,5165,7230,6195,13190,1504,0,33284,73408
8454,Dem. Rep. of the Congo,2019,2019Dem. Rep. of the Congo,5676,8789,6523,17462,998,0,39448,5865,9081,6674,15914,825,0,38359,77807
8455,Dem. Rep. of the Congo,2019,2019Dem. Rep. of the Congo,40933,45362,26238,83641,5460,0,201634,40892,45759,26911,74591,4250,0,192403,394037
8456,Dem. Rep. of the Congo,2020,2020Dem. Rep. of the Congo,0,0,0,0,0,0,0,0,0,0,0,0,0,0,26873
8457,Dem. Rep. of the Congo,2020,2020Dem. Rep. of the Congo,0,0,0,0,0,0,0,0,0,0,5,5,0,10,10
8458,Dem. Rep. of the Congo,2020,2020Dem. Rep. of the Congo,0,0,0,0,0,0,0,0,0,5,0,0,0,5,5
8459,Dem. Rep. of the Congo,2020,2020Dem. Rep. of the Congo,0,0,0,0,0,8,8,0,0,0,0,0,16,16,24
8460,Dem. Rep. of the Congo,2020,2020Dem. Rep. of the Congo,0,0,0,0,0,8,8,0,0,0,0,0,17,17,25
8461,Dem. Rep. of the Congo,2020,2020Dem. Rep. of the Congo,0,0,0,0,0,24,24,0,0,0,0,0,19,19,43
8462,Dem. Rep. of the Congo,2020,2020Dem. Rep. of the Congo,0,0,0,0,0,27,27,0,0,0,0,0,34,34,61
8463,Dem. Rep. of the Congo,2020,2020Dem. Rep. of the Congo,0,0,0,0,0,757,757,0,0,0,0,0,751,751,1508
8464,Dem. Rep. of the Congo,2020,2020Dem. Rep. of the Congo,0,0,0,5,0,0,5,0,0,0,0,0,0,0,5
8465,Dem. Rep. of the Congo,2020,2020Dem. Rep. of the Congo,0,0,0,5,0,0,5,0,0,0,5,0,0,5,20
8466,Dem. Rep. of the Congo,2020,2020Dem. Rep. of the Congo,0,0,0,5,0,0,5,0,0,0,6,0,0,6,11
8467,Dem. Rep. of the Congo,2020,2020Dem. Rep. of the Congo,0,0,0,6,0,0,6,0,0,0,0,0,0,0,6
8468,Dem. Rep. of the Congo,2020,2020Dem. Rep. of the Congo,0,0,0,8,0,0,8,0,0,0,0,0,0,0,8
8469,Dem. Rep. of the Congo,2020,2020Dem. Rep. of the Congo,0,0,0,10,0,0,10,0,0,0,5,0,0,5,15
8470,Dem. Rep. of the Congo,2020,2020Dem. Rep. of the Congo,0,0,0,44,0,58,102,0,0,0,71,0,40,111,1039
8471,Dem. Rep. of the Congo,2020,2020Dem. Rep. of the Congo,0,0,5,0,0,0,5,0,0,0,0,0,0,0,5
8472,Dem. Rep. of the Congo,2020,2020Dem. Rep. of the Congo,0,0,5,0,0,0,5,0,0,0,5,0,0,5,10
8473,Dem. Rep. of the Congo,2020,2020Dem. Rep. of the Congo,0,0,5,5,0,0,10,0,0,0,0,0,0,0,10
8474,Dem. Rep. of the Congo,2020,2020Dem. Rep. of the Congo,0,0,5,6,0,0,11,0,5,5,12,0,0,22,33
8475,Dem. Rep. of the Congo,2020,2020Dem. Rep. of the Congo,0,0,5,8,0,0,13,0,0,0,13,0,0,13,26
8476,Dem. Rep. of the Congo,2020,2020Dem. Rep. of the Congo,0,0,5,10,0,0,15,0,0,16,9,0,0,25,40
8477,Dem. Rep. of the Congo,2020,2020Dem. Rep. of the Congo,0,0,6,18,0,0,24,11,0,5,18,0,0,34,58
8478,Dem. Rep. of the Congo,2020,2020Dem. Rep. of the Congo,0,5,0,0,0,0,5,0,0,0,0,0,0,0,5
8479,Dem. Rep. of the Congo,2020,2020Dem. Rep. of the Congo,0,5,0,6,0,0,11,0,0,0,7,0,0,7,18
8480,Dem. Rep. of the Congo,2020,2020Dem. Rep. of the Congo,0,6,0,0,0,0,6,0,0,0,5,0,0,5,11
8481,Dem. Rep. of the Congo,2020,2020Dem. Rep. of the Congo,0,6,0,7,0,0,13,0,0,8,0,0,0,8,21
8482,Dem. Rep. of the Congo,2020,2020Dem. Rep. of the Congo,0,7,0,12,0,0,19,0,5,0,7,0,0,12,31
8483,Dem. Rep. of the Congo,2020,2020Dem. Rep. of the Congo,0,7,5,15,0,0,27,0,6,0,19,0,0,25,52
8484,Dem. Rep. of the Congo,2020,2020Dem. Rep. of the Congo,0,17,14,89,12,0,132,9,24,22,93,29,0,177,309
8485,Dem. Rep. of the Congo,2020,2020Dem. Rep. of the Congo,5,0,0,20,0,0,25,0,5,11,11,0,0,27,52
8486,Dem. Rep. of the Congo,2020,2020Dem. Rep. of the Congo,5,7,5,37,7,0,61,8,5,6,51,5,0,75,136
8487,Dem. Rep. of the Congo,2020,2020Dem. Rep. of the Congo,5,12,8,53,0,0,78,10,6,12,72,5,0,105,183
8488,Dem. Rep. of the Congo,2020,2020Dem. Rep. of the Congo,5,15,5,35,0,0,60,5,5,0,31,5,0,46,106
8489,Dem. Rep. of the Congo,2020,2020Dem. Rep. of the Congo,7,0,0,35,0,0,42,0,0,6,33,0,0,39,81
8490,Dem. Rep. of the Congo,2020,2020Dem. Rep. of the Congo,7,6,0,16,0,0,29,5,0,0,15,0,0,20,49
8491,Dem. Rep. of the Congo,2020,2020Dem. Rep. of the Congo,7,26,15,148,5,0,201,8,29,16,176,5,0,234,435
8492,Dem. Rep. of the Congo,2020,2020Dem. Rep. of the Congo,8,5,0,18,0,0,31,0,5,6,27,5,0,43,74
8493,Dem. Rep. of the Congo,2020,2020Dem. Rep. of the Congo,8,7,6,24,0,0,45,5,8,5,9,0,0,27,72
8494,Dem. Rep. of the Congo,2020,2020Dem. Rep. of the Congo,8,13,11,50,0,0,82,9,13,11,77,0,0,110,192
8495,Dem. Rep. of the Congo,2020,2020Dem. Rep. of the Congo,9,12,13,27,0,0,61,12,15,6,65,0,0,98,159
8496,Dem. Rep. of the Congo,2020,2020Dem. Rep. of the Congo,9,32,15,40,5,0,101,13,26,16,79,8,0,142,243
8497,Dem. Rep. of the Congo,2020,2020Dem. Rep. of the Congo,11,18,15,91,7,0,142,11,26,9,84,0,0,130,272
8498,Dem. Rep. of the Congo,2020,2020Dem. Rep. of the Congo,12,44,46,173,0,0,275,13,49,51,246,18,0,377,652
8499,Dem. Rep. of the Congo,2020,2020Dem. Rep. of the Congo,14,51,40,148,5,0,258,23,38,31,159,16,0,267,525
8500,Dem. Rep. of the Congo,2020,2020Dem. Rep. of the Congo,14,68,60,553,94,0,789,33,54,60,469,134,0,750,1539
8501,Dem. Rep. of the Congo,2020,2020Dem. Rep. of the Congo,16,37,23,107,0,0,183,16,33,24,138,5,0,216,399
8502,Dem. Rep. of the Congo,2020,2020Dem. Rep. of the Congo,33,79,48,347,47,0,554,41,77,55,167,19,0,359,1255
8503,Dem. Rep. of the Congo,2020,2020Dem. Rep. of the Congo,45,76,40,178,0,0,339,49,72,56,217,5,0,399,738
8504,Dem. Rep. of the Congo,2020,2020Dem. Rep. of the Congo,162,337,219,786,38,0,1542,159,321,56,844,37,0,1417,2959
8505,Dem. Rep. of the Congo,2020,2020Dem. Rep. of the Congo,185,1707,1428,6937,167,0,10424,217,1711,1367,8927,170,0,12392,22816
8506,Dem. Rep. of the Congo,2020,2020Dem. Rep. of the Congo,239,301,196,659,18,0,1413,242,308,208,858,16,0,1632,3045
8507,Dem. Rep. of the Congo,2020,2020Dem. Rep. of the Congo,566,672,349,1009,87,0,2683,554,630,332,1253,89,0,2858,5541
8508,Dem. Rep. of the Congo,2020,2020Dem. Rep. of the Congo,585,795,557,1592,53,0,3582,590,813,642,2084,46,0,4175,7757
8509,Dem. Rep. of the Congo,2020,2020Dem. Rep. of the Congo,604,2218,1340,4246,446,0,8854,613,2185,1319,3194,333,0,7644,16498
8510,Dem. Rep. of the Congo,2020,2020Dem. Rep. of the Congo,888,1171,691,1987,101,0,4838,904,1130,636,1821,153,0,4644,22905
8511,Dem. Rep. of the Congo,2020,2020Dem. Rep. of the Congo,927,1046,745,1858,80,0,4656,884,1109,840,2318,30,0,5181,9837
8512,Dem. Rep. of the Congo,2020,2020Dem. Rep. of the Congo,995,960,790,1886,126,0,4757,933,870,719,2295,178,0,4995,9752
8513,Dem. Rep. of the Congo,2020,2020Dem. Rep. of the Congo,1808,2463,2108,7212,274,0,13865,1867,2654,2047,8987,205,0,15760,29625
8514,Dem. Rep. of the Congo,2020,2020Dem. Rep. of the Congo,3929,5905,4246,11646,600,0,26326,3893,5816,4381,13600,699,0,28389,54715
8515,Dem. Rep. of the Congo,2020,2020Dem. Rep. of the Congo,5003,7456,6413,19652,2025,0,40549,4987,7567,6420,13261,1519,0,33754,74303
8516,Dem. Rep. of the Congo,2020,2020Dem. Rep. of the Congo,5163,4991,4124,11200,1031,0,26509,5257,4999,4003,9197,895,0,24351,50860
8517,Dem. Rep. of the Congo,2020,2020Dem. Rep. of the Congo,5908,8520,6324,16419,933,0,38104,6088,8789,6454,14726,767,0,36824,74928
8518,Dem. Rep. of the Congo,2020,2020Dem. Rep. of the Congo,38254,49888,29549,89619,6223,0,213533,38247,49995,30345,80370,4917,0,203874,417407
8519,Dem. Rep. of the Congo,2021,2021Dem. Rep. of the Congo,0,0,0,0,0,0,0,0,0,0,0,0,0,0,41711
8520,Dem. Rep. of the Congo,2021,2021Dem. Rep. of the Congo,0,0,0,0,0,0,0,0,0,0,5,0,0,5,5
8521,Dem. Rep. of the Congo,2021,2021Dem. Rep. of the Congo,0,0,0,0,0,0,0,0,0,0,7,0,0,7,7
8522,Dem. Rep. of the Congo,2021,2021Dem. Rep. of the Congo,0,0,0,0,0,0,0,0,5,0,6,0,0,11,11
8523,Dem. Rep. of the Congo,2021,2021Dem. Rep. of the Congo,0,0,0,0,0,5,5,0,0,0,0,0,21,21,26
8524,Dem. Rep. of the Congo,2021,2021Dem. Rep. of the Congo,0,0,0,0,0,6,6,0,0,0,0,0,0,0,6
8525,Dem. Rep. of the Congo,2021,2021Dem. Rep. of the Congo,0,0,0,5,0,0,5,0,0,0,6,0,0,6,11
8526,Dem. Rep. of the Congo,2021,2021Dem. Rep. of the Congo,0,0,0,5,0,0,5,0,5,0,0,0,0,5,10
8527,Dem. Rep. of the Congo,2021,2021Dem. Rep. of the Congo,0,0,0,8,0,0,8,0,0,0,0,0,0,0,8
8528,Dem. Rep. of the Congo,2021,2021Dem. Rep. of the Congo,0,0,0,10,0,0,10,0,0,0,7,0,0,7,17
8529,Dem. Rep. of the Congo,2021,2021Dem. Rep. of the Congo,0,0,0,15,0,0,15,0,0,16,42,0,0,58,73
8530,Dem. Rep. of the Congo,2021,2021Dem. Rep. of the Congo,0,0,5,0,0,0,5,0,0,0,0,0,0,0,5
8531,Dem. Rep. of the Congo,2021,2021Dem. Rep. of the Congo,0,0,5,0,0,0,5,0,0,0,5,0,0,5,10
8532,Dem. Rep. of the Congo,2021,2021Dem. Rep. of the Congo,0,0,5,5,0,0,10,0,0,0,0,0,0,0,10
8533,Dem. Rep. of the Congo,2021,2021Dem. Rep. of the Congo,0,0,5,6,0,0,11,0,5,0,11,0,0,16,27
8534,Dem. Rep. of the Congo,2021,2021Dem. Rep. of the Congo,0,0,5,8,0,0,13,0,0,0,13,0,0,13,26
8535,Dem. Rep. of the Congo,2021,2021Dem. Rep. of the Congo,0,0,6,20,0,0,26,11,0,5,17,0,0,33,59
8536,Dem. Rep. of the Congo,2021,2021Dem. Rep. of the Congo,0,0,8,15,0,0,23,0,6,0,18,0,0,24,47
8537,Dem. Rep. of the Congo,2021,2021Dem. Rep. of the Congo,0,0,9,0,0,0,9,0,0,0,15,0,0,15,24
8538,Dem. Rep. of the Congo,2021,2021Dem. Rep. of the Congo,0,0,9,0,0,0,9,0,5,5,11,0,0,21,30
8539,Dem. Rep. of the Congo,2021,2021Dem. Rep. of the Congo,0,5,0,0,0,0,5,0,0,0,0,0,0,0,5
8540,Dem. Rep. of the Congo,2021,2021Dem. Rep. of the Congo,0,6,0,7,0,0,13,0,0,0,7,0,0,7,20
8541,Dem. Rep. of the Congo,2021,2021Dem. Rep. of the Congo,0,6,0,24,0,0,30,0,5,10,16,0,0,31,61
8542,Dem. Rep. of the Congo,2021,2021Dem. Rep. of the Congo,0,7,0,12,0,0,19,0,5,0,7,0,0,12,31
8543,Dem. Rep. of the Congo,2021,2021Dem. Rep. of the Congo,0,8,0,18,0,0,26,0,5,10,17,0,0,32,58
8544,Dem. Rep. of the Congo,2021,2021Dem. Rep. of the Congo,0,9,0,13,0,0,22,0,0,6,0,0,0,6,28
8545,Dem. Rep. of the Congo,2021,2021Dem. Rep. of the Congo,0,17,0,17,0,0,34,0,5,5,24,5,0,39,73
8546,Dem. Rep. of the Congo,2021,2021Dem. Rep. of the Congo,0,17,7,34,0,0,58,6,6,0,33,5,0,50,108
8547,Dem. Rep. of the Congo,2021,2021Dem. Rep. of the Congo,5,0,0,5,0,0,10,0,0,0,0,0,0,0,10
8548,Dem. Rep. of the Congo,2021,2021Dem. Rep. of the Congo,5,8,5,35,7,0,60,5,5,5,42,5,0,62,122
8549,Dem. Rep. of the Congo,2021,2021Dem. Rep. of the Congo,7,7,0,18,0,0,32,5,0,0,17,0,0,22,54
8550,Dem. Rep. of the Congo,2021,2021Dem. Rep. of the Congo,7,11,6,63,0,0,87,8,17,8,85,0,0,118,205
8551,Dem. Rep. of the Congo,2021,2021Dem. Rep. of the Congo,7,13,9,54,0,0,83,9,9,13,74,6,0,111,194
8552,Dem. Rep. of the Congo,2021,2021Dem. Rep. of the Congo,7,23,19,98,9,0,156,6,21,18,92,0,0,137,293
8553,Dem. Rep. of the Congo,2021,2021Dem. Rep. of the Congo,7,29,18,161,5,0,220,7,31,17,177,6,0,238,458
8554,Dem. Rep. of the Congo,2021,2021Dem. Rep. of the Congo,8,7,6,29,0,0,50,5,8,5,13,0,0,31,81
8555,Dem. Rep. of the Congo,2021,2021Dem. Rep. of the Congo,9,0,0,18,0,0,27,8,0,0,14,0,0,22,49
8556,Dem. Rep. of the Congo,2021,2021Dem. Rep. of the Congo,9,40,43,179,0,0,271,18,44,46,253,21,0,382,653
8557,Dem. Rep. of the Congo,2021,2021Dem. Rep. of the Congo,11,30,20,42,5,0,108,14,25,17,81,9,0,146,254
8558,Dem. Rep. of the Congo,2021,2021Dem. Rep. of the Congo,13,34,21,251,24,58,401,11,27,10,254,10,40,352,1361
8559,Dem. Rep. of the Congo,2021,2021Dem. Rep. of the Congo,13,38,33,130,5,0,219,18,50,25,133,15,0,241,460
8560,Dem. Rep. of the Congo,2021,2021Dem. Rep. of the Congo,13,69,62,524,99,0,767,34,61,55,447,135,0,732,1761
8561,Dem. Rep. of the Congo,2021,2021Dem. Rep. of the Congo,16,24,17,47,0,0,104,17,27,6,85,0,0,135,239
8562,Dem. Rep. of the Congo,2021,2021Dem. Rep. of the Congo,16,26,32,126,18,0,218,24,38,43,138,31,0,274,492
8563,Dem. Rep. of the Congo,2021,2021Dem. Rep. of the Congo,31,43,25,110,0,0,209,25,32,24,131,5,0,217,426
8564,Dem. Rep. of the Congo,2021,2021Dem. Rep. of the Congo,34,57,50,331,48,0,520,33,70,46,169,18,0,336,1204
8565,Dem. Rep. of the Congo,2021,2021Dem. Rep. of the Congo,41,1295,1569,7238,196,0,10339,47,1284,1564,9201,223,0,12319,22658
8566,Dem. Rep. of the Congo,2021,2021Dem. Rep. of the Congo,49,81,41,182,0,0,353,42,84,54,231,5,0,416,769
8567,Dem. Rep. of the Congo,2021,2021Dem. Rep. of the Congo,136,309,234,721,34,0,1434,121,315,243,851,29,0,1559,2993
8568,Dem. Rep. of the Congo,2021,2021Dem. Rep. of the Congo,186,709,1201,3468,375,0,5939,205,738,1294,3576,369,0,6182,12121
8569,Dem. Rep. of the Congo,2021,2021Dem. Rep. of the Congo,249,313,204,698,18,0,1482,268,321,221,872,23,0,1705,3187
8570,Dem. Rep. of the Congo,2021,2021Dem. Rep. of the Congo,368,706,390,1315,107,0,2886,386,746,400,1057,102,0,2691,5577
8571,Dem. Rep. of the Congo,2021,2021Dem. Rep. of the Congo,542,859,571,1685,51,0,3708,562,828,676,2174,46,0,4286,7994
8572,Dem. Rep. of the Congo,2021,2021Dem. Rep. of the Congo,780,2241,1493,4650,489,0,9653,805,2185,1486,3466,363,0,8305,17958
8573,Dem. Rep. of the Congo,2021,2021Dem. Rep. of the Congo,823,1256,738,2046,100,0,4963,848,1222,677,1882,157,0,4786,23163
8574,Dem. Rep. of the Congo,2021,2021Dem. Rep. of the Congo,1315,1666,1059,2877,122,0,7039,1274,1627,1214,3748,39,0,7902,14941
8575,Dem. Rep. of the Congo,2021,2021Dem. Rep. of the Congo,1900,2528,2067,7479,287,0,14261,1999,2669,2015,9248,219,0,16150,30411
8576,Dem. Rep. of the Congo,2021,2021Dem. Rep. of the Congo,4328,6685,4818,13238,665,0,29734,4314,6540,4922,15775,754,0,32305,62039
8577,Dem. Rep. of the Congo,2021,2021Dem. Rep. of the Congo,4811,7229,6251,19984,1990,0,40265,4807,7324,6262,13619,1486,0,33498,73763
8578,Dem. Rep. of the Congo,2021,2021Dem. Rep. of the Congo,5477,4971,4050,11191,1140,0,26829,5565,5006,3992,9350,905,0,24818,51647
8579,Dem. Rep. of the Congo,2021,2021Dem. Rep. of the Congo,6342,7966,6973,19265,1089,0,41635,6757,8076,6996,16515,838,0,39182,80817
8580,Dem. Rep. of the Congo,2021,2021Dem. Rep. of the Congo,38113,54276,33143,96579,6748,0,228859,38330,54267,33675,87060,5349,0,218681,447540
8581,Egypt,2001,2001Egypt,0,0,0,0,0,0,0,0,0,0,0,0,0,0,4538
8582,Egypt,2001,2001Egypt,0,0,0,0,0,0,0,0,0,0,0,0,5,5,5
8583,Egypt,2001,2001Egypt,0,0,0,0,0,0,0,0,0,0,5,0,0,5,10
8584,Egypt,2001,2001Egypt,0,0,0,0,0,16,16,0,0,0,0,0,20,20,36
8585,Egypt,2001,2001Egypt,0,0,0,0,0,26,26,0,0,0,0,0,40,40,66
8586,Egypt,2001,2001Egypt,0,0,0,5,0,0,5,0,0,0,0,0,0,0,5
8587,Egypt,2001,2001Egypt,0,0,0,6,0,0,6,0,0,0,11,0,0,11,17
8588,Egypt,2002,2002Egypt,0,0,0,0,0,0,0,0,0,0,0,0,0,0,6310
8589,Egypt,2002,2002Egypt,0,0,0,0,0,0,0,0,0,0,5,0,0,5,5
8590,Egypt,2002,2002Egypt,0,0,0,0,0,12,12,0,0,0,0,0,18,18,30
8591,Egypt,2002,2002Egypt,0,0,0,0,0,23,23,0,0,0,0,0,43,43,66
8592,Egypt,2002,2002Egypt,0,0,0,5,0,0,5,0,0,0,0,0,0,0,5
8593,Egypt,2002,2002Egypt,0,0,0,5,0,0,5,0,5,0,0,0,0,5,10
8594,Egypt,2002,2002Egypt,0,0,0,6,0,0,6,0,0,0,10,0,0,10,16
8595,Egypt,2003,2003Egypt,0,0,0,0,0,0,0,0,0,0,0,0,0,0,5600
8596,Egypt,2003,2003Egypt,0,0,0,0,0,0,0,0,0,0,5,0,0,5,5
8597,Egypt,2003,2003Egypt,0,0,0,0,0,12,12,0,0,0,0,0,20,20,32
8598,Egypt,2003,2003Egypt,0,0,0,0,0,25,25,0,0,0,0,0,42,42,67
8599,Egypt,2003,2003Egypt,0,0,0,5,0,0,5,0,0,0,0,0,0,0,5
8600,Egypt,2003,2003Egypt,0,0,0,5,0,0,5,0,0,0,5,0,0,5,10
8601,Egypt,2003,2003Egypt,0,0,0,5,0,0,5,5,0,0,0,0,0,5,10
8602,Egypt,2003,2003Egypt,5,0,0,0,0,0,5,0,0,0,0,0,0,0,5
8603,Egypt,2004,2004Egypt,0,0,0,0,0,0,0,0,0,0,0,0,0,0,5283
8604,Egypt,2004,2004Egypt,0,0,0,0,0,0,0,0,0,0,5,0,0,5,20
8605,Egypt,2004,2004Egypt,0,0,0,0,0,0,0,0,0,0,9,0,0,9,9
8606,Egypt,2004,2004Egypt,0,0,0,0,0,8,8,0,0,0,0,0,24,24,32
8607,Egypt,2004,2004Egypt,0,0,0,5,0,0,5,0,6,0,0,0,0,6,11
8608,Egypt,2004,2004Egypt,0,0,0,6,0,0,6,0,0,0,0,0,0,0,6
8609,Egypt,2005,2005Egypt,0,0,0,0,0,0,0,0,0,0,0,0,0,0,6126
8610,Egypt,2005,2005Egypt,0,0,0,0,0,0,0,0,0,0,5,0,0,5,10
8611,Egypt,2005,2005Egypt,0,0,0,0,0,0,0,0,0,0,9,0,0,9,9
8612,Egypt,2005,2005Egypt,0,0,0,0,0,0,0,5,0,0,0,0,0,5,5
8613,Egypt,2005,2005Egypt,0,0,0,0,0,6,6,0,0,0,0,0,9,9,15
8614,Egypt,2005,2005Egypt,0,0,0,0,0,10,10,0,0,0,0,0,21,21,31
8615,Egypt,2005,2005Egypt,0,0,0,0,0,29,29,0,0,0,0,0,52,52,81
8616,Egypt,2005,2005Egypt,0,0,0,5,0,0,5,0,0,0,0,0,0,0,5
8617,Egypt,2005,2005Egypt,0,0,0,6,0,0,6,0,0,0,0,0,0,0,6
8618,Egypt,2006,2006Egypt,0,0,0,0,0,0,0,0,0,0,0,0,0,0,7413
8619,Egypt,2006,2006Egypt,0,0,0,0,0,0,0,0,0,0,5,0,0,5,20
8620,Egypt,2006,2006Egypt,0,0,0,0,0,0,0,0,0,0,7,0,0,7,7
8621,Egypt,2006,2006Egypt,0,0,0,0,0,5,5,0,0,0,0,0,0,0,5
8622,Egypt,2006,2006Egypt,0,0,0,0,0,7,7,0,0,0,0,0,12,12,19
8623,Egypt,2006,2006Egypt,0,0,0,0,0,10,10,0,0,0,0,0,21,21,31
8624,Egypt,2006,2006Egypt,0,0,0,0,0,33,33,0,0,0,0,0,63,63,96
8625,Egypt,2006,2006Egypt,0,0,0,5,0,0,5,0,0,0,0,0,0,0,5
8626,Egypt,2006,2006Egypt,0,0,0,6,0,0,6,0,0,0,0,0,0,0,6
8627,Egypt,2006,2006Egypt,0,0,6,0,0,0,6,0,0,0,0,0,0,0,6
8628,Egypt,2007,2007Egypt,0,0,0,0,0,0,0,0,0,0,0,0,0,0,6594
8629,Egypt,2007,2007Egypt,0,0,0,0,0,0,0,0,0,0,0,0,5,5,5
8630,Egypt,2007,2007Egypt,0,0,0,0,0,0,0,0,0,0,5,0,0,5,5
8631,Egypt,2007,2007Egypt,0,0,0,0,0,13,13,0,0,0,5,0,20,25,38
8632,Egypt,2007,2007Egypt,0,0,0,0,0,34,34,0,0,0,0,0,70,70,104
8633,Egypt,2007,2007Egypt,0,0,0,5,0,0,5,0,0,0,0,0,0,0,10
8634,Egypt,2007,2007Egypt,0,0,0,6,0,0,6,0,0,0,0,0,0,0,6
8635,Egypt,2007,2007Egypt,0,0,0,7,0,0,7,0,0,0,8,0,0,8,15
8636,Egypt,2007,2007Egypt,0,0,5,0,0,0,5,0,0,7,0,0,0,7,12
8637,Egypt,2008,2008Egypt,0,0,0,0,0,0,0,0,0,0,0,0,0,0,6562
8638,Egypt,2008,2008Egypt,0,0,0,0,0,0,0,0,0,0,0,0,7,7,7
8639,Egypt,2008,2008Egypt,0,0,0,0,0,0,0,0,0,0,5,0,0,5,15
8640,Egypt,2008,2008Egypt,0,0,0,0,0,13,13,0,0,0,0,0,23,23,36
8641,Egypt,2008,2008Egypt,0,0,0,0,0,35,35,0,0,0,0,0,76,76,111
8642,Egypt,2008,2008Egypt,0,0,0,5,0,0,5,0,0,0,6,0,0,6,11
8643,Egypt,2008,2008Egypt,0,0,0,6,0,0,6,0,0,0,0,0,0,0,6
8644,Egypt,2008,2008Egypt,0,7,0,0,0,0,7,0,0,0,0,0,0,0,7
8645,Egypt,2008,2008Egypt,0,8,0,0,0,0,8,0,0,0,9,0,0,9,22
8646,Egypt,2009,2009Egypt,0,0,0,0,0,0,0,0,0,0,0,0,0,0,6052
8647,Egypt,2009,2009Egypt,0,0,0,0,0,0,0,0,0,0,0,0,9,9,9
8648,Egypt,2009,2009Egypt,0,0,0,0,0,0,0,5,0,0,0,0,0,5,5
8649,Egypt,2009,2009Egypt,0,0,0,5,0,0,5,0,0,0,0,0,0,0,5
8650,Egypt,2009,2009Egypt,0,0,0,5,0,8,13,0,0,0,0,0,23,23,36
8651,Egypt,2009,2009Egypt,0,0,0,8,0,0,8,5,0,0,5,0,0,10,23
8652,Egypt,2009,2009Egypt,0,6,0,0,0,0,6,0,6,0,9,0,0,15,21
8653,Egypt,2009,2009Egypt,12,29,22,84,14,0,161,23,39,31,509,69,0,671,832
8654,Egypt,2010,2010Egypt,0,0,0,0,0,0,0,0,0,0,0,0,0,0,5750
8655,Egypt,2010,2010Egypt,0,0,0,0,0,0,0,0,0,0,0,0,9,9,9
8656,Egypt,2010,2010Egypt,0,0,0,0,0,0,0,0,0,0,5,0,0,5,5
8657,Egypt,2010,2010Egypt,0,0,0,0,0,0,0,0,0,0,6,0,0,6,6
8658,Egypt,2010,2010Egypt,0,0,0,0,0,0,0,5,0,0,0,0,0,5,5
8659,Egypt,2010,2010Egypt,0,0,0,0,0,18,18,0,0,0,0,0,25,25,43
8660,Egypt,2010,2010Egypt,0,0,0,0,0,41,41,0,0,0,0,0,95,95,136
8661,Egypt,2010,2010Egypt,0,0,0,5,0,0,5,0,5,6,5,0,0,16,21
8662,Egypt,2010,2010Egypt,0,0,0,7,0,0,7,0,0,0,7,0,0,7,14
8663,Egypt,2010,2010Egypt,0,0,0,9,0,0,9,0,0,0,0,0,0,0,9
8664,Egypt,2010,2010Egypt,0,0,6,0,0,0,6,0,0,0,0,0,0,0,6
8665,Egypt,2010,2010Egypt,0,7,0,0,0,0,7,0,0,7,0,0,0,7,14
8666,Egypt,2010,2010Egypt,5,0,0,0,0,0,5,0,0,0,0,0,0,0,10
8667,Egypt,2010,2010Egypt,15,33,22,107,17,0,194,22,46,29,504,80,0,681,875
8668,Egypt,2011,2011Egypt,0,0,0,0,0,0,0,0,0,0,0,0,0,0,6136
8669,Egypt,2011,2011Egypt,0,0,0,0,0,0,0,0,0,0,5,0,0,5,10
8670,Egypt,2011,2011Egypt,0,0,0,0,0,0,0,5,0,0,0,0,0,5,5
8671,Egypt,2011,2011Egypt,0,0,0,0,0,5,5,0,0,0,0,0,6,6,11
8672,Egypt,2011,2011Egypt,0,0,0,0,0,19,19,0,0,0,0,0,24,24,43
8673,Egypt,2011,2011Egypt,0,0,0,0,0,53,53,0,0,0,0,0,131,131,184
8674,Egypt,2011,2011Egypt,0,0,0,5,0,0,5,0,0,0,0,0,0,0,5
8675,Egypt,2011,2011Egypt,0,0,0,6,0,0,6,0,0,0,0,0,0,0,6
8676,Egypt,2011,2011Egypt,0,0,0,7,0,0,7,0,0,0,7,0,0,7,14
8677,Egypt,2011,2011Egypt,0,0,6,0,0,0,6,0,0,0,8,0,0,8,14
8678,Egypt,2011,2011Egypt,0,0,8,32,13,0,53,0,6,8,55,7,0,76,555
8679,Egypt,2011,2011Egypt,0,9,6,0,0,0,15,0,5,9,0,0,0,14,29
8680,Egypt,2011,2011Egypt,5,7,9,5,0,0,26,0,0,7,0,0,0,7,33
8681,Egypt,2011,2011Egypt,15,36,17,120,22,0,210,20,46,35,478,88,0,667,877
8682,Egypt,2012,2012Egypt,0,0,0,0,0,0,0,0,0,0,0,0,0,0,8049
8683,Egypt,2012,2012Egypt,0,0,0,0,0,0,0,0,0,0,5,0,0,5,15
8684,Egypt,2012,2012Egypt,0,0,0,0,0,0,0,0,0,0,6,0,0,6,15
8685,Egypt,2012,2012Egypt,0,0,0,0,0,0,0,0,0,5,0,0,0,5,5
8686,Egypt,2012,2012Egypt,0,0,0,0,0,0,0,5,0,0,0,0,0,5,5
8687,Egypt,2012,2012Egypt,0,0,0,0,0,9,9,0,0,0,0,0,9,9,18
8688,Egypt,2012,2012Egypt,0,0,0,0,0,22,22,0,0,0,0,0,24,24,46
8689,Egypt,2012,2012Egypt,0,0,0,0,0,80,80,0,0,0,0,0,206,206,286
8690,Egypt,2012,2012Egypt,0,0,0,5,0,0,5,0,0,0,0,0,0,0,5
8691,Egypt,2012,2012Egypt,0,0,0,5,0,0,5,0,0,0,6,0,0,6,11
8692,Egypt,2012,2012Egypt,0,0,0,7,0,0,7,0,0,0,7,0,0,7,14
8693,Egypt,2012,2012Egypt,0,0,5,0,0,0,5,0,0,0,0,0,0,0,5
8694,Egypt,2012,2012Egypt,0,0,5,20,23,0,48,0,0,5,27,9,0,41,597
8695,Egypt,2012,2012Egypt,0,0,6,0,0,0,6,0,0,0,7,0,0,7,13
8696,Egypt,2012,2012Egypt,0,5,0,7,0,0,12,0,0,0,0,0,0,0,17
8697,Egypt,2012,2012Egypt,0,5,6,0,0,0,11,0,0,10,0,0,0,10,21
8698,Egypt,2012,2012Egypt,5,0,8,0,0,0,13,0,5,8,0,0,0,13,26
8699,Egypt,2012,2012Egypt,6,0,0,0,0,0,6,0,0,0,0,0,0,0,6
8700,Egypt,2012,2012Egypt,14,32,18,121,30,0,215,14,42,28,458,103,0,645,860
8701,Egypt,2013,2013Egypt,0,0,0,0,0,0,0,0,0,0,0,0,0,0,11181
8702,Egypt,2013,2013Egypt,0,0,0,0,0,0,0,0,0,0,5,0,0,5,15
8703,Egypt,2013,2013Egypt,0,0,0,0,0,0,0,0,0,5,0,0,0,5,5
8704,Egypt,2013,2013Egypt,0,0,0,0,0,0,0,0,0,6,0,0,0,6,6
8705,Egypt,2013,2013Egypt,0,0,0,0,0,9,9,0,0,0,0,0,10,10,19
8706,Egypt,2013,2013Egypt,0,0,0,0,0,28,28,0,0,0,0,0,28,28,56
8707,Egypt,2013,2013Egypt,0,0,0,0,0,114,114,0,0,0,0,0,308,308,422
8708,Egypt,2013,2013Egypt,0,0,0,0,5,0,5,0,0,0,0,0,0,0,5
8709,Egypt,2013,2013Egypt,0,0,0,5,0,0,5,0,0,0,0,0,0,0,20
8710,Egypt,2013,2013Egypt,0,0,0,6,0,0,6,0,0,0,0,0,0,0,12
8711,Egypt,2013,2013Egypt,0,0,0,6,0,0,6,0,5,5,0,0,0,10,16
8712,Egypt,2013,2013Egypt,0,0,0,7,0,0,7,0,0,0,7,0,0,7,14
8713,Egypt,2013,2013Egypt,0,0,7,13,0,0,20,0,0,0,18,0,0,18,38
8714,Egypt,2013,2013Egypt,0,5,0,5,0,0,10,5,0,0,13,0,0,18,28
8715,Egypt,2013,2013Egypt,0,5,6,0,0,0,11,0,0,0,6,0,0,6,17
8716,Egypt,2013,2013Egypt,0,11,0,7,0,0,18,0,6,5,7,0,0,18,36
8717,Egypt,2013,2013Egypt,5,0,0,0,0,0,5,0,0,0,0,0,0,0,10
8718,Egypt,2013,2013Egypt,5,17,10,59,58,0,149,9,9,13,56,28,0,115,638
8719,Egypt,2013,2013Egypt,12,28,11,50,5,0,106,14,40,17,73,16,0,160,266
8720,Egypt,2014,2014Egypt,0,0,0,0,0,0,0,0,0,0,0,0,0,0,13882
8721,Egypt,2014,2014Egypt,0,0,0,0,0,0,0,0,0,0,0,0,5,5,5
8722,Egypt,2014,2014Egypt,0,0,0,0,0,0,0,0,0,0,5,0,0,5,20
8723,Egypt,2014,2014Egypt,0,0,0,0,0,0,0,0,0,5,0,0,0,5,5
8724,Egypt,2014,2014Egypt,0,0,0,0,0,0,0,0,5,0,0,0,0,5,5
8725,Egypt,2014,2014Egypt,0,0,0,0,0,5,5,0,0,0,0,0,0,0,5
8726,Egypt,2014,2014Egypt,0,0,0,0,0,173,173,0,0,0,0,0,489,489,662
8727,Egypt,2014,2014Egypt,0,0,0,5,0,0,5,0,0,0,0,0,0,0,10
8728,Egypt,2014,2014Egypt,0,0,0,5,0,0,5,0,0,0,5,0,0,5,10
8729,Egypt,2014,2014Egypt,0,0,0,5,0,0,5,0,0,0,12,0,0,12,17
8730,Egypt,2014,2014Egypt,0,0,0,6,0,0,6,0,0,0,0,0,0,0,6
8731,Egypt,2014,2014Egypt,0,0,0,8,0,0,8,0,0,0,0,0,0,0,8
8732,Egypt,2014,2014Egypt,0,0,0,8,0,0,8,0,0,0,7,0,0,7,15
8733,Egypt,2014,2014Egypt,0,0,5,0,0,26,31,0,0,5,0,0,28,33,64
8734,Egypt,2014,2014Egypt,0,0,8,0,0,0,8,0,0,0,0,0,0,0,8
8735,Egypt,2014,2014Egypt,0,0,8,0,0,0,8,0,5,5,0,0,0,10,18
8736,Egypt,2014,2014Egypt,0,5,0,0,0,0,5,0,0,0,0,0,0,0,5
8737,Egypt,2014,2014Egypt,0,5,0,10,0,0,15,0,6,0,5,0,0,11,26
8738,Egypt,2014,2014Egypt,0,5,6,0,0,0,11,0,0,5,6,0,0,11,22
8739,Egypt,2014,2014Egypt,0,6,0,0,0,0,6,0,7,0,0,0,0,7,13
8740,Egypt,2014,2014Egypt,0,7,5,9,0,0,21,8,0,5,10,0,0,23,44
8741,Egypt,2014,2014Egypt,5,0,0,0,0,0,5,0,0,0,0,0,0,0,10
8742,Egypt,2014,2014Egypt,15,16,7,62,43,0,143,5,11,11,89,29,0,145,684
8743,Egypt,2014,2014Egypt,15,33,17,65,5,0,135,21,37,24,121,17,0,220,355
8744,Egypt,2015,2015Egypt,0,0,0,0,0,0,0,0,0,0,0,0,0,0,16079
8745,Egypt,2015,2015Egypt,0,0,0,0,0,0,0,0,0,0,0,0,5,5,5
8746,Egypt,2015,2015Egypt,0,0,0,0,0,0,0,0,0,0,5,0,0,5,10
8747,Egypt,2015,2015Egypt,0,0,0,0,0,0,0,0,0,0,6,0,0,6,6
8748,Egypt,2015,2015Egypt,0,0,0,0,0,0,0,0,5,0,0,0,0,5,5
8749,Egypt,2015,2015Egypt,0,0,0,0,0,5,5,0,0,0,0,0,0,0,5
8750,Egypt,2015,2015Egypt,0,0,0,0,0,28,28,0,0,0,0,0,31,31,59
8751,Egypt,2015,2015Egypt,0,0,0,0,0,192,192,0,0,0,0,0,575,575,767
8752,Egypt,2015,2015Egypt,0,0,0,5,0,0,5,0,0,0,8,0,0,8,13
8753,Egypt,2015,2015Egypt,0,0,0,5,0,0,5,0,0,0,16,0,0,16,21
8754,Egypt,2015,2015Egypt,0,0,0,6,0,0,6,0,0,0,0,0,0,0,12
8755,Egypt,2015,2015Egypt,0,0,0,8,0,0,8,0,0,0,7,0,0,7,15
8756,Egypt,2015,2015Egypt,0,0,5,0,0,0,5,0,0,0,0,0,0,0,5
8757,Egypt,2015,2015Egypt,0,0,6,5,0,0,11,0,0,5,14,0,0,19,30
8758,Egypt,2015,2015Egypt,0,0,6,13,0,0,19,0,0,0,17,0,0,17,36
8759,Egypt,2015,2015Egypt,0,5,0,0,0,0,5,0,0,0,0,0,0,0,15
8760,Egypt,2015,2015Egypt,0,5,0,7,0,0,12,0,9,0,6,0,0,15,27
8761,Egypt,2015,2015Egypt,0,7,0,5,0,0,12,0,7,0,5,0,0,12,24
8762,Egypt,2015,2015Egypt,0,7,0,9,0,0,16,8,5,0,31,0,0,44,86
8763,Egypt,2015,2015Egypt,0,7,0,10,0,0,17,0,7,7,14,0,0,28,45
8764,Egypt,2015,2015Egypt,5,0,0,0,0,0,5,0,0,0,0,0,0,0,5
8765,Egypt,2015,2015Egypt,5,0,0,0,0,0,5,0,0,0,5,0,0,5,10
8766,Egypt,2015,2015Egypt,6,0,7,0,0,0,13,0,0,0,0,0,0,0,13
8767,Egypt,2015,2015Egypt,25,42,35,147,5,0,254,33,55,41,233,20,0,382,636
8768,Egypt,2016,2016Egypt,0,0,0,0,0,0,0,0,0,0,0,0,0,0,16205
8769,Egypt,2016,2016Egypt,0,0,0,0,0,0,0,0,0,0,0,0,5,5,5
8770,Egypt,2016,2016Egypt,0,0,0,0,0,0,0,0,0,0,5,0,0,5,10
8771,Egypt,2016,2016Egypt,0,0,0,0,0,0,0,0,0,0,6,0,0,6,6
8772,Egypt,2016,2016Egypt,0,0,0,0,0,0,0,5,0,0,0,0,0,5,5
8773,Egypt,2016,2016Egypt,0,0,0,0,0,5,5,0,0,0,0,0,0,0,5
8774,Egypt,2016,2016Egypt,0,0,0,0,0,21,21,0,0,0,0,0,29,29,50
8775,Egypt,2016,2016Egypt,0,0,0,0,0,41,41,0,0,0,9,0,45,54,95
8776,Egypt,2016,2016Egypt,0,0,0,0,0,211,211,0,0,0,0,0,631,631,842
8777,Egypt,2016,2016Egypt,0,0,0,5,0,0,5,0,0,0,0,0,0,0,5
8778,Egypt,2016,2016Egypt,0,0,0,5,0,0,5,0,0,0,12,0,0,12,34
8779,Egypt,2016,2016Egypt,0,0,0,9,0,0,9,0,0,0,7,0,0,7,16
8780,Egypt,2016,2016Egypt,0,0,5,9,0,0,14,0,0,0,16,0,0,16,30
8781,Egypt,2016,2016Egypt,0,0,8,0,0,0,8,0,0,0,0,0,0,0,8
8782,Egypt,2016,2016Egypt,0,0,10,5,0,0,15,0,7,0,6,0,0,13,28
8783,Egypt,2016,2016Egypt,0,0,10,9,0,0,19,0,0,8,8,0,0,16,35
8784,Egypt,2016,2016Egypt,0,5,0,0,0,0,5,0,0,0,0,0,0,0,10
8785,Egypt,2016,2016Egypt,0,5,8,37,16,0,66,0,8,6,60,13,0,87,1155
8786,Egypt,2016,2016Egypt,0,8,0,0,0,0,8,0,8,0,0,0,0,8,16
8787,Egypt,2016,2016Egypt,5,0,0,0,0,0,5,0,0,0,0,0,0,0,5
8788,Egypt,2016,2016Egypt,5,6,9,13,0,0,33,0,6,12,18,0,0,36,69
8789,Egypt,2016,2016Egypt,6,0,0,0,0,0,6,0,0,0,8,0,0,8,14
8790,Egypt,2016,2016Egypt,6,0,8,0,0,0,14,0,0,0,0,0,0,0,14
8791,Egypt,2016,2016Egypt,6,8,0,6,0,0,20,0,8,8,15,0,0,31,51
8792,Egypt,2016,2016Egypt,37,69,58,250,10,0,424,55,93,67,410,30,0,655,1079
8793,Egypt,2017,2017Egypt,0,0,0,0,0,0,0,0,0,0,0,0,0,0,18850
8794,Egypt,2017,2017Egypt,0,0,0,0,0,0,0,0,0,0,0,0,5,5,5
8795,Egypt,2017,2017Egypt,0,0,0,0,0,0,0,0,0,0,5,0,0,5,10
8796,Egypt,2017,2017Egypt,0,0,0,0,0,0,0,0,7,0,0,0,0,7,7
8797,Egypt,2017,2017Egypt,0,0,0,0,0,51,51,0,0,0,9,0,46,55,106
8798,Egypt,2017,2017Egypt,0,0,0,0,0,223,223,0,0,0,0,0,663,663,886
8799,Egypt,2017,2017Egypt,0,0,0,5,0,0,5,0,0,0,0,0,0,0,10
8800,Egypt,2017,2017Egypt,0,0,0,6,0,0,6,0,0,0,13,0,0,13,38
8801,Egypt,2017,2017Egypt,0,0,0,7,0,0,7,0,5,0,7,0,0,12,19
8802,Egypt,2017,2017Egypt,0,0,0,9,0,0,9,0,0,0,7,0,0,7,48
8803,Egypt,2017,2017Egypt,0,0,0,12,0,0,12,0,0,0,17,0,0,17,29
8804,Egypt,2017,2017Egypt,0,0,5,0,0,0,5,0,0,0,0,0,0,0,5
8805,Egypt,2017,2017Egypt,0,0,12,5,0,0,17,0,7,0,11,0,0,18,35
8806,Egypt,2017,2017Egypt,0,5,0,0,0,0,5,0,0,0,0,0,0,0,20
8807,Egypt,2017,2017Egypt,0,5,5,18,0,0,28,0,6,7,20,5,0,38,66
8808,Egypt,2017,2017Egypt,0,6,0,0,0,0,6,0,0,0,10,0,0,10,16
8809,Egypt,2017,2017Egypt,0,6,8,0,0,0,14,0,0,0,0,0,0,0,14
8810,Egypt,2017,2017Egypt,0,9,0,0,0,0,9,0,0,0,0,0,0,0,9
8811,Egypt,2017,2017Egypt,5,0,0,0,0,0,5,0,0,0,0,0,0,0,5
8812,Egypt,2017,2017Egypt,5,0,0,18,0,0,23,0,8,7,13,0,0,28,51
8813,Egypt,2017,2017Egypt,5,8,9,13,0,0,35,11,5,10,18,0,0,44,79
8814,Egypt,2017,2017Egypt,93,112,93,406,16,0,720,98,142,109,695,34,0,1078,1798
8815,Egypt,2018,2018Egypt,0,0,0,0,0,0,0,0,0,0,0,0,0,0,19395
8816,Egypt,2018,2018Egypt,0,0,0,0,0,0,0,0,0,0,5,0,0,5,10
8817,Egypt,2018,2018Egypt,0,0,0,0,0,0,0,0,0,0,7,0,0,7,7
8818,Egypt,2018,2018Egypt,0,0,0,0,0,0,0,0,5,0,0,0,0,5,5
8819,Egypt,2018,2018Egypt,0,0,0,0,0,5,5,0,0,0,0,0,0,0,5
8820,Egypt,2018,2018Egypt,0,0,0,0,0,253,253,0,0,0,0,0,727,727,980
8821,Egypt,2018,2018Egypt,0,0,0,5,0,47,52,0,0,0,6,0,52,58,110
8822,Egypt,2018,2018Egypt,0,0,0,6,0,0,6,0,0,0,15,0,0,15,21
8823,Egypt,2018,2018Egypt,0,0,0,8,0,0,8,0,0,0,0,0,0,0,8
8824,Egypt,2018,2018Egypt,0,0,0,8,0,0,8,0,0,0,11,0,0,11,19
8825,Egypt,2018,2018Egypt,0,0,0,9,0,0,9,0,0,0,7,0,0,7,16
8826,Egypt,2018,2018Egypt,0,0,0,11,0,0,11,0,0,0,15,0,0,15,26
8827,Egypt,2018,2018Egypt,0,0,12,5,0,0,17,0,0,7,11,0,0,18,35
8828,Egypt,2018,2018Egypt,0,5,0,0,0,0,5,0,0,0,0,0,0,0,5
8829,Egypt,2018,2018Egypt,0,5,0,0,0,0,5,0,0,0,11,0,0,11,16
8830,Egypt,2018,2018Egypt,0,6,0,0,0,0,6,0,0,0,9,0,0,9,15
8831,Egypt,2018,2018Egypt,0,8,0,9,0,0,17,5,6,0,15,0,0,26,43
8832,Egypt,2018,2018Egypt,0,9,0,0,0,0,9,0,0,0,0,0,0,0,9
8833,Egypt,2018,2018Egypt,0,9,14,24,0,0,47,5,14,9,30,0,0,58,105
8834,Egypt,2018,2018Egypt,0,10,7,17,0,0,34,0,5,7,19,5,0,36,70
8835,Egypt,2018,2018Egypt,5,0,0,0,0,0,5,0,0,0,0,0,0,0,5
8836,Egypt,2018,2018Egypt,5,0,0,16,0,0,21,0,8,0,30,0,0,38,59
8837,Egypt,2018,2018Egypt,28,49,32,143,45,0,297,29,56,28,143,20,0,276,1764
8838,Egypt,2018,2018Egypt,105,153,108,477,22,0,865,103,177,118,819,40,0,1257,2122
8839,Egypt,2019,2019Egypt,0,0,0,0,0,0,0,0,0,0,0,0,0,0,23437
8840,Egypt,2019,2019Egypt,0,0,0,0,0,0,0,0,0,0,0,0,5,5,5
8841,Egypt,2019,2019Egypt,0,0,0,0,0,0,0,0,0,0,5,0,0,5,10
8842,Egypt,2019,2019Egypt,0,0,0,0,0,0,0,0,0,0,7,0,0,7,7
8843,Egypt,2019,2019Egypt,0,0,0,0,0,0,0,0,5,0,0,0,0,5,5
8844,Egypt,2019,2019Egypt,0,0,0,0,0,0,0,0,8,0,0,0,0,8,8
8845,Egypt,2019,2019Egypt,0,0,0,0,0,294,294,0,0,0,0,0,797,797,1091
8846,Egypt,2019,2019Egypt,0,0,0,5,0,0,5,0,0,0,8,0,0,8,115
8847,Egypt,2019,2019Egypt,0,0,0,5,0,0,5,0,0,0,14,0,0,14,19
8848,Egypt,2019,2019Egypt,0,0,0,9,0,0,9,0,0,0,7,0,0,7,16
8849,Egypt,2019,2019Egypt,0,0,0,10,0,0,10,0,0,0,20,0,0,20,30
8850,Egypt,2019,2019Egypt,0,0,5,0,0,0,5,0,0,0,0,0,0,0,5
8851,Egypt,2019,2019Egypt,0,0,7,0,0,0,7,0,0,0,8,0,0,8,15
8852,Egypt,2019,2019Egypt,0,0,15,0,0,0,15,0,0,7,11,0,0,18,33
8853,Egypt,2019,2019Egypt,0,5,0,0,0,0,5,0,0,0,13,0,0,13,18
8854,Egypt,2019,2019Egypt,0,6,0,0,0,0,6,0,0,0,10,0,0,10,16
8855,Egypt,2019,2019Egypt,0,7,0,0,0,0,7,0,0,6,0,0,0,6,13
8856,Egypt,2019,2019Egypt,0,7,5,15,0,0,27,0,10,5,18,0,0,33,60
8857,Egypt,2019,2019Egypt,0,10,14,21,0,0,45,5,17,8,25,0,0,55,100
8858,Egypt,2019,2019Egypt,5,0,0,0,0,0,5,0,0,0,0,0,0,0,15
8859,Egypt,2019,2019Egypt,5,5,10,29,0,0,49,5,5,5,19,5,0,39,88
8860,Egypt,2019,2019Egypt,110,183,109,506,24,0,932,97,210,129,901,41,0,1378,2310
8861,Egypt,2020,2020Egypt,0,0,0,0,0,0,0,0,0,0,0,0,0,0,20509
8862,Egypt,2020,2020Egypt,0,0,0,0,0,0,0,0,0,0,0,0,5,5,5
8863,Egypt,2020,2020Egypt,0,0,0,0,0,0,0,0,0,0,5,0,0,5,5
8864,Egypt,2020,2020Egypt,0,0,0,0,0,0,0,0,0,0,7,0,0,7,14
8865,Egypt,2020,2020Egypt,0,0,0,0,0,0,0,0,0,0,8,0,0,8,128
8866,Egypt,2020,2020Egypt,0,0,0,0,0,0,0,0,0,5,0,0,0,5,5
8867,Egypt,2020,2020Egypt,0,0,0,0,0,0,0,0,5,0,0,0,0,5,5
8868,Egypt,2020,2020Egypt,0,0,0,0,0,5,5,0,0,0,0,0,6,6,11
8869,Egypt,2020,2020Egypt,0,0,0,0,0,17,17,0,0,0,0,0,27,27,44
8870,Egypt,2020,2020Egypt,0,0,0,0,0,40,40,0,0,0,0,0,58,58,98
8871,Egypt,2020,2020Egypt,0,0,0,5,0,0,5,0,0,0,0,0,0,0,5
8872,Egypt,2020,2020Egypt,0,0,0,5,0,0,5,0,0,0,12,0,0,12,17
8873,Egypt,2020,2020Egypt,0,0,0,9,0,0,9,0,0,0,7,0,0,7,16
8874,Egypt,2020,2020Egypt,0,0,0,9,0,0,9,0,0,0,11,0,0,11,20
8875,Egypt,2020,2020Egypt,0,0,5,0,0,0,5,0,0,0,0,0,0,0,5
8876,Egypt,2020,2020Egypt,0,0,6,8,0,0,14,0,0,7,11,0,0,18,32
8877,Egypt,2020,2020Egypt,0,0,7,0,0,0,7,0,0,0,7,0,0,7,14
8878,Egypt,2020,2020Egypt,0,0,7,0,0,0,7,0,0,0,8,0,0,8,15
8879,Egypt,2020,2020Egypt,0,5,10,26,0,0,41,5,6,12,19,5,0,47,88
8880,Egypt,2020,2020Egypt,0,6,0,10,0,0,16,0,0,5,22,0,0,27,43
8881,Egypt,2020,2020Egypt,0,6,5,0,0,0,11,0,0,0,7,0,0,7,18
8882,Egypt,2020,2020Egypt,0,7,0,0,0,0,7,0,0,6,0,0,0,6,13
8883,Egypt,2020,2020Egypt,0,7,6,18,0,0,31,0,10,5,18,0,0,33,64
8884,Egypt,2020,2020Egypt,0,8,0,0,0,0,8,0,9,0,0,0,0,9,17
8885,Egypt,2020,2020Egypt,5,0,0,0,0,0,5,0,0,0,0,0,0,0,10
8886,Egypt,2020,2020Egypt,5,8,15,21,0,0,49,5,19,13,28,0,0,65,114
8887,Egypt,2020,2020Egypt,20,43,30,90,23,23,229,0,35,41,90,0,53,219,2940
8888,Egypt,2020,2020Egypt,105,186,120,516,23,0,950,96,200,128,881,43,0,1348,2298
8889,Egypt,2021,2021Egypt,0,0,0,0,0,0,0,0,0,0,0,0,0,0,21154
8890,Egypt,2021,2021Egypt,0,0,0,0,0,0,0,0,0,0,0,0,5,5,5
8891,Egypt,2021,2021Egypt,0,0,0,0,0,0,0,0,0,0,0,0,7,7,7
8892,Egypt,2021,2021Egypt,0,0,0,0,0,0,0,0,0,0,5,0,0,5,20
8893,Egypt,2021,2021Egypt,0,0,0,0,0,0,0,0,0,0,7,0,0,7,7
8894,Egypt,2021,2021Egypt,0,0,0,0,0,0,0,0,0,0,8,0,0,8,8
8895,Egypt,2021,2021Egypt,0,0,0,0,0,0,0,0,0,5,0,0,0,5,5
8896,Egypt,2021,2021Egypt,0,0,0,0,5,0,5,0,0,0,5,5,0,10,140
8897,Egypt,2021,2021Egypt,0,0,0,5,0,0,5,0,0,0,0,0,0,0,5
8898,Egypt,2021,2021Egypt,0,0,0,6,0,0,6,0,0,0,10,0,0,10,16
8899,Egypt,2021,2021Egypt,0,0,0,7,0,0,7,0,0,0,10,0,0,10,17
8900,Egypt,2021,2021Egypt,0,0,0,9,0,0,9,0,0,0,7,0,0,7,16
8901,Egypt,2021,2021Egypt,0,0,0,14,0,0,14,0,0,7,11,0,0,18,32
8902,Egypt,2021,2021Egypt,0,0,5,0,0,0,5,0,0,0,0,0,0,0,5
8903,Egypt,2021,2021Egypt,0,0,7,0,0,0,7,0,0,6,0,0,0,6,13
8904,Egypt,2021,2021Egypt,0,0,7,11,0,0,18,0,0,5,28,0,0,33,51
8905,Egypt,2021,2021Egypt,0,0,8,0,0,0,8,0,9,0,0,0,0,9,17
8906,Egypt,2021,2021Egypt,0,5,0,5,0,0,10,0,0,0,8,0,0,8,18
8907,Egypt,2021,2021Egypt,0,6,0,0,0,0,6,0,0,0,7,0,0,7,13
8908,Egypt,2021,2021Egypt,0,6,0,5,0,0,11,0,0,0,7,0,0,7,18
8909,Egypt,2021,2021Egypt,0,6,7,18,0,0,31,0,9,5,20,0,0,34,65
8910,Egypt,2021,2021Egypt,0,8,0,0,0,0,8,0,0,0,0,0,0,0,8
8911,Egypt,2021,2021Egypt,5,0,0,0,0,0,5,0,0,0,0,0,0,0,5
8912,Egypt,2021,2021Egypt,5,7,7,41,0,0,60,5,10,13,33,0,0,61,121
8913,Egypt,2021,2021Egypt,6,0,0,0,0,0,6,0,0,0,0,0,0,0,6
8914,Egypt,2021,2021Egypt,6,6,15,32,0,0,59,0,24,13,32,0,0,69,128
8915,Egypt,2021,2021Egypt,37,74,68,206,42,23,450,10,76,67,263,14,53,483,3339
8916,Egypt,2021,2021Egypt,87,208,125,506,29,0,955,82,197,136,844,45,0,1304,2259
8917,El Salvador,2001,2001El Salvador,0,0,0,0,0,0,0,0,0,0,0,0,0,0,3674
8918,El Salvador,2001,2001El Salvador,0,0,0,0,0,5,5,0,0,0,0,0,16,16,21
8919,El Salvador,2001,2001El Salvador,0,0,0,0,0,359,359,0,0,0,0,0,375,375,734
8920,El Salvador,2001,2001El Salvador,0,0,0,6,0,0,6,0,0,0,0,0,0,0,6
8921,El Salvador,2001,2001El Salvador,0,0,0,150,0,0,150,0,0,0,142,30,0,172,322
8922,El Salvador,2001,2001El Salvador,0,19,18,100,8,0,145,5,12,12,98,5,0,132,277
8923,El Salvador,2001,2001El Salvador,5,124,108,577,87,0,901,5,122,105,743,61,0,1036,1937
8924,El Salvador,2001,2001El Salvador,7,9,7,60,8,0,91,5,6,5,64,5,0,85,176
8925,El Salvador,2002,2002El Salvador,0,0,0,0,0,0,0,0,0,0,0,0,0,0,2430
8926,El Salvador,2002,2002El Salvador,0,0,0,0,0,5,5,0,0,0,0,0,11,11,16
8927,El Salvador,2002,2002El Salvador,0,0,0,6,0,0,6,0,0,0,0,0,0,0,6
8928,El Salvador,2002,2002El Salvador,0,0,0,25,5,0,30,0,0,0,29,0,0,29,790
8929,El Salvador,2002,2002El Salvador,0,0,0,85,10,0,95,0,0,0,71,10,0,81,176
8930,El Salvador,2002,2002El Salvador,0,0,0,148,0,0,148,0,0,0,137,29,0,166,314
8931,El Salvador,2002,2002El Salvador,0,19,18,98,8,0,143,0,15,13,95,5,0,128,271
8932,El Salvador,2002,2002El Salvador,0,91,78,659,98,0,926,5,75,64,775,68,0,987,1913
8933,El Salvador,2002,2002El Salvador,5,11,11,35,5,0,67,6,11,11,35,5,0,68,714
8934,El Salvador,2003,2003El Salvador,0,0,0,0,0,0,0,0,0,0,0,0,0,0,2558
8935,El Salvador,2003,2003El Salvador,0,0,0,0,0,5,5,0,0,0,0,0,10,10,15
8936,El Salvador,2003,2003El Salvador,0,0,0,6,0,0,6,0,0,0,0,0,0,0,6
8937,El Salvador,2003,2003El Salvador,0,0,0,85,10,0,95,0,0,0,71,10,0,81,176
8938,El Salvador,2003,2003El Salvador,0,0,0,143,0,0,143,0,0,0,110,30,0,140,290
8939,El Salvador,2003,2003El Salvador,0,19,18,98,8,0,143,0,15,13,95,5,0,128,271
8940,El Salvador,2003,2003El Salvador,0,74,64,544,83,0,765,0,67,58,735,62,0,922,1687
8941,El Salvador,2003,2003El Salvador,52,91,78,87,17,0,325,46,94,81,89,20,0,330,655
8942,El Salvador,2004,2004El Salvador,0,0,0,0,0,0,0,0,0,0,0,0,0,0,1494
8943,El Salvador,2004,2004El Salvador,0,0,0,0,0,0,0,0,0,0,5,0,0,5,5
8944,El Salvador,2004,2004El Salvador,0,0,0,6,0,0,6,0,0,0,0,0,0,0,6
8945,El Salvador,2004,2004El Salvador,0,0,0,7,0,0,7,0,0,0,0,0,0,0,269
8946,El Salvador,2004,2004El Salvador,0,0,0,74,9,0,83,0,0,0,64,10,0,74,157
8947,El Salvador,2004,2004El Salvador,0,0,0,170,0,0,170,0,0,0,63,32,0,95,265
8948,El Salvador,2004,2004El Salvador,0,46,39,548,84,0,717,0,62,54,762,86,0,964,1681
8949,El Salvador,2004,2004El Salvador,52,87,75,74,17,0,305,46,92,79,83,15,0,315,620
8950,El Salvador,2005,2005El Salvador,0,0,0,0,0,0,0,0,0,0,0,0,0,0,1513
8951,El Salvador,2005,2005El Salvador,0,0,0,0,0,5,5,0,0,0,0,0,10,10,15
8952,El Salvador,2005,2005El Salvador,0,0,0,6,0,0,6,0,0,0,0,0,0,0,6
8953,El Salvador,2005,2005El Salvador,0,0,0,24,7,0,31,0,0,0,14,10,0,24,55
8954,El Salvador,2005,2005El Salvador,0,0,0,69,25,0,94,0,0,0,129,46,0,175,269
8955,El Salvador,2005,2005El Salvador,0,0,0,128,5,0,133,0,0,0,30,29,0,59,192
8956,El Salvador,2005,2005El Salvador,0,46,39,561,82,0,728,0,65,55,812,20,0,952,1680
8957,El Salvador,2005,2005El Salvador,0,79,68,76,23,0,246,0,84,72,125,26,0,307,553
8958,El Salvador,2006,2006El Salvador,0,0,0,0,0,0,0,0,0,0,0,0,0,0,3758
8959,El Salvador,2006,2006El Salvador,0,0,0,0,0,0,0,0,0,0,0,0,5,5,5
8960,El Salvador,2006,2006El Salvador,0,0,0,0,0,5,5,0,0,0,0,0,10,10,15
8961,El Salvador,2006,2006El Salvador,0,0,0,6,0,0,6,0,0,0,0,0,0,0,6
8962,El Salvador,2006,2006El Salvador,0,0,0,23,7,0,30,0,0,0,13,10,0,23,53
8963,El Salvador,2006,2006El Salvador,0,0,0,69,25,0,94,0,0,0,129,46,0,175,269
8964,El Salvador,2006,2006El Salvador,0,0,0,117,5,0,122,0,0,0,14,25,0,39,161
8965,El Salvador,2006,2006El Salvador,0,0,65,86,26,0,177,0,0,72,146,49,0,267,444
8966,El Salvador,2006,2006El Salvador,0,0,80,570,78,0,728,0,0,100,822,29,0,951,1679
8967,El Salvador,2007,2007El Salvador,0,0,0,0,0,0,0,0,0,0,0,0,0,0,4268
8968,El Salvador,2007,2007El Salvador,0,0,0,0,0,0,0,0,0,0,5,0,0,5,5
8969,El Salvador,2007,2007El Salvador,0,0,0,0,0,5,5,0,0,0,0,0,11,11,16
8970,El Salvador,2007,2007El Salvador,0,0,0,6,0,0,6,0,0,0,0,0,0,0,6
8971,El Salvador,2007,2007El Salvador,0,0,0,22,7,0,29,0,0,0,13,10,0,23,52
8972,El Salvador,2007,2007El Salvador,0,0,0,69,25,0,94,0,0,0,129,46,0,175,269
8973,El Salvador,2007,2007El Salvador,0,0,0,115,0,0,115,0,0,0,10,15,0,25,140
8974,El Salvador,2007,2007El Salvador,0,0,7,22,0,0,29,0,5,5,30,0,0,40,69
8975,El Salvador,2007,2007El Salvador,0,0,8,291,54,0,353,0,0,12,457,47,0,516,869
8976,El Salvador,2007,2007El Salvador,0,0,30,64,28,0,122,0,0,33,123,54,0,210,332
8977,El Salvador,2008,2008El Salvador,0,0,0,0,0,0,0,0,0,0,0,0,0,0,4220
8978,El Salvador,2008,2008El Salvador,0,0,0,0,0,0,0,0,0,0,5,0,0,5,5
8979,El Salvador,2008,2008El Salvador,0,0,0,0,0,5,5,0,0,0,0,0,11,11,16
8980,El Salvador,2008,2008El Salvador,0,0,0,13,0,0,13,0,0,0,10,0,0,10,23
8981,El Salvador,2008,2008El Salvador,0,0,0,69,25,0,94,0,0,0,129,46,0,175,269
8982,El Salvador,2008,2008El Salvador,0,0,0,100,0,0,100,0,0,0,0,14,0,14,114
8983,El Salvador,2008,2008El Salvador,0,0,5,60,20,0,85,0,0,5,124,50,0,179,264
8984,El Salvador,2008,2008El Salvador,0,0,7,24,0,0,31,0,5,5,31,0,0,41,72
8985,El Salvador,2008,2008El Salvador,8,12,14,42,5,0,81,0,8,15,54,13,0,90,171
8986,El Salvador,2009,2009El Salvador,0,0,0,0,0,0,0,0,0,0,0,0,0,0,4203
8987,El Salvador,2009,2009El Salvador,0,0,0,5,0,0,5,0,0,0,0,0,0,0,10
8988,El Salvador,2009,2009El Salvador,0,0,0,7,0,0,7,0,0,0,5,0,0,5,12
8989,El Salvador,2009,2009El Salvador,0,0,0,13,0,0,13,0,0,0,10,0,0,10,23
8990,El Salvador,2009,2009El Salvador,0,0,0,34,0,0,34,0,0,0,0,13,0,13,47
8991,El Salvador,2009,2009El Salvador,0,0,0,49,19,0,68,0,0,0,109,48,0,157,225
8992,El Salvador,2009,2009El Salvador,0,0,0,69,25,0,94,0,0,0,129,46,0,175,269
8993,El Salvador,2009,2009El Salvador,0,5,5,25,0,0,35,0,6,6,34,0,0,46,81
8994,El Salvador,2009,2009El Salvador,0,5,5,45,12,0,67,0,0,24,66,26,0,116,183
8995,El Salvador,2010,2010El Salvador,0,0,0,0,0,0,0,0,0,0,0,0,0,0,4295
8996,El Salvador,2010,2010El Salvador,0,0,0,0,0,0,0,0,0,0,5,0,0,5,5
8997,El Salvador,2010,2010El Salvador,0,0,0,5,0,0,5,0,0,0,0,0,0,0,5
8998,El Salvador,2010,2010El Salvador,0,0,0,7,0,0,7,0,0,0,0,0,0,0,7
8999,El Salvador,2010,2010El Salvador,0,0,0,8,0,0,8,0,0,0,6,0,0,6,14
9000,El Salvador,2010,2010El Salvador,0,0,0,9,0,0,9,0,0,0,0,5,0,5,14
9001,El Salvador,2010,2010El Salvador,0,0,0,16,0,0,16,0,0,0,12,0,0,12,28
9002,El Salvador,2010,2010El Salvador,0,0,0,69,25,0,94,0,0,0,129,46,0,175,269
9003,El Salvador,2010,2010El Salvador,0,5,6,33,0,0,44,0,7,7,42,0,0,56,100
9004,El Salvador,2010,2010El Salvador,0,6,13,76,10,0,105,0,0,18,100,18,0,136,241
9005,El Salvador,2011,2011El Salvador,0,0,0,0,0,0,0,0,0,0,0,0,0,0,4812
9006,El Salvador,2011,2011El Salvador,0,0,0,0,0,0,0,0,0,0,5,0,0,5,5
9007,El Salvador,2011,2011El Salvador,0,0,0,0,0,7,7,0,0,0,0,0,13,13,20
9008,El Salvador,2011,2011El Salvador,0,0,0,5,0,0,5,0,0,0,0,0,0,0,5
9009,El Salvador,2011,2011El Salvador,0,0,0,7,0,0,7,0,0,0,0,0,0,0,7
9010,El Salvador,2011,2011El Salvador,0,0,0,9,0,0,9,0,0,0,6,0,0,6,15
9011,El Salvador,2011,2011El Salvador,0,0,0,13,5,0,18,0,0,5,11,0,0,16,34
9012,El Salvador,2011,2011El Salvador,0,0,0,19,0,0,19,0,0,0,11,0,0,11,30
9013,El Salvador,2011,2011El Salvador,0,0,0,27,0,0,27,0,0,0,38,13,0,51,78
9014,El Salvador,2011,2011El Salvador,0,0,0,69,25,0,94,0,0,0,129,46,0,175,269
9015,El Salvador,2011,2011El Salvador,0,5,6,36,0,0,47,0,7,8,46,0,0,61,108
9016,El Salvador,2011,2011El Salvador,0,6,13,76,10,0,105,0,0,18,100,18,0,136,319
9017,El Salvador,2011,2011El Salvador,5,15,15,125,0,0,160,0,19,23,129,5,0,176,1023
9018,El Salvador,2012,2012El Salvador,0,0,0,0,0,0,0,0,0,0,0,0,0,0,6146
9019,El Salvador,2012,2012El Salvador,0,0,0,0,0,0,0,0,0,0,5,0,0,5,5
9020,El Salvador,2012,2012El Salvador,0,0,0,0,0,7,7,0,0,0,0,0,13,13,20
9021,El Salvador,2012,2012El Salvador,0,0,0,5,0,0,5,0,0,0,0,0,0,0,5
9022,El Salvador,2012,2012El Salvador,0,0,0,5,0,0,5,0,5,0,0,0,0,5,10
9023,El Salvador,2012,2012El Salvador,0,0,0,6,5,0,11,0,0,0,8,0,0,8,19
9024,El Salvador,2012,2012El Salvador,0,0,0,7,0,0,7,0,0,0,0,0,0,0,7
9025,El Salvador,2012,2012El Salvador,0,0,0,7,0,0,7,0,0,0,13,7,0,20,27
9026,El Salvador,2012,2012El Salvador,0,0,0,69,25,0,94,0,0,0,129,46,0,175,269
9027,El Salvador,2012,2012El Salvador,0,0,5,15,0,0,20,0,0,5,11,0,0,16,36
9028,El Salvador,2012,2012El Salvador,0,5,0,25,5,0,35,0,0,5,24,5,0,34,69
9029,El Salvador,2012,2012El Salvador,0,7,7,35,0,0,49,0,6,7,47,5,0,65,114
9030,El Salvador,2012,2012El Salvador,5,10,15,58,0,0,88,5,14,10,71,0,0,100,1122
9031,El Salvador,2012,2012El Salvador,5,14,18,80,5,0,122,5,6,13,158,0,0,182,324
9032,El Salvador,2013,2013El Salvador,0,0,0,0,0,0,0,0,0,0,0,0,0,0,7360
9033,El Salvador,2013,2013El Salvador,0,0,0,0,0,0,0,0,0,0,5,0,0,5,5
9034,El Salvador,2013,2013El Salvador,0,0,0,0,0,7,7,0,0,0,0,0,13,13,20
9035,El Salvador,2013,2013El Salvador,0,0,0,5,0,0,5,0,0,0,0,0,0,0,5
9036,El Salvador,2013,2013El Salvador,0,0,0,5,0,0,5,0,0,0,9,7,0,16,21
9037,El Salvador,2013,2013El Salvador,0,0,0,7,0,0,7,0,0,0,0,0,0,0,14
9038,El Salvador,2013,2013El Salvador,0,0,0,7,0,0,7,6,0,0,0,0,0,6,13
9039,El Salvador,2013,2013El Salvador,0,0,0,15,5,0,20,0,0,5,11,0,0,16,36
9040,El Salvador,2013,2013El Salvador,0,0,0,69,25,0,94,0,0,0,129,46,0,175,269
9041,El Salvador,2013,2013El Salvador,0,5,0,38,7,0,50,0,8,5,34,5,0,52,102
9042,El Salvador,2013,2013El Salvador,5,5,11,71,0,0,92,8,11,18,58,0,0,95,1223
9043,El Salvador,2013,2013El Salvador,5,6,6,44,0,0,61,5,6,7,64,5,0,87,148
9044,El Salvador,2013,2013El Salvador,5,16,22,108,5,0,156,8,18,20,216,0,0,262,418
9045,El Salvador,2014,2014El Salvador,0,0,0,0,0,0,0,0,0,0,0,0,0,0,9149
9046,El Salvador,2014,2014El Salvador,0,0,0,0,0,0,0,0,0,0,5,0,0,5,5
9047,El Salvador,2014,2014El Salvador,0,0,0,0,0,0,0,0,0,0,6,0,0,6,6
9048,El Salvador,2014,2014El Salvador,0,0,0,0,0,0,0,5,0,0,0,0,0,5,5
9049,El Salvador,2014,2014El Salvador,0,0,0,0,0,6,6,0,0,0,0,0,12,12,18
9050,El Salvador,2014,2014El Salvador,0,0,0,5,0,0,5,0,0,0,5,0,0,5,10
9051,El Salvador,2014,2014El Salvador,0,0,0,6,0,0,6,0,0,0,0,0,0,0,6
9052,El Salvador,2014,2014El Salvador,0,0,0,7,0,0,7,0,0,0,0,0,0,0,7
9053,El Salvador,2014,2014El Salvador,0,0,0,7,0,0,7,6,0,0,0,0,0,6,13
9054,El Salvador,2014,2014El Salvador,0,0,0,70,25,0,95,0,0,0,130,46,0,176,271
9055,El Salvador,2014,2014El Salvador,5,8,19,52,11,0,95,5,13,9,46,9,0,82,177
9056,El Salvador,2014,2014El Salvador,6,10,6,38,0,0,60,5,8,7,46,0,0,66,1301
9057,El Salvador,2015,2015El Salvador,0,0,0,0,0,0,0,0,0,0,0,0,0,0,14100
9058,El Salvador,2015,2015El Salvador,0,0,0,0,0,0,0,0,0,0,7,0,0,7,7
9059,El Salvador,2015,2015El Salvador,0,0,0,0,0,6,6,0,0,0,0,0,0,0,6
9060,El Salvador,2015,2015El Salvador,0,0,0,0,0,6,6,0,0,0,0,0,12,12,18
9061,El Salvador,2015,2015El Salvador,0,0,0,6,0,0,6,0,0,0,0,0,0,0,6
9062,El Salvador,2015,2015El Salvador,0,0,0,7,0,0,7,0,0,0,0,0,0,0,7
9063,El Salvador,2015,2015El Salvador,0,0,0,7,0,0,7,0,6,0,0,0,0,6,13
9064,El Salvador,2015,2015El Salvador,0,0,0,8,0,0,8,0,0,0,0,0,0,0,8
9065,El Salvador,2015,2015El Salvador,0,0,0,70,25,0,95,0,0,0,130,46,0,176,271
9066,El Salvador,2015,2015El Salvador,0,5,9,28,5,0,47,0,0,9,32,0,0,41,88
9067,El Salvador,2015,2015El Salvador,0,6,0,11,0,0,17,5,0,0,12,0,0,17,34
9068,El Salvador,2015,2015El Salvador,8,14,9,61,15,0,107,9,8,31,54,11,0,113,220
9069,El Salvador,2016,2016El Salvador,0,0,0,0,0,0,0,0,0,0,0,0,0,0,17156
9070,El Salvador,2016,2016El Salvador,0,0,0,0,0,7,7,0,0,0,0,0,0,0,7
9071,El Salvador,2016,2016El Salvador,0,0,0,0,0,12,12,0,0,0,0,0,17,17,29
9072,El Salvador,2016,2016El Salvador,0,0,0,0,0,201,201,0,0,0,0,0,300,300,501
9073,El Salvador,2016,2016El Salvador,0,0,0,5,0,0,5,0,0,0,5,0,0,5,10
9074,El Salvador,2016,2016El Salvador,0,0,0,6,0,0,6,0,0,5,0,0,0,5,11
9075,El Salvador,2016,2016El Salvador,0,0,0,7,0,0,7,0,0,0,0,0,0,0,7
9076,El Salvador,2016,2016El Salvador,0,0,0,10,0,0,10,0,0,0,8,0,0,8,18
9077,El Salvador,2016,2016El Salvador,0,0,0,71,25,0,96,0,0,0,131,46,0,177,273
9078,El Salvador,2016,2016El Salvador,0,5,0,0,0,0,5,0,0,0,0,0,0,0,5
9079,El Salvador,2016,2016El Salvador,0,5,0,41,0,0,46,0,5,8,36,0,0,49,1230
9080,El Salvador,2016,2016El Salvador,0,5,19,46,5,0,75,0,5,19,51,0,0,75,150
9081,El Salvador,2016,2016El Salvador,8,14,9,61,15,0,107,9,8,31,54,11,0,113,220
9082,El Salvador,2017,2017El Salvador,0,0,0,0,0,0,0,0,0,0,0,0,0,0,24368
9083,El Salvador,2017,2017El Salvador,0,0,0,0,0,15,15,0,0,0,0,0,23,23,38
9084,El Salvador,2017,2017El Salvador,0,0,0,0,0,102,102,0,0,0,0,0,104,104,206
9085,El Salvador,2017,2017El Salvador,0,0,0,0,0,267,267,0,0,0,0,0,400,400,667
9086,El Salvador,2017,2017El Salvador,0,0,0,5,0,0,5,0,0,0,0,0,0,0,5
9087,El Salvador,2017,2017El Salvador,0,0,0,6,0,0,6,0,0,5,0,0,0,5,22
9088,El Salvador,2017,2017El Salvador,0,0,0,8,0,0,8,0,0,5,5,0,0,10,18
9089,El Salvador,2017,2017El Salvador,0,0,5,8,0,0,13,0,0,0,9,0,0,9,22
9090,El Salvador,2017,2017El Salvador,0,5,0,6,0,0,11,0,0,0,0,0,0,0,11
9091,El Salvador,2017,2017El Salvador,0,5,0,80,24,0,109,0,6,0,141,46,0,193,302
9092,El Salvador,2017,2017El Salvador,0,5,5,106,9,0,125,0,0,7,79,6,0,92,217
9093,El Salvador,2018,2018El Salvador,0,0,0,0,0,0,0,0,0,0,0,0,0,0,30609
9094,El Salvador,2018,2018El Salvador,0,0,0,0,0,23,23,0,0,0,0,0,32,32,55
9095,El Salvador,2018,2018El Salvador,0,0,0,5,0,0,5,0,0,0,0,0,0,0,5
9096,El Salvador,2018,2018El Salvador,0,0,0,5,0,0,5,0,5,0,5,0,0,10,15
9097,El Salvador,2018,2018El Salvador,0,0,0,6,0,0,6,0,0,0,5,0,0,5,11
9098,El Salvador,2018,2018El Salvador,0,0,0,11,0,0,11,0,0,5,10,0,0,15,26
9099,El Salvador,2018,2018El Salvador,0,0,5,8,0,0,13,0,5,0,5,0,0,10,23
9100,El Salvador,2018,2018El Salvador,0,5,5,106,9,0,125,0,0,7,79,6,0,92,217
9101,El Salvador,2018,2018El Salvador,0,8,0,17,0,0,25,0,0,5,12,0,0,17,42
9102,El Salvador,2018,2018El Salvador,5,5,13,77,8,0,108,6,12,13,95,5,0,131,1559
9103,El Salvador,2019,2019El Salvador,0,0,0,0,0,0,0,0,0,0,0,0,0,0,41354
9104,El Salvador,2019,2019El Salvador,0,0,0,0,0,0,0,0,0,0,5,0,0,5,5
9105,El Salvador,2019,2019El Salvador,0,0,0,0,0,31,31,0,0,0,0,0,35,35,66
9106,El Salvador,2019,2019El Salvador,0,0,0,6,0,0,6,0,0,0,5,0,0,5,11
9107,El Salvador,2019,2019El Salvador,0,0,0,7,0,0,7,0,0,0,0,0,0,0,7
9108,El Salvador,2019,2019El Salvador,0,0,0,15,0,0,15,0,6,0,16,0,0,22,37
9109,El Salvador,2019,2019El Salvador,0,0,6,11,0,0,17,0,5,0,10,0,0,15,32
9110,El Salvador,2019,2019El Salvador,0,5,5,108,9,0,127,0,0,7,79,6,0,92,219
9111,El Salvador,2019,2019El Salvador,0,7,5,31,0,0,43,0,5,5,32,0,0,42,85
9112,El Salvador,2020,2020El Salvador,0,0,0,0,0,0,0,0,0,0,0,0,0,0,43184
9113,El Salvador,2020,2020El Salvador,0,0,0,0,0,234,234,0,0,0,0,0,208,208,442
9114,El Salvador,2020,2020El Salvador,0,0,0,5,0,0,5,0,0,0,8,0,0,8,13
9115,El Salvador,2020,2020El Salvador,0,0,0,6,0,0,6,0,0,0,5,0,0,5,11
9116,El Salvador,2020,2020El Salvador,0,0,0,8,0,0,8,0,0,0,0,0,0,0,8
9117,El Salvador,2020,2020El Salvador,0,0,0,9,0,0,9,0,7,0,7,0,0,14,23
9118,El Salvador,2020,2020El Salvador,0,0,0,15,0,0,15,0,8,0,19,0,0,27,42
9119,El Salvador,2020,2020El Salvador,0,0,0,27,0,22,49,8,0,0,25,0,25,58,1540
9120,El Salvador,2020,2020El Salvador,0,0,7,15,0,0,22,0,5,0,19,0,0,24,46
9121,El Salvador,2020,2020El Salvador,0,5,5,105,9,0,124,0,0,7,73,6,0,86,210
9122,El Salvador,2020,2020El Salvador,5,10,5,42,0,0,62,5,5,5,44,0,0,59,121
9123,El Salvador,2021,2021El Salvador,0,0,0,0,0,0,0,0,0,0,0,0,0,0,37559
9124,El Salvador,2021,2021El Salvador,0,0,0,7,0,0,7,0,0,0,0,0,0,0,7
9125,El Salvador,2021,2021El Salvador,0,0,0,7,0,0,7,0,0,0,5,0,0,5,12
9126,El Salvador,2021,2021El Salvador,0,0,0,8,0,0,8,0,0,0,0,0,0,0,8
9127,El Salvador,2021,2021El Salvador,0,0,0,9,0,0,9,0,0,0,0,0,0,0,9
9128,El Salvador,2021,2021El Salvador,0,0,0,10,0,0,10,0,9,0,8,0,0,17,27
9129,El Salvador,2021,2021El Salvador,0,0,0,11,0,0,11,0,0,5,18,0,0,23,34
9130,El Salvador,2021,2021El Salvador,0,0,6,17,0,0,23,0,0,0,24,0,0,24,47
9131,El Salvador,2021,2021El Salvador,0,5,0,12,0,0,17,0,8,0,23,0,0,31,48
9132,El Salvador,2021,2021El Salvador,0,22,15,87,11,0,135,0,18,17,97,11,0,143,278
9133,El Salvador,2021,2021El Salvador,5,12,5,53,0,0,75,7,5,6,50,0,0,68,143
9134,El Salvador,2021,2021El Salvador,9,18,11,107,5,22,172,15,11,17,113,5,25,186,1604
9135,El Salvador,2021,2021El Salvador,296,756,581,3847,83,0,5563,293,855,601,4843,110,0,6702,12265
9136,Eritrea,2001,2001Eritrea,0,0,0,0,0,0,0,0,0,0,0,0,0,0,3395
9137,Eritrea,2001,2001Eritrea,0,0,0,0,0,0,0,0,0,0,5,0,0,5,20
9138,Eritrea,2001,2001Eritrea,0,0,0,0,0,0,0,0,0,0,6,0,0,6,6
9139,Eritrea,2001,2001Eritrea,0,0,0,0,0,0,0,0,0,0,43,0,0,43,43
9140,Eritrea,2001,2001Eritrea,0,0,0,0,0,11,11,0,0,0,0,0,6,6,17
9141,Eritrea,2001,2001Eritrea,0,0,0,0,0,136,136,0,0,0,0,0,149,149,285
9142,Eritrea,2001,2001Eritrea,0,0,0,5,0,0,5,0,0,0,0,0,0,0,5
9143,Eritrea,2001,2001Eritrea,0,0,0,5,0,0,5,0,0,0,6,0,0,6,11
9144,Eritrea,2001,2001Eritrea,0,9,0,0,0,0,9,0,0,5,6,0,0,11,20
9145,Eritrea,2001,2001Eritrea,5,0,0,12,0,0,17,0,0,0,24,0,0,24,41
9146,Eritrea,2001,2001Eritrea,6,0,5,18,0,0,29,5,5,5,25,6,0,46,75
9147,Eritrea,2001,2001Eritrea,9,16,9,110,111,0,255,10,45,33,198,5,0,291,546
9148,Eritrea,2001,2001Eritrea,346,377,323,740,342,0,2128,363,426,366,596,333,0,2084,4212
9149,Eritrea,2001,2001Eritrea,14469,13140,11258,27654,0,0,66521,13150,14171,12145,23893,0,0,63359,324546
9150,Eritrea,2002,2002Eritrea,0,0,0,0,0,0,0,0,0,0,0,0,0,0,6903
9151,Eritrea,2002,2002Eritrea,0,0,0,0,0,0,0,0,0,0,5,0,0,5,10
9152,Eritrea,2002,2002Eritrea,0,0,0,0,0,0,0,0,0,0,6,0,0,6,6
9153,Eritrea,2002,2002Eritrea,0,0,0,0,0,0,0,0,0,0,9,0,0,9,9
9154,Eritrea,2002,2002Eritrea,0,0,0,0,0,7,7,0,0,0,0,0,7,7,201
9155,Eritrea,2002,2002Eritrea,0,0,0,0,0,12,12,0,0,0,0,0,8,8,20
9156,Eritrea,2002,2002Eritrea,0,0,0,5,0,0,5,0,0,0,6,0,0,6,11
9157,Eritrea,2002,2002Eritrea,0,0,0,8,0,0,8,0,5,0,7,0,0,12,20
9158,Eritrea,2002,2002Eritrea,0,0,5,0,0,0,5,0,5,0,41,0,0,46,51
9159,Eritrea,2002,2002Eritrea,0,5,0,20,0,0,25,0,6,7,28,5,0,46,71
9160,Eritrea,2002,2002Eritrea,0,7,0,0,0,0,7,0,0,7,0,0,0,7,14
9161,Eritrea,2002,2002Eritrea,7,12,6,92,78,0,195,5,36,26,169,0,0,236,431
9162,Eritrea,2002,2002Eritrea,347,353,302,980,79,0,2061,392,412,353,1773,135,0,3065,5126
9163,Eritrea,2002,2002Eritrea,7978,11424,9795,21833,2410,0,53440,7630,12070,10345,24320,2823,0,57188,305294
9164,Eritrea,2003,2003Eritrea,0,0,0,0,0,0,0,0,0,0,0,0,0,0,8286
9165,Eritrea,2003,2003Eritrea,0,0,0,0,0,0,0,0,0,0,5,0,0,5,5
9166,Eritrea,2003,2003Eritrea,0,0,0,0,0,0,0,0,0,0,6,0,0,6,6
9167,Eritrea,2003,2003Eritrea,0,0,0,0,0,0,0,0,0,6,0,0,0,6,6
9168,Eritrea,2003,2003Eritrea,0,0,0,0,0,8,8,0,0,0,0,0,8,8,200
9169,Eritrea,2003,2003Eritrea,0,0,0,0,0,14,14,0,0,0,0,0,8,8,22
9170,Eritrea,2003,2003Eritrea,0,0,0,5,0,0,5,0,0,0,0,0,0,0,5
9171,Eritrea,2003,2003Eritrea,0,0,0,5,0,0,5,0,0,0,7,0,0,7,12
9172,Eritrea,2003,2003Eritrea,0,0,0,8,0,0,8,0,5,0,8,0,0,13,21
9173,Eritrea,2003,2003Eritrea,0,0,5,0,0,0,5,0,5,0,42,0,0,47,52
9174,Eritrea,2003,2003Eritrea,0,5,0,0,0,0,5,5,0,0,0,0,0,5,10
9175,Eritrea,2003,2003Eritrea,0,5,0,25,0,0,30,0,7,7,37,5,0,56,86
9176,Eritrea,2003,2003Eritrea,0,8,0,0,0,0,8,0,0,8,0,0,0,8,16
9177,Eritrea,2003,2003Eritrea,7,6,6,80,77,0,176,5,34,26,138,0,0,203,379
9178,Eritrea,2003,2003Eritrea,433,361,310,906,280,0,2290,479,429,367,2843,346,0,4464,6754
9179,Eritrea,2003,2003Eritrea,7637,10101,8660,19246,2324,0,47968,7449,10710,9180,21120,3613,0,52072,108251
9180,Eritrea,2004,2004Eritrea,0,0,0,0,0,0,0,0,0,0,0,0,0,0,10500
9181,Eritrea,2004,2004Eritrea,0,0,0,0,0,0,0,0,0,0,5,0,0,5,5
9182,Eritrea,2004,2004Eritrea,0,0,0,0,0,0,0,0,0,0,6,0,0,6,12
9183,Eritrea,2004,2004Eritrea,0,0,0,0,0,0,0,0,0,0,10,0,0,10,10
9184,Eritrea,2004,2004Eritrea,0,0,0,0,0,0,0,6,0,0,52,0,0,58,58
9185,Eritrea,2004,2004Eritrea,0,0,0,0,0,16848,16848,0,0,0,0,0,25273,25273,110927
9186,Eritrea,2004,2004Eritrea,0,0,0,8,0,0,8,0,0,0,0,0,0,0,8
9187,Eritrea,2004,2004Eritrea,0,0,0,8,0,0,8,0,5,0,8,0,0,13,21
9188,Eritrea,2004,2004Eritrea,0,0,7,27,0,0,34,0,10,9,48,0,0,67,101
9189,Eritrea,2004,2004Eritrea,0,0,8,5,0,0,13,7,7,0,17,0,0,31,44
9190,Eritrea,2004,2004Eritrea,0,6,0,0,0,0,6,0,6,0,0,0,0,6,12
9191,Eritrea,2004,2004Eritrea,0,7,0,0,0,0,7,0,0,8,0,0,0,8,15
9192,Eritrea,2004,2004Eritrea,0,58,49,47,0,0,154,10,103,93,90,11,0,307,461
9193,Eritrea,2004,2004Eritrea,6,15,12,60,5,8,106,13,17,14,49,5,11,109,215
9194,Eritrea,2004,2004Eritrea,397,404,346,1253,139,591,3130,406,449,384,3125,174,1051,5589,8719
9195,Eritrea,2005,2005Eritrea,0,0,0,0,0,0,0,0,0,0,0,0,0,0,131769
9196,Eritrea,2005,2005Eritrea,0,0,0,0,0,0,0,0,0,0,5,0,0,5,5
9197,Eritrea,2005,2005Eritrea,0,0,0,0,0,0,0,0,0,0,6,0,0,6,6
9198,Eritrea,2005,2005Eritrea,0,0,0,0,0,0,0,0,0,0,7,0,0,7,7
9199,Eritrea,2005,2005Eritrea,0,0,0,0,0,34,34,0,0,0,0,0,29,29,63
9200,Eritrea,2005,2005Eritrea,0,0,0,5,0,0,5,0,0,0,0,0,0,0,10
9201,Eritrea,2005,2005Eritrea,0,0,0,5,0,0,5,0,0,0,5,0,0,5,10
9202,Eritrea,2005,2005Eritrea,0,0,5,0,0,0,5,0,0,0,0,0,0,0,5
9203,Eritrea,2005,2005Eritrea,0,0,7,0,0,0,7,0,0,0,0,0,0,0,7
9204,Eritrea,2005,2005Eritrea,0,0,13,10,0,0,23,0,5,0,225,0,0,230,253
9205,Eritrea,2005,2005Eritrea,0,7,0,0,0,0,7,0,0,5,8,0,0,13,20
9206,Eritrea,2005,2005Eritrea,0,15,18,172,0,0,205,15,15,19,344,14,0,407,612
9207,Eritrea,2005,2005Eritrea,8,0,0,32,0,0,40,5,8,6,58,5,0,82,122
9208,Eritrea,2005,2005Eritrea,8,8,7,98,0,0,121,5,6,5,68,0,0,84,205
9209,Eritrea,2005,2005Eritrea,9,17,15,75,5,13,134,16,20,18,60,5,15,134,268
9210,Eritrea,2005,2005Eritrea,484,447,384,1514,144,0,2973,503,485,415,6129,0,195,7727,10700
9211,Eritrea,2006,2006Eritrea,0,0,0,0,0,0,0,0,0,0,0,0,0,0,21043
9212,Eritrea,2006,2006Eritrea,0,0,0,0,0,0,0,0,0,0,0,0,6,6,6
9213,Eritrea,2006,2006Eritrea,0,0,0,0,0,0,0,0,0,0,5,0,0,5,10
9214,Eritrea,2006,2006Eritrea,0,0,0,0,0,0,0,0,0,0,6,0,0,6,6
9215,Eritrea,2006,2006Eritrea,0,0,0,0,0,0,0,0,0,0,7,0,0,7,7
9216,Eritrea,2006,2006Eritrea,0,0,0,0,0,0,0,5,0,0,0,0,0,5,5
9217,Eritrea,2006,2006Eritrea,0,0,0,0,0,5,5,0,0,0,0,0,0,0,5
9218,Eritrea,2006,2006Eritrea,0,0,0,0,0,52,52,0,0,0,0,0,52,52,104
9219,Eritrea,2006,2006Eritrea,0,0,0,0,0,294,294,0,0,0,0,0,334,334,628
9220,Eritrea,2006,2006Eritrea,0,0,0,5,0,0,5,0,0,0,0,0,0,0,5
9221,Eritrea,2006,2006Eritrea,0,0,0,5,0,0,5,0,0,0,5,0,0,5,10
9222,Eritrea,2006,2006Eritrea,0,0,0,5,0,0,5,0,0,0,14,0,0,14,19
9223,Eritrea,2006,2006Eritrea,0,0,0,7,0,0,7,0,0,5,0,0,0,5,12
9224,Eritrea,2006,2006Eritrea,0,0,5,8,0,0,13,0,0,0,8,0,0,8,21
9225,Eritrea,2006,2006Eritrea,0,19,14,169,0,0,202,15,18,15,399,14,0,461,663
9226,Eritrea,2006,2006Eritrea,6,8,7,119,0,0,140,9,5,5,115,0,0,134,274
9227,Eritrea,2006,2006Eritrea,9,5,5,55,0,0,74,9,9,9,105,0,0,132,206
9228,Eritrea,2006,2006Eritrea,10,30,29,75,5,0,149,5,40,45,163,14,0,267,416
9229,Eritrea,2006,2006Eritrea,494,557,397,1726,171,0,3345,533,569,435,7982,214,0,9733,13078
9230,Eritrea,2006,2006Eritrea,4394,8203,6994,24442,3823,31700,79556,4676,7341,6284,23848,3815,31700,77664,157220
9231,Eritrea,2007,2007Eritrea,0,0,0,0,0,0,0,0,0,0,0,0,0,0,24037
9232,Eritrea,2007,2007Eritrea,0,0,0,0,0,0,0,0,0,0,5,0,0,5,20
9233,Eritrea,2007,2007Eritrea,0,0,0,0,0,0,0,0,0,0,6,0,0,6,12
9234,Eritrea,2007,2007Eritrea,0,0,0,0,0,0,0,0,5,0,0,0,0,5,5
9235,Eritrea,2007,2007Eritrea,0,0,0,0,0,0,0,5,0,0,0,0,0,5,5
9236,Eritrea,2007,2007Eritrea,0,0,0,0,0,11,11,0,0,0,0,0,0,0,11
9237,Eritrea,2007,2007Eritrea,0,0,0,0,0,72,72,0,0,0,0,0,90,90,162
9238,Eritrea,2007,2007Eritrea,0,0,0,5,0,0,5,0,0,0,5,0,0,5,10
9239,Eritrea,2007,2007Eritrea,0,0,0,6,0,0,6,0,0,0,6,0,0,6,12
9240,Eritrea,2007,2007Eritrea,0,0,0,10,0,0,10,0,0,0,5,0,0,5,15
9241,Eritrea,2007,2007Eritrea,0,0,8,0,0,0,8,0,0,0,7,0,0,7,15
9242,Eritrea,2007,2007Eritrea,0,6,0,19,0,0,25,0,7,0,40,0,0,47,72
9243,Eritrea,2007,2007Eritrea,0,25,19,192,0,0,236,23,16,17,369,14,0,439,675
9244,Eritrea,2007,2007Eritrea,6,10,0,21,0,0,37,0,5,0,46,0,0,51,88
9245,Eritrea,2007,2007Eritrea,10,30,29,75,5,0,149,5,40,45,150,14,0,254,403
9246,Eritrea,2007,2007Eritrea,11,16,6,135,0,0,168,10,10,9,176,0,0,205,373
9247,Eritrea,2007,2007Eritrea,12,7,0,45,0,0,64,0,13,6,56,0,0,75,139
9248,Eritrea,2007,2007Eritrea,12,17,9,73,6,324,441,11,25,11,51,0,498,596,1037
9249,Eritrea,2007,2007Eritrea,15,18,11,109,5,0,158,17,16,20,193,11,0,257,415
9250,Eritrea,2007,2007Eritrea,799,1215,1533,1980,168,0,5695,856,606,1404,11850,342,0,15058,20753
9251,Eritrea,2007,2007Eritrea,4907,8526,10392,31927,4207,19700,79659,4833,7469,9494,34852,3910,19700,80258,160488
9252,Eritrea,2008,2008Eritrea,0,0,0,0,0,0,0,0,0,0,0,0,0,0,29508
9253,Eritrea,2008,2008Eritrea,0,0,0,0,0,0,0,0,0,0,5,0,0,5,4442
9254,Eritrea,2008,2008Eritrea,0,0,0,0,0,0,0,0,0,0,6,0,0,6,6
9255,Eritrea,2008,2008Eritrea,0,0,0,0,0,0,0,0,0,0,7,0,0,7,7
9256,Eritrea,2008,2008Eritrea,0,0,0,0,0,0,0,5,0,0,0,0,0,5,5
9257,Eritrea,2008,2008Eritrea,0,0,0,0,0,10,10,0,0,0,0,0,6,6,16
9258,Eritrea,2008,2008Eritrea,0,0,0,0,0,96,96,0,0,0,0,0,126,126,222
9259,Eritrea,2008,2008Eritrea,0,0,0,5,0,0,5,0,0,0,5,0,0,5,10
9260,Eritrea,2008,2008Eritrea,0,0,0,5,0,0,5,0,0,0,9,0,0,9,14
9261,Eritrea,2008,2008Eritrea,0,0,0,7,0,0,7,0,6,0,12,0,0,18,25
9262,Eritrea,2008,2008Eritrea,0,0,0,8,0,0,8,0,0,0,0,0,0,0,8
9263,Eritrea,2008,2008Eritrea,0,0,0,10,0,0,10,0,0,0,15,0,0,15,25
9264,Eritrea,2008,2008Eritrea,0,0,0,21,0,0,21,0,0,0,5,0,0,5,26
9265,Eritrea,2008,2008Eritrea,0,0,8,0,0,0,8,0,0,0,5,0,0,5,13
9266,Eritrea,2008,2008Eritrea,0,0,9,0,0,0,9,0,0,0,0,0,0,0,9
9267,Eritrea,2008,2008Eritrea,5,9,0,22,0,0,36,0,5,0,109,0,0,114,150
9268,Eritrea,2008,2008Eritrea,6,8,8,56,0,0,78,10,7,11,206,0,0,234,312
9269,Eritrea,2008,2008Eritrea,8,0,0,0,0,0,8,0,0,0,0,0,0,0,8
9270,Eritrea,2008,2008Eritrea,10,32,29,77,5,0,153,5,40,46,124,14,0,229,382
9271,Eritrea,2008,2008Eritrea,16,43,31,236,0,0,326,13,15,30,388,7,0,453,779
9272,Eritrea,2008,2008Eritrea,17,26,21,245,5,0,314,17,21,29,371,0,0,438,752
9273,Eritrea,2008,2008Eritrea,22,27,12,173,5,0,239,27,26,26,268,17,0,364,603
9274,Eritrea,2008,2008Eritrea,38,33,26,206,5,632,940,34,34,34,292,5,1132,1531,2471
9275,Eritrea,2008,2008Eritrea,39,45,35,234,0,0,353,34,52,39,313,5,0,443,796
9276,Eritrea,2008,2008Eritrea,1005,1222,777,3572,241,0,6817,1065,1378,1104,10266,388,0,14201,21018
9277,Eritrea,2008,2008Eritrea,4403,7589,4810,27960,1511,15000,61273,4616,7886,5112,28664,2234,15000,63512,124785
9278,Eritrea,2009,2009Eritrea,0,0,0,0,0,0,0,0,0,0,0,0,0,0,43998
9279,Eritrea,2009,2009Eritrea,0,0,0,0,0,0,0,0,0,0,5,0,0,5,35
9280,Eritrea,2009,2009Eritrea,0,0,0,0,0,0,0,0,0,0,6,0,0,6,6
9281,Eritrea,2009,2009Eritrea,0,0,0,0,0,0,0,0,0,0,10,0,0,10,10
9282,Eritrea,2009,2009Eritrea,0,0,0,0,0,12,12,0,0,0,0,0,12,12,24
9283,Eritrea,2009,2009Eritrea,0,0,0,5,0,0,5,0,0,0,0,0,0,0,5
9284,Eritrea,2009,2009Eritrea,0,0,0,5,0,0,5,0,0,0,5,0,0,5,10
9285,Eritrea,2009,2009Eritrea,0,0,0,5,0,0,5,0,0,0,11,0,0,11,16
9286,Eritrea,2009,2009Eritrea,0,0,0,17,0,0,17,0,0,0,18,0,0,18,35
9287,Eritrea,2009,2009Eritrea,0,0,5,0,0,0,5,0,0,0,0,0,0,0,5
9288,Eritrea,2009,2009Eritrea,0,0,9,0,0,0,9,0,0,0,0,0,0,0,9
9289,Eritrea,2009,2009Eritrea,0,9,0,0,0,0,9,0,0,0,0,0,0,0,9
9290,Eritrea,2009,2009Eritrea,5,0,0,0,0,0,5,0,0,0,0,0,0,0,5
9291,Eritrea,2009,2009Eritrea,5,0,0,11,0,0,16,9,0,0,9,0,0,18,34
9292,Eritrea,2009,2009Eritrea,5,0,0,19,0,0,24,0,0,0,17,0,0,17,41
9293,Eritrea,2009,2009Eritrea,9,8,0,18,0,0,35,5,5,0,248,0,0,258,293
9294,Eritrea,2009,2009Eritrea,10,32,29,77,5,0,153,5,40,46,123,12,0,226,379
9295,Eritrea,2009,2009Eritrea,13,12,5,95,0,0,125,11,9,19,453,5,0,497,622
9296,Eritrea,2009,2009Eritrea,19,28,22,350,5,0,424,23,28,34,350,0,0,435,859
9297,Eritrea,2009,2009Eritrea,20,27,21,221,9,0,298,23,33,27,361,25,0,469,767
9298,Eritrea,2009,2009Eritrea,24,58,41,348,0,0,471,31,33,42,445,5,0,556,1027
9299,Eritrea,2009,2009Eritrea,63,38,29,287,6,1032,1455,54,53,32,483,5,1862,2489,3944
9300,Eritrea,2009,2009Eritrea,67,146,173,1740,179,0,2305,82,175,178,1439,114,0,1988,4293
9301,Eritrea,2009,2009Eritrea,100,153,112,942,5,0,1312,116,181,128,1293,16,0,1734,3046
9302,Eritrea,2009,2009Eritrea,1503,1835,1051,5903,310,0,10602,1652,2079,1735,19579,517,0,25562,36164
9303,Eritrea,2009,2009Eritrea,4455,6750,5682,20900,1718,5749,45254,4701,6984,6091,16596,2424,5748,42544,113528
9304,Eritrea,2010,2010Eritrea,0,0,0,0,0,0,0,0,0,0,0,0,0,0,53327
9305,Eritrea,2010,2010Eritrea,0,0,0,0,0,0,0,0,0,0,0,0,6,6,6
9306,Eritrea,2010,2010Eritrea,0,0,0,0,0,0,0,0,0,0,5,0,0,5,25
9307,Eritrea,2010,2010Eritrea,0,0,0,0,0,0,0,0,0,0,6,0,0,6,6
9308,Eritrea,2010,2010Eritrea,0,0,0,0,0,0,0,0,0,0,8,0,0,8,8
9309,Eritrea,2010,2010Eritrea,0,0,0,0,0,0,0,0,0,0,9,0,0,9,9
9310,Eritrea,2010,2010Eritrea,0,0,0,0,0,13,13,0,0,0,0,0,23,23,36
9311,Eritrea,2010,2010Eritrea,0,0,0,0,0,184,184,0,0,0,0,0,479,479,663
9312,Eritrea,2010,2010Eritrea,0,0,0,5,0,0,5,0,0,0,0,0,0,0,10
9313,Eritrea,2010,2010Eritrea,0,0,0,5,0,0,5,0,0,0,7,0,0,7,12
9314,Eritrea,2010,2010Eritrea,0,0,0,6,0,0,6,0,0,0,14,0,0,14,20
9315,Eritrea,2010,2010Eritrea,0,0,0,6,0,0,6,0,0,0,29,0,0,29,35
9316,Eritrea,2010,2010Eritrea,0,0,0,20,0,0,20,0,0,0,30,0,0,30,50
9317,Eritrea,2010,2010Eritrea,0,0,0,30,0,0,30,6,7,0,17,0,0,30,60
9318,Eritrea,2010,2010Eritrea,0,0,6,0,0,0,6,0,0,0,0,0,0,0,6
9319,Eritrea,2010,2010Eritrea,0,5,0,0,0,0,5,0,0,0,0,0,0,0,10
9320,Eritrea,2010,2010Eritrea,0,8,0,0,0,0,8,0,0,0,0,0,0,0,8
9321,Eritrea,2010,2010Eritrea,5,34,32,72,10,0,153,0,42,49,123,12,0,226,379
9322,Eritrea,2010,2010Eritrea,6,0,0,11,0,0,17,5,7,0,8,0,0,20,37
9323,Eritrea,2010,2010Eritrea,14,0,0,27,0,0,41,9,0,5,181,0,0,195,236
9324,Eritrea,2010,2010Eritrea,14,30,18,403,10,0,475,19,32,38,369,5,0,463,938
9325,Eritrea,2010,2010Eritrea,27,41,35,405,18,0,526,20,36,29,295,12,0,392,918
9326,Eritrea,2010,2010Eritrea,28,25,15,170,0,0,238,26,18,22,667,5,0,738,976
9327,Eritrea,2010,2010Eritrea,31,59,41,428,5,0,564,35,38,56,520,12,0,661,1225
9328,Eritrea,2010,2010Eritrea,69,153,197,1783,228,0,2430,73,189,194,1484,149,0,2089,4519
9329,Eritrea,2010,2010Eritrea,104,66,45,466,6,1868,2555,92,79,58,796,10,3269,4304,6859
9330,Eritrea,2010,2010Eritrea,109,165,137,1097,5,0,1513,114,219,143,1477,24,0,1977,3490
9331,Eritrea,2010,2010Eritrea,2226,2878,1629,8148,386,0,15267,2420,3182,2723,20562,637,0,29524,44791
9332,Eritrea,2010,2010Eritrea,4911,7591,6275,22762,1869,9433,52841,5185,7920,6704,19060,2659,9429,50957,103798
9333,Eritrea,2011,2011Eritrea,0,0,0,0,0,0,0,0,0,0,0,0,0,0,70731
9334,Eritrea,2011,2011Eritrea,0,0,0,0,0,0,0,0,0,0,5,0,0,5,20
9335,Eritrea,2011,2011Eritrea,0,0,0,0,0,0,0,0,0,0,6,0,0,6,6
9336,Eritrea,2011,2011Eritrea,0,0,0,0,0,0,0,0,0,0,8,0,0,8,8
9337,Eritrea,2011,2011Eritrea,0,0,0,0,0,0,0,0,0,0,9,0,0,9,18
9338,Eritrea,2011,2011Eritrea,0,0,0,0,0,0,0,0,0,5,0,0,0,5,5
9339,Eritrea,2011,2011Eritrea,0,0,0,0,0,0,0,0,0,7,0,0,0,7,7
9340,Eritrea,2011,2011Eritrea,0,0,0,0,0,19,19,0,0,0,0,0,30,30,81
9341,Eritrea,2011,2011Eritrea,0,0,0,0,0,295,295,0,0,0,0,0,798,798,1093
9342,Eritrea,2011,2011Eritrea,0,0,0,5,0,0,5,0,0,0,0,0,0,0,5
9343,Eritrea,2011,2011Eritrea,0,0,0,5,0,0,5,0,0,0,8,0,0,8,13
9344,Eritrea,2011,2011Eritrea,0,0,0,6,0,0,6,0,0,0,15,0,0,15,21
9345,Eritrea,2011,2011Eritrea,0,0,0,7,0,0,7,0,0,0,5,0,0,5,12
9346,Eritrea,2011,2011Eritrea,0,0,0,8,0,0,8,0,0,0,42,0,0,42,50
9347,Eritrea,2011,2011Eritrea,0,0,0,23,0,0,23,5,0,0,29,0,0,34,57
9348,Eritrea,2011,2011Eritrea,0,0,5,0,0,0,5,0,0,0,0,0,0,0,5
9349,Eritrea,2011,2011Eritrea,0,5,0,0,0,0,5,0,0,0,0,0,0,0,5
9350,Eritrea,2011,2011Eritrea,0,5,5,24,0,0,34,0,7,5,20,0,0,32,66
9351,Eritrea,2011,2011Eritrea,0,8,0,0,0,0,8,0,0,0,0,0,0,0,16
9352,Eritrea,2011,2011Eritrea,5,34,32,72,10,0,153,0,42,49,123,12,0,226,379
9353,Eritrea,2011,2011Eritrea,7,0,0,10,0,0,17,0,8,0,9,0,0,17,34
9354,Eritrea,2011,2011Eritrea,12,5,6,70,0,0,93,24,11,24,408,7,0,474,567
9355,Eritrea,2011,2011Eritrea,13,26,27,457,10,0,533,22,34,39,403,5,0,503,1036
9356,Eritrea,2011,2011Eritrea,16,18,18,110,0,0,162,19,14,69,477,5,0,584,917
9357,Eritrea,2011,2011Eritrea,17,0,0,30,0,0,47,5,5,5,228,0,0,243,290
9358,Eritrea,2011,2011Eritrea,21,37,24,258,15,0,355,31,45,39,355,17,0,487,842
9359,Eritrea,2011,2011Eritrea,34,57,53,427,5,0,576,38,50,53,489,14,0,644,1220
9360,Eritrea,2011,2011Eritrea,36,59,42,397,29,0,563,55,63,47,527,14,0,706,1350
9361,Eritrea,2011,2011Eritrea,72,137,205,1782,239,0,2435,75,202,185,1542,167,0,2171,4606
9362,Eritrea,2011,2011Eritrea,104,198,217,1011,0,0,1530,115,238,278,1343,25,0,1999,3529
9363,Eritrea,2011,2011Eritrea,120,79,59,529,11,3106,3904,109,100,69,844,13,4553,5688,9592
9364,Eritrea,2011,2011Eritrea,2412,3261,1848,10652,431,0,18604,2685,3518,3080,26308,701,0,36292,54896
9365,Eritrea,2011,2011Eritrea,5525,7986,6426,23575,1913,5749,51174,5813,8331,6849,19811,2738,5748,49290,100464
9366,Eritrea,2012,2012Eritrea,0,0,0,0,0,0,0,0,0,0,0,0,0,0,80582
9367,Eritrea,2012,2012Eritrea,0,0,0,0,0,0,0,0,0,0,0,0,7,7,7
9368,Eritrea,2012,2012Eritrea,0,0,0,0,0,0,0,0,0,0,5,0,0,5,30
9369,Eritrea,2012,2012Eritrea,0,0,0,0,0,0,0,0,0,0,7,0,0,7,7
9370,Eritrea,2012,2012Eritrea,0,0,0,0,0,0,0,0,0,0,8,0,0,8,8
9371,Eritrea,2012,2012Eritrea,0,0,0,0,0,0,0,0,0,0,9,0,0,9,26
9372,Eritrea,2012,2012Eritrea,0,0,0,0,0,0,0,0,0,0,11,0,0,11,11
9373,Eritrea,2012,2012Eritrea,0,0,0,0,0,0,0,0,7,0,0,0,0,7,7
9374,Eritrea,2012,2012Eritrea,0,0,0,0,0,0,0,5,0,0,0,0,0,5,5
9375,Eritrea,2012,2012Eritrea,0,0,0,0,0,7,7,0,0,0,0,0,5,5,12
9376,Eritrea,2012,2012Eritrea,0,0,0,0,0,28,28,0,0,0,0,0,34,34,62
9377,Eritrea,2012,2012Eritrea,0,0,0,0,0,382,382,0,0,0,0,0,934,934,1316
9378,Eritrea,2012,2012Eritrea,0,0,0,5,0,0,5,0,0,0,0,0,0,0,5
9379,Eritrea,2012,2012Eritrea,0,0,0,5,0,0,5,0,0,0,10,0,0,10,15
9380,Eritrea,2012,2012Eritrea,0,0,0,6,0,0,6,0,0,0,15,0,0,15,21
9381,Eritrea,2012,2012Eritrea,0,0,0,7,0,0,7,0,0,0,28,0,0,28,35
9382,Eritrea,2012,2012Eritrea,0,0,0,7,0,0,7,0,0,0,45,0,0,45,52
9383,Eritrea,2012,2012Eritrea,0,0,0,18,0,0,18,0,0,0,112,0,0,112,130
9384,Eritrea,2012,2012Eritrea,0,0,0,21,0,0,21,0,0,5,23,0,0,28,49
9385,Eritrea,2012,2012Eritrea,0,0,10,17,0,0,27,0,6,5,16,0,0,27,54
9386,Eritrea,2012,2012Eritrea,0,5,0,0,0,0,5,0,0,0,0,0,0,0,5
9387,Eritrea,2012,2012Eritrea,0,9,0,0,0,0,9,0,0,0,0,0,0,0,9
9388,Eritrea,2012,2012Eritrea,5,6,0,11,0,0,22,0,8,0,9,0,0,17,39
9389,Eritrea,2012,2012Eritrea,5,10,9,82,0,0,106,8,7,11,345,0,0,371,477
9390,Eritrea,2012,2012Eritrea,5,12,0,33,0,0,50,11,6,0,225,0,0,242,292
9391,Eritrea,2012,2012Eritrea,5,34,32,72,10,0,153,0,42,49,123,12,0,226,379
9392,Eritrea,2012,2012Eritrea,9,5,8,50,5,0,77,6,5,6,55,5,0,77,1547
9393,Eritrea,2012,2012Eritrea,18,45,26,262,17,0,368,30,53,45,537,22,0,687,1055
9394,Eritrea,2012,2012Eritrea,19,36,33,501,17,0,606,17,45,74,430,10,0,576,1182
9395,Eritrea,2012,2012Eritrea,29,33,34,221,10,4324,4651,33,33,31,129,10,6094,6330,10981
9396,Eritrea,2012,2012Eritrea,36,68,69,508,6,0,687,55,67,65,545,17,0,749,1436
9397,Eritrea,2012,2012Eritrea,95,138,206,1835,264,0,2538,88,211,191,1614,194,0,2298,4836
9398,Eritrea,2012,2012Eritrea,157,284,666,907,5,0,2019,156,358,895,1178,24,0,2611,4630
9399,Eritrea,2012,2012Eritrea,2620,3602,2315,12426,421,0,21384,2920,3927,4022,29978,712,0,41559,63771
9400,Eritrea,2012,2012Eritrea,3821,8009,6708,25963,2924,9622,57047,3977,8426,7128,22364,3719,9622,55236,112283
9401,Eritrea,2013,2013Eritrea,0,0,0,0,0,0,0,0,0,0,0,0,0,0,86206
9402,Eritrea,2013,2013Eritrea,0,0,0,0,0,0,0,0,0,0,5,0,0,5,25
9403,Eritrea,2013,2013Eritrea,0,0,0,0,0,0,0,0,0,0,7,0,0,7,7
9404,Eritrea,2013,2013Eritrea,0,0,0,0,0,0,0,0,0,0,9,0,0,9,9
9405,Eritrea,2013,2013Eritrea,0,0,0,0,0,0,0,0,0,0,11,0,0,11,11
9406,Eritrea,2013,2013Eritrea,0,0,0,0,0,19,19,0,0,0,0,0,35,35,105
9407,Eritrea,2013,2013Eritrea,0,0,0,0,0,455,455,0,0,0,0,0,1053,1053,1508
9408,Eritrea,2013,2013Eritrea,0,0,0,5,0,0,5,0,0,0,0,0,0,0,5
9409,Eritrea,2013,2013Eritrea,0,0,0,5,0,0,5,0,0,0,5,0,0,5,10
9410,Eritrea,2013,2013Eritrea,0,0,0,5,0,0,5,0,0,0,6,0,0,6,11
9411,Eritrea,2013,2013Eritrea,0,0,0,7,0,0,7,0,0,0,18,0,0,18,25
9412,Eritrea,2013,2013Eritrea,0,0,0,7,0,0,7,0,0,0,31,0,0,31,38
9413,Eritrea,2013,2013Eritrea,0,0,0,8,0,0,8,0,0,5,48,0,0,53,61
9414,Eritrea,2013,2013Eritrea,0,5,0,0,0,0,5,0,0,0,0,0,0,0,5
9415,Eritrea,2013,2013Eritrea,0,5,0,16,0,0,21,0,5,0,13,0,0,18,39
9416,Eritrea,2013,2013Eritrea,0,5,0,16,0,0,21,5,0,5,40,0,0,50,71
9417,Eritrea,2013,2013Eritrea,0,5,0,21,0,0,26,0,6,0,11,0,0,17,43
9418,Eritrea,2013,2013Eritrea,0,11,8,83,0,0,102,0,16,6,356,0,0,378,480
9419,Eritrea,2013,2013Eritrea,0,13,0,27,0,0,40,6,7,0,277,0,0,290,330
9420,Eritrea,2013,2013Eritrea,5,0,0,14,0,0,19,5,0,0,23,0,0,28,47
9421,Eritrea,2013,2013Eritrea,5,5,0,11,0,0,21,0,0,8,9,0,0,17,38
9422,Eritrea,2013,2013Eritrea,8,0,0,5,0,0,13,0,0,5,0,0,0,5,18
9423,Eritrea,2013,2013Eritrea,10,34,28,71,10,0,153,0,42,49,123,12,0,226,379
9424,Eritrea,2013,2013Eritrea,12,11,9,52,5,0,89,5,9,12,62,5,0,93,1676
9425,Eritrea,2013,2013Eritrea,18,53,35,304,18,0,428,34,47,40,435,25,0,581,1009
9426,Eritrea,2013,2013Eritrea,33,53,72,659,16,0,833,27,56,84,517,6,0,690,1523
9427,Eritrea,2013,2013Eritrea,41,79,51,523,7,0,701,59,77,48,531,16,0,731,1432
9428,Eritrea,2013,2013Eritrea,75,131,158,1481,248,0,2093,91,176,152,1308,164,0,1891,3984
9429,Eritrea,2013,2013Eritrea,123,156,221,318,64,0,882,130,211,206,551,12,0,1110,1992
9430,Eritrea,2013,2013Eritrea,136,148,89,735,11,4808,5927,132,148,111,832,16,5940,7179,13106
9431,Eritrea,2013,2013Eritrea,2724,8140,6635,27976,3037,7189,55701,2868,8550,7089,24348,3893,7191,53939,109640
9432,Eritrea,2013,2013Eritrea,3547,5248,3090,16673,589,0,29147,3932,5696,4254,40472,876,0,55230,84377
9433,Eritrea,2014,2014Eritrea,0,0,0,0,0,0,0,0,0,0,0,0,0,0,95245
9434,Eritrea,2014,2014Eritrea,0,0,0,0,0,0,0,0,0,0,5,0,0,5,30
9435,Eritrea,2014,2014Eritrea,0,0,0,0,0,0,0,0,0,0,7,0,0,7,7
9436,Eritrea,2014,2014Eritrea,0,0,0,0,0,0,0,5,0,0,0,0,0,5,5
9437,Eritrea,2014,2014Eritrea,0,0,0,0,0,9,9,0,0,0,0,0,13,13,22
9438,Eritrea,2014,2014Eritrea,0,0,0,0,0,516,516,0,0,0,0,0,1155,1155,1671
9439,Eritrea,2014,2014Eritrea,0,0,0,0,0,778,778,0,0,0,0,0,1441,1441,2219
9440,Eritrea,2014,2014Eritrea,0,0,0,5,0,0,5,0,0,0,7,0,0,7,12
9441,Eritrea,2014,2014Eritrea,0,0,0,5,0,0,5,0,0,0,8,0,0,8,13
9442,Eritrea,2014,2014Eritrea,0,0,0,5,0,0,5,0,0,5,33,0,0,38,43
9443,Eritrea,2014,2014Eritrea,0,0,0,5,0,0,5,0,5,0,0,0,0,5,10
9444,Eritrea,2014,2014Eritrea,0,0,0,5,0,0,5,5,0,0,0,0,0,5,10
9445,Eritrea,2014,2014Eritrea,0,0,0,6,0,0,6,0,0,0,8,0,0,8,14
9446,Eritrea,2014,2014Eritrea,0,0,0,7,0,0,7,0,0,0,31,0,0,31,38
9447,Eritrea,2014,2014Eritrea,0,0,0,8,0,0,8,0,0,5,34,0,0,39,47
9448,Eritrea,2014,2014Eritrea,0,0,0,9,0,0,9,0,0,5,11,0,0,16,25
9449,Eritrea,2014,2014Eritrea,0,0,0,10,0,0,10,0,0,0,0,0,0,0,10
9450,Eritrea,2014,2014Eritrea,0,0,0,23,0,0,23,14,0,0,22,0,0,36,59
9451,Eritrea,2014,2014Eritrea,0,5,0,0,0,0,5,0,0,0,0,0,0,0,5
9452,Eritrea,2014,2014Eritrea,0,5,15,0,0,0,20,0,6,8,0,0,0,14,34
9453,Eritrea,2014,2014Eritrea,0,8,0,8,0,0,16,0,0,0,0,0,0,0,16
9454,Eritrea,2014,2014Eritrea,0,8,6,29,0,0,43,0,7,5,248,0,0,260,303
9455,Eritrea,2014,2014Eritrea,0,9,0,7,0,0,16,0,0,8,9,0,0,17,33
9456,Eritrea,2014,2014Eritrea,0,12,13,82,0,0,107,0,15,11,352,0,0,378,485
9457,Eritrea,2014,2014Eritrea,5,33,28,71,10,0,147,0,42,49,126,12,0,229,376
9458,Eritrea,2014,2014Eritrea,11,6,6,61,5,0,89,7,17,8,77,5,0,114,1750
9459,Eritrea,2014,2014Eritrea,25,54,39,314,18,0,450,33,69,52,623,27,0,804,1254
9460,Eritrea,2014,2014Eritrea,33,77,47,480,6,0,643,42,80,54,500,14,0,690,1333
9461,Eritrea,2014,2014Eritrea,48,70,707,58,17,0,900,39,68,532,78,8,0,725,1625
9462,Eritrea,2014,2014Eritrea,90,140,133,1639,266,0,2268,99,181,229,1770,169,0,2448,4716
9463,Eritrea,2014,2014Eritrea,135,194,121,731,5,0,1186,141,197,127,912,37,0,1414,2600
9464,Eritrea,2014,2014Eritrea,204,213,153,1205,27,5750,7552,192,214,231,1030,26,6846,8539,16091
9465,Eritrea,2014,2014Eritrea,2959,8918,6882,33489,3044,0,55292,3066,9340,7365,30223,3910,0,53904,109196
9466,Eritrea,2014,2014Eritrea,4022,7162,4669,25564,739,0,42156,4327,7774,6295,62163,1069,0,81628,123784
9467,Eritrea,2015,2015Eritrea,0,0,0,0,0,0,0,0,0,0,0,0,0,0,109944
9468,Eritrea,2015,2015Eritrea,0,0,0,0,0,0,0,0,0,0,5,0,0,5,25
9469,Eritrea,2015,2015Eritrea,0,0,0,0,0,0,0,0,0,0,6,0,0,6,11
9470,Eritrea,2015,2015Eritrea,0,0,0,0,0,0,0,0,0,0,9,0,0,9,9
9471,Eritrea,2015,2015Eritrea,0,0,0,0,0,0,0,0,0,0,10,0,0,10,10
9472,Eritrea,2015,2015Eritrea,0,0,0,0,0,0,0,0,0,0,11,0,0,11,11
9473,Eritrea,2015,2015Eritrea,0,0,0,0,0,0,0,0,0,0,12,0,0,12,12
9474,Eritrea,2015,2015Eritrea,0,0,0,0,0,0,0,0,0,0,14,0,0,14,14
9475,Eritrea,2015,2015Eritrea,0,0,0,0,0,0,0,0,0,0,16,0,0,16,16
9476,Eritrea,2015,2015Eritrea,0,0,0,0,0,5,5,0,0,0,0,0,14,14,19
9477,Eritrea,2015,2015Eritrea,0,0,0,0,0,23,23,0,0,0,0,0,28,28,51
9478,Eritrea,2015,2015Eritrea,0,0,0,0,0,174,174,0,0,0,0,0,526,526,700
9479,Eritrea,2015,2015Eritrea,0,0,0,0,0,662,662,0,0,0,0,0,1546,1546,2208
9480,Eritrea,2015,2015Eritrea,0,0,0,5,0,0,5,0,0,0,8,0,0,8,13
9481,Eritrea,2015,2015Eritrea,0,0,0,5,0,0,5,0,0,5,10,0,0,15,20
9482,Eritrea,2015,2015Eritrea,0,0,0,6,0,0,6,0,0,0,13,0,0,13,19
9483,Eritrea,2015,2015Eritrea,0,0,0,7,0,0,7,0,0,0,0,0,0,0,7
9484,Eritrea,2015,2015Eritrea,0,0,0,7,0,0,7,0,0,0,18,0,0,18,25
9485,Eritrea,2015,2015Eritrea,0,0,0,7,0,0,7,0,0,0,32,0,0,32,39
9486,Eritrea,2015,2015Eritrea,0,0,0,15,0,0,15,0,0,0,5,0,0,5,20
9487,Eritrea,2015,2015Eritrea,0,0,5,0,0,0,5,0,0,7,0,0,0,7,12
9488,Eritrea,2015,2015Eritrea,0,0,5,9,0,0,14,0,5,0,9,0,0,14,28
9489,Eritrea,2015,2015Eritrea,0,0,7,5,0,0,12,0,0,6,13,0,0,19,31
9490,Eritrea,2015,2015Eritrea,0,5,0,0,0,0,5,0,0,0,0,0,0,0,5
9491,Eritrea,2015,2015Eritrea,0,5,0,6,0,0,11,0,0,9,22,0,0,31,42
9492,Eritrea,2015,2015Eritrea,0,6,0,20,0,0,26,0,0,5,14,0,0,19,45
9493,Eritrea,2015,2015Eritrea,0,7,9,79,0,0,95,0,12,8,328,0,0,348,443
9494,Eritrea,2015,2015Eritrea,0,8,0,31,0,0,39,5,9,8,21,0,0,43,82
9495,Eritrea,2015,2015Eritrea,0,9,0,6,0,0,15,0,0,0,0,0,0,0,15
9496,Eritrea,2015,2015Eritrea,0,9,0,7,0,0,16,0,0,8,9,0,0,17,33
9497,Eritrea,2015,2015Eritrea,0,12,11,39,0,0,62,14,19,6,218,0,0,257,319
9498,Eritrea,2015,2015Eritrea,26,55,48,316,21,0,466,36,67,58,620,31,0,812,1278
9499,Eritrea,2015,2015Eritrea,33,67,45,438,6,0,589,46,79,47,455,13,0,640,1229
9500,Eritrea,2015,2015Eritrea,36,55,69,620,17,0,797,34,72,59,433,10,0,608,1405
9501,Eritrea,2015,2015Eritrea,167,258,164,964,7,0,1560,174,253,181,1187,46,0,1841,3401
9502,Eritrea,2015,2015Eritrea,194,199,153,2701,291,0,3538,238,207,347,6474,176,0,7442,10980
9503,Eritrea,2015,2015Eritrea,325,205,310,2608,36,0,3484,340,277,995,5680,39,0,7331,21000
9504,Eritrea,2015,2015Eritrea,2772,8357,6712,28584,3152,0,49577,2835,8830,6995,26356,4083,0,49099,98676
9505,Eritrea,2015,2015Eritrea,4637,8345,5654,33635,805,0,53076,5001,8768,9108,78099,1179,0,102155,155231
9506,Eritrea,2016,2016Eritrea,0,0,0,0,0,0,0,0,0,0,0,0,0,0,114423
9507,Eritrea,2016,2016Eritrea,0,0,0,0,0,0,0,0,0,0,5,0,0,5,30
9508,Eritrea,2016,2016Eritrea,0,0,0,0,0,0,0,0,0,0,7,0,0,7,7
9509,Eritrea,2016,2016Eritrea,0,0,0,0,0,0,0,0,0,0,8,0,0,8,8
9510,Eritrea,2016,2016Eritrea,0,0,0,0,0,0,0,0,0,0,10,0,0,10,10
9511,Eritrea,2016,2016Eritrea,0,0,0,0,0,0,0,0,0,0,27,0,0,27,27
9512,Eritrea,2016,2016Eritrea,0,0,0,0,0,0,0,0,0,0,34,0,0,34,34
9513,Eritrea,2016,2016Eritrea,0,0,0,0,0,0,0,0,0,5,0,0,0,5,5
9514,Eritrea,2016,2016Eritrea,0,0,0,0,0,0,0,0,5,0,13,0,0,18,18
9515,Eritrea,2016,2016Eritrea,0,0,0,0,0,5,5,0,0,0,0,0,13,13,18
9516,Eritrea,2016,2016Eritrea,0,0,0,0,0,29,29,0,0,0,0,0,50,50,79
9517,Eritrea,2016,2016Eritrea,0,0,0,0,0,288,288,0,0,0,0,0,712,712,1000
9518,Eritrea,2016,2016Eritrea,0,0,0,0,0,716,716,0,0,0,0,0,1262,1262,1978
9519,Eritrea,2016,2016Eritrea,0,0,0,0,0,895,895,0,0,0,0,0,2168,2168,3063
9520,Eritrea,2016,2016Eritrea,0,0,0,5,0,0,5,0,0,0,12,0,0,12,17
9521,Eritrea,2016,2016Eritrea,0,0,0,5,0,0,5,0,0,0,15,0,0,15,20
9522,Eritrea,2016,2016Eritrea,0,0,0,5,0,0,5,0,0,0,17,0,0,17,22
9523,Eritrea,2016,2016Eritrea,0,0,0,5,0,0,5,0,0,0,18,0,0,18,23
9524,Eritrea,2016,2016Eritrea,0,0,0,5,0,0,5,6,0,0,0,0,0,6,11
9525,Eritrea,2016,2016Eritrea,0,0,0,6,0,0,6,0,0,5,10,0,0,15,21
9526,Eritrea,2016,2016Eritrea,0,0,0,7,0,0,7,0,0,0,18,0,0,18,25
9527,Eritrea,2016,2016Eritrea,0,0,0,8,0,0,8,0,5,0,25,0,0,30,38
9528,Eritrea,2016,2016Eritrea,0,0,0,9,0,0,9,0,0,0,7,0,0,7,16
9529,Eritrea,2016,2016Eritrea,0,0,0,13,0,0,13,0,0,0,6,0,0,6,19
9530,Eritrea,2016,2016Eritrea,0,0,0,21,0,0,21,0,0,0,0,0,0,0,21
9531,Eritrea,2016,2016Eritrea,0,0,6,82,20,0,108,0,7,0,89,7,0,103,1806
9532,Eritrea,2016,2016Eritrea,0,0,7,5,0,0,12,0,0,6,13,0,0,19,31
9533,Eritrea,2016,2016Eritrea,0,6,0,22,0,0,28,0,0,5,14,0,0,19,47
9534,Eritrea,2016,2016Eritrea,0,7,7,96,0,0,110,0,13,10,299,5,0,327,437
9535,Eritrea,2016,2016Eritrea,0,9,0,5,0,0,14,0,0,0,5,0,0,5,19
9536,Eritrea,2016,2016Eritrea,0,9,0,6,0,0,15,0,0,9,12,0,0,21,36
9537,Eritrea,2016,2016Eritrea,5,0,0,0,0,0,5,0,0,0,0,0,0,0,5
9538,Eritrea,2016,2016Eritrea,5,11,0,27,0,0,43,0,7,7,21,0,0,35,78
9539,Eritrea,2016,2016Eritrea,5,14,5,44,0,0,68,13,15,12,214,0,0,254,322
9540,Eritrea,2016,2016Eritrea,22,54,40,387,14,0,517,47,70,38,397,12,0,564,1081
9541,Eritrea,2016,2016Eritrea,27,59,42,336,24,0,488,36,81,58,704,35,0,914,1402
9542,Eritrea,2016,2016Eritrea,53,81,84,632,27,0,877,41,71,119,412,11,0,654,1531
9543,Eritrea,2016,2016Eritrea,232,307,205,1328,14,0,2086,231,329,232,1575,58,0,2425,4511
9544,Eritrea,2016,2016Eritrea,446,312,307,2253,39,7867,11224,425,332,778,2958,35,10512,15040,26264
9545,Eritrea,2016,2016Eritrea,725,428,267,6339,324,0,8083,808,433,683,19814,199,0,21937,30020
9546,Eritrea,2016,2016Eritrea,3004,8970,8057,28659,3161,0,51851,3098,9426,8431,26280,4090,0,51325,103176
9547,Eritrea,2016,2016Eritrea,4070,8337,5716,20904,835,0,39862,4217,8906,7981,22355,1147,0,44606,165548
9548,Eritrea,2017,2017Eritrea,0,0,0,0,0,0,0,0,0,0,0,0,0,0,116514
9549,Eritrea,2017,2017Eritrea,0,0,0,0,0,0,0,0,0,0,0,0,34,34,34
9550,Eritrea,2017,2017Eritrea,0,0,0,0,0,0,0,0,0,0,5,0,0,5,30
9551,Eritrea,2017,2017Eritrea,0,0,0,0,0,0,0,0,0,0,6,0,0,6,6
9552,Eritrea,2017,2017Eritrea,0,0,0,0,0,0,0,0,0,0,8,0,0,8,16
9553,Eritrea,2017,2017Eritrea,0,0,0,0,0,0,0,0,0,0,10,0,0,10,10
9554,Eritrea,2017,2017Eritrea,0,0,0,0,0,0,0,0,0,0,11,0,0,11,11
9555,Eritrea,2017,2017Eritrea,0,0,0,0,0,0,0,0,0,0,19,0,0,19,19
9556,Eritrea,2017,2017Eritrea,0,0,0,0,0,5,5,0,0,0,0,0,11,11,16
9557,Eritrea,2017,2017Eritrea,0,0,0,0,0,713,713,0,0,0,0,0,1211,1211,1924
9558,Eritrea,2017,2017Eritrea,0,0,0,0,0,1102,1102,0,0,0,0,0,2666,2666,3768
9559,Eritrea,2017,2017Eritrea,0,0,0,5,0,0,5,0,0,0,15,0,0,15,20
9560,Eritrea,2017,2017Eritrea,0,0,0,5,0,0,5,0,0,0,48,0,0,48,53
9561,Eritrea,2017,2017Eritrea,0,0,0,5,0,0,5,8,0,0,0,0,0,8,13
9562,Eritrea,2017,2017Eritrea,0,0,0,5,7,0,12,0,0,5,0,15,0,20,32
9563,Eritrea,2017,2017Eritrea,0,0,0,6,0,0,6,0,0,0,26,0,0,26,32
9564,Eritrea,2017,2017Eritrea,0,0,0,6,0,0,6,0,0,0,50,0,0,50,56
9565,Eritrea,2017,2017Eritrea,0,0,0,7,0,0,7,0,5,0,17,0,0,22,29
9566,Eritrea,2017,2017Eritrea,0,0,0,8,0,0,8,0,0,10,7,0,0,17,25
9567,Eritrea,2017,2017Eritrea,0,0,0,8,0,0,8,5,0,0,12,0,0,17,25
9568,Eritrea,2017,2017Eritrea,0,0,0,9,0,0,9,0,0,0,7,0,0,7,16
9569,Eritrea,2017,2017Eritrea,0,0,0,12,0,0,12,0,0,20,0,0,0,20,32
9570,Eritrea,2017,2017Eritrea,0,0,0,15,0,0,15,0,0,0,5,0,0,5,20
9571,Eritrea,2017,2017Eritrea,0,0,5,0,0,0,5,0,0,0,0,0,0,0,5
9572,Eritrea,2017,2017Eritrea,0,0,5,6,0,0,11,0,0,0,12,0,0,12,23
9573,Eritrea,2017,2017Eritrea,0,0,9,6,0,0,15,0,0,0,5,0,0,5,20
9574,Eritrea,2017,2017Eritrea,0,5,0,0,0,0,5,0,0,0,0,0,0,0,5
9575,Eritrea,2017,2017Eritrea,0,6,0,23,0,0,29,0,0,5,14,0,0,19,48
9576,Eritrea,2017,2017Eritrea,0,9,5,9,0,0,23,0,8,5,13,0,0,26,49
9577,Eritrea,2017,2017Eritrea,0,11,0,21,0,0,32,0,17,0,26,0,0,43,75
9578,Eritrea,2017,2017Eritrea,5,0,0,0,0,0,5,0,0,0,0,0,0,0,5
9579,Eritrea,2017,2017Eritrea,5,5,5,123,5,0,143,5,5,6,312,0,0,328,471
9580,Eritrea,2017,2017Eritrea,7,16,12,50,0,0,85,21,18,13,269,0,0,321,406
9581,Eritrea,2017,2017Eritrea,13,52,45,332,33,0,475,15,73,53,712,42,0,895,1370
9582,Eritrea,2017,2017Eritrea,15,43,30,247,8,0,343,31,51,31,240,6,0,359,702
9583,Eritrea,2017,2017Eritrea,92,162,199,996,37,0,1486,110,150,307,659,15,0,1241,2727
9584,Eritrea,2017,2017Eritrea,226,315,217,1346,16,0,2120,223,341,219,1608,55,0,2446,4566
9585,Eritrea,2017,2017Eritrea,550,380,308,2664,46,12434,16382,553,400,728,3674,34,9164,14553,30935
9586,Eritrea,2017,2017Eritrea,1815,704,592,10526,355,0,13992,1917,778,1304,31048,214,0,35261,49253
9587,Eritrea,2017,2017Eritrea,3945,8777,17361,21267,3382,0,54732,3780,8813,14692,21942,4284,0,53511,108243
9588,Eritrea,2017,2017Eritrea,5564,10083,6947,37619,945,0,61158,5847,10680,10596,74978,1346,0,103447,164605
9589,Eritrea,2018,2018Eritrea,0,0,0,0,0,0,0,0,0,0,0,0,0,0,109565
9590,Eritrea,2018,2018Eritrea,0,0,0,0,0,0,0,0,0,0,5,0,0,5,30
9591,Eritrea,2018,2018Eritrea,0,0,0,0,0,0,0,0,0,0,7,0,0,7,7
9592,Eritrea,2018,2018Eritrea,0,0,0,0,0,0,0,0,0,0,10,0,0,10,10
9593,Eritrea,2018,2018Eritrea,0,0,0,0,0,0,0,0,0,0,11,0,0,11,11
9594,Eritrea,2018,2018Eritrea,0,0,0,0,0,0,0,0,0,0,17,0,0,17,17
9595,Eritrea,2018,2018Eritrea,0,0,0,0,0,0,0,0,0,0,21,0,0,21,21
9596,Eritrea,2018,2018Eritrea,0,0,0,0,0,1404,1404,0,0,0,0,0,3636,3636,5040
9597,Eritrea,2018,2018Eritrea,0,0,0,5,0,0,5,0,0,0,0,0,0,0,15
9598,Eritrea,2018,2018Eritrea,0,0,0,6,0,0,6,0,0,0,50,0,0,50,82
9599,Eritrea,2018,2018Eritrea,0,0,0,7,0,0,7,0,0,0,52,0,0,52,59
9600,Eritrea,2018,2018Eritrea,0,0,0,7,5,0,12,0,0,0,14,5,0,19,31
9601,Eritrea,2018,2018Eritrea,0,0,0,9,0,0,9,0,0,0,0,0,0,0,18
9602,Eritrea,2018,2018Eritrea,0,0,0,9,0,0,9,5,0,5,10,0,0,20,29
9603,Eritrea,2018,2018Eritrea,0,0,0,17,0,0,17,0,0,0,0,0,0,0,17
9604,Eritrea,2018,2018Eritrea,0,0,5,0,0,0,5,0,0,0,0,0,0,0,5
9605,Eritrea,2018,2018Eritrea,0,0,5,6,0,0,11,0,0,0,12,0,0,12,23
9606,Eritrea,2018,2018Eritrea,0,0,6,22,0,0,28,0,0,5,14,0,0,19,47
9607,Eritrea,2018,2018Eritrea,0,5,0,0,0,0,5,0,0,0,0,0,0,0,5
9608,Eritrea,2018,2018Eritrea,0,5,0,0,0,0,5,0,0,0,10,0,0,10,15
9609,Eritrea,2018,2018Eritrea,0,5,0,5,0,0,10,0,0,0,7,0,0,7,17
9610,Eritrea,2018,2018Eritrea,0,5,0,5,0,0,10,0,0,0,12,0,0,12,22
9611,Eritrea,2018,2018Eritrea,0,5,6,11,0,0,22,0,7,5,16,0,0,28,50
9612,Eritrea,2018,2018Eritrea,0,6,0,0,0,0,6,0,0,0,10,0,0,10,16
9613,Eritrea,2018,2018Eritrea,0,11,0,18,0,0,29,0,15,0,20,0,0,35,64
9614,Eritrea,2018,2018Eritrea,5,0,0,5,0,0,10,5,0,0,14,0,0,19,29
9615,Eritrea,2018,2018Eritrea,5,0,0,10,0,0,15,0,0,0,24,0,0,24,39
9616,Eritrea,2018,2018Eritrea,5,5,0,16,0,0,26,8,0,0,35,0,0,43,69
9617,Eritrea,2018,2018Eritrea,5,6,0,19,0,0,30,12,0,0,41,0,0,53,83
9618,Eritrea,2018,2018Eritrea,7,5,21,77,0,0,110,7,0,73,303,0,0,383,493
9619,Eritrea,2018,2018Eritrea,8,11,13,143,5,0,180,9,12,12,291,5,0,329,509
9620,Eritrea,2018,2018Eritrea,9,11,10,57,0,0,87,15,15,15,250,0,0,295,382
9621,Eritrea,2018,2018Eritrea,10,45,53,330,37,0,475,12,53,63,737,49,0,914,1389
9622,Eritrea,2018,2018Eritrea,13,41,28,256,8,0,346,30,46,27,245,8,0,356,707
9623,Eritrea,2018,2018Eritrea,148,159,87,697,20,0,1111,143,173,98,1158,27,0,1599,2715
9624,Eritrea,2018,2018Eritrea,174,255,291,1511,49,0,2280,200,229,526,1081,24,0,2060,4340
9625,Eritrea,2018,2018Eritrea,223,250,155,936,18,0,1582,239,247,160,1111,34,0,1791,3373
9626,Eritrea,2018,2018Eritrea,604,437,243,2815,56,10536,14691,624,441,418,3967,36,13895,19381,34072
9627,Eritrea,2018,2018Eritrea,2390,932,499,11970,387,0,16178,2587,994,911,34430,234,0,39156,55334
9628,Eritrea,2018,2018Eritrea,2776,8986,7606,34133,4169,0,57670,2914,9202,7942,31808,5009,0,56875,114545
9629,Eritrea,2018,2018Eritrea,5204,10450,8052,40182,1056,0,64944,5506,11318,12527,78193,1477,0,109021,173965
9630,Eritrea,2019,2019Eritrea,0,0,0,0,0,0,0,0,0,0,0,0,0,0,111443
9631,Eritrea,2019,2019Eritrea,0,0,0,0,0,0,0,0,0,0,5,0,0,5,20
9632,Eritrea,2019,2019Eritrea,0,0,0,0,0,0,0,0,0,0,6,0,0,6,6
9633,Eritrea,2019,2019Eritrea,0,0,0,0,0,0,0,0,0,0,7,0,0,7,7
9634,Eritrea,2019,2019Eritrea,0,0,0,0,0,0,0,0,0,0,14,0,0,14,14
9635,Eritrea,2019,2019Eritrea,0,0,0,0,0,0,0,0,0,0,23,0,0,23,23
9636,Eritrea,2019,2019Eritrea,0,0,0,0,0,0,0,0,9,0,0,0,0,9,9
9637,Eritrea,2019,2019Eritrea,0,0,0,0,0,5,5,0,0,0,0,0,6,6,11
9638,Eritrea,2019,2019Eritrea,0,0,0,0,0,1761,1761,0,0,0,0,0,4611,4611,6372
9639,Eritrea,2019,2019Eritrea,0,0,0,5,0,0,5,0,0,0,0,0,0,0,10
9640,Eritrea,2019,2019Eritrea,0,0,0,5,0,0,5,0,0,0,10,0,0,10,15
9641,Eritrea,2019,2019Eritrea,0,0,0,6,0,0,6,0,0,0,0,0,0,0,6
9642,Eritrea,2019,2019Eritrea,0,0,0,8,0,0,8,5,0,0,9,0,0,14,22
9643,Eritrea,2019,2019Eritrea,0,0,0,9,0,0,9,6,0,0,9,0,0,15,24
9644,Eritrea,2019,2019Eritrea,0,0,0,10,0,0,10,5,0,5,10,0,0,20,30
9645,Eritrea,2019,2019Eritrea,0,0,0,16,0,0,16,0,0,0,0,0,0,0,16
9646,Eritrea,2019,2019Eritrea,0,0,5,0,0,0,5,0,0,0,0,0,0,0,5
9647,Eritrea,2019,2019Eritrea,0,0,5,7,5,0,17,0,0,0,19,6,0,25,42
9648,Eritrea,2019,2019Eritrea,0,0,5,11,0,0,16,0,0,21,121,0,0,142,158
9649,Eritrea,2019,2019Eritrea,0,0,5,13,0,0,18,0,0,0,0,0,0,0,18
9650,Eritrea,2019,2019Eritrea,0,0,5,17,0,0,22,0,0,5,25,0,0,30,52
9651,Eritrea,2019,2019Eritrea,0,0,6,25,0,0,31,0,0,0,38,0,0,38,69
9652,Eritrea,2019,2019Eritrea,0,5,0,6,0,0,11,0,0,0,8,0,0,8,19
9653,Eritrea,2019,2019Eritrea,0,5,0,7,0,0,12,0,5,0,28,0,0,33,45
9654,Eritrea,2019,2019Eritrea,0,5,0,15,0,0,20,8,5,0,31,0,0,44,64
9655,Eritrea,2019,2019Eritrea,0,6,8,10,0,0,24,7,0,7,19,0,0,33,57
9656,Eritrea,2019,2019Eritrea,0,7,0,0,0,0,7,0,0,0,0,0,0,0,7
9657,Eritrea,2019,2019Eritrea,0,14,0,0,0,0,14,0,0,0,6,0,0,6,20
9658,Eritrea,2019,2019Eritrea,5,0,0,0,0,0,5,0,0,0,0,0,0,0,5
9659,Eritrea,2019,2019Eritrea,5,0,0,6,0,0,11,5,0,0,14,0,0,19,30
9660,Eritrea,2019,2019Eritrea,5,0,0,14,0,0,19,0,0,22,63,0,0,85,104
9661,Eritrea,2019,2019Eritrea,5,45,47,330,40,0,467,9,57,51,730,51,0,898,1365
9662,Eritrea,2019,2019Eritrea,6,0,12,40,0,0,58,5,0,72,149,0,0,226,284
9663,Eritrea,2019,2019Eritrea,11,12,0,37,0,0,60,7,0,12,113,10,0,142,202
9664,Eritrea,2019,2019Eritrea,12,11,20,74,0,0,117,21,21,20,243,0,0,305,422
9665,Eritrea,2019,2019Eritrea,13,10,7,123,0,0,153,19,14,25,164,0,0,222,375
9666,Eritrea,2019,2019Eritrea,13,45,41,324,10,0,433,27,54,36,293,26,0,436,869
9667,Eritrea,2019,2019Eritrea,339,601,570,2977,120,0,4607,440,629,916,2197,69,0,4251,8858
9668,Eritrea,2019,2019Eritrea,404,479,271,1928,30,0,3112,383,513,302,2074,51,0,3323,6435
9669,Eritrea,2019,2019Eritrea,632,480,236,2870,62,0,4280,652,489,339,3971,37,0,5488,36698
9670,Eritrea,2019,2019Eritrea,1971,8416,7830,34342,4391,0,56950,2045,8656,8103,31919,5231,0,55954,112904
9671,Eritrea,2019,2019Eritrea,3065,1233,519,12488,403,0,17708,3325,1336,705,35256,239,0,40861,58569
9672,Eritrea,2019,2019Eritrea,9492,11853,11670,44697,1163,0,78875,9581,14320,14725,39625,1470,0,79721,158596
9673,Eritrea,2020,2020Eritrea,0,0,0,0,0,0,0,0,0,0,0,0,0,0,95271
9674,Eritrea,2020,2020Eritrea,0,0,0,0,0,0,0,0,0,0,5,0,0,5,20
9675,Eritrea,2020,2020Eritrea,0,0,0,0,0,0,0,0,0,0,6,0,0,6,6
9676,Eritrea,2020,2020Eritrea,0,0,0,0,0,0,0,0,0,0,9,0,0,9,27
9677,Eritrea,2020,2020Eritrea,0,0,0,0,0,0,0,0,0,0,11,0,0,11,11
9678,Eritrea,2020,2020Eritrea,0,0,0,0,0,0,0,0,0,0,12,0,0,12,12
9679,Eritrea,2020,2020Eritrea,0,0,0,0,0,0,0,0,0,0,23,0,0,23,23
9680,Eritrea,2020,2020Eritrea,0,0,0,0,0,5,5,0,0,0,0,0,5,5,10
9681,Eritrea,2020,2020Eritrea,0,0,0,0,0,5,5,0,0,0,0,0,6,6,11
9682,Eritrea,2020,2020Eritrea,0,0,0,0,0,22,22,0,0,0,0,0,25,25,47
9683,Eritrea,2020,2020Eritrea,0,0,0,0,0,444,444,0,0,0,0,0,600,600,1044
9684,Eritrea,2020,2020Eritrea,0,0,0,0,0,1014,1014,0,0,0,0,0,1750,1750,2764
9685,Eritrea,2020,2020Eritrea,0,0,0,5,0,0,5,0,0,0,0,0,0,0,5
9686,Eritrea,2020,2020Eritrea,0,0,0,5,0,0,5,0,0,0,7,0,0,7,12
9687,Eritrea,2020,2020Eritrea,0,0,0,6,0,0,6,0,0,0,0,0,0,0,6
9688,Eritrea,2020,2020Eritrea,0,0,0,8,0,0,8,0,0,0,0,0,0,0,8
9689,Eritrea,2020,2020Eritrea,0,0,0,8,0,0,8,0,0,0,11,0,0,11,19
9690,Eritrea,2020,2020Eritrea,0,0,0,9,0,0,9,0,0,0,11,0,0,11,20
9691,Eritrea,2020,2020Eritrea,0,0,0,10,0,0,10,0,0,0,32,0,0,32,42
9692,Eritrea,2020,2020Eritrea,0,0,0,12,0,0,12,5,0,0,14,0,0,19,31
9693,Eritrea,2020,2020Eritrea,0,0,0,15,0,0,15,0,0,0,0,0,0,0,15
9694,Eritrea,2020,2020Eritrea,0,0,0,16,0,0,16,0,0,12,52,0,0,64,80
9695,Eritrea,2020,2020Eritrea,0,0,5,0,0,0,5,0,0,0,0,0,0,0,5
9696,Eritrea,2020,2020Eritrea,0,0,5,7,5,0,17,0,0,0,13,6,0,19,36
9697,Eritrea,2020,2020Eritrea,0,0,5,14,0,0,19,0,0,0,0,0,0,0,19
9698,Eritrea,2020,2020Eritrea,0,0,6,27,0,0,33,0,0,5,46,0,0,51,84
9699,Eritrea,2020,2020Eritrea,0,5,0,5,0,0,10,0,5,0,17,0,0,22,32
9700,Eritrea,2020,2020Eritrea,0,5,0,5,0,0,10,0,5,5,10,0,0,20,30
9701,Eritrea,2020,2020Eritrea,0,5,0,6,0,0,11,6,0,0,20,0,0,26,37
9702,Eritrea,2020,2020Eritrea,0,5,0,7,0,0,12,0,0,18,167,0,0,185,197
9703,Eritrea,2020,2020Eritrea,0,6,0,39,8,55,108,0,7,0,87,0,41,135,2151
9704,Eritrea,2020,2020Eritrea,0,6,5,11,0,0,22,6,0,5,18,0,0,29,51
9705,Eritrea,2020,2020Eritrea,0,14,0,0,0,0,14,0,0,0,6,0,0,6,20
9706,Eritrea,2020,2020Eritrea,5,6,8,28,0,0,47,5,6,5,32,5,0,53,100
9707,Eritrea,2020,2020Eritrea,6,5,0,23,0,0,34,9,5,0,55,0,0,69,103
9708,Eritrea,2020,2020Eritrea,8,87,40,412,5,0,552,7,80,38,782,10,0,917,1469
9709,Eritrea,2020,2020Eritrea,10,40,45,332,46,0,473,5,48,54,729,61,0,897,1370
9710,Eritrea,2020,2020Eritrea,11,16,0,48,0,0,75,13,6,0,158,7,0,184,259
9711,Eritrea,2020,2020Eritrea,12,0,7,46,0,0,65,11,5,28,163,0,0,207,272
9712,Eritrea,2020,2020Eritrea,13,38,45,329,15,0,440,15,62,29,314,28,0,448,888
9713,Eritrea,2020,2020Eritrea,20,12,18,95,0,0,145,19,30,26,290,5,0,370,515
9714,Eritrea,2020,2020Eritrea,23,10,5,160,0,0,198,32,8,37,163,0,0,240,438
9715,Eritrea,2020,2020Eritrea,471,943,818,4703,189,0,7124,569,1045,1019,3643,128,0,6404,13528
9716,Eritrea,2020,2020Eritrea,479,706,344,2625,39,0,4193,518,719,355,2792,73,0,4457,8650
9717,Eritrea,2020,2020Eritrea,623,515,237,2843,68,0,4286,631,519,311,3825,39,0,5325,37816
9718,Eritrea,2020,2020Eritrea,1479,8176,8504,35394,4491,0,58044,1549,8316,8741,32894,5323,0,56823,114867
9719,Eritrea,2020,2020Eritrea,3419,1742,596,12865,420,0,19042,3924,1878,649,35436,261,0,42148,61226
9720,Eritrea,2020,2020Eritrea,8078,15139,13600,52722,1305,0,90844,8322,15810,18510,46090,1515,0,90247,181091
9721,Eritrea,2021,2021Eritrea,0,0,0,0,0,0,0,0,0,0,0,0,0,0,102507
9722,Eritrea,2021,2021Eritrea,0,0,0,0,0,0,0,0,0,0,5,0,0,5,25
9723,Eritrea,2021,2021Eritrea,0,0,0,0,0,0,0,0,0,0,7,0,0,7,14
9724,Eritrea,2021,2021Eritrea,0,0,0,0,0,0,0,0,0,0,11,0,0,11,11
9725,Eritrea,2021,2021Eritrea,0,0,0,0,0,0,0,0,0,0,13,0,0,13,13
9726,Eritrea,2021,2021Eritrea,0,0,0,0,0,0,0,6,0,0,0,0,0,6,6
9727,Eritrea,2021,2021Eritrea,0,0,0,0,0,5,5,0,0,0,0,0,6,6,11
9728,Eritrea,2021,2021Eritrea,0,0,0,0,0,6,6,0,0,0,0,0,5,5,11
9729,Eritrea,2021,2021Eritrea,0,0,0,5,0,0,5,0,0,0,0,0,0,0,5
9730,Eritrea,2021,2021Eritrea,0,0,0,5,0,0,5,0,0,0,5,0,0,5,10
9731,Eritrea,2021,2021Eritrea,0,0,0,6,0,0,6,0,0,0,8,0,0,8,14
9732,Eritrea,2021,2021Eritrea,0,0,0,7,0,0,7,0,0,0,0,0,0,0,7
9733,Eritrea,2021,2021Eritrea,0,0,0,8,0,0,8,0,0,0,0,0,0,0,8
9734,Eritrea,2021,2021Eritrea,0,0,0,8,0,0,8,0,0,0,11,0,0,11,19
9735,Eritrea,2021,2021Eritrea,0,0,0,13,0,0,13,0,0,0,16,7,0,23,36
9736,Eritrea,2021,2021Eritrea,0,0,0,17,0,0,17,0,0,0,60,0,0,60,77
9737,Eritrea,2021,2021Eritrea,0,0,5,0,0,0,5,0,0,0,0,0,0,0,5
9738,Eritrea,2021,2021Eritrea,0,0,5,5,0,0,10,0,5,0,28,0,0,33,43
9739,Eritrea,2021,2021Eritrea,0,0,5,7,0,0,12,0,0,0,7,0,0,7,19
9740,Eritrea,2021,2021Eritrea,0,0,5,8,0,0,13,0,8,0,17,0,0,25,38
9741,Eritrea,2021,2021Eritrea,0,0,6,7,0,0,13,0,6,0,6,0,0,12,25
9742,Eritrea,2021,2021Eritrea,0,0,8,28,0,0,36,0,0,0,60,0,0,60,96
9743,Eritrea,2021,2021Eritrea,0,5,0,6,0,0,11,0,0,25,106,0,0,131,142
9744,Eritrea,2021,2021Eritrea,0,5,0,6,0,0,11,0,5,0,5,0,0,10,21
9745,Eritrea,2021,2021Eritrea,0,5,6,11,0,0,22,0,6,5,14,5,0,30,52
9746,Eritrea,2021,2021Eritrea,0,5,6,22,0,0,33,0,14,0,55,0,0,69,102
9747,Eritrea,2021,2021Eritrea,0,6,0,6,0,0,12,5,5,0,18,0,0,28,40
9748,Eritrea,2021,2021Eritrea,0,6,0,17,0,0,23,0,7,0,56,0,0,63,86
9749,Eritrea,2021,2021Eritrea,0,6,8,0,0,0,14,0,0,0,6,0,0,6,20
9750,Eritrea,2021,2021Eritrea,0,12,13,38,5,0,68,5,12,8,35,5,0,65,133
9751,Eritrea,2021,2021Eritrea,0,17,10,89,17,55,188,9,8,5,150,11,41,224,2086
9752,Eritrea,2021,2021Eritrea,0,65,58,398,6,0,527,5,60,43,748,12,0,868,1395
9753,Eritrea,2021,2021Eritrea,5,0,0,0,0,0,5,0,0,0,19,0,0,19,24
9754,Eritrea,2021,2021Eritrea,5,0,0,6,0,0,11,5,0,7,49,0,0,61,72
9755,Eritrea,2021,2021Eritrea,5,0,0,14,0,0,19,0,0,0,0,0,0,0,19
9756,Eritrea,2021,2021Eritrea,9,0,6,19,0,0,34,0,0,13,84,0,0,97,131
9757,Eritrea,2021,2021Eritrea,11,33,49,329,49,0,471,5,40,47,704,63,0,859,1330
9758,Eritrea,2021,2021Eritrea,13,37,41,334,16,0,441,16,62,38,314,31,0,461,902
9759,Eritrea,2021,2021Eritrea,14,22,0,72,0,0,108,18,14,0,217,8,0,257,365
9760,Eritrea,2021,2021Eritrea,27,9,5,83,0,0,124,24,10,8,178,0,0,220,344
9761,Eritrea,2021,2021Eritrea,30,14,28,123,0,0,195,19,42,35,320,6,0,422,617
9762,Eritrea,2021,2021Eritrea,468,962,804,4937,211,0,7382,559,1075,915,4072,138,0,6759,14141
9763,Eritrea,2021,2021Eritrea,548,902,434,3492,59,0,5435,603,919,427,3716,101,0,5766,11201
9764,Eritrea,2021,2021Eritrea,557,572,253,2746,75,0,4203,555,595,324,3535,43,0,5052,38588
9765,Eritrea,2021,2021Eritrea,1222,7483,8525,36353,4911,0,58494,1289,7676,8671,33931,5617,0,57184,115678
9766,Eritrea,2021,2021Eritrea,3523,2518,707,13163,412,0,20323,4038,2670,764,35065,268,0,42805,63128
9767,Eritrea,2021,2021Eritrea,7272,14533,11681,48642,1285,0,83413,7631,14849,12937,37957,1507,0,74881,158294
9768,Ethiopia,2001,2001Ethiopia,0,0,0,0,0,0,0,0,0,0,0,0,0,0,24618
9769,Ethiopia,2001,2001Ethiopia,0,0,0,0,0,0,0,0,0,0,5,0,0,5,10
9770,Ethiopia,2001,2001Ethiopia,0,0,0,0,0,0,0,0,0,0,6,0,0,6,12
9771,Ethiopia,2001,2001Ethiopia,0,0,0,0,0,0,0,0,0,0,7,0,0,7,7
9772,Ethiopia,2001,2001Ethiopia,0,0,0,0,0,0,0,0,0,0,10,0,0,10,10
9773,Ethiopia,2001,2001Ethiopia,0,0,0,0,0,0,0,0,0,0,14,0,0,14,14
9774,Ethiopia,2001,2001Ethiopia,0,0,0,0,0,0,0,0,0,0,35,0,0,35,35
9775,Ethiopia,2001,2001Ethiopia,0,0,0,0,0,0,0,5,0,0,16,0,0,21,21
9776,Ethiopia,2001,2001Ethiopia,0,0,0,0,0,11,11,0,0,0,0,0,30,30,41
9777,Ethiopia,2001,2001Ethiopia,0,0,0,0,0,148,148,0,0,0,0,0,151,151,299
9778,Ethiopia,2001,2001Ethiopia,0,0,0,0,0,155,155,0,0,0,0,0,180,180,340
9779,Ethiopia,2001,2001Ethiopia,0,0,0,5,0,0,5,0,0,0,7,0,0,7,12
9780,Ethiopia,2001,2001Ethiopia,0,0,0,7,0,0,7,0,0,0,6,0,0,6,13
9781,Ethiopia,2001,2001Ethiopia,0,0,0,8,0,0,8,0,0,0,0,0,0,0,8
9782,Ethiopia,2001,2001Ethiopia,0,0,0,8,0,0,8,0,0,0,6,0,0,6,14
9783,Ethiopia,2001,2001Ethiopia,0,0,0,8,0,0,8,0,0,0,31,0,0,31,39
9784,Ethiopia,2001,2001Ethiopia,0,9,0,0,0,0,9,0,0,0,14,0,0,14,23
9785,Ethiopia,2001,2001Ethiopia,5,0,0,15,0,0,20,0,0,0,15,0,0,15,35
9786,Ethiopia,2001,2001Ethiopia,5,17,11,13,0,0,46,0,8,8,129,0,0,145,191
9787,Ethiopia,2001,2001Ethiopia,6,0,0,49,0,0,55,0,0,5,42,0,0,47,102
9788,Ethiopia,2001,2001Ethiopia,48,34,29,174,0,0,285,42,36,30,174,0,0,282,567
9789,Ethiopia,2001,2001Ethiopia,52,66,57,161,0,0,336,52,76,65,113,0,0,306,16120
9790,Ethiopia,2001,2001Ethiopia,73,52,46,157,18,518,864,31,44,38,184,5,262,564,1428
9791,Ethiopia,2001,2001Ethiopia,93,41,36,451,10,0,631,91,40,34,635,7,0,807,1480
9792,Ethiopia,2001,2001Ethiopia,347,1226,1050,3192,62,0,5877,333,1198,1027,5023,83,0,7664,13541
9793,Ethiopia,2002,2002Ethiopia,0,0,0,0,0,0,0,0,0,0,0,0,0,0,32586
9794,Ethiopia,2002,2002Ethiopia,0,0,0,0,0,0,0,0,0,0,0,0,5,5,5
9795,Ethiopia,2002,2002Ethiopia,0,0,0,0,0,0,0,0,0,0,5,0,0,5,10
9796,Ethiopia,2002,2002Ethiopia,0,0,0,0,0,0,0,0,0,0,6,0,0,6,12
9797,Ethiopia,2002,2002Ethiopia,0,0,0,0,0,0,0,0,0,0,7,0,0,7,7
9798,Ethiopia,2002,2002Ethiopia,0,0,0,0,0,0,0,0,0,0,35,0,0,35,35
9799,Ethiopia,2002,2002Ethiopia,0,0,0,0,0,0,0,5,0,0,16,0,0,21,21
9800,Ethiopia,2002,2002Ethiopia,0,0,0,0,0,71,71,0,0,0,0,0,89,89,322
9801,Ethiopia,2002,2002Ethiopia,0,0,0,0,0,150,150,0,0,0,0,0,142,142,292
9802,Ethiopia,2002,2002Ethiopia,0,0,0,5,0,0,5,0,0,0,0,0,0,0,5
9803,Ethiopia,2002,2002Ethiopia,0,0,0,5,0,0,5,0,0,0,8,0,0,8,13
9804,Ethiopia,2002,2002Ethiopia,0,0,0,5,0,0,5,0,0,0,10,0,0,10,15
9805,Ethiopia,2002,2002Ethiopia,0,0,0,6,0,0,6,0,0,0,10,0,0,10,16
9806,Ethiopia,2002,2002Ethiopia,0,0,0,6,0,0,6,0,0,5,0,0,0,5,11
9807,Ethiopia,2002,2002Ethiopia,0,0,0,7,0,0,7,0,0,0,6,0,0,6,13
9808,Ethiopia,2002,2002Ethiopia,0,0,0,8,0,0,8,0,0,0,30,0,0,30,38
9809,Ethiopia,2002,2002Ethiopia,0,0,0,9,0,0,9,0,0,0,0,0,0,0,9
9810,Ethiopia,2002,2002Ethiopia,0,0,5,5,0,0,10,0,0,0,13,0,0,13,23
9811,Ethiopia,2002,2002Ethiopia,0,5,0,0,0,0,5,0,0,0,9,0,0,9,14
9812,Ethiopia,2002,2002Ethiopia,0,5,0,16,0,0,21,0,0,9,30,0,0,39,60
9813,Ethiopia,2002,2002Ethiopia,5,0,0,51,0,0,56,0,0,7,48,0,0,55,111
9814,Ethiopia,2002,2002Ethiopia,5,17,11,15,0,0,48,0,8,8,134,0,0,150,198
9815,Ethiopia,2002,2002Ethiopia,9,44,34,256,30,0,373,25,46,34,430,38,0,573,1485
9816,Ethiopia,2002,2002Ethiopia,14,10,9,46,0,0,79,16,12,11,43,0,0,82,161
9817,Ethiopia,2002,2002Ethiopia,42,71,63,146,20,0,342,39,79,67,183,5,0,373,14571
9818,Ethiopia,2002,2002Ethiopia,344,938,804,2616,41,0,4743,361,976,835,4217,70,0,6459,11202
9819,Ethiopia,2003,2003Ethiopia,0,0,0,0,0,0,0,0,0,0,0,0,0,0,32627
9820,Ethiopia,2003,2003Ethiopia,0,0,0,0,0,0,0,0,0,0,5,0,0,5,44
9821,Ethiopia,2003,2003Ethiopia,0,0,0,0,0,0,0,0,0,0,6,0,0,6,6
9822,Ethiopia,2003,2003Ethiopia,0,0,0,0,0,0,0,0,0,0,35,0,0,35,35
9823,Ethiopia,2003,2003Ethiopia,0,0,0,0,0,0,0,0,5,0,0,0,0,5,5
9824,Ethiopia,2003,2003Ethiopia,0,0,0,0,0,0,0,5,0,0,0,0,0,5,5
9825,Ethiopia,2003,2003Ethiopia,0,0,0,0,0,0,0,5,0,0,15,0,0,20,20
9826,Ethiopia,2003,2003Ethiopia,0,0,0,0,0,69,69,0,0,0,0,0,91,91,326
9827,Ethiopia,2003,2003Ethiopia,0,0,0,0,0,150,150,0,0,0,0,0,149,149,299
9828,Ethiopia,2003,2003Ethiopia,0,0,0,5,0,0,5,0,0,0,0,0,0,0,10
9829,Ethiopia,2003,2003Ethiopia,0,0,0,5,0,0,5,0,0,0,6,0,0,6,11
9830,Ethiopia,2003,2003Ethiopia,0,0,0,6,0,0,6,0,0,0,10,0,0,10,16
9831,Ethiopia,2003,2003Ethiopia,0,0,0,6,0,0,6,0,0,5,10,0,0,15,21
9832,Ethiopia,2003,2003Ethiopia,0,0,0,7,0,0,7,0,0,0,6,0,0,6,13
9833,Ethiopia,2003,2003Ethiopia,0,0,0,7,0,0,7,0,0,0,29,0,0,29,36
9834,Ethiopia,2003,2003Ethiopia,0,0,0,8,0,0,8,0,0,0,6,0,0,6,14
9835,Ethiopia,2003,2003Ethiopia,0,0,5,0,0,0,5,0,0,0,0,0,0,0,5
9836,Ethiopia,2003,2003Ethiopia,0,0,6,5,0,0,11,0,0,0,12,0,0,12,23
9837,Ethiopia,2003,2003Ethiopia,0,5,0,10,0,0,15,0,8,0,0,0,0,8,23
9838,Ethiopia,2003,2003Ethiopia,0,6,6,190,0,0,202,5,5,5,112,0,0,127,329
9839,Ethiopia,2003,2003Ethiopia,5,6,0,13,0,0,24,0,0,9,37,0,0,46,70
9840,Ethiopia,2003,2003Ethiopia,5,12,11,21,0,0,49,0,8,8,157,0,0,173,222
9841,Ethiopia,2003,2003Ethiopia,38,15,13,94,0,0,160,35,19,16,99,0,0,169,329
9842,Ethiopia,2003,2003Ethiopia,44,76,66,154,21,0,361,41,82,71,191,5,0,390,15251
9843,Ethiopia,2003,2003Ethiopia,108,96,83,410,30,0,727,130,111,100,680,47,0,1068,1795
9844,Ethiopia,2003,2003Ethiopia,283,928,797,2637,39,0,4684,334,973,834,4246,68,0,6455,11139
9845,Ethiopia,2004,2004Ethiopia,0,0,0,0,0,0,0,0,0,0,0,0,0,0,32099
9846,Ethiopia,2004,2004Ethiopia,0,0,0,0,0,0,0,0,0,0,5,0,0,5,35
9847,Ethiopia,2004,2004Ethiopia,0,0,0,0,0,0,0,0,0,0,6,0,0,6,21
9848,Ethiopia,2004,2004Ethiopia,0,0,0,0,0,0,0,0,0,0,33,0,0,33,33
9849,Ethiopia,2004,2004Ethiopia,0,0,0,0,0,0,0,0,5,0,14,0,0,19,19
9850,Ethiopia,2004,2004Ethiopia,0,0,0,0,0,0,0,5,0,0,0,0,0,5,5
9851,Ethiopia,2004,2004Ethiopia,0,0,0,0,0,6489,6489,0,0,0,0,0,7234,7234,14812
9852,Ethiopia,2004,2004Ethiopia,0,0,0,5,0,0,5,0,0,0,0,0,0,0,5
9853,Ethiopia,2004,2004Ethiopia,0,0,0,5,0,0,5,0,0,0,9,0,0,9,14
9854,Ethiopia,2004,2004Ethiopia,0,0,0,5,0,0,5,0,0,0,13,0,0,13,18
9855,Ethiopia,2004,2004Ethiopia,0,0,0,6,0,0,6,0,0,0,10,0,0,10,16
9856,Ethiopia,2004,2004Ethiopia,0,0,0,7,0,0,7,0,0,0,6,0,0,6,13
9857,Ethiopia,2004,2004Ethiopia,0,0,0,8,0,0,8,0,0,0,6,0,0,6,14
9858,Ethiopia,2004,2004Ethiopia,0,0,5,0,0,0,5,0,0,0,0,0,0,0,5
9859,Ethiopia,2004,2004Ethiopia,0,0,7,5,0,0,12,0,0,0,13,0,0,13,25
9860,Ethiopia,2004,2004Ethiopia,0,5,0,10,0,0,15,0,8,0,0,0,0,8,23
9861,Ethiopia,2004,2004Ethiopia,5,0,0,0,0,0,5,0,0,0,0,0,0,0,10
9862,Ethiopia,2004,2004Ethiopia,5,5,6,288,0,0,304,5,5,5,157,5,0,177,481
9863,Ethiopia,2004,2004Ethiopia,6,0,0,28,0,0,34,5,11,0,66,0,0,82,116
9864,Ethiopia,2004,2004Ethiopia,6,9,8,64,5,79,171,8,6,0,55,0,91,160,331
9865,Ethiopia,2004,2004Ethiopia,12,13,12,9,0,0,46,23,26,22,35,0,0,106,152
9866,Ethiopia,2004,2004Ethiopia,31,17,14,92,0,0,154,37,19,17,94,0,0,167,321
9867,Ethiopia,2004,2004Ethiopia,158,71,60,578,16,0,883,179,78,69,754,27,0,1107,1990
9868,Ethiopia,2004,2004Ethiopia,398,1425,1223,1400,31,0,4477,518,2571,2202,2749,78,0,8118,12595
9869,Ethiopia,2005,2005Ethiopia,0,0,0,0,0,0,0,0,0,0,0,0,0,0,46910
9870,Ethiopia,2005,2005Ethiopia,0,0,0,0,0,0,0,0,0,0,5,0,0,5,10
9871,Ethiopia,2005,2005Ethiopia,0,0,0,0,0,0,0,0,0,0,7,0,0,7,7
9872,Ethiopia,2005,2005Ethiopia,0,0,0,0,0,0,0,0,0,0,9,0,0,9,9
9873,Ethiopia,2005,2005Ethiopia,0,0,0,0,0,0,0,0,5,0,14,0,0,19,19
9874,Ethiopia,2005,2005Ethiopia,0,0,0,0,0,0,0,5,0,0,0,0,0,5,5
9875,Ethiopia,2005,2005Ethiopia,0,0,0,0,0,5,5,0,0,0,0,0,0,0,5
9876,Ethiopia,2005,2005Ethiopia,0,0,0,0,0,170,170,0,0,0,0,0,163,163,333
9877,Ethiopia,2005,2005Ethiopia,0,0,0,5,0,0,5,0,0,0,0,0,0,0,30
9878,Ethiopia,2005,2005Ethiopia,0,0,0,5,0,0,5,0,0,0,6,0,0,6,11
9879,Ethiopia,2005,2005Ethiopia,0,0,0,5,0,0,5,0,0,0,8,0,0,8,13
9880,Ethiopia,2005,2005Ethiopia,0,0,0,5,0,0,5,0,0,0,29,0,0,29,34
9881,Ethiopia,2005,2005Ethiopia,0,0,0,6,0,0,6,0,0,0,10,0,0,10,16
9882,Ethiopia,2005,2005Ethiopia,0,0,0,6,0,0,6,7,0,0,37,0,0,44,50
9883,Ethiopia,2005,2005Ethiopia,0,0,0,11,0,0,11,0,0,0,22,0,0,22,33
9884,Ethiopia,2005,2005Ethiopia,0,0,5,0,0,0,5,0,0,0,0,0,0,0,5
9885,Ethiopia,2005,2005Ethiopia,0,0,7,6,0,0,13,0,0,0,13,0,0,13,26
9886,Ethiopia,2005,2005Ethiopia,0,5,0,10,0,0,15,0,9,0,0,0,0,9,24
9887,Ethiopia,2005,2005Ethiopia,7,5,0,19,0,0,31,6,0,0,62,0,0,68,99
9888,Ethiopia,2005,2005Ethiopia,8,9,8,290,0,0,315,7,6,5,183,0,0,201,516
9889,Ethiopia,2005,2005Ethiopia,9,8,7,89,5,82,200,9,5,5,61,0,90,170,370
9890,Ethiopia,2005,2005Ethiopia,58,17,15,122,0,0,212,52,26,22,132,0,0,232,444
9891,Ethiopia,2005,2005Ethiopia,183,57,49,447,5,0,741,175,72,63,560,5,0,875,1616
9892,Ethiopia,2005,2005Ethiopia,359,594,510,3331,31,0,4825,425,723,620,8072,197,0,10037,14862
9893,Ethiopia,2006,2006Ethiopia,0,0,0,0,0,0,0,0,0,0,0,0,0,0,42268
9894,Ethiopia,2006,2006Ethiopia,0,0,0,0,0,0,0,0,0,0,0,0,19,19,19
9895,Ethiopia,2006,2006Ethiopia,0,0,0,0,0,0,0,0,0,0,5,0,0,5,35
9896,Ethiopia,2006,2006Ethiopia,0,0,0,0,0,0,0,0,0,0,7,0,0,7,14
9897,Ethiopia,2006,2006Ethiopia,0,0,0,0,0,0,0,0,0,0,16,0,0,16,16
9898,Ethiopia,2006,2006Ethiopia,0,0,0,0,0,0,0,0,5,0,0,0,0,5,5
9899,Ethiopia,2006,2006Ethiopia,0,0,0,0,0,5,5,0,0,0,0,0,0,0,5
9900,Ethiopia,2006,2006Ethiopia,0,0,0,0,0,5,5,0,0,0,0,0,27,27,32
9901,Ethiopia,2006,2006Ethiopia,0,0,0,0,0,14,14,0,0,0,0,0,26,26,40
9902,Ethiopia,2006,2006Ethiopia,0,0,0,0,0,181,181,0,0,0,0,0,166,166,347
9903,Ethiopia,2006,2006Ethiopia,0,0,0,0,0,245,245,0,0,0,0,0,209,209,454
9904,Ethiopia,2006,2006Ethiopia,0,0,0,5,0,0,5,0,0,0,5,0,0,5,10
9905,Ethiopia,2006,2006Ethiopia,0,0,0,7,0,0,7,0,0,0,24,0,0,24,31
9906,Ethiopia,2006,2006Ethiopia,0,0,0,8,0,0,8,0,0,0,0,0,0,0,8
9907,Ethiopia,2006,2006Ethiopia,0,0,0,11,0,0,11,0,0,0,22,0,0,22,33
9908,Ethiopia,2006,2006Ethiopia,0,6,0,6,0,0,12,0,0,0,13,0,0,13,25
9909,Ethiopia,2006,2006Ethiopia,0,9,0,7,0,0,16,0,10,0,51,0,0,61,77
9910,Ethiopia,2006,2006Ethiopia,6,5,5,25,0,0,41,6,0,5,76,0,0,87,128
9911,Ethiopia,2006,2006Ethiopia,8,9,5,277,0,0,299,5,6,5,192,0,0,208,507
9912,Ethiopia,2006,2006Ethiopia,10,25,23,34,6,5411,5509,10,27,26,43,5,5389,5500,11009
9913,Ethiopia,2006,2006Ethiopia,54,24,19,180,0,0,277,69,23,22,224,0,0,338,620
9914,Ethiopia,2006,2006Ethiopia,202,56,65,486,5,0,814,193,76,77,726,10,0,1082,1896
9915,Ethiopia,2006,2006Ethiopia,479,749,545,3602,31,0,5406,554,873,776,8608,211,0,11022,16428
9916,Ethiopia,2007,2007Ethiopia,0,0,0,0,0,0,0,0,0,0,0,0,0,0,24874
9917,Ethiopia,2007,2007Ethiopia,0,0,0,0,0,0,0,0,0,0,5,0,0,5,25
9918,Ethiopia,2007,2007Ethiopia,0,0,0,0,0,0,0,0,0,0,6,0,0,6,6
9919,Ethiopia,2007,2007Ethiopia,0,0,0,0,0,0,0,0,0,0,7,0,0,7,7
9920,Ethiopia,2007,2007Ethiopia,0,0,0,0,0,0,0,0,0,0,8,0,0,8,8
9921,Ethiopia,2007,2007Ethiopia,0,0,0,0,0,0,0,0,0,0,9,0,0,9,9
9922,Ethiopia,2007,2007Ethiopia,0,0,0,0,0,0,0,0,0,0,13,0,0,13,13
9923,Ethiopia,2007,2007Ethiopia,0,0,0,0,0,0,0,0,0,5,14,0,0,19,19
9924,Ethiopia,2007,2007Ethiopia,0,0,0,0,0,0,0,0,5,0,0,0,0,5,5
9925,Ethiopia,2007,2007Ethiopia,0,0,0,0,0,5,5,0,0,0,0,0,26,26,31
9926,Ethiopia,2007,2007Ethiopia,0,0,0,0,0,16,16,0,0,0,0,0,26,26,42
9927,Ethiopia,2007,2007Ethiopia,0,0,0,0,0,209,209,0,0,0,0,0,187,187,396
9928,Ethiopia,2007,2007Ethiopia,0,0,0,6,0,0,6,0,0,0,27,0,0,27,33
9929,Ethiopia,2007,2007Ethiopia,0,0,0,7,0,0,7,0,0,0,0,0,0,0,7
9930,Ethiopia,2007,2007Ethiopia,0,0,0,8,0,0,8,0,0,0,28,0,0,28,54
9931,Ethiopia,2007,2007Ethiopia,0,0,0,9,0,0,9,0,0,0,10,0,0,10,19
9932,Ethiopia,2007,2007Ethiopia,0,0,7,5,0,0,12,0,0,0,13,0,0,13,25
9933,Ethiopia,2007,2007Ethiopia,5,0,0,14,0,0,19,0,14,0,19,0,0,33,52
9934,Ethiopia,2007,2007Ethiopia,5,14,6,52,0,0,77,8,7,5,152,0,0,172,249
9935,Ethiopia,2007,2007Ethiopia,10,6,5,17,0,0,38,6,10,0,20,0,0,36,85
9936,Ethiopia,2007,2007Ethiopia,11,9,5,256,0,0,281,5,7,0,175,0,0,187,468
9937,Ethiopia,2007,2007Ethiopia,18,6,9,122,5,93,253,17,7,7,83,0,97,211,464
9938,Ethiopia,2007,2007Ethiopia,34,21,382,933,34,4278,5682,39,29,377,1297,39,3953,5734,11416
9939,Ethiopia,2007,2007Ethiopia,44,52,0,199,0,0,295,48,56,0,181,0,0,285,580
9940,Ethiopia,2007,2007Ethiopia,76,49,33,219,0,0,377,84,54,44,292,0,0,474,851
9941,Ethiopia,2007,2007Ethiopia,175,153,33,571,5,0,937,154,171,38,667,21,0,1051,1988
9942,Ethiopia,2007,2007Ethiopia,565,804,626,4101,45,0,6141,604,971,818,9369,216,0,11978,18119
9943,Ethiopia,2008,2008Ethiopia,0,0,0,0,0,0,0,0,0,0,0,0,0,0,25587
9944,Ethiopia,2008,2008Ethiopia,0,0,0,0,0,0,0,0,0,0,5,0,0,5,25
9945,Ethiopia,2008,2008Ethiopia,0,0,0,0,0,0,0,0,0,0,6,0,0,6,6
9946,Ethiopia,2008,2008Ethiopia,0,0,0,0,0,0,0,0,0,0,8,0,0,8,8
9947,Ethiopia,2008,2008Ethiopia,0,0,0,0,0,0,0,0,0,0,10,0,0,10,10
9948,Ethiopia,2008,2008Ethiopia,0,0,0,0,0,0,0,0,0,0,12,0,0,12,12
9949,Ethiopia,2008,2008Ethiopia,0,0,0,0,0,0,0,0,0,5,14,0,0,19,19
9950,Ethiopia,2008,2008Ethiopia,0,0,0,0,0,0,0,0,5,0,0,0,0,5,5
9951,Ethiopia,2008,2008Ethiopia,0,0,0,0,0,0,0,0,9,0,0,0,0,9,9
9952,Ethiopia,2008,2008Ethiopia,0,0,0,0,0,0,0,5,0,0,0,0,0,5,5
9953,Ethiopia,2008,2008Ethiopia,0,0,0,0,0,24,24,0,0,0,0,0,39,39,63
9954,Ethiopia,2008,2008Ethiopia,0,0,0,0,0,227,227,0,0,0,0,0,196,196,423
9955,Ethiopia,2008,2008Ethiopia,0,0,0,5,0,0,5,0,0,0,0,0,0,0,21
9956,Ethiopia,2008,2008Ethiopia,0,0,0,5,0,0,5,0,0,0,24,0,0,24,29
9957,Ethiopia,2008,2008Ethiopia,0,0,0,5,0,0,5,0,0,0,25,0,0,25,30
9958,Ethiopia,2008,2008Ethiopia,0,0,0,8,0,0,8,0,0,0,12,0,0,12,20
9959,Ethiopia,2008,2008Ethiopia,0,0,0,8,0,0,8,0,0,0,39,0,0,39,47
9960,Ethiopia,2008,2008Ethiopia,0,0,0,9,0,0,9,0,0,0,0,0,0,0,9
9961,Ethiopia,2008,2008Ethiopia,0,0,5,5,0,0,10,0,0,0,14,0,0,14,24
9962,Ethiopia,2008,2008Ethiopia,0,6,0,14,0,0,20,0,5,5,23,0,0,33,53
9963,Ethiopia,2008,2008Ethiopia,7,0,0,11,0,0,18,0,8,0,13,0,0,21,39
9964,Ethiopia,2008,2008Ethiopia,7,7,5,14,0,0,33,8,12,0,23,0,0,43,76
9965,Ethiopia,2008,2008Ethiopia,10,10,5,256,0,0,281,7,7,0,178,0,0,192,473
9966,Ethiopia,2008,2008Ethiopia,17,27,16,154,0,0,214,18,25,11,313,0,0,367,581
9967,Ethiopia,2008,2008Ethiopia,19,12,8,149,5,105,298,31,15,5,94,5,97,247,545
9968,Ethiopia,2008,2008Ethiopia,26,43,23,186,0,0,278,42,45,24,162,0,0,273,551
9969,Ethiopia,2008,2008Ethiopia,68,177,10,1742,22,2486,4505,55,252,28,1957,46,1778,4116,8621
9970,Ethiopia,2008,2008Ethiopia,198,138,58,444,0,0,838,198,156,72,485,7,0,918,1783
9971,Ethiopia,2008,2008Ethiopia,198,167,39,622,5,0,1031,169,181,50,687,22,0,1109,2140
9972,Ethiopia,2008,2008Ethiopia,1058,1400,971,5131,150,0,8710,1139,1511,1127,9973,189,0,13939,22649
9973,Ethiopia,2009,2009Ethiopia,0,0,0,0,0,0,0,0,0,0,0,0,0,0,23570
9974,Ethiopia,2009,2009Ethiopia,0,0,0,0,0,0,0,0,0,0,5,0,0,5,35
9975,Ethiopia,2009,2009Ethiopia,0,0,0,0,0,0,0,0,0,0,7,0,0,7,7
9976,Ethiopia,2009,2009Ethiopia,0,0,0,0,0,0,0,0,0,0,8,0,0,8,8
9977,Ethiopia,2009,2009Ethiopia,0,0,0,0,0,0,0,0,0,0,9,0,0,9,9
9978,Ethiopia,2009,2009Ethiopia,0,0,0,0,0,0,0,0,0,0,11,0,0,11,11
9979,Ethiopia,2009,2009Ethiopia,0,0,0,0,0,0,0,0,0,5,15,0,0,20,20
9980,Ethiopia,2009,2009Ethiopia,0,0,0,0,0,0,0,0,5,0,0,0,0,5,5
9981,Ethiopia,2009,2009Ethiopia,0,0,0,0,0,0,0,0,9,0,0,0,0,9,9
9982,Ethiopia,2009,2009Ethiopia,0,0,0,0,0,0,0,5,0,0,0,0,0,5,5
9983,Ethiopia,2009,2009Ethiopia,0,0,0,0,0,33,33,0,0,0,0,0,47,47,80
9984,Ethiopia,2009,2009Ethiopia,0,0,0,5,0,0,5,0,0,0,11,0,0,11,16
9985,Ethiopia,2009,2009Ethiopia,0,0,0,5,0,0,5,0,0,0,18,0,0,18,23
9986,Ethiopia,2009,2009Ethiopia,0,0,0,5,0,0,5,0,0,0,24,0,0,24,29
9987,Ethiopia,2009,2009Ethiopia,0,0,0,7,0,0,7,0,0,0,0,0,0,0,7
9988,Ethiopia,2009,2009Ethiopia,0,0,0,9,0,0,9,0,0,0,17,0,0,17,26
9989,Ethiopia,2009,2009Ethiopia,0,0,0,12,0,0,12,0,0,0,0,0,0,0,12
9990,Ethiopia,2009,2009Ethiopia,0,0,0,33,0,0,33,0,0,0,48,5,0,53,86
9991,Ethiopia,2009,2009Ethiopia,0,5,6,0,0,0,11,0,0,0,13,0,0,13,24
9992,Ethiopia,2009,2009Ethiopia,0,7,0,9,0,0,16,0,0,6,30,0,0,36,52
9993,Ethiopia,2009,2009Ethiopia,5,0,0,11,0,0,16,0,0,5,16,0,0,21,37
9994,Ethiopia,2009,2009Ethiopia,7,0,0,11,0,0,18,0,8,0,14,0,0,22,40
9995,Ethiopia,2009,2009Ethiopia,12,10,0,15,0,0,37,10,8,5,13,0,0,36,73
9996,Ethiopia,2009,2009Ethiopia,14,9,7,265,0,0,295,6,5,5,181,0,0,197,492
9997,Ethiopia,2009,2009Ethiopia,17,54,29,212,0,0,312,38,64,30,171,0,0,303,615
9998,Ethiopia,2009,2009Ethiopia,19,15,7,149,5,122,317,33,18,5,101,5,106,268,585
9999,Ethiopia,2009,2009Ethiopia,19,40,23,253,0,0,335,31,29,15,476,5,0,556,891
10000,Ethiopia,2009,2009Ethiopia,38,107,94,1839,112,0,2190,45,97,65,2142,92,0,2441,4631
10001,Ethiopia,2009,2009Ethiopia,238,128,51,416,0,0,833,238,162,57,463,7,0,927,1760
10002,Ethiopia,2009,2009Ethiopia,297,272,69,1126,10,0,1774,333,275,86,949,29,0,1672,3446
10003,Ethiopia,2009,2009Ethiopia,495,697,251,1597,47,1148,4235,498,662,314,1452,53,1148,4127,9170
10004,Ethiopia,2009,2009Ethiopia,793,894,727,4376,122,0,6912,812,940,814,7455,170,0,10191,17103
10005,Ethiopia,2010,2010Ethiopia,0,0,0,0,0,0,0,0,0,0,0,0,0,0,24007
10006,Ethiopia,2010,2010Ethiopia,0,0,0,0,0,0,0,0,0,0,5,0,0,5,25
10007,Ethiopia,2010,2010Ethiopia,0,0,0,0,0,0,0,0,0,0,9,0,0,9,18
10008,Ethiopia,2010,2010Ethiopia,0,0,0,0,0,0,0,0,0,0,10,0,0,10,10
10009,Ethiopia,2010,2010Ethiopia,0,0,0,0,0,0,0,0,0,5,15,0,0,20,20
10010,Ethiopia,2010,2010Ethiopia,0,0,0,0,0,0,0,0,5,0,0,0,0,5,5
10011,Ethiopia,2010,2010Ethiopia,0,0,0,0,0,6,6,0,0,0,0,0,5,5,11
10012,Ethiopia,2010,2010Ethiopia,0,0,0,0,0,6,6,0,0,0,0,0,16,16,22
10013,Ethiopia,2010,2010Ethiopia,0,0,0,0,0,32,32,0,0,0,0,0,55,55,87
10014,Ethiopia,2010,2010Ethiopia,0,0,0,0,0,258,258,0,0,0,0,0,223,223,481
10015,Ethiopia,2010,2010Ethiopia,0,0,0,5,0,0,5,0,0,0,11,0,0,11,16
10016,Ethiopia,2010,2010Ethiopia,0,0,0,5,0,0,5,0,0,0,24,0,0,24,29
10017,Ethiopia,2010,2010Ethiopia,0,0,0,7,0,0,7,0,0,0,0,0,0,0,7
10018,Ethiopia,2010,2010Ethiopia,0,0,0,9,0,0,9,0,0,0,0,0,0,0,9
10019,Ethiopia,2010,2010Ethiopia,0,0,0,9,0,0,9,0,0,0,20,0,0,20,29
10020,Ethiopia,2010,2010Ethiopia,0,7,0,6,0,0,13,0,0,0,8,0,0,8,21
10021,Ethiopia,2010,2010Ethiopia,0,7,0,8,0,0,15,0,5,5,20,0,0,30,45
10022,Ethiopia,2010,2010Ethiopia,0,9,0,12,0,0,21,0,0,11,19,0,0,30,56
10023,Ethiopia,2010,2010Ethiopia,5,0,0,12,0,0,17,0,0,5,17,0,0,22,39
10024,Ethiopia,2010,2010Ethiopia,8,10,0,18,0,0,36,9,8,5,22,0,0,44,80
10025,Ethiopia,2010,2010Ethiopia,18,13,11,295,0,0,337,19,5,5,196,0,0,225,562
10026,Ethiopia,2010,2010Ethiopia,20,19,8,132,5,140,324,31,16,6,98,5,121,277,601
10027,Ethiopia,2010,2010Ethiopia,22,35,31,278,0,0,366,29,35,26,521,5,0,616,982
10028,Ethiopia,2010,2010Ethiopia,27,52,30,212,5,0,326,38,61,29,177,0,0,305,631
10029,Ethiopia,2010,2010Ethiopia,43,89,112,1851,114,0,2209,53,110,68,2088,100,0,2419,4628
10030,Ethiopia,2010,2010Ethiopia,158,242,279,1115,47,0,1841,134,214,287,1667,38,0,2340,4181
10031,Ethiopia,2010,2010Ethiopia,224,180,73,442,0,0,919,195,189,78,491,10,0,963,1882
10032,Ethiopia,2010,2010Ethiopia,514,755,344,1738,78,1197,4626,569,757,332,1567,54,1196,4475,9101
10033,Ethiopia,2010,2010Ethiopia,998,1357,950,5613,192,0,9110,1018,1487,1164,8243,231,0,12143,21253
10034,Ethiopia,2011,2011Ethiopia,0,0,0,0,0,0,0,0,0,0,0,0,0,0,27009
10035,Ethiopia,2011,2011Ethiopia,0,0,0,0,0,0,0,0,0,0,5,0,0,5,30
10036,Ethiopia,2011,2011Ethiopia,0,0,0,0,0,0,0,0,0,0,9,0,0,9,9
10037,Ethiopia,2011,2011Ethiopia,0,0,0,0,0,0,0,0,0,0,10,0,0,10,10
10038,Ethiopia,2011,2011Ethiopia,0,0,0,0,0,0,0,0,0,5,0,0,0,5,5
10039,Ethiopia,2011,2011Ethiopia,0,0,0,0,0,0,0,0,0,5,15,0,0,20,20
10040,Ethiopia,2011,2011Ethiopia,0,0,0,0,0,0,0,0,9,5,5,0,0,19,42
10041,Ethiopia,2011,2011Ethiopia,0,0,0,0,0,6,6,0,0,0,0,0,5,5,11
10042,Ethiopia,2011,2011Ethiopia,0,0,0,0,0,33,33,0,0,0,0,0,54,54,87
10043,Ethiopia,2011,2011Ethiopia,0,0,0,0,0,290,290,0,0,0,0,0,238,238,528
10044,Ethiopia,2011,2011Ethiopia,0,0,0,5,0,0,5,0,0,0,5,0,0,5,10
10045,Ethiopia,2011,2011Ethiopia,0,0,0,5,0,0,5,0,0,0,11,0,0,11,16
10046,Ethiopia,2011,2011Ethiopia,0,0,0,5,0,0,5,0,0,0,24,0,0,24,29
10047,Ethiopia,2011,2011Ethiopia,0,0,0,9,0,0,9,0,0,0,0,0,0,0,9
10048,Ethiopia,2011,2011Ethiopia,0,0,0,9,0,0,9,0,0,0,19,0,0,19,28
10049,Ethiopia,2011,2011Ethiopia,0,0,0,10,0,0,10,0,0,0,0,0,0,0,10
10050,Ethiopia,2011,2011Ethiopia,0,5,0,8,0,0,13,0,0,5,12,0,0,17,30
10051,Ethiopia,2011,2011Ethiopia,0,5,5,19,0,0,29,5,5,0,12,0,0,22,51
10052,Ethiopia,2011,2011Ethiopia,5,0,0,0,0,0,5,0,0,0,0,0,0,0,5
10053,Ethiopia,2011,2011Ethiopia,5,5,5,8,0,0,23,0,7,0,30,0,0,37,60
10054,Ethiopia,2011,2011Ethiopia,8,7,5,16,0,0,36,8,10,5,15,0,0,38,74
10055,Ethiopia,2011,2011Ethiopia,9,6,9,65,0,0,89,5,0,10,125,0,0,140,229
10056,Ethiopia,2011,2011Ethiopia,16,15,15,315,0,0,361,17,6,10,215,0,0,248,609
10057,Ethiopia,2011,2011Ethiopia,18,19,5,126,5,151,324,30,20,5,93,5,126,279,603
10058,Ethiopia,2011,2011Ethiopia,28,48,29,209,0,0,314,34,59,28,165,0,0,286,600
10059,Ethiopia,2011,2011Ethiopia,30,37,73,254,0,0,394,42,40,117,466,5,0,670,1064
10060,Ethiopia,2011,2011Ethiopia,43,83,113,1804,115,0,2158,42,106,72,1997,110,0,2327,4485
10061,Ethiopia,2011,2011Ethiopia,49,121,111,677,16,1151,2125,50,118,122,828,28,1150,2296,4421
10062,Ethiopia,2011,2011Ethiopia,57,47,63,473,19,0,659,52,46,56,580,11,0,745,1928
10063,Ethiopia,2011,2011Ethiopia,264,198,73,466,0,0,1001,238,215,81,495,16,0,1045,2046
10064,Ethiopia,2011,2011Ethiopia,294,381,136,1612,23,0,2446,354,402,177,1278,29,0,2240,4686
10065,Ethiopia,2011,2011Ethiopia,1116,1783,1046,5577,145,0,9667,1114,1803,1306,7775,192,0,12190,21857
10066,Ethiopia,2012,2012Ethiopia,0,0,0,0,0,0,0,0,0,0,0,0,0,0,23308
10067,Ethiopia,2012,2012Ethiopia,0,0,0,0,0,0,0,0,0,0,0,0,10,10,10
10068,Ethiopia,2012,2012Ethiopia,0,0,0,0,0,0,0,0,0,0,5,0,0,5,35
10069,Ethiopia,2012,2012Ethiopia,0,0,0,0,0,0,0,0,0,0,8,0,0,8,8
10070,Ethiopia,2012,2012Ethiopia,0,0,0,0,0,0,0,0,0,0,10,0,0,10,10
10071,Ethiopia,2012,2012Ethiopia,0,0,0,0,0,0,0,0,0,5,15,0,0,20,20
10072,Ethiopia,2012,2012Ethiopia,0,0,0,0,0,0,0,0,0,6,0,0,0,6,6
10073,Ethiopia,2012,2012Ethiopia,0,0,0,0,0,0,0,0,5,0,0,0,0,5,5
10074,Ethiopia,2012,2012Ethiopia,0,0,0,0,0,5,5,0,0,0,0,0,8,8,13
10075,Ethiopia,2012,2012Ethiopia,0,0,0,0,0,5,5,0,0,0,0,0,11,11,16
10076,Ethiopia,2012,2012Ethiopia,0,0,0,0,0,35,35,0,0,0,0,0,50,50,85
10077,Ethiopia,2012,2012Ethiopia,0,0,0,0,0,307,307,0,0,0,0,0,252,252,559
10078,Ethiopia,2012,2012Ethiopia,0,0,0,5,0,0,5,0,0,0,0,0,0,0,5
10079,Ethiopia,2012,2012Ethiopia,0,0,0,5,0,0,5,0,0,0,11,0,0,11,16
10080,Ethiopia,2012,2012Ethiopia,0,0,0,9,0,0,9,0,0,0,0,0,0,0,9
10081,Ethiopia,2012,2012Ethiopia,0,0,0,10,0,0,10,0,0,0,22,0,0,22,32
10082,Ethiopia,2012,2012Ethiopia,0,0,0,19,5,0,24,0,0,0,5,0,0,5,29
10083,Ethiopia,2012,2012Ethiopia,0,0,5,5,0,0,10,0,0,5,8,0,0,13,23
10084,Ethiopia,2012,2012Ethiopia,0,5,0,0,0,0,5,0,0,0,0,0,0,0,10
10085,Ethiopia,2012,2012Ethiopia,0,6,0,8,0,0,14,0,0,8,17,0,0,25,44
10086,Ethiopia,2012,2012Ethiopia,0,6,5,10,0,0,21,0,0,8,30,5,0,43,64
10087,Ethiopia,2012,2012Ethiopia,0,11,5,32,0,0,48,5,5,0,16,0,0,26,74
10088,Ethiopia,2012,2012Ethiopia,5,0,0,0,0,0,5,0,0,0,7,0,0,7,12
10089,Ethiopia,2012,2012Ethiopia,5,5,0,18,0,0,28,5,0,0,53,0,0,58,86
10090,Ethiopia,2012,2012Ethiopia,5,5,6,58,5,0,79,7,5,8,59,0,0,79,2059
10091,Ethiopia,2012,2012Ethiopia,5,12,5,17,0,0,39,0,12,8,14,0,0,34,73
10092,Ethiopia,2012,2012Ethiopia,18,18,6,110,5,184,341,23,20,7,76,0,148,274,615
10093,Ethiopia,2012,2012Ethiopia,21,30,15,448,0,0,514,18,35,22,274,0,0,349,863
10094,Ethiopia,2012,2012Ethiopia,30,42,27,188,0,0,287,25,50,27,146,0,0,248,535
10095,Ethiopia,2012,2012Ethiopia,45,82,124,1808,119,0,2178,56,113,78,1993,120,0,2360,4538
10096,Ethiopia,2012,2012Ethiopia,47,68,280,176,0,0,571,66,76,498,318,0,0,958,1529
10097,Ethiopia,2012,2012Ethiopia,56,119,132,767,24,1175,2273,31,133,137,966,45,1176,2488,4761
10098,Ethiopia,2012,2012Ethiopia,255,240,79,508,0,0,1082,238,238,98,508,15,0,1097,2179
10099,Ethiopia,2012,2012Ethiopia,312,440,137,1662,20,0,2571,369,479,250,1519,33,0,2650,5221
10100,Ethiopia,2012,2012Ethiopia,463,701,430,1339,44,0,2977,497,746,450,1194,27,0,2914,5891
10101,Ethiopia,2012,2012Ethiopia,1554,1919,1230,5195,238,0,10136,1605,2051,1440,6768,221,0,12085,22221
10102,Ethiopia,2013,2013Ethiopia,0,0,0,0,0,0,0,0,0,0,0,0,0,0,25462
10103,Ethiopia,2013,2013Ethiopia,0,0,0,0,0,0,0,0,0,0,5,0,0,5,35
10104,Ethiopia,2013,2013Ethiopia,0,0,0,0,0,0,0,0,0,0,6,0,0,6,6
10105,Ethiopia,2013,2013Ethiopia,0,0,0,0,0,0,0,0,0,0,8,0,0,8,8
10106,Ethiopia,2013,2013Ethiopia,0,0,0,0,0,0,0,0,0,0,9,0,0,9,9
10107,Ethiopia,2013,2013Ethiopia,0,0,0,0,0,0,0,0,0,5,15,0,0,20,20
10108,Ethiopia,2013,2013Ethiopia,0,0,0,0,0,0,0,0,5,0,0,0,0,5,5
10109,Ethiopia,2013,2013Ethiopia,0,0,0,0,0,5,5,0,0,0,0,0,9,9,14
10110,Ethiopia,2013,2013Ethiopia,0,0,0,0,0,29,29,0,0,0,0,0,43,43,82
10111,Ethiopia,2013,2013Ethiopia,0,0,0,0,0,329,329,0,0,0,0,0,269,269,598
10112,Ethiopia,2013,2013Ethiopia,0,0,0,5,0,0,5,0,0,0,0,0,0,0,5
10113,Ethiopia,2013,2013Ethiopia,0,0,0,5,0,0,5,0,0,0,11,0,0,11,16
10114,Ethiopia,2013,2013Ethiopia,0,0,0,5,0,0,5,5,0,0,7,0,0,12,17
10115,Ethiopia,2013,2013Ethiopia,0,0,0,11,0,0,11,0,0,0,24,0,0,24,35
10116,Ethiopia,2013,2013Ethiopia,0,0,0,14,0,0,14,0,0,0,5,0,0,5,19
10117,Ethiopia,2013,2013Ethiopia,0,0,5,5,0,0,10,0,0,0,19,0,0,19,29
10118,Ethiopia,2013,2013Ethiopia,0,0,5,6,0,0,11,0,0,0,12,0,0,12,23
10119,Ethiopia,2013,2013Ethiopia,0,5,0,0,0,0,5,0,0,0,0,0,0,0,5
10120,Ethiopia,2013,2013Ethiopia,0,6,0,0,0,0,6,0,0,0,0,0,0,0,6
10121,Ethiopia,2013,2013Ethiopia,0,6,5,12,0,0,23,0,8,0,34,5,0,47,70
10122,Ethiopia,2013,2013Ethiopia,0,7,6,9,0,0,22,0,9,9,18,0,0,36,58
10123,Ethiopia,2013,2013Ethiopia,0,9,5,7,0,0,21,5,5,0,8,0,0,18,39
10124,Ethiopia,2013,2013Ethiopia,0,10,9,39,0,0,58,16,5,0,14,0,0,35,93
10125,Ethiopia,2013,2013Ethiopia,5,5,0,0,0,0,10,0,0,0,13,0,0,13,23
10126,Ethiopia,2013,2013Ethiopia,5,7,0,43,0,0,55,5,9,12,45,5,0,76,2163
10127,Ethiopia,2013,2013Ethiopia,22,21,7,121,5,198,374,24,22,7,82,0,148,283,657
10128,Ethiopia,2013,2013Ethiopia,27,40,21,175,5,0,268,18,49,28,134,0,0,229,497
10129,Ethiopia,2013,2013Ethiopia,37,24,36,518,0,0,615,37,24,16,337,0,0,414,1029
10130,Ethiopia,2013,2013Ethiopia,37,55,64,1115,90,0,1361,54,66,34,1024,100,0,1278,2639
10131,Ethiopia,2013,2013Ethiopia,50,39,48,195,0,0,332,68,48,76,349,7,0,548,880
10132,Ethiopia,2013,2013Ethiopia,55,161,158,884,36,1170,2464,42,151,174,1056,50,1171,2644,5108
10133,Ethiopia,2013,2013Ethiopia,254,267,107,526,0,0,1154,241,249,129,515,17,0,1151,2305
10134,Ethiopia,2013,2013Ethiopia,335,483,160,1839,20,0,2837,389,558,267,1645,44,0,2903,5740
10135,Ethiopia,2013,2013Ethiopia,463,729,409,1370,78,0,3049,480,810,423,1084,44,0,2841,5890
10136,Ethiopia,2013,2013Ethiopia,1719,2135,1332,5507,217,0,10910,1859,2262,1552,6757,184,0,12614,23524
10137,Ethiopia,2014,2014Ethiopia,0,0,0,0,0,0,0,0,0,0,0,0,0,0,18074
10138,Ethiopia,2014,2014Ethiopia,0,0,0,0,0,0,0,0,0,0,5,0,0,5,25
10139,Ethiopia,2014,2014Ethiopia,0,0,0,0,0,0,0,0,0,0,6,0,0,6,6
10140,Ethiopia,2014,2014Ethiopia,0,0,0,0,0,0,0,0,0,0,7,0,0,7,14
10141,Ethiopia,2014,2014Ethiopia,0,0,0,0,0,0,0,0,0,0,8,0,0,8,8
10142,Ethiopia,2014,2014Ethiopia,0,0,0,0,0,0,0,0,0,0,20,0,0,20,20
10143,Ethiopia,2014,2014Ethiopia,0,0,0,0,0,0,0,0,0,5,14,0,0,19,19
10144,Ethiopia,2014,2014Ethiopia,0,0,0,0,0,0,0,0,5,0,0,0,0,5,5
10145,Ethiopia,2014,2014Ethiopia,0,0,0,0,0,5,5,0,0,0,0,0,9,9,14
10146,Ethiopia,2014,2014Ethiopia,0,0,0,0,0,13,13,0,0,0,0,0,19,19,32
10147,Ethiopia,2014,2014Ethiopia,0,0,0,0,0,334,334,0,0,0,0,0,267,267,601
10148,Ethiopia,2014,2014Ethiopia,0,0,0,0,0,4421,4421,0,0,0,0,0,14409,14409,18830
10149,Ethiopia,2014,2014Ethiopia,0,0,0,5,0,0,5,0,0,0,0,0,0,0,15
10150,Ethiopia,2014,2014Ethiopia,0,0,0,5,0,0,5,0,0,0,11,0,0,11,16
10151,Ethiopia,2014,2014Ethiopia,0,0,0,33,0,0,33,0,0,7,50,0,0,57,2155
10152,Ethiopia,2014,2014Ethiopia,0,0,5,0,0,0,5,0,0,0,0,0,0,0,5
10153,Ethiopia,2014,2014Ethiopia,0,0,5,5,0,0,10,0,0,6,11,0,0,17,27
10154,Ethiopia,2014,2014Ethiopia,0,0,5,9,0,0,14,0,0,6,6,0,0,12,26
10155,Ethiopia,2014,2014Ethiopia,0,0,5,19,0,0,24,5,0,0,49,0,0,54,78
10156,Ethiopia,2014,2014Ethiopia,0,0,6,0,0,0,6,0,0,0,0,0,0,0,6
10157,Ethiopia,2014,2014Ethiopia,0,0,11,5,0,0,16,0,0,0,0,0,0,0,16
10158,Ethiopia,2014,2014Ethiopia,0,5,0,0,0,0,5,0,0,0,0,0,0,0,5
10159,Ethiopia,2014,2014Ethiopia,0,5,0,9,0,0,14,0,0,9,0,0,0,9,23
10160,Ethiopia,2014,2014Ethiopia,0,6,0,0,0,0,6,0,0,0,0,0,0,0,6
10161,Ethiopia,2014,2014Ethiopia,0,6,0,0,0,0,6,0,0,0,5,0,0,5,11
10162,Ethiopia,2014,2014Ethiopia,0,7,0,8,0,0,15,0,5,0,30,5,0,40,55
10163,Ethiopia,2014,2014Ethiopia,5,7,0,10,0,0,22,0,5,8,17,0,0,30,52
10164,Ethiopia,2014,2014Ethiopia,5,16,9,36,0,0,66,11,10,0,11,0,0,32,98
10165,Ethiopia,2014,2014Ethiopia,20,35,23,176,5,0,259,12,43,34,134,5,0,228,487
10166,Ethiopia,2014,2014Ethiopia,31,27,16,185,5,221,485,44,25,12,92,5,182,360,845
10167,Ethiopia,2014,2014Ethiopia,39,25,578,28,0,0,670,56,16,367,29,0,0,468,1138
10168,Ethiopia,2014,2014Ethiopia,51,59,53,1159,91,0,1413,56,70,38,1011,107,0,1282,2695
10169,Ethiopia,2014,2014Ethiopia,58,201,171,2146,41,0,2617,74,152,180,2407,65,0,2878,5495
10170,Ethiopia,2014,2014Ethiopia,67,61,59,314,5,0,506,74,68,69,531,17,0,759,1265
10171,Ethiopia,2014,2014Ethiopia,266,351,124,573,0,0,1314,256,314,149,551,22,0,1292,2606
10172,Ethiopia,2014,2014Ethiopia,367,562,217,1902,16,0,3064,416,688,288,1420,58,0,2870,5934
10173,Ethiopia,2014,2014Ethiopia,382,629,353,1094,49,0,2507,429,716,310,922,16,0,2393,4900
10174,Ethiopia,2014,2014Ethiopia,1534,1945,1184,4956,217,0,9836,1663,2030,1448,6078,195,0,11414,21250
10175,Ethiopia,2015,2015Ethiopia,0,0,0,0,0,0,0,0,0,0,0,0,0,0,40586
10176,Ethiopia,2015,2015Ethiopia,0,0,0,0,0,0,0,0,0,0,5,0,0,5,60
10177,Ethiopia,2015,2015Ethiopia,0,0,0,0,0,0,0,0,0,0,8,0,0,8,8
10178,Ethiopia,2015,2015Ethiopia,0,0,0,0,0,0,0,0,0,5,0,0,0,5,5
10179,Ethiopia,2015,2015Ethiopia,0,0,0,0,0,0,0,0,0,5,15,0,0,20,20
10180,Ethiopia,2015,2015Ethiopia,0,0,0,0,0,5,5,0,0,0,0,0,13,13,18
10181,Ethiopia,2015,2015Ethiopia,0,0,0,0,0,16,16,0,0,0,0,0,22,22,38
10182,Ethiopia,2015,2015Ethiopia,0,0,0,0,0,45,45,0,0,0,0,0,58,58,103
10183,Ethiopia,2015,2015Ethiopia,0,0,0,0,0,363,363,0,0,0,0,0,290,290,653
10184,Ethiopia,2015,2015Ethiopia,0,0,0,5,0,0,5,0,0,0,0,0,0,0,15
10185,Ethiopia,2015,2015Ethiopia,0,0,0,5,0,0,5,0,0,0,12,0,0,12,17
10186,Ethiopia,2015,2015Ethiopia,0,0,0,10,0,0,10,0,0,0,13,0,0,13,23
10187,Ethiopia,2015,2015Ethiopia,0,0,0,13,0,0,13,0,0,0,0,0,0,0,13
10188,Ethiopia,2015,2015Ethiopia,0,0,0,18,0,0,18,0,0,0,0,0,0,0,18
10189,Ethiopia,2015,2015Ethiopia,0,0,5,8,0,0,13,0,0,0,25,0,0,25,38
10190,Ethiopia,2015,2015Ethiopia,0,0,5,9,0,0,14,0,6,0,6,0,0,12,26
10191,Ethiopia,2015,2015Ethiopia,0,0,5,19,0,0,24,6,0,6,15,0,0,27,51
10192,Ethiopia,2015,2015Ethiopia,0,0,5,20,0,0,25,5,0,0,59,0,0,64,89
10193,Ethiopia,2015,2015Ethiopia,0,0,6,0,0,0,6,0,0,0,0,0,0,0,12
10194,Ethiopia,2015,2015Ethiopia,0,5,0,0,0,0,5,0,0,0,0,0,0,0,5
10195,Ethiopia,2015,2015Ethiopia,0,6,0,8,0,0,14,0,0,5,31,5,0,41,55
10196,Ethiopia,2015,2015Ethiopia,0,7,0,0,0,0,7,0,0,0,0,0,0,0,7
10197,Ethiopia,2015,2015Ethiopia,0,9,0,0,0,0,9,0,0,0,5,0,0,5,14
10198,Ethiopia,2015,2015Ethiopia,0,21,5,40,0,0,66,5,11,0,10,0,0,26,92
10199,Ethiopia,2015,2015Ethiopia,5,0,0,0,0,0,5,0,0,0,0,0,0,0,5
10200,Ethiopia,2015,2015Ethiopia,9,9,0,10,0,0,28,0,5,8,25,0,0,38,66
10201,Ethiopia,2015,2015Ethiopia,25,39,29,191,5,0,289,24,44,35,130,0,0,233,522
10202,Ethiopia,2015,2015Ethiopia,42,38,40,514,0,0,634,60,42,21,328,0,0,451,1085
10203,Ethiopia,2015,2015Ethiopia,50,200,163,1008,43,0,1464,53,138,178,1291,70,0,1730,3194
10204,Ethiopia,2015,2015Ethiopia,53,63,47,1124,100,0,1387,59,62,45,995,109,0,1270,2657
10205,Ethiopia,2015,2015Ethiopia,57,35,18,375,5,0,490,62,28,51,383,5,0,529,1019
10206,Ethiopia,2015,2015Ethiopia,62,69,67,404,10,0,612,71,80,75,641,16,0,883,1495
10207,Ethiopia,2015,2015Ethiopia,243,402,142,607,0,0,1394,247,345,160,590,20,0,1362,2756
10208,Ethiopia,2015,2015Ethiopia,333,566,338,972,43,0,2252,379,638,302,610,19,0,1948,4200
10209,Ethiopia,2015,2015Ethiopia,348,545,196,1829,19,0,2937,385,659,245,1371,48,0,2708,5645
10210,Ethiopia,2015,2015Ethiopia,1548,1974,1266,4863,222,0,9873,1686,2058,1470,5938,204,0,11356,21229
10211,Ethiopia,2016,2016Ethiopia,0,0,0,0,0,0,0,0,0,0,0,0,0,0,18741
10212,Ethiopia,2016,2016Ethiopia,0,0,0,0,0,0,0,0,0,0,5,0,0,5,50
10213,Ethiopia,2016,2016Ethiopia,0,0,0,0,0,0,0,0,0,0,6,0,0,6,6
10214,Ethiopia,2016,2016Ethiopia,0,0,0,0,0,0,0,0,0,0,7,0,0,7,7
10215,Ethiopia,2016,2016Ethiopia,0,0,0,0,0,5,5,0,0,0,0,0,15,15,20
10216,Ethiopia,2016,2016Ethiopia,0,0,0,0,0,20,20,0,0,0,0,0,23,23,43
10217,Ethiopia,2016,2016Ethiopia,0,0,0,0,0,46,46,0,0,0,0,0,75,75,121
10218,Ethiopia,2016,2016Ethiopia,0,0,0,0,0,400,400,0,0,0,0,0,395,395,795
10219,Ethiopia,2016,2016Ethiopia,0,0,0,0,0,4322,4322,0,0,0,0,0,13454,13454,17776
10220,Ethiopia,2016,2016Ethiopia,0,0,0,5,0,0,5,0,0,0,0,0,0,0,15
10221,Ethiopia,2016,2016Ethiopia,0,0,0,5,0,0,5,0,0,0,6,0,0,6,11
10222,Ethiopia,2016,2016Ethiopia,0,0,0,5,0,0,5,0,0,0,12,0,0,12,17
10223,Ethiopia,2016,2016Ethiopia,0,0,0,5,0,0,5,0,0,0,17,0,0,17,22
10224,Ethiopia,2016,2016Ethiopia,0,0,0,6,0,0,6,0,0,0,0,0,0,0,12
10225,Ethiopia,2016,2016Ethiopia,0,0,0,19,0,0,19,0,0,0,0,0,0,0,19
10226,Ethiopia,2016,2016Ethiopia,0,0,0,24,0,0,24,0,0,0,0,0,0,0,24
10227,Ethiopia,2016,2016Ethiopia,0,0,5,12,0,0,17,0,0,0,25,0,0,25,42
10228,Ethiopia,2016,2016Ethiopia,0,0,6,0,0,0,6,0,0,0,0,0,0,0,12
10229,Ethiopia,2016,2016Ethiopia,0,0,6,27,0,0,33,0,0,5,63,0,0,68,101
10230,Ethiopia,2016,2016Ethiopia,0,0,10,0,0,0,10,0,0,0,12,0,0,12,22
10231,Ethiopia,2016,2016Ethiopia,0,5,0,0,0,0,5,0,0,0,0,0,0,0,5
10232,Ethiopia,2016,2016Ethiopia,0,6,0,0,0,0,6,0,0,0,0,0,0,0,6
10233,Ethiopia,2016,2016Ethiopia,0,7,0,5,0,0,12,0,0,0,9,0,0,9,21
10234,Ethiopia,2016,2016Ethiopia,0,7,0,9,0,0,16,0,5,0,34,5,0,44,60
10235,Ethiopia,2016,2016Ethiopia,0,10,15,39,0,0,64,6,7,0,15,0,0,28,92
10236,Ethiopia,2016,2016Ethiopia,5,0,0,0,0,0,5,0,0,0,0,0,0,0,5
10237,Ethiopia,2016,2016Ethiopia,5,0,12,22,0,0,39,0,0,14,11,0,0,25,64
10238,Ethiopia,2016,2016Ethiopia,5,8,0,12,0,0,25,0,0,13,23,0,0,36,61
10239,Ethiopia,2016,2016Ethiopia,7,0,0,6,0,0,13,0,0,5,5,0,0,10,23
10240,Ethiopia,2016,2016Ethiopia,9,13,11,80,5,0,118,6,12,11,128,0,0,157,1470
10241,Ethiopia,2016,2016Ethiopia,25,33,32,192,0,0,282,20,39,39,136,0,0,234,516
10242,Ethiopia,2016,2016Ethiopia,49,44,12,286,0,275,666,50,46,42,143,5,255,541,1207
10243,Ethiopia,2016,2016Ethiopia,67,213,350,1032,50,0,1712,80,187,305,1296,83,0,1951,3663
10244,Ethiopia,2016,2016Ethiopia,68,66,48,1184,113,0,1479,76,73,49,1024,122,0,1344,2823
10245,Ethiopia,2016,2016Ethiopia,74,71,56,573,0,0,774,84,60,52,422,0,0,618,1392
10246,Ethiopia,2016,2016Ethiopia,88,116,97,534,13,0,848,108,117,93,815,21,0,1154,2002
10247,Ethiopia,2016,2016Ethiopia,260,453,177,663,0,0,1553,234,430,180,642,21,0,1507,3060
10248,Ethiopia,2016,2016Ethiopia,291,596,241,1903,21,0,3052,342,717,267,1449,50,0,2825,5877
10249,Ethiopia,2016,2016Ethiopia,329,531,478,1091,55,0,2484,358,559,520,748,22,0,2207,4691
10250,Ethiopia,2016,2016Ethiopia,1465,1869,1168,4374,188,0,9064,1562,1999,1334,4899,206,0,10000,19064
10251,Ethiopia,2017,2017Ethiopia,0,0,0,0,0,0,0,0,0,0,0,0,0,0,20634
10252,Ethiopia,2017,2017Ethiopia,0,0,0,0,0,0,0,0,0,0,5,0,0,5,55
10253,Ethiopia,2017,2017Ethiopia,0,0,0,0,0,0,0,0,0,0,6,0,0,6,12
10254,Ethiopia,2017,2017Ethiopia,0,0,0,0,0,0,0,0,0,7,0,0,0,7,7
10255,Ethiopia,2017,2017Ethiopia,0,0,0,0,0,0,0,5,0,0,0,0,0,5,26
10256,Ethiopia,2017,2017Ethiopia,0,0,0,0,0,5,5,0,0,0,0,0,15,15,20
10257,Ethiopia,2017,2017Ethiopia,0,0,0,0,0,508,508,0,0,0,0,0,601,601,1109
10258,Ethiopia,2017,2017Ethiopia,0,0,0,0,0,4354,4354,0,0,0,0,0,13208,13208,17562
10259,Ethiopia,2017,2017Ethiopia,0,0,0,5,0,0,5,0,0,0,0,0,0,0,5
10260,Ethiopia,2017,2017Ethiopia,0,0,0,5,0,0,5,0,0,0,7,0,0,7,12
10261,Ethiopia,2017,2017Ethiopia,0,0,0,5,0,0,5,0,0,0,12,0,0,12,17
10262,Ethiopia,2017,2017Ethiopia,0,0,0,5,0,0,5,0,5,0,8,0,0,13,18
10263,Ethiopia,2017,2017Ethiopia,0,0,0,7,0,0,7,0,0,0,6,0,0,6,13
10264,Ethiopia,2017,2017Ethiopia,0,0,0,8,0,0,8,0,0,0,0,0,0,0,16
10265,Ethiopia,2017,2017Ethiopia,0,0,0,8,0,0,8,0,0,0,5,0,0,5,13
10266,Ethiopia,2017,2017Ethiopia,0,0,0,14,0,0,14,0,0,0,10,0,0,10,24
10267,Ethiopia,2017,2017Ethiopia,0,0,0,19,0,0,19,0,0,0,0,0,0,0,19
10268,Ethiopia,2017,2017Ethiopia,0,0,0,25,0,0,25,0,5,0,0,0,0,5,30
10269,Ethiopia,2017,2017Ethiopia,0,0,5,0,0,0,5,0,0,0,0,0,0,0,5
10270,Ethiopia,2017,2017Ethiopia,0,0,5,13,0,0,18,0,0,0,24,0,0,24,42
10271,Ethiopia,2017,2017Ethiopia,0,0,6,0,0,0,6,0,0,0,0,0,0,0,6
10272,Ethiopia,2017,2017Ethiopia,0,0,8,0,0,0,8,0,0,0,0,0,0,0,8
10273,Ethiopia,2017,2017Ethiopia,0,9,0,5,0,0,14,0,6,0,0,0,0,6,20
10274,Ethiopia,2017,2017Ethiopia,6,0,5,53,0,0,64,10,0,14,55,0,0,79,143
10275,Ethiopia,2017,2017Ethiopia,7,0,0,6,0,0,13,0,0,8,9,0,0,17,30
10276,Ethiopia,2017,2017Ethiopia,8,0,8,12,0,0,28,0,0,12,28,0,0,40,68
10277,Ethiopia,2017,2017Ethiopia,11,0,0,45,0,0,56,0,0,5,69,0,0,74,130
10278,Ethiopia,2017,2017Ethiopia,15,5,15,34,0,0,69,0,11,0,15,0,0,26,95
10279,Ethiopia,2017,2017Ethiopia,21,29,34,195,5,0,284,20,40,43,135,5,0,243,527
10280,Ethiopia,2017,2017Ethiopia,55,52,18,313,0,305,743,66,49,72,180,5,303,675,1418
10281,Ethiopia,2017,2017Ethiopia,87,101,96,533,12,0,829,99,126,91,780,19,0,1115,1944
10282,Ethiopia,2017,2017Ethiopia,100,365,337,1125,77,0,2004,122,307,399,1352,89,0,2269,4273
10283,Ethiopia,2017,2017Ethiopia,115,101,105,1088,0,0,1409,146,108,98,910,5,0,1267,2676
10284,Ethiopia,2017,2017Ethiopia,220,574,352,2000,25,0,3171,262,695,358,1655,64,0,3034,6205
10285,Ethiopia,2017,2017Ethiopia,241,101,69,1598,130,0,2139,249,114,113,1480,135,0,2091,4230
10286,Ethiopia,2017,2017Ethiopia,306,505,467,1102,66,0,2446,318,512,525,733,21,0,2109,4555
10287,Ethiopia,2017,2017Ethiopia,318,507,237,755,5,0,1822,294,506,240,722,24,0,1786,3608
10288,Ethiopia,2017,2017Ethiopia,1366,1684,1224,4017,185,0,8476,1411,1798,1368,4632,188,0,9397,17873
10289,Ethiopia,2018,2018Ethiopia,0,0,0,0,0,0,0,0,0,0,0,0,0,0,36891
10290,Ethiopia,2018,2018Ethiopia,0,0,0,0,0,0,0,0,0,0,5,0,0,5,35
10291,Ethiopia,2018,2018Ethiopia,0,0,0,0,0,0,0,0,0,0,6,0,0,6,6
10292,Ethiopia,2018,2018Ethiopia,0,0,0,0,0,0,0,0,0,0,7,0,0,7,7
10293,Ethiopia,2018,2018Ethiopia,0,0,0,0,0,0,0,0,0,0,9,0,0,9,9
10294,Ethiopia,2018,2018Ethiopia,0,0,0,0,0,643,643,0,0,0,0,0,780,780,1423
10295,Ethiopia,2018,2018Ethiopia,0,0,0,5,0,0,5,0,0,0,5,0,0,5,20
10296,Ethiopia,2018,2018Ethiopia,0,0,0,5,0,0,5,0,0,0,12,0,0,12,17
10297,Ethiopia,2018,2018Ethiopia,0,0,0,6,0,0,6,0,0,0,0,0,0,0,6
10298,Ethiopia,2018,2018Ethiopia,0,0,0,7,0,0,7,0,0,0,0,0,0,0,7
10299,Ethiopia,2018,2018Ethiopia,0,0,0,8,0,0,8,0,0,0,5,0,0,5,13
10300,Ethiopia,2018,2018Ethiopia,0,0,0,8,0,0,8,0,5,0,14,0,0,19,27
10301,Ethiopia,2018,2018Ethiopia,0,0,0,10,0,0,10,0,0,0,0,0,0,0,10
10302,Ethiopia,2018,2018Ethiopia,0,0,0,11,0,0,11,0,0,0,8,0,0,8,19
10303,Ethiopia,2018,2018Ethiopia,0,0,0,11,0,0,11,0,0,0,13,0,0,13,24
10304,Ethiopia,2018,2018Ethiopia,0,0,0,17,0,0,17,0,0,0,0,0,0,0,17
10305,Ethiopia,2018,2018Ethiopia,0,0,5,11,0,0,16,0,0,0,16,0,0,16,32
10306,Ethiopia,2018,2018Ethiopia,0,0,5,29,0,0,34,0,5,0,0,0,0,5,39
10307,Ethiopia,2018,2018Ethiopia,0,0,9,5,0,0,14,0,6,0,0,0,0,6,20
10308,Ethiopia,2018,2018Ethiopia,0,5,0,0,0,0,5,0,0,0,5,0,0,5,10
10309,Ethiopia,2018,2018Ethiopia,0,5,0,6,0,0,11,0,0,8,7,0,0,15,26
10310,Ethiopia,2018,2018Ethiopia,5,0,0,0,0,0,5,0,0,0,0,0,0,0,5
10311,Ethiopia,2018,2018Ethiopia,5,0,0,15,0,0,20,0,0,6,22,0,0,28,48
10312,Ethiopia,2018,2018Ethiopia,7,0,0,0,0,0,7,0,0,0,0,0,0,0,7
10313,Ethiopia,2018,2018Ethiopia,9,0,7,12,0,0,28,0,6,6,27,0,0,39,67
10314,Ethiopia,2018,2018Ethiopia,10,10,5,22,0,0,47,0,17,0,9,0,0,26,73
10315,Ethiopia,2018,2018Ethiopia,16,0,0,49,0,0,65,0,0,5,77,0,0,82,147
10316,Ethiopia,2018,2018Ethiopia,20,35,27,190,5,0,277,21,38,34,135,5,0,233,510
10317,Ethiopia,2018,2018Ethiopia,22,0,14,40,0,0,76,11,10,5,58,0,0,84,160
10318,Ethiopia,2018,2018Ethiopia,59,54,16,337,5,330,801,78,55,57,222,5,345,762,1563
10319,Ethiopia,2018,2018Ethiopia,97,113,80,451,12,0,753,106,121,92,616,20,0,955,1708
10320,Ethiopia,2018,2018Ethiopia,126,102,52,633,8,0,921,80,131,44,709,9,0,973,1900
10321,Ethiopia,2018,2018Ethiopia,130,336,333,1802,121,110,2832,163,370,287,2200,193,0,3213,6045
10322,Ethiopia,2018,2018Ethiopia,194,575,385,2077,28,0,3259,213,701,411,1796,68,0,3189,6448
10323,Ethiopia,2018,2018Ethiopia,195,127,105,1540,5,0,1972,211,142,108,1375,6,0,1842,3814
10324,Ethiopia,2018,2018Ethiopia,321,567,302,834,8,0,2032,306,542,294,778,29,0,1949,3981
10325,Ethiopia,2018,2018Ethiopia,338,128,81,1748,136,0,2431,322,149,113,1618,147,0,2349,4780
10326,Ethiopia,2018,2018Ethiopia,372,438,351,1025,70,0,2256,381,504,381,660,21,0,1947,4203
10327,Ethiopia,2018,2018Ethiopia,1348,1814,1229,4143,172,0,8706,1411,1866,1336,4604,192,0,9409,18115
10328,Ethiopia,2019,2019Ethiopia,0,0,0,0,0,0,0,0,0,0,0,0,0,0,36189
10329,Ethiopia,2019,2019Ethiopia,0,0,0,0,0,0,0,0,0,0,0,0,26,26,26
10330,Ethiopia,2019,2019Ethiopia,0,0,0,0,0,0,0,0,0,0,5,0,0,5,25
10331,Ethiopia,2019,2019Ethiopia,0,0,0,0,0,0,0,0,0,0,6,0,0,6,12
10332,Ethiopia,2019,2019Ethiopia,0,0,0,0,0,0,0,0,0,0,9,0,0,9,9
10333,Ethiopia,2019,2019Ethiopia,0,0,0,0,0,0,0,8,0,0,0,0,0,8,8
10334,Ethiopia,2019,2019Ethiopia,0,0,0,0,0,752,752,0,0,0,0,0,937,937,1689
10335,Ethiopia,2019,2019Ethiopia,0,0,0,5,0,0,5,0,0,0,8,0,0,8,13
10336,Ethiopia,2019,2019Ethiopia,0,0,0,5,0,0,5,0,0,0,12,0,0,12,17
10337,Ethiopia,2019,2019Ethiopia,0,0,0,6,0,0,6,0,0,0,0,0,0,0,6
10338,Ethiopia,2019,2019Ethiopia,0,0,0,6,0,0,6,0,0,0,5,0,0,5,11
10339,Ethiopia,2019,2019Ethiopia,0,0,0,7,0,0,7,0,0,0,0,0,0,0,7
10340,Ethiopia,2019,2019Ethiopia,0,0,0,8,0,0,8,0,0,0,6,0,0,6,14
10341,Ethiopia,2019,2019Ethiopia,0,0,0,8,0,0,8,0,0,5,9,5,0,19,27
10342,Ethiopia,2019,2019Ethiopia,0,0,0,12,0,0,12,0,0,0,0,0,0,0,12
10343,Ethiopia,2019,2019Ethiopia,0,0,0,12,0,0,12,0,0,0,6,0,0,6,18
10344,Ethiopia,2019,2019Ethiopia,0,0,0,15,0,0,15,0,0,0,0,0,0,0,15
10345,Ethiopia,2019,2019Ethiopia,0,0,0,17,0,0,17,0,0,0,17,0,0,17,34
10346,Ethiopia,2019,2019Ethiopia,0,0,0,26,0,0,26,0,0,5,0,0,0,5,31
10347,Ethiopia,2019,2019Ethiopia,0,0,5,0,0,0,5,0,0,0,5,0,0,5,10
10348,Ethiopia,2019,2019Ethiopia,0,0,7,5,0,0,12,0,0,6,0,0,0,6,18
10349,Ethiopia,2019,2019Ethiopia,0,5,0,0,0,0,5,5,0,0,5,0,0,10,15
10350,Ethiopia,2019,2019Ethiopia,0,6,0,8,0,0,14,0,6,0,0,0,0,6,20
10351,Ethiopia,2019,2019Ethiopia,0,8,0,0,0,0,8,0,0,0,0,0,0,0,8
10352,Ethiopia,2019,2019Ethiopia,5,0,0,0,0,0,5,0,0,0,0,0,0,0,5
10353,Ethiopia,2019,2019Ethiopia,5,0,0,16,0,0,21,0,0,5,12,0,0,17,38
10354,Ethiopia,2019,2019Ethiopia,8,0,0,0,0,0,8,0,0,0,0,0,0,0,8
10355,Ethiopia,2019,2019Ethiopia,8,0,5,15,0,0,28,0,11,0,32,0,0,43,71
10356,Ethiopia,2019,2019Ethiopia,15,41,34,213,5,0,308,23,39,43,158,10,0,273,581
10357,Ethiopia,2019,2019Ethiopia,26,5,0,32,0,0,63,6,12,5,46,0,0,69,132
10358,Ethiopia,2019,2019Ethiopia,63,55,16,346,5,0,485,88,47,39,257,5,0,436,1637
10359,Ethiopia,2019,2019Ethiopia,93,143,97,538,12,0,883,121,149,89,740,25,0,1124,2007
10360,Ethiopia,2019,2019Ethiopia,152,375,328,2079,151,0,3085,161,403,338,2502,215,0,3619,6704
10361,Ethiopia,2019,2019Ethiopia,175,593,405,2105,33,0,3311,182,704,449,1845,74,0,3254,6565
10362,Ethiopia,2019,2019Ethiopia,271,137,111,1865,5,0,2389,270,149,101,1681,9,0,2210,4599
10363,Ethiopia,2019,2019Ethiopia,338,602,329,921,10,0,2200,318,575,329,827,38,0,2087,4287
10364,Ethiopia,2019,2019Ethiopia,354,451,344,986,70,0,2205,383,505,402,552,18,0,1860,4065
10365,Ethiopia,2019,2019Ethiopia,395,169,86,1796,135,0,2581,370,184,84,1608,155,0,2401,4982
10366,Ethiopia,2019,2019Ethiopia,1406,1978,1285,4538,201,0,9408,1545,2022,1397,4948,232,0,10144,19552
10367,Ethiopia,2020,2020Ethiopia,0,0,0,0,0,0,0,0,0,0,0,0,0,0,19267
10368,Ethiopia,2020,2020Ethiopia,0,0,0,0,0,0,0,0,0,0,0,0,26,26,26
10369,Ethiopia,2020,2020Ethiopia,0,0,0,0,0,0,0,0,0,0,0,5,0,5,5
10370,Ethiopia,2020,2020Ethiopia,0,0,0,0,0,0,0,0,0,0,5,0,0,5,30
10371,Ethiopia,2020,2020Ethiopia,0,0,0,0,0,0,0,0,0,0,6,0,0,6,6
10372,Ethiopia,2020,2020Ethiopia,0,0,0,0,0,0,0,0,0,0,7,0,0,7,14
10373,Ethiopia,2020,2020Ethiopia,0,0,0,0,0,0,0,8,0,0,0,0,0,8,8
10374,Ethiopia,2020,2020Ethiopia,0,0,0,0,0,19,19,0,0,0,0,0,20,20,39
10375,Ethiopia,2020,2020Ethiopia,0,0,0,0,0,23,23,0,0,0,0,0,35,35,58
10376,Ethiopia,2020,2020Ethiopia,0,0,0,0,0,64,64,0,0,0,0,0,96,96,160
10377,Ethiopia,2020,2020Ethiopia,0,0,0,0,0,67,67,0,0,0,0,0,108,108,175
10378,Ethiopia,2020,2020Ethiopia,0,0,0,5,0,0,5,0,0,0,18,0,0,18,23
10379,Ethiopia,2020,2020Ethiopia,0,0,0,6,0,0,6,0,0,0,0,0,0,0,6
10380,Ethiopia,2020,2020Ethiopia,0,0,0,7,0,0,7,0,0,0,5,0,0,5,12
10381,Ethiopia,2020,2020Ethiopia,0,0,0,8,0,0,8,0,0,0,0,0,0,0,8
10382,Ethiopia,2020,2020Ethiopia,0,0,0,9,0,0,9,0,5,0,11,5,0,21,30
10383,Ethiopia,2020,2020Ethiopia,0,0,0,12,0,0,12,0,0,0,7,0,0,7,19
10384,Ethiopia,2020,2020Ethiopia,0,0,0,13,0,0,13,0,0,0,0,0,0,0,13
10385,Ethiopia,2020,2020Ethiopia,0,0,0,15,0,0,15,0,0,0,0,0,0,0,15
10386,Ethiopia,2020,2020Ethiopia,0,0,0,18,0,0,18,0,0,0,18,0,0,18,36
10387,Ethiopia,2020,2020Ethiopia,0,0,0,116,0,51,167,0,0,0,124,0,74,198,1420
10388,Ethiopia,2020,2020Ethiopia,0,0,5,0,0,0,5,0,0,0,6,0,0,6,11
10389,Ethiopia,2020,2020Ethiopia,0,0,5,6,0,0,11,0,0,7,0,0,0,7,18
10390,Ethiopia,2020,2020Ethiopia,0,0,8,0,0,0,8,0,0,0,0,0,0,0,8
10391,Ethiopia,2020,2020Ethiopia,0,0,9,0,0,0,9,0,0,6,0,0,0,6,15
10392,Ethiopia,2020,2020Ethiopia,0,5,0,0,0,0,5,0,0,0,0,0,0,0,5
10393,Ethiopia,2020,2020Ethiopia,0,5,0,0,0,0,5,0,5,0,5,0,0,10,15
10394,Ethiopia,2020,2020Ethiopia,0,6,0,28,0,0,34,0,0,5,0,0,0,5,39
10395,Ethiopia,2020,2020Ethiopia,0,7,5,16,0,0,28,0,5,6,32,0,0,43,71
10396,Ethiopia,2020,2020Ethiopia,0,8,0,0,0,0,8,0,0,0,0,0,0,0,8
10397,Ethiopia,2020,2020Ethiopia,5,0,0,11,0,0,16,0,0,0,9,0,0,9,25
10398,Ethiopia,2020,2020Ethiopia,5,0,0,16,0,0,21,0,5,0,24,0,0,29,50
10399,Ethiopia,2020,2020Ethiopia,8,0,0,0,0,0,8,0,0,0,0,0,0,0,8
10400,Ethiopia,2020,2020Ethiopia,23,7,0,34,0,0,64,14,6,0,51,0,0,71,135
10401,Ethiopia,2020,2020Ethiopia,35,96,68,405,10,0,614,55,98,93,541,12,0,799,1413
10402,Ethiopia,2020,2020Ethiopia,46,422,120,3535,5,0,4128,64,464,129,10822,22,0,11501,15629
10403,Ethiopia,2020,2020Ethiopia,72,67,20,344,5,0,508,98,52,31,283,6,0,470,1748
10404,Ethiopia,2020,2020Ethiopia,98,145,103,607,14,0,967,122,159,93,854,27,0,1255,2222
10405,Ethiopia,2020,2020Ethiopia,135,585,458,2137,40,0,3355,144,669,489,1901,86,0,3289,6644
10406,Ethiopia,2020,2020Ethiopia,285,159,111,2146,5,0,2706,292,179,104,2005,10,0,2590,5296
10407,Ethiopia,2020,2020Ethiopia,304,545,361,917,15,0,2142,308,542,348,798,39,0,2035,4177
10408,Ethiopia,2020,2020Ethiopia,369,441,364,1025,79,0,2278,395,493,422,582,24,0,1916,4194
10409,Ethiopia,2020,2020Ethiopia,490,260,82,1856,148,0,2836,434,258,71,1621,160,0,2544,5385
10410,Ethiopia,2020,2020Ethiopia,798,2247,3101,15797,1862,0,23805,1153,2814,3692,27493,3541,0,38693,62498
10411,Ethiopia,2020,2020Ethiopia,1282,2148,1400,4775,213,0,9818,1398,2210,1499,5277,240,0,10624,20442
10412,Ethiopia,2021,2021Ethiopia,0,0,0,0,0,0,0,0,0,0,0,0,0,0,19849
10413,Ethiopia,2021,2021Ethiopia,0,0,0,0,0,0,0,0,0,0,0,0,5,5,5
10414,Ethiopia,2021,2021Ethiopia,0,0,0,0,0,0,0,0,0,0,5,0,0,5,30
10415,Ethiopia,2021,2021Ethiopia,0,0,0,0,0,0,0,0,0,0,6,0,0,6,12
10416,Ethiopia,2021,2021Ethiopia,0,0,0,0,0,0,0,0,0,0,7,0,0,7,14
10417,Ethiopia,2021,2021Ethiopia,0,0,0,0,0,0,0,0,0,0,24,0,0,24,24
10418,Ethiopia,2021,2021Ethiopia,0,0,0,0,0,0,0,8,0,0,0,0,0,8,8
10419,Ethiopia,2021,2021Ethiopia,0,0,0,0,0,5,5,0,0,0,0,0,21,21,26
10420,Ethiopia,2021,2021Ethiopia,0,0,0,5,0,0,5,0,0,0,0,0,0,0,5
10421,Ethiopia,2021,2021Ethiopia,0,0,0,6,0,0,6,0,0,0,0,0,0,0,6
10422,Ethiopia,2021,2021Ethiopia,0,0,0,6,0,0,6,0,0,0,6,0,0,6,12
10423,Ethiopia,2021,2021Ethiopia,0,0,0,7,0,0,7,0,0,0,5,0,0,5,12
10424,Ethiopia,2021,2021Ethiopia,0,0,0,8,0,0,8,0,0,0,0,0,0,0,16
10425,Ethiopia,2021,2021Ethiopia,0,0,0,12,0,0,12,0,0,0,0,0,0,0,12
10426,Ethiopia,2021,2021Ethiopia,0,0,0,12,0,0,12,0,0,0,7,0,0,7,19
10427,Ethiopia,2021,2021Ethiopia,0,0,0,19,0,0,19,0,0,0,0,0,0,0,19
10428,Ethiopia,2021,2021Ethiopia,0,0,0,25,5,0,30,0,0,0,28,0,0,28,58
10429,Ethiopia,2021,2021Ethiopia,0,0,5,0,0,0,5,0,0,0,7,0,0,7,12
10430,Ethiopia,2021,2021Ethiopia,0,0,5,0,0,0,5,0,5,0,5,0,0,10,15
10431,Ethiopia,2021,2021Ethiopia,0,0,7,5,0,0,12,0,0,0,11,0,0,11,23
10432,Ethiopia,2021,2021Ethiopia,0,0,8,0,0,0,8,0,0,0,0,0,0,0,8
10433,Ethiopia,2021,2021Ethiopia,0,5,0,31,0,0,36,0,0,5,5,0,0,10,46
10434,Ethiopia,2021,2021Ethiopia,0,6,5,15,0,0,26,0,5,5,31,0,0,41,67
10435,Ethiopia,2021,2021Ethiopia,0,8,0,0,0,0,8,0,0,0,0,0,0,0,8
10436,Ethiopia,2021,2021Ethiopia,0,8,0,6,0,0,14,0,5,0,20,5,0,30,44
10437,Ethiopia,2021,2021Ethiopia,5,0,0,0,0,0,5,0,0,0,0,0,0,0,5
10438,Ethiopia,2021,2021Ethiopia,5,0,0,0,0,0,5,6,0,0,0,0,0,6,11
10439,Ethiopia,2021,2021Ethiopia,5,0,0,7,0,0,12,5,0,0,13,0,0,18,30
10440,Ethiopia,2021,2021Ethiopia,5,0,0,17,0,0,22,5,0,0,5,0,0,10,32
10441,Ethiopia,2021,2021Ethiopia,11,361,197,3500,0,0,4069,12,404,201,10556,42,0,11215,15284
10442,Ethiopia,2021,2021Ethiopia,14,29,16,286,10,51,406,12,25,17,335,5,73,467,1715
10443,Ethiopia,2021,2021Ethiopia,22,13,0,25,0,0,60,13,8,0,44,0,0,65,125
10444,Ethiopia,2021,2021Ethiopia,64,134,92,589,11,0,890,84,130,144,891,19,0,1268,2158
10445,Ethiopia,2021,2021Ethiopia,71,64,28,348,5,0,516,87,68,21,290,8,0,474,1781
10446,Ethiopia,2021,2021Ethiopia,98,174,115,738,14,0,1139,114,189,111,1110,28,0,1552,2691
10447,Ethiopia,2021,2021Ethiopia,126,530,467,2133,35,0,3291,151,602,518,1819,85,0,3175,6466
10448,Ethiopia,2021,2021Ethiopia,324,561,393,989,15,0,2282,307,539,387,826,59,0,2118,4400
10449,Ethiopia,2021,2021Ethiopia,373,176,102,2159,5,0,2815,399,201,100,2063,11,0,2774,5589
10450,Ethiopia,2021,2021Ethiopia,419,422,365,1093,92,0,2391,442,466,428,771,34,0,2141,4532
10451,Ethiopia,2021,2021Ethiopia,536,469,84,2162,146,0,3397,537,490,75,1839,170,0,3111,6508
10452,Ethiopia,2021,2021Ethiopia,1293,2155,1389,4888,210,0,9935,1421,2225,1447,5372,247,0,10712,20647
10453,Ethiopia,2021,2021Ethiopia,2458,3106,2699,13721,1075,0,23059,2631,3411,3240,22830,1635,0,33747,56806
10454,Gambia,2001,2001Gambia,0,0,0,0,0,0,0,0,0,0,0,0,0,0,670
10455,Gambia,2001,2001Gambia,0,0,0,0,0,0,0,0,0,5,0,0,0,5,5
10456,Gambia,2001,2001Gambia,0,0,0,0,0,14,14,0,0,0,0,0,30,30,44
10457,Gambia,2001,2001Gambia,0,0,0,5,0,0,5,0,0,0,8,0,0,8,13
10458,Gambia,2002,2002Gambia,0,0,0,0,0,0,0,0,0,0,0,0,0,0,795
10459,Gambia,2002,2002Gambia,0,0,0,0,0,0,0,0,0,5,0,0,0,5,5
10460,Gambia,2002,2002Gambia,0,0,0,0,0,15,15,0,0,0,0,0,29,29,44
10461,Gambia,2002,2002Gambia,0,0,0,5,0,0,5,0,0,0,9,0,0,9,14
10462,Gambia,2003,2003Gambia,0,0,0,0,0,0,0,0,0,0,0,0,0,0,678
10463,Gambia,2003,2003Gambia,0,0,0,0,0,5,5,0,0,0,0,0,7,7,12
10464,Gambia,2003,2003Gambia,0,0,0,0,0,11,11,0,0,0,0,0,29,29,40
10465,Gambia,2003,2003Gambia,0,5,0,0,0,0,5,0,0,0,9,0,0,9,14
10466,Gambia,2004,2004Gambia,0,0,0,0,0,0,0,0,0,0,0,0,0,0,656
10467,Gambia,2004,2004Gambia,0,0,0,0,0,5,5,0,0,0,0,0,6,6,11
10468,Gambia,2004,2004Gambia,0,0,0,5,0,0,5,0,0,0,12,0,0,12,17
10469,Gambia,2005,2005Gambia,0,0,0,0,0,0,0,0,0,0,0,0,0,0,1608
10470,Gambia,2005,2005Gambia,0,0,0,0,0,5,5,0,0,0,0,0,6,6,11
10471,Gambia,2005,2005Gambia,0,0,0,0,0,12,12,0,0,0,0,0,32,32,44
10472,Gambia,2005,2005Gambia,0,0,0,5,0,0,5,0,0,0,12,0,0,12,17
10473,Gambia,2006,2006Gambia,0,0,0,0,0,0,0,0,0,0,0,0,0,0,1174
10474,Gambia,2006,2006Gambia,0,0,0,0,0,0,0,0,0,0,14,0,0,14,14
10475,Gambia,2006,2006Gambia,0,0,0,0,0,5,5,0,0,0,0,0,11,11,16
10476,Gambia,2006,2006Gambia,0,0,0,0,0,12,12,0,0,0,0,0,33,33,45
10477,Gambia,2007,2007Gambia,0,0,0,0,0,0,0,0,0,0,0,0,0,0,1180
10478,Gambia,2007,2007Gambia,0,0,0,0,0,6,6,0,0,0,0,0,12,12,18
10479,Gambia,2007,2007Gambia,0,0,0,0,0,11,11,0,0,0,0,0,33,33,44
10480,Gambia,2007,2007Gambia,0,0,0,5,0,0,5,0,0,0,10,0,0,10,15
10481,Gambia,2008,2008Gambia,0,0,0,0,0,0,0,0,0,0,0,0,0,0,1262
10482,Gambia,2008,2008Gambia,0,0,0,0,0,7,7,0,0,0,0,0,14,14,21
10483,Gambia,2008,2008Gambia,0,0,0,0,0,19,19,0,0,0,0,0,34,34,53
10484,Gambia,2009,2009Gambia,0,0,0,0,0,0,0,0,0,0,0,0,0,0,1462
10485,Gambia,2009,2009Gambia,0,0,0,0,0,0,0,0,0,0,5,0,0,5,10
10486,Gambia,2009,2009Gambia,0,0,0,0,0,9,9,0,5,0,0,0,11,16,25
10487,Gambia,2009,2009Gambia,7,0,15,34,0,0,56,5,6,7,386,9,0,413,469
10488,Gambia,2010,2010Gambia,0,0,0,0,0,0,0,0,0,0,0,0,0,0,1637
10489,Gambia,2010,2010Gambia,0,0,0,0,0,0,0,0,0,0,5,0,0,5,10
10490,Gambia,2010,2010Gambia,0,0,0,0,0,9,9,0,0,5,5,0,11,21,30
10491,Gambia,2010,2010Gambia,0,0,0,0,0,45,45,0,0,0,0,0,42,42,87
10492,Gambia,2010,2010Gambia,6,5,13,41,0,0,65,5,7,6,376,10,0,404,469
10493,Gambia,2011,2011Gambia,0,0,0,0,0,0,0,0,0,0,0,0,0,0,1895
10494,Gambia,2011,2011Gambia,0,0,0,0,0,0,0,0,0,0,5,0,0,5,10
10495,Gambia,2011,2011Gambia,0,0,0,0,0,8,8,0,0,0,6,0,14,20,28
10496,Gambia,2011,2011Gambia,0,0,0,0,0,61,61,0,0,0,0,0,49,49,110
10497,Gambia,2011,2011Gambia,0,0,0,5,0,0,5,0,0,0,9,0,0,9,51
10498,Gambia,2011,2011Gambia,0,5,0,0,0,0,5,0,0,0,0,0,0,0,5
10499,Gambia,2011,2011Gambia,7,8,15,50,0,0,80,5,6,5,367,10,0,393,473
10500,Gambia,2012,2012Gambia,0,0,0,0,0,0,0,0,0,0,0,0,0,0,2340
10501,Gambia,2012,2012Gambia,0,0,0,0,0,0,0,0,0,0,5,0,0,5,64
10502,Gambia,2012,2012Gambia,0,0,0,0,0,8,8,0,0,5,6,0,13,24,32
10503,Gambia,2012,2012Gambia,0,0,0,0,0,67,67,0,0,0,0,0,53,53,120
10504,Gambia,2012,2012Gambia,0,5,0,0,0,0,5,0,0,0,0,0,0,0,5
10505,Gambia,2012,2012Gambia,7,12,10,62,0,0,91,5,6,5,380,15,0,411,502
10506,Gambia,2013,2013Gambia,0,0,0,0,0,0,0,0,0,0,0,0,0,0,2985
10507,Gambia,2013,2013Gambia,0,0,0,0,0,0,0,0,0,0,5,0,0,5,10
10508,Gambia,2013,2013Gambia,0,0,0,0,0,0,0,0,0,0,9,0,0,9,9
10509,Gambia,2013,2013Gambia,0,0,0,0,0,8,8,0,0,5,9,0,13,27,35
10510,Gambia,2013,2013Gambia,0,0,0,0,0,80,80,0,0,0,0,0,60,60,140
10511,Gambia,2013,2013Gambia,0,5,0,0,0,0,5,0,0,0,0,0,0,0,5
10512,Gambia,2013,2013Gambia,0,5,0,5,0,0,10,0,0,5,10,0,0,15,72
10513,Gambia,2013,2013Gambia,6,8,5,42,0,0,61,0,8,0,57,0,0,65,126
10514,Gambia,2014,2014Gambia,0,0,0,0,0,0,0,0,0,0,0,0,0,0,4625
10515,Gambia,2014,2014Gambia,0,0,0,0,0,0,0,0,0,0,0,0,5,5,5
10516,Gambia,2014,2014Gambia,0,0,0,0,0,0,0,0,0,0,5,0,0,5,10
10517,Gambia,2014,2014Gambia,0,0,0,0,0,0,0,0,0,0,9,0,0,9,78
10518,Gambia,2014,2014Gambia,0,0,0,0,0,0,0,0,5,0,0,0,0,5,5
10519,Gambia,2014,2014Gambia,0,0,0,0,0,97,97,0,0,0,0,0,67,67,164
10520,Gambia,2014,2014Gambia,0,0,0,5,0,0,5,0,0,0,31,0,0,31,36
10521,Gambia,2014,2014Gambia,0,0,0,5,0,6,11,0,0,6,18,0,15,39,50
10522,Gambia,2014,2014Gambia,0,5,0,0,0,0,5,0,0,0,0,0,0,0,5
10523,Gambia,2014,2014Gambia,7,10,0,47,0,0,64,5,5,0,70,0,0,80,144
10524,Gambia,2015,2015Gambia,0,0,0,0,0,0,0,0,0,0,0,0,0,0,7977
10525,Gambia,2015,2015Gambia,0,0,0,0,0,0,0,0,0,0,0,0,5,5,5
10526,Gambia,2015,2015Gambia,0,0,0,0,0,0,0,0,0,0,6,0,0,6,6
10527,Gambia,2015,2015Gambia,0,0,0,0,0,5,5,0,0,0,0,0,5,5,10
10528,Gambia,2015,2015Gambia,0,0,0,0,0,114,114,0,0,0,0,0,70,70,184
10529,Gambia,2015,2015Gambia,0,0,0,5,0,17,22,0,0,0,20,0,8,28,50
10530,Gambia,2015,2015Gambia,0,0,0,11,0,0,11,0,0,0,58,0,0,58,69
10531,Gambia,2015,2015Gambia,7,11,0,58,0,0,76,0,6,7,83,0,0,96,172
10532,Gambia,2016,2016Gambia,0,0,0,0,0,0,0,0,0,0,0,0,0,0,10888
10533,Gambia,2016,2016Gambia,0,0,0,0,0,0,0,0,0,0,0,0,6,6,6
10534,Gambia,2016,2016Gambia,0,0,0,0,0,0,0,0,0,0,5,0,0,5,10
10535,Gambia,2016,2016Gambia,0,0,0,0,0,0,0,0,0,0,6,0,0,6,6
10536,Gambia,2016,2016Gambia,0,0,0,0,0,0,0,5,0,0,0,0,0,5,5
10537,Gambia,2016,2016Gambia,0,0,0,0,0,7,7,0,0,0,0,0,8,8,15
10538,Gambia,2016,2016Gambia,0,0,0,0,0,128,128,0,0,0,0,0,82,82,210
10539,Gambia,2016,2016Gambia,0,0,0,5,0,8,13,0,0,0,19,0,16,35,48
10540,Gambia,2016,2016Gambia,0,0,0,7,0,0,7,0,0,0,10,0,0,10,73
10541,Gambia,2016,2016Gambia,0,0,0,14,0,0,14,0,0,0,82,0,0,82,96
10542,Gambia,2016,2016Gambia,0,5,0,0,0,0,5,0,0,0,0,0,0,0,5
10543,Gambia,2016,2016Gambia,8,11,5,66,0,0,90,5,6,0,126,0,0,137,227
10544,Gambia,2017,2017Gambia,0,0,0,0,0,0,0,0,0,0,0,0,0,0,13643
10545,Gambia,2017,2017Gambia,0,0,0,0,0,0,0,0,0,0,5,0,0,5,10
10546,Gambia,2017,2017Gambia,0,0,0,0,0,0,0,0,0,0,44,0,0,44,44
10547,Gambia,2017,2017Gambia,0,0,0,0,0,0,0,0,5,0,0,0,0,5,5
10548,Gambia,2017,2017Gambia,0,0,0,0,0,158,158,0,0,0,0,0,94,94,252
10549,Gambia,2017,2017Gambia,0,0,0,5,0,15,20,0,0,0,20,0,6,26,46
10550,Gambia,2017,2017Gambia,0,0,6,0,0,0,6,0,0,0,0,0,0,0,6
10551,Gambia,2017,2017Gambia,20,18,10,147,0,0,195,22,21,20,300,0,0,363,558
10552,Gambia,2018,2018Gambia,0,0,0,0,0,0,0,0,0,0,0,0,0,0,15887
10553,Gambia,2018,2018Gambia,0,0,0,0,0,0,0,0,0,0,5,0,0,5,5
10554,Gambia,2018,2018Gambia,0,0,0,0,0,0,0,0,0,0,7,0,0,7,7
10555,Gambia,2018,2018Gambia,0,0,0,0,0,0,0,0,0,0,10,0,0,10,10
10556,Gambia,2018,2018Gambia,0,0,0,0,0,185,185,0,0,0,0,0,101,101,286
10557,Gambia,2018,2018Gambia,0,0,0,5,0,7,12,0,0,5,19,0,16,40,52
10558,Gambia,2018,2018Gambia,0,5,0,10,0,0,15,0,0,0,21,0,0,21,91
10559,Gambia,2018,2018Gambia,56,34,14,244,0,0,348,36,30,35,450,0,0,551,899
10560,Gambia,2019,2019Gambia,0,0,0,0,0,0,0,0,0,0,0,0,0,0,16374
10561,Gambia,2019,2019Gambia,0,0,0,0,0,0,0,0,0,0,7,0,0,7,7
10562,Gambia,2019,2019Gambia,0,0,0,0,0,0,0,0,0,0,10,0,0,10,10
10563,Gambia,2019,2019Gambia,0,0,0,0,0,0,0,0,0,5,0,0,0,5,5
10564,Gambia,2019,2019Gambia,0,0,0,0,0,0,0,0,0,5,26,0,0,31,52
10565,Gambia,2019,2019Gambia,0,0,0,0,0,210,210,0,0,0,0,0,123,123,333
10566,Gambia,2019,2019Gambia,60,43,15,277,0,0,395,49,30,25,533,0,0,637,1032
10567,Gambia,2020,2020Gambia,0,0,0,0,0,0,0,0,0,0,0,0,0,0,9268
10568,Gambia,2020,2020Gambia,0,0,0,0,0,0,0,0,0,0,0,0,6,6,6
10569,Gambia,2020,2020Gambia,0,0,0,0,0,0,0,0,0,0,7,0,0,7,7
10570,Gambia,2020,2020Gambia,0,0,0,0,0,0,0,0,0,0,19,0,0,19,19
10571,Gambia,2020,2020Gambia,0,0,0,0,0,0,0,0,5,0,0,0,0,5,5
10572,Gambia,2020,2020Gambia,0,0,0,0,0,13,13,0,0,0,0,0,18,18,31
10573,Gambia,2020,2020Gambia,0,0,0,5,0,0,5,0,0,0,30,0,0,30,54
10574,Gambia,2020,2020Gambia,70,58,14,311,0,0,453,56,39,21,610,5,0,731,1189
10575,Gambia,2021,2021Gambia,0,0,0,0,0,0,0,0,0,0,0,0,0,0,9478
10576,Gambia,2021,2021Gambia,0,0,0,0,0,0,0,0,0,0,5,0,0,5,5
10577,Gambia,2021,2021Gambia,0,0,0,0,0,0,0,0,5,0,0,0,0,5,5
10578,Gambia,2021,2021Gambia,0,0,0,5,0,0,5,0,0,0,28,0,0,28,53
10579,Gambia,2021,2021Gambia,0,0,0,6,0,0,6,0,0,5,20,0,0,25,31
10580,Gambia,2021,2021Gambia,0,0,0,13,0,0,13,0,0,0,19,0,0,19,101
10581,Gambia,2021,2021Gambia,93,71,20,354,0,0,538,64,54,27,681,5,0,831,1369
10582,Georgia,2001,2001Georgia,0,0,0,0,0,0,0,0,0,0,0,0,0,0,16929
10583,Georgia,2001,2001Georgia,0,0,0,0,0,9,9,0,0,0,0,0,12,12,21
10584,Georgia,2001,2001Georgia,0,0,0,0,0,9,9,0,0,0,0,0,13,13,22
10585,Georgia,2001,2001Georgia,0,0,0,0,0,188,188,0,0,0,0,0,151,151,339
10586,Georgia,2001,2001Georgia,0,0,7,29,5,0,41,0,6,0,8,5,0,19,60
10587,Georgia,2001,2001Georgia,0,5,11,36,5,0,57,0,5,10,42,5,0,62,119
10588,Georgia,2002,2002Georgia,0,0,0,0,0,0,0,0,0,0,0,0,0,0,16332
10589,Georgia,2002,2002Georgia,0,0,0,0,0,0,0,0,0,0,0,0,5,5,37
10590,Georgia,2002,2002Georgia,0,0,0,0,0,228,228,0,0,0,0,0,188,188,416
10591,Georgia,2002,2002Georgia,0,0,7,25,11,0,43,0,6,0,15,5,0,26,69
10592,Georgia,2002,2002Georgia,0,11,5,35,5,0,56,0,6,9,40,5,0,60,116
10593,Georgia,2003,2003Georgia,0,0,0,0,0,0,0,0,0,0,0,0,0,0,11555
10594,Georgia,2003,2003Georgia,0,0,0,0,0,0,0,0,0,0,0,0,9,9,48
10595,Georgia,2003,2003Georgia,0,0,0,0,0,339,339,0,0,0,0,0,309,309,648
10596,Georgia,2003,2003Georgia,0,0,0,6,0,0,6,0,0,0,0,0,0,0,23
10597,Georgia,2003,2003Georgia,0,0,6,39,11,0,56,0,6,6,25,5,0,42,98
10598,Georgia,2003,2003Georgia,0,7,7,36,6,0,56,0,8,7,40,5,0,60,116
10599,Georgia,2004,2004Georgia,0,0,0,0,0,0,0,0,0,0,0,0,0,0,6357
10600,Georgia,2004,2004Georgia,0,0,0,0,0,0,0,0,0,0,0,0,5,5,5
10601,Georgia,2004,2004Georgia,0,0,0,0,0,0,0,0,0,0,5,0,0,5,5
10602,Georgia,2004,2004Georgia,0,0,0,9,0,0,9,0,0,0,0,0,0,0,9
10603,Georgia,2004,2004Georgia,0,0,5,13,0,5,23,0,5,5,13,0,5,28,51
10604,Georgia,2004,2004Georgia,0,5,6,33,5,0,49,0,6,6,20,5,0,37,86
10605,Georgia,2004,2004Georgia,0,5,7,40,5,0,57,0,12,0,33,5,0,50,107
10606,Georgia,2005,2005Georgia,0,0,0,0,0,0,0,0,0,0,0,0,0,0,5482
10607,Georgia,2005,2005Georgia,0,0,0,0,0,0,0,0,0,0,0,0,5,5,10
10608,Georgia,2005,2005Georgia,0,0,0,0,0,0,0,0,0,0,5,0,0,5,5
10609,Georgia,2005,2005Georgia,0,0,0,0,0,782,782,0,0,0,0,0,734,734,1516
10610,Georgia,2005,2005Georgia,0,0,6,19,0,5,30,0,7,6,22,0,5,40,70
10611,Georgia,2005,2005Georgia,0,6,6,31,5,0,48,0,6,6,21,0,0,33,81
10612,Georgia,2005,2005Georgia,0,8,5,51,5,0,69,0,12,0,39,5,0,56,125
10613,Georgia,2006,2006Georgia,0,0,0,0,0,0,0,0,0,0,0,0,0,0,4297
10614,Georgia,2006,2006Georgia,0,0,0,0,0,0,0,0,0,0,5,0,0,5,10
10615,Georgia,2006,2006Georgia,0,0,0,0,0,5,5,0,0,0,0,0,5,5,10
10616,Georgia,2006,2006Georgia,0,0,0,0,0,16,16,0,0,0,0,0,15,15,31
10617,Georgia,2006,2006Georgia,0,0,0,0,0,19,19,0,0,0,0,0,20,20,39
10618,Georgia,2006,2006Georgia,0,0,0,0,0,36,36,0,0,0,0,0,45,45,81
10619,Georgia,2006,2006Georgia,0,0,0,0,0,46,46,0,0,0,0,0,34,34,80
10620,Georgia,2006,2006Georgia,0,0,0,0,0,880,880,0,0,0,0,0,788,788,1668
10621,Georgia,2006,2006Georgia,0,0,5,56,0,0,61,0,5,5,50,0,0,60,121
10622,Georgia,2007,2007Georgia,0,0,0,0,0,0,0,0,0,0,0,0,0,0,4689
10623,Georgia,2007,2007Georgia,0,0,0,0,0,0,0,0,0,0,5,0,0,5,10
10624,Georgia,2007,2007Georgia,0,0,0,0,0,11,11,0,0,0,0,0,8,8,19
10625,Georgia,2007,2007Georgia,0,0,0,0,0,46,46,0,0,0,0,0,33,33,5079
10626,Georgia,2007,2007Georgia,0,0,0,0,0,946,946,0,0,0,0,0,840,840,1786
10627,Georgia,2007,2007Georgia,0,0,0,5,0,0,5,0,0,0,5,0,0,5,10
10628,Georgia,2007,2007Georgia,0,0,0,7,0,0,7,0,0,0,8,0,0,8,15
10629,Georgia,2007,2007Georgia,0,0,5,56,0,0,61,0,5,0,57,0,0,62,123
10630,Georgia,2007,2007Georgia,6,5,0,18,5,0,34,0,7,7,21,0,5,40,74
10631,Georgia,2008,2008Georgia,0,0,0,0,0,0,0,0,0,0,0,0,0,0,5416
10632,Georgia,2008,2008Georgia,0,0,0,0,0,0,0,0,0,0,5,0,0,5,5
10633,Georgia,2008,2008Georgia,0,0,0,0,0,9,9,0,0,0,0,0,8,8,17
10634,Georgia,2008,2008Georgia,0,0,0,0,0,995,995,0,0,0,0,0,894,894,1889
10635,Georgia,2008,2008Georgia,0,0,0,7,0,0,7,0,0,0,8,0,0,8,15
10636,Georgia,2008,2008Georgia,0,0,0,9,0,0,9,0,0,0,0,0,0,0,9
10637,Georgia,2008,2008Georgia,0,0,5,47,5,0,57,0,0,0,48,0,0,48,105
10638,Georgia,2008,2008Georgia,0,0,7,33,5,0,45,0,0,11,15,5,0,31,5076
10639,Georgia,2008,2008Georgia,5,0,5,16,5,0,31,0,5,5,19,0,5,34,65
10640,Georgia,2009,2009Georgia,0,0,0,0,0,0,0,0,0,0,0,0,0,0,12842
10641,Georgia,2009,2009Georgia,0,0,0,0,0,0,0,0,0,0,5,0,0,5,5
10642,Georgia,2009,2009Georgia,0,0,0,0,0,7,7,0,0,0,0,0,7,7,14
10643,Georgia,2009,2009Georgia,0,0,0,5,0,0,5,0,0,0,5,0,0,5,10
10644,Georgia,2009,2009Georgia,0,0,0,7,0,0,7,0,0,0,8,0,0,8,15
10645,Georgia,2009,2009Georgia,0,0,0,8,0,0,8,0,0,0,0,0,0,0,8
10646,Georgia,2009,2009Georgia,0,0,5,44,5,0,54,0,0,0,46,0,0,46,100
10647,Georgia,2009,2009Georgia,0,7,5,25,0,0,37,0,5,6,25,0,5,41,78
10648,Georgia,2009,2009Georgia,14,74,100,701,155,0,1044,10,64,114,621,90,0,899,1943
10649,Georgia,2010,2010Georgia,0,0,0,0,0,0,0,0,0,0,0,0,0,0,5638
10650,Georgia,2010,2010Georgia,0,0,0,0,0,0,0,0,0,0,8,0,0,8,8
10651,Georgia,2010,2010Georgia,0,0,0,0,0,10,10,0,0,0,0,0,9,9,19
10652,Georgia,2010,2010Georgia,0,0,0,0,0,42,42,0,0,0,0,0,29,29,571
10653,Georgia,2010,2010Georgia,0,0,0,0,0,1111,1111,0,0,0,0,0,1042,1042,2153
10654,Georgia,2010,2010Georgia,0,0,0,5,0,0,5,0,0,0,5,0,0,5,10
10655,Georgia,2010,2010Georgia,0,0,0,6,0,0,6,0,0,0,5,0,0,5,11
10656,Georgia,2010,2010Georgia,0,0,0,7,0,0,7,0,0,0,8,0,0,8,15
10657,Georgia,2010,2010Georgia,0,0,5,41,5,0,51,0,0,0,45,0,0,45,96
10658,Georgia,2010,2010Georgia,0,8,0,22,0,5,35,5,0,6,25,0,5,41,76
10659,Georgia,2010,2010Georgia,5,0,0,0,0,0,5,0,0,0,0,0,0,0,5
10660,Georgia,2010,2010Georgia,12,67,95,742,173,0,1089,13,55,111,667,99,0,945,2034
10661,Georgia,2011,2011Georgia,0,0,0,0,0,0,0,0,0,0,0,0,0,0,5013
10662,Georgia,2011,2011Georgia,0,0,0,0,0,0,0,0,0,0,8,0,0,8,8
10663,Georgia,2011,2011Georgia,0,0,0,0,0,8,8,0,0,0,0,0,11,11,19
10664,Georgia,2011,2011Georgia,0,0,0,0,0,1147,1147,0,0,0,0,0,1102,1102,2249
10665,Georgia,2011,2011Georgia,0,0,0,5,0,0,5,0,0,0,5,0,0,5,10
10666,Georgia,2011,2011Georgia,0,0,0,6,0,0,6,0,0,0,5,0,0,5,11
10667,Georgia,2011,2011Georgia,0,0,0,6,0,0,6,0,0,0,9,0,0,9,15
10668,Georgia,2011,2011Georgia,0,0,5,50,0,0,55,0,0,0,39,0,0,39,94
10669,Georgia,2011,2011Georgia,0,0,9,23,0,0,32,0,5,5,32,0,0,42,506
10670,Georgia,2011,2011Georgia,0,9,0,23,0,5,37,0,5,5,27,0,6,43,80
10671,Georgia,2011,2011Georgia,5,0,0,0,0,0,5,0,0,0,0,0,0,0,5
10672,Georgia,2011,2011Georgia,14,60,108,736,196,0,1114,13,54,105,700,119,0,991,2105
10673,Georgia,2012,2012Georgia,0,0,0,0,0,0,0,0,0,0,0,0,0,0,3820
10674,Georgia,2012,2012Georgia,0,0,0,0,0,0,0,0,0,0,5,0,0,5,5
10675,Georgia,2012,2012Georgia,0,0,0,0,0,0,0,5,0,0,0,0,0,5,5
10676,Georgia,2012,2012Georgia,0,0,0,0,0,10,10,0,0,0,0,0,16,16,26
10677,Georgia,2012,2012Georgia,0,0,0,0,0,14,14,0,0,0,0,0,18,18,32
10678,Georgia,2012,2012Georgia,0,0,0,0,0,38,38,0,0,0,0,0,28,28,66
10679,Georgia,2012,2012Georgia,0,0,0,0,0,1219,1219,0,0,0,0,0,1172,1172,2391
10680,Georgia,2012,2012Georgia,0,0,0,5,0,0,5,0,0,0,5,0,0,5,10
10681,Georgia,2012,2012Georgia,0,0,0,6,0,0,6,0,0,0,9,0,0,9,15
10682,Georgia,2012,2012Georgia,0,0,0,8,0,0,8,0,0,0,0,0,0,0,8
10683,Georgia,2012,2012Georgia,0,0,0,10,0,0,10,0,0,0,15,0,0,15,504
10684,Georgia,2012,2012Georgia,0,0,0,46,5,0,51,0,0,0,41,0,0,41,92
10685,Georgia,2012,2012Georgia,0,5,5,21,0,6,37,0,6,5,29,0,8,48,85
10686,Georgia,2012,2012Georgia,5,0,0,0,0,0,5,0,0,0,0,0,0,0,5
10687,Georgia,2012,2012Georgia,11,70,100,755,232,0,1168,17,41,106,724,146,0,1034,2202
10688,Georgia,2013,2013Georgia,0,0,0,0,0,0,0,0,0,0,0,0,0,0,3067
10689,Georgia,2013,2013Georgia,0,0,0,0,0,0,0,0,0,0,5,0,0,5,5
10690,Georgia,2013,2013Georgia,0,0,0,0,0,0,0,5,0,0,0,0,0,5,5
10691,Georgia,2013,2013Georgia,0,0,0,0,0,12,12,0,0,0,0,0,16,16,33
10692,Georgia,2013,2013Georgia,0,0,0,0,0,1313,1313,0,0,0,0,0,1258,1258,2571
10693,Georgia,2013,2013Georgia,0,0,0,5,0,0,5,0,0,0,0,0,0,0,5
10694,Georgia,2013,2013Georgia,0,0,0,5,0,0,5,0,0,0,5,0,0,5,10
10695,Georgia,2013,2013Georgia,0,0,0,6,0,0,6,0,0,0,9,0,0,9,15
10696,Georgia,2013,2013Georgia,0,0,0,8,0,0,8,0,0,0,0,0,0,0,8
10697,Georgia,2013,2013Georgia,0,0,0,44,5,0,49,0,0,0,41,0,0,41,90
10698,Georgia,2013,2013Georgia,0,0,5,22,0,0,27,0,0,0,40,5,0,45,72
10699,Georgia,2013,2013Georgia,0,5,0,15,0,0,20,0,0,8,14,0,0,22,485
10700,Georgia,2013,2013Georgia,0,5,5,20,0,6,36,0,5,5,28,0,9,47,83
10701,Georgia,2013,2013Georgia,0,15,10,117,28,0,170,5,19,13,106,20,0,163,333
10702,Georgia,2013,2013Georgia,5,0,0,0,0,0,5,0,0,0,0,0,0,0,5
10703,Georgia,2014,2014Georgia,0,0,0,0,0,0,0,0,0,0,0,0,0,0,2944
10704,Georgia,2014,2014Georgia,0,0,0,0,0,0,0,0,0,0,5,0,0,5,5
10705,Georgia,2014,2014Georgia,0,0,0,0,0,0,0,0,0,0,10,0,0,10,10
10706,Georgia,2014,2014Georgia,0,0,0,0,0,0,0,5,0,0,0,0,0,5,5
10707,Georgia,2014,2014Georgia,0,0,0,0,0,1386,1386,0,0,0,0,0,1328,1328,2714
10708,Georgia,2014,2014Georgia,0,0,0,5,0,0,5,0,0,0,0,0,0,0,5
10709,Georgia,2014,2014Georgia,0,0,0,8,0,0,8,0,0,0,0,0,0,0,8
10710,Georgia,2014,2014Georgia,0,0,0,12,0,0,12,0,0,0,24,0,0,24,474
10711,Georgia,2014,2014Georgia,0,0,5,38,10,0,53,0,0,0,34,0,0,34,87
10712,Georgia,2014,2014Georgia,0,5,0,0,0,0,5,0,0,0,0,0,0,0,5
10713,Georgia,2014,2014Georgia,0,6,5,25,0,6,42,0,9,0,27,0,9,45,87
10714,Georgia,2014,2014Georgia,5,9,10,120,35,0,179,5,17,11,114,17,0,164,343
10715,Georgia,2015,2015Georgia,0,0,0,0,0,0,0,0,0,0,0,0,0,0,2909
10716,Georgia,2015,2015Georgia,0,0,0,0,0,0,0,0,0,0,5,0,0,5,10
10717,Georgia,2015,2015Georgia,0,0,0,0,0,0,0,5,0,0,0,0,0,5,5
10718,Georgia,2015,2015Georgia,0,0,0,0,0,22,22,0,0,0,0,0,29,29,51
10719,Georgia,2015,2015Georgia,0,0,0,0,0,28,28,0,0,0,0,0,32,32,60
10720,Georgia,2015,2015Georgia,0,0,0,0,0,1451,1451,0,0,0,0,0,1375,1375,2826
10721,Georgia,2015,2015Georgia,0,0,0,5,0,0,5,0,0,0,0,0,0,0,5
10722,Georgia,2015,2015Georgia,0,0,0,5,0,0,5,0,0,0,5,0,0,5,10
10723,Georgia,2015,2015Georgia,0,0,0,8,0,0,8,0,0,0,0,0,0,0,8
10724,Georgia,2015,2015Georgia,0,0,0,22,5,0,27,0,5,0,43,0,0,48,75
10725,Georgia,2015,2015Georgia,0,0,0,38,0,0,38,0,0,0,43,0,0,43,81
10726,Georgia,2015,2015Georgia,0,5,0,0,0,0,5,0,0,0,0,0,0,0,5
10727,Georgia,2015,2015Georgia,0,10,10,122,38,0,180,5,18,15,119,23,0,180,360
10728,Georgia,2015,2015Georgia,7,0,0,19,0,9,35,6,0,0,53,0,6,65,100
10729,Georgia,2016,2016Georgia,0,0,0,0,0,0,0,0,0,0,0,0,0,0,2366
10730,Georgia,2016,2016Georgia,0,0,0,0,0,0,0,0,0,0,5,0,0,5,10
10731,Georgia,2016,2016Georgia,0,0,0,0,0,21,21,0,0,0,0,0,28,28,49
10732,Georgia,2016,2016Georgia,0,0,0,0,0,23,23,0,0,0,0,0,26,26,49
10733,Georgia,2016,2016Georgia,0,0,0,0,0,1551,1551,0,0,0,0,0,1460,1460,3011
10734,Georgia,2016,2016Georgia,0,0,0,5,0,0,5,0,0,0,5,0,0,5,10
10735,Georgia,2016,2016Georgia,0,0,0,8,0,0,8,0,0,0,0,0,0,0,8
10736,Georgia,2016,2016Georgia,0,0,0,24,0,0,24,0,0,5,41,0,0,46,70
10737,Georgia,2016,2016Georgia,0,0,0,29,0,0,29,0,0,0,32,0,0,32,61
10738,Georgia,2016,2016Georgia,0,0,5,12,0,0,17,0,6,0,23,0,0,29,257
10739,Georgia,2016,2016Georgia,0,5,0,0,0,0,5,0,0,0,0,0,0,0,5
10740,Georgia,2016,2016Georgia,0,13,11,132,43,0,199,5,19,16,132,23,0,195,394
10741,Georgia,2016,2016Georgia,5,7,8,30,0,8,58,5,7,5,30,0,10,57,115
10742,Georgia,2017,2017Georgia,0,0,0,0,0,0,0,0,0,0,0,0,0,0,2608
10743,Georgia,2017,2017Georgia,0,0,0,0,0,0,0,0,0,0,5,0,0,5,10
10744,Georgia,2017,2017Georgia,0,0,0,0,0,23,23,0,0,0,0,0,25,25,48
10745,Georgia,2017,2017Georgia,0,0,0,0,0,1586,1586,0,0,0,0,0,1497,1497,3083
10746,Georgia,2017,2017Georgia,0,0,0,8,0,0,8,0,0,0,0,0,0,0,8
10747,Georgia,2017,2017Georgia,0,0,0,24,0,0,24,0,0,0,35,0,0,35,59
10748,Georgia,2017,2017Georgia,0,0,0,24,0,0,24,0,0,5,41,0,0,46,70
10749,Georgia,2017,2017Georgia,0,5,0,0,0,0,5,0,0,0,0,0,0,0,5
10750,Georgia,2017,2017Georgia,5,9,13,38,5,8,78,6,9,6,36,0,7,64,142
10751,Georgia,2017,2017Georgia,9,18,10,167,46,0,250,13,34,28,150,27,0,252,502
10752,Georgia,2018,2018Georgia,0,0,0,0,0,0,0,0,0,0,0,0,0,0,2465
10753,Georgia,2018,2018Georgia,0,0,0,0,0,0,0,0,0,0,5,0,0,5,5
10754,Georgia,2018,2018Georgia,0,0,0,0,0,1681,1681,0,0,0,0,0,1552,1552,3233
10755,Georgia,2018,2018Georgia,0,0,0,8,0,0,8,0,0,0,0,0,0,0,8
10756,Georgia,2018,2018Georgia,0,0,0,24,0,0,24,0,0,0,35,0,0,35,59
10757,Georgia,2018,2018Georgia,0,0,0,28,0,0,28,0,0,5,33,0,0,38,66
10758,Georgia,2018,2018Georgia,0,0,5,0,0,0,5,0,0,0,0,0,0,0,5
10759,Georgia,2018,2018Georgia,0,5,0,27,0,0,32,0,7,6,43,0,0,56,345
10760,Georgia,2018,2018Georgia,5,12,13,50,6,7,93,5,13,7,34,5,7,71,164
10761,Georgia,2018,2018Georgia,15,29,22,210,52,0,328,19,57,26,173,30,0,305,633
10762,Georgia,2019,2019Georgia,0,0,0,0,0,0,0,0,0,0,0,0,0,0,2950
10763,Georgia,2019,2019Georgia,0,0,0,0,0,0,0,0,0,0,5,0,0,5,5
10764,Georgia,2019,2019Georgia,0,0,0,0,0,5,5,0,0,0,0,0,21,21,26
10765,Georgia,2019,2019Georgia,0,0,0,0,0,1895,1895,0,0,0,0,0,1655,1655,3550
10766,Georgia,2019,2019Georgia,0,0,0,5,0,0,5,0,0,0,0,0,0,0,5
10767,Georgia,2019,2019Georgia,0,0,0,8,0,0,8,0,0,0,0,0,0,0,8
10768,Georgia,2019,2019Georgia,0,0,0,24,0,0,24,0,0,0,33,0,0,33,57
10769,Georgia,2019,2019Georgia,0,0,0,36,5,0,41,0,0,5,46,0,0,51,92
10770,Georgia,2019,2019Georgia,5,16,8,57,6,0,92,5,15,9,45,0,0,74,177
10771,Georgia,2019,2019Georgia,14,32,23,209,55,0,333,17,61,26,177,35,0,316,649
10772,Georgia,2020,2020Georgia,0,0,0,0,0,0,0,0,0,0,0,0,0,0,5714
10773,Georgia,2020,2020Georgia,0,0,0,0,0,0,0,0,0,0,5,0,0,5,5
10774,Georgia,2020,2020Georgia,0,0,0,0,0,0,0,0,0,0,6,0,0,6,14
10775,Georgia,2020,2020Georgia,0,0,0,0,0,5,5,0,0,0,0,0,20,20,25
10776,Georgia,2020,2020Georgia,0,0,0,0,0,8,8,0,0,0,0,0,0,0,8
10777,Georgia,2020,2020Georgia,0,0,0,0,0,14,14,0,0,0,18,0,5,23,337
10778,Georgia,2020,2020Georgia,0,0,0,0,0,22,22,0,0,0,0,0,37,37,59
10779,Georgia,2020,2020Georgia,0,0,0,0,0,49,49,0,0,0,0,0,90,90,139
10780,Georgia,2020,2020Georgia,0,0,0,5,0,0,5,0,0,0,0,0,0,0,5
10781,Georgia,2020,2020Georgia,0,6,0,47,5,0,58,5,6,0,63,0,0,74,132
10782,Georgia,2020,2020Georgia,5,18,11,70,7,0,111,6,21,9,54,5,0,95,217
10783,Georgia,2020,2020Georgia,14,37,30,211,59,0,351,16,63,34,187,40,0,340,691
10784,Georgia,2021,2021Georgia,0,0,0,0,0,0,0,0,0,0,0,0,0,0,8137
10785,Georgia,2021,2021Georgia,0,0,0,0,0,0,0,0,0,0,5,0,0,5,5
10786,Georgia,2021,2021Georgia,0,0,0,0,0,5,5,0,0,0,0,0,20,20,25
10787,Georgia,2021,2021Georgia,0,0,0,0,0,6,6,0,0,0,0,0,6,6,12
10788,Georgia,2021,2021Georgia,0,0,0,0,0,8,8,0,0,0,0,0,0,0,8
10789,Georgia,2021,2021Georgia,0,0,0,5,0,0,5,0,0,0,0,0,0,0,5
10790,Georgia,2021,2021Georgia,0,0,0,20,5,0,25,0,0,0,18,5,0,23,48
10791,Georgia,2021,2021Georgia,0,0,0,24,0,14,38,0,0,5,87,0,0,92,408
10792,Georgia,2021,2021Georgia,0,8,0,59,6,0,73,0,7,6,66,0,0,79,152
10793,Georgia,2021,2021Georgia,5,18,13,78,8,0,122,8,23,14,58,7,0,110,243
10794,Georgia,2021,2021Georgia,13,43,32,208,65,0,361,11,61,37,201,40,0,350,711
10795,Ghana,2001,2001Ghana,0,0,0,0,0,0,0,0,0,0,0,0,0,0,2407
10796,Ghana,2001,2001Ghana,0,0,0,0,0,0,0,0,0,0,6,0,0,6,6
10797,Ghana,2001,2001Ghana,0,0,0,0,0,7,7,0,0,0,0,0,10,10,17
10798,Ghana,2001,2001Ghana,0,0,0,0,0,327,327,0,0,0,0,0,475,475,802
10799,Ghana,2001,2001Ghana,0,6,0,0,0,0,6,0,5,0,9,0,0,14,20
10800,Ghana,2001,2001Ghana,11,5,5,12,5,0,38,8,6,5,22,8,0,49,87
10801,Ghana,2001,2001Ghana,1488,1402,1201,2540,50,0,6681,1467,895,768,1329,68,0,4527,11208
10802,Ghana,2002,2002Ghana,0,0,0,0,0,0,0,0,0,0,0,0,0,0,3590
10803,Ghana,2002,2002Ghana,0,0,0,0,0,0,0,0,0,0,6,0,0,6,6
10804,Ghana,2002,2002Ghana,0,0,0,0,0,0,0,0,0,5,0,0,0,5,5
10805,Ghana,2002,2002Ghana,0,0,0,0,0,302,302,0,0,0,0,0,458,458,760
10806,Ghana,2002,2002Ghana,0,6,0,0,0,0,6,0,5,0,9,0,0,14,20
10807,Ghana,2002,2002Ghana,8,6,5,14,5,0,38,6,5,5,25,7,0,48,86
10808,Ghana,2002,2002Ghana,1488,1402,1201,2540,50,0,6681,1467,895,768,1329,68,0,4527,11208
10809,Ghana,2003,2003Ghana,0,0,0,0,0,0,0,0,0,0,0,0,0,0,3862
10810,Ghana,2003,2003Ghana,0,0,0,0,0,0,0,0,0,0,6,0,0,6,6
10811,Ghana,2003,2003Ghana,0,0,0,0,0,266,266,0,0,0,0,0,418,418,684
10812,Ghana,2003,2003Ghana,0,6,0,0,0,0,6,0,5,0,9,0,0,14,20
10813,Ghana,2003,2003Ghana,8,6,5,14,5,0,38,6,5,5,25,7,0,48,86
10814,Ghana,2003,2003Ghana,1488,1402,1201,2540,50,0,6681,1467,895,768,1329,68,0,4527,11208
10815,Ghana,2004,2004Ghana,0,0,0,0,0,0,0,0,0,0,0,0,0,0,14619
10816,Ghana,2004,2004Ghana,0,0,0,0,0,0,0,0,0,0,5,0,0,5,10
10817,Ghana,2004,2004Ghana,0,0,0,0,0,0,0,0,6,5,6,0,0,17,17
10818,Ghana,2004,2004Ghana,0,0,0,6,0,0,6,0,0,0,0,0,0,0,6
10819,Ghana,2004,2004Ghana,0,6,0,0,0,0,6,0,5,0,9,0,0,14,20
10820,Ghana,2004,2004Ghana,8,6,5,14,5,0,38,6,5,5,26,7,0,49,87
10821,Ghana,2005,2005Ghana,0,0,0,0,0,0,0,0,0,0,0,0,0,0,17683
10822,Ghana,2005,2005Ghana,0,0,0,0,0,0,0,0,0,0,7,0,0,7,7
10823,Ghana,2005,2005Ghana,0,0,0,0,0,245,245,0,0,0,0,0,390,390,635
10824,Ghana,2005,2005Ghana,0,0,0,6,0,0,6,0,0,0,0,0,0,0,6
10825,Ghana,2005,2005Ghana,0,0,0,11,0,0,11,0,0,0,9,0,0,9,20
10826,Ghana,2005,2005Ghana,0,7,7,15,0,0,29,0,5,5,26,5,0,41,70
10827,Ghana,2006,2006Ghana,0,0,0,0,0,0,0,0,0,0,0,0,0,0,9215
10828,Ghana,2006,2006Ghana,0,0,0,0,0,0,0,0,0,0,0,0,6,6,6
10829,Ghana,2006,2006Ghana,0,0,0,0,0,0,0,0,0,0,0,0,8,8,8
10830,Ghana,2006,2006Ghana,0,0,0,0,0,0,0,0,0,0,11,0,0,11,11
10831,Ghana,2006,2006Ghana,0,0,0,0,0,6,6,0,0,0,0,0,0,0,6
10832,Ghana,2006,2006Ghana,0,0,0,0,0,230,230,0,0,0,0,0,365,365,595
10833,Ghana,2006,2006Ghana,0,0,6,11,0,0,17,0,0,7,15,0,0,22,39
10834,Ghana,2006,2006Ghana,5,0,9,15,0,0,29,0,0,10,25,5,0,40,69
10835,Ghana,2007,2007Ghana,0,0,0,0,0,0,0,0,0,0,0,0,0,0,4363
10836,Ghana,2007,2007Ghana,0,0,0,0,0,0,0,0,0,0,0,0,5,5,5
10837,Ghana,2007,2007Ghana,0,0,0,0,0,0,0,0,0,0,6,0,0,6,6
10838,Ghana,2007,2007Ghana,0,0,0,0,0,0,0,0,0,0,11,0,0,11,11
10839,Ghana,2007,2007Ghana,0,0,0,0,0,0,0,5,0,0,0,0,0,5,5
10840,Ghana,2007,2007Ghana,0,0,0,0,0,225,225,0,0,0,0,0,353,353,578
10841,Ghana,2007,2007Ghana,0,0,0,21,0,0,21,0,0,0,40,8,0,48,69
10842,Ghana,2007,2007Ghana,0,5,0,0,0,0,5,0,0,0,0,0,0,0,5
10843,Ghana,2008,2008Ghana,0,0,0,0,0,0,0,0,0,0,0,0,0,0,4441
10844,Ghana,2008,2008Ghana,0,0,0,0,0,0,0,0,0,0,0,0,5,5,5
10845,Ghana,2008,2008Ghana,0,0,0,0,0,0,0,0,0,0,5,0,0,5,10
10846,Ghana,2008,2008Ghana,0,0,0,0,0,0,0,0,0,0,6,0,0,6,6
10847,Ghana,2008,2008Ghana,0,0,0,0,0,0,0,5,0,0,0,0,0,5,5
10848,Ghana,2008,2008Ghana,0,0,0,0,0,218,218,0,0,0,0,0,351,351,569
10849,Ghana,2008,2008Ghana,0,0,0,7,0,0,7,0,0,0,0,0,0,0,7
10850,Ghana,2008,2008Ghana,0,0,0,21,0,0,21,0,0,0,40,8,0,48,69
10851,Ghana,2008,2008Ghana,998,1556,557,1525,21,0,4657,1095,995,427,926,13,0,3456,8113
10852,Ghana,2009,2009Ghana,0,0,0,0,0,0,0,0,0,0,0,0,0,0,2422
10853,Ghana,2009,2009Ghana,0,0,0,0,0,0,0,0,0,0,0,0,8,8,8
10854,Ghana,2009,2009Ghana,0,0,0,0,0,0,0,0,0,0,5,0,0,5,5
10855,Ghana,2009,2009Ghana,0,0,0,0,0,0,0,0,0,0,6,0,0,6,6
10856,Ghana,2009,2009Ghana,0,0,0,0,0,0,0,0,0,0,11,0,0,11,11
10857,Ghana,2009,2009Ghana,0,0,0,0,0,0,0,5,0,0,0,0,0,5,5
10858,Ghana,2009,2009Ghana,0,0,0,7,0,0,7,0,0,0,0,0,0,0,7
10859,Ghana,2009,2009Ghana,0,0,23,0,0,0,23,0,0,0,34,12,0,46,69
10860,Ghana,2009,2009Ghana,31,98,94,1614,33,0,1870,35,76,88,2056,145,0,2400,4270
10861,Ghana,2009,2009Ghana,998,1556,552,1512,21,0,4639,1095,992,423,912,12,0,3434,8073
10862,Ghana,2010,2010Ghana,0,0,0,0,0,0,0,0,0,0,0,0,0,0,1621
10863,Ghana,2010,2010Ghana,0,0,0,0,0,0,0,0,0,0,0,0,9,9,9
10864,Ghana,2010,2010Ghana,0,0,0,0,0,0,0,0,0,0,5,0,0,5,10
10865,Ghana,2010,2010Ghana,0,0,0,0,0,0,0,0,0,0,6,0,0,6,6
10866,Ghana,2010,2010Ghana,0,0,0,0,0,0,0,0,0,0,11,0,0,11,11
10867,Ghana,2010,2010Ghana,0,0,0,0,0,217,217,0,0,0,0,0,348,348,565
10868,Ghana,2010,2010Ghana,0,0,0,5,0,0,5,0,0,0,0,0,0,0,10
10869,Ghana,2010,2010Ghana,0,0,23,0,0,0,23,0,0,0,34,12,0,46,69
10870,Ghana,2010,2010Ghana,5,0,0,0,0,0,5,0,0,0,0,0,0,0,5
10871,Ghana,2010,2010Ghana,34,95,89,1582,53,0,1853,31,74,93,2041,202,0,2441,4294
10872,Ghana,2010,2010Ghana,1308,1898,707,2841,420,0,7174,1273,2029,891,1906,302,0,6401,13575
10873,Ghana,2011,2011Ghana,0,0,0,0,0,0,0,0,0,0,0,0,0,0,1314
10874,Ghana,2011,2011Ghana,0,0,0,0,0,0,0,0,0,0,0,0,10,10,10
10875,Ghana,2011,2011Ghana,0,0,0,0,0,0,0,0,0,0,5,0,0,5,5
10876,Ghana,2011,2011Ghana,0,0,0,0,0,0,0,0,0,0,7,0,0,7,7
10877,Ghana,2011,2011Ghana,0,0,0,0,0,218,218,0,0,0,0,0,341,341,559
10878,Ghana,2011,2011Ghana,0,0,0,5,0,0,5,0,0,0,0,0,0,0,5
10879,Ghana,2011,2011Ghana,0,0,0,5,0,0,5,0,0,6,22,0,0,28,38
10880,Ghana,2011,2011Ghana,0,0,23,0,0,0,23,0,0,0,34,12,0,46,69
10881,Ghana,2011,2011Ghana,0,5,0,20,0,0,25,0,5,0,34,0,0,39,370
10882,Ghana,2011,2011Ghana,24,88,85,1542,65,0,1804,28,87,86,2024,251,0,2476,4280
10883,Ghana,2011,2011Ghana,1376,1898,706,2837,414,0,7231,1329,2029,889,1900,298,0,6445,13676
10884,Ghana,2012,2012Ghana,0,0,0,0,0,0,0,0,0,0,0,0,0,0,1503
10885,Ghana,2012,2012Ghana,0,0,0,0,0,0,0,0,0,0,0,0,15,15,15
10886,Ghana,2012,2012Ghana,0,0,0,0,0,0,0,0,0,0,5,0,0,5,5
10887,Ghana,2012,2012Ghana,0,0,0,0,0,0,0,0,0,0,9,0,0,9,9
10888,Ghana,2012,2012Ghana,0,0,0,0,0,0,0,0,8,0,0,0,0,8,8
10889,Ghana,2012,2012Ghana,0,0,0,0,0,5,5,0,0,0,0,0,6,6,11
10890,Ghana,2012,2012Ghana,0,0,0,0,0,215,215,0,0,0,0,0,336,336,551
10891,Ghana,2012,2012Ghana,0,0,0,5,0,0,5,0,0,8,28,0,0,36,46
10892,Ghana,2012,2012Ghana,0,0,0,17,0,0,17,0,0,0,20,0,0,20,356
10893,Ghana,2012,2012Ghana,0,0,0,24,0,0,24,0,0,28,19,0,0,47,71
10894,Ghana,2012,2012Ghana,26,92,85,1519,96,0,1818,29,89,84,1997,306,0,2505,4323
10895,Ghana,2012,2012Ghana,1945,2421,966,4086,508,0,9926,1868,2528,1044,1757,248,0,7445,17371
10896,Ghana,2013,2013Ghana,0,0,0,0,0,0,0,0,0,0,0,0,0,0,2026
10897,Ghana,2013,2013Ghana,0,0,0,0,0,0,0,0,0,0,0,0,18,18,18
10898,Ghana,2013,2013Ghana,0,0,0,0,0,0,0,0,0,0,5,0,0,5,10
10899,Ghana,2013,2013Ghana,0,0,0,0,0,0,0,0,0,0,12,0,0,12,12
10900,Ghana,2013,2013Ghana,0,0,0,0,0,0,0,0,8,0,0,0,0,8,8
10901,Ghana,2013,2013Ghana,0,0,0,0,0,211,211,0,0,0,0,0,333,333,544
10902,Ghana,2013,2013Ghana,0,0,0,6,0,0,6,0,0,5,20,0,0,25,361
10903,Ghana,2013,2013Ghana,0,0,0,12,0,0,12,0,0,8,42,0,0,50,62
10904,Ghana,2013,2013Ghana,0,0,5,6,0,0,11,0,0,5,9,0,0,14,25
10905,Ghana,2013,2013Ghana,0,23,17,61,7,0,108,7,15,17,84,5,0,128,236
10906,Ghana,2013,2013Ghana,2053,2584,1011,3980,515,0,10143,2004,2791,1072,1508,228,0,7603,17746
10907,Ghana,2014,2014Ghana,0,0,0,0,0,0,0,0,0,0,0,0,0,0,2425
10908,Ghana,2014,2014Ghana,0,0,0,0,0,0,0,0,0,0,5,0,0,5,5
10909,Ghana,2014,2014Ghana,0,0,0,0,0,5,5,0,0,0,0,0,11,11,16
10910,Ghana,2014,2014Ghana,0,0,0,0,0,203,203,0,0,0,0,0,323,323,526
10911,Ghana,2014,2014Ghana,0,0,0,5,0,0,5,0,0,0,0,0,0,0,5
10912,Ghana,2014,2014Ghana,0,0,0,5,0,0,5,0,6,0,0,0,0,6,11
10913,Ghana,2014,2014Ghana,0,0,0,12,0,0,12,0,0,0,0,0,0,0,12
10914,Ghana,2014,2014Ghana,0,0,0,12,0,0,12,0,0,0,26,0,0,26,352
10915,Ghana,2014,2014Ghana,0,0,0,14,0,0,14,0,0,8,42,0,0,50,64
10916,Ghana,2014,2014Ghana,7,12,15,72,9,0,115,5,13,23,88,12,0,141,256
10917,Ghana,2014,2014Ghana,2173,2667,1038,4144,535,0,10557,2117,2880,1104,1553,233,0,7887,18444
10918,Ghana,2015,2015Ghana,0,0,0,0,0,0,0,0,0,0,0,0,0,0,3551
10919,Ghana,2015,2015Ghana,0,0,0,0,0,0,0,0,0,0,5,0,0,5,5
10920,Ghana,2015,2015Ghana,0,0,0,0,0,0,0,0,0,0,18,0,0,18,18
10921,Ghana,2015,2015Ghana,0,0,0,0,0,5,5,0,0,0,0,0,30,30,35
10922,Ghana,2015,2015Ghana,0,0,0,0,0,200,200,0,0,0,0,0,321,321,521
10923,Ghana,2015,2015Ghana,0,0,0,5,0,0,5,0,0,0,0,0,0,0,5
10924,Ghana,2015,2015Ghana,0,0,0,5,0,0,5,0,0,0,10,0,0,10,15
10925,Ghana,2015,2015Ghana,0,0,0,8,0,0,8,0,0,0,34,0,0,34,42
10926,Ghana,2015,2015Ghana,0,0,5,5,0,0,10,0,0,5,5,0,0,10,20
10927,Ghana,2015,2015Ghana,5,12,10,78,11,0,116,5,13,12,114,14,0,158,274
10928,Ghana,2015,2015Ghana,2178,2667,1038,4291,535,0,10709,2127,2879,1103,1425,233,0,7767,18476
10929,Ghana,2016,2016Ghana,0,0,0,0,0,0,0,0,0,0,0,0,0,0,4647
10930,Ghana,2016,2016Ghana,0,0,0,0,0,0,0,0,0,0,5,0,0,5,5
10931,Ghana,2016,2016Ghana,0,0,0,0,0,5,5,0,0,0,0,0,31,31,36
10932,Ghana,2016,2016Ghana,0,0,0,0,0,200,200,0,0,0,0,0,318,318,518
10933,Ghana,2016,2016Ghana,0,0,0,5,0,0,5,0,0,0,0,0,0,0,5
10934,Ghana,2016,2016Ghana,0,0,0,5,0,0,5,0,0,0,7,0,5,12,17
10935,Ghana,2016,2016Ghana,0,0,0,6,0,0,6,0,0,0,26,0,0,26,32
10936,Ghana,2016,2016Ghana,0,0,0,7,0,0,7,0,0,0,32,0,0,32,39
10937,Ghana,2016,2016Ghana,0,0,0,16,0,0,16,0,0,0,26,0,0,26,269
10938,Ghana,2016,2016Ghana,0,0,5,9,0,0,14,0,0,5,7,0,0,12,26
10939,Ghana,2016,2016Ghana,5,5,9,84,13,0,116,5,9,8,125,22,0,169,285
10940,Ghana,2016,2016Ghana,1163,1388,540,2236,278,0,5605,1107,1497,574,742,123,0,4043,9648
10941,Ghana,2017,2017Ghana,0,0,0,0,0,0,0,0,0,0,0,0,0,0,6184
10942,Ghana,2017,2017Ghana,0,0,0,0,0,0,0,0,0,0,5,0,0,5,5
10943,Ghana,2017,2017Ghana,0,0,0,0,0,0,0,0,0,0,6,0,0,6,6
10944,Ghana,2017,2017Ghana,0,0,0,0,0,200,200,0,0,0,0,0,316,316,516
10945,Ghana,2017,2017Ghana,0,0,0,5,0,0,5,0,0,0,0,0,0,0,10
10946,Ghana,2017,2017Ghana,0,0,0,5,0,5,10,0,0,0,7,0,0,7,17
10947,Ghana,2017,2017Ghana,0,0,0,7,0,0,7,0,0,0,31,0,0,31,38
10948,Ghana,2017,2017Ghana,0,0,5,9,0,0,14,0,0,5,7,0,0,12,26
10949,Ghana,2017,2017Ghana,19,16,9,135,17,0,196,14,16,8,195,33,0,266,462
10950,Ghana,2017,2017Ghana,1185,1388,540,2236,278,0,5627,1132,1497,574,742,123,0,4068,9695
10951,Ghana,2018,2018Ghana,0,0,0,0,0,0,0,0,0,0,0,0,0,0,6809
10952,Ghana,2018,2018Ghana,0,0,0,0,0,0,0,0,0,0,5,0,0,5,5
10953,Ghana,2018,2018Ghana,0,0,0,0,0,0,0,0,0,0,7,0,0,7,7
10954,Ghana,2018,2018Ghana,0,0,0,0,0,199,199,0,0,0,0,0,314,314,513
10955,Ghana,2018,2018Ghana,0,0,0,5,0,0,5,0,0,0,0,0,0,0,5
10956,Ghana,2018,2018Ghana,0,0,0,5,0,0,5,0,0,0,8,0,6,14,19
10957,Ghana,2018,2018Ghana,0,0,0,7,0,0,7,0,0,0,31,0,0,31,38
10958,Ghana,2018,2018Ghana,0,0,5,0,0,0,5,0,0,0,0,0,0,0,5
10959,Ghana,2018,2018Ghana,0,0,5,6,0,0,11,0,0,0,11,0,0,11,22
10960,Ghana,2018,2018Ghana,0,6,0,19,0,0,25,0,6,5,33,0,0,44,352
10961,Ghana,2018,2018Ghana,25,31,11,157,18,0,242,25,31,8,208,35,0,307,549
10962,Ghana,2018,2018Ghana,1206,1388,540,2235,278,0,5647,1164,1497,579,743,117,0,4100,9747
10963,Ghana,2019,2019Ghana,0,0,0,0,0,0,0,0,0,0,0,0,0,0,7450
10964,Ghana,2019,2019Ghana,0,0,0,0,0,0,0,0,0,0,5,0,0,5,5
10965,Ghana,2019,2019Ghana,0,0,0,0,0,198,198,0,0,0,0,0,319,319,517
10966,Ghana,2019,2019Ghana,0,0,0,5,0,0,5,0,0,0,0,0,0,0,5
10967,Ghana,2019,2019Ghana,0,0,0,5,0,0,5,0,0,0,8,0,0,8,20
10968,Ghana,2019,2019Ghana,0,0,0,7,0,0,7,0,0,0,31,0,0,31,38
10969,Ghana,2019,2019Ghana,0,0,0,11,0,0,11,0,5,0,8,0,0,13,24
10970,Ghana,2019,2019Ghana,0,0,5,0,0,0,5,0,0,0,0,0,0,0,5
10971,Ghana,2019,2019Ghana,29,31,7,159,22,0,248,28,32,10,240,42,0,352,600
10972,Ghana,2019,2019Ghana,1220,1388,540,2235,278,0,5661,1171,1497,579,743,117,0,4107,9768
10973,Ghana,2020,2020Ghana,0,0,0,0,0,0,0,0,0,0,0,0,0,0,4543
10974,Ghana,2020,2020Ghana,0,0,0,0,0,0,0,0,0,0,0,0,5,5,5
10975,Ghana,2020,2020Ghana,0,0,0,0,0,0,0,0,0,0,0,0,7,7,7
10976,Ghana,2020,2020Ghana,0,0,0,0,0,0,0,0,0,0,0,0,19,19,19
10977,Ghana,2020,2020Ghana,0,0,0,0,0,0,0,0,0,0,5,0,0,5,10
10978,Ghana,2020,2020Ghana,0,0,0,0,0,0,0,0,0,0,7,0,0,7,7
10979,Ghana,2020,2020Ghana,0,0,0,5,0,0,5,0,0,0,0,0,0,0,5
10980,Ghana,2020,2020Ghana,0,0,0,5,0,0,5,0,0,0,9,0,0,9,21
10981,Ghana,2020,2020Ghana,0,0,0,7,0,0,7,0,0,0,31,0,0,31,38
10982,Ghana,2020,2020Ghana,0,0,0,17,0,0,17,0,5,0,9,0,0,14,31
10983,Ghana,2020,2020Ghana,0,0,5,0,0,0,5,0,0,0,0,0,0,0,5
10984,Ghana,2020,2020Ghana,29,39,15,157,25,0,265,34,47,11,237,46,0,375,640
10985,Ghana,2020,2020Ghana,552,1053,918,2056,390,0,4969,0,973,1298,1106,167,0,3544,8513
10986,Ghana,2021,2021Ghana,0,0,0,0,0,0,0,0,0,0,0,0,0,0,4517
10987,Ghana,2021,2021Ghana,0,0,0,0,0,0,0,0,0,0,5,0,0,5,10
10988,Ghana,2021,2021Ghana,0,0,0,0,0,0,0,0,0,0,7,0,0,7,7
10989,Ghana,2021,2021Ghana,0,0,0,5,0,0,5,0,0,0,0,0,0,0,15
10990,Ghana,2021,2021Ghana,0,0,0,5,0,0,5,0,0,5,6,0,0,11,23
10991,Ghana,2021,2021Ghana,0,0,0,6,0,0,6,0,0,0,31,0,0,31,37
10992,Ghana,2021,2021Ghana,0,0,0,7,0,0,7,0,0,5,31,0,0,36,43
10993,Ghana,2021,2021Ghana,0,0,5,14,0,0,19,0,5,0,12,0,0,17,36
10994,Ghana,2021,2021Ghana,0,855,1298,2416,396,0,4965,0,882,1295,1203,168,0,3548,8513
10995,Ghana,2021,2021Ghana,5,0,0,29,0,0,34,0,0,6,70,0,0,76,372
10996,Ghana,2021,2021Ghana,26,50,17,161,32,0,286,32,51,12,245,52,0,392,678
10997,Guatemala,2001,2001Guatemala,0,0,0,0,0,0,0,0,0,0,0,0,0,0,3660
10998,Guatemala,2001,2001Guatemala,0,0,0,0,0,0,0,0,0,0,0,0,5,5,5
10999,Guatemala,2001,2001Guatemala,0,0,0,0,0,0,0,5,0,0,0,0,0,5,5
11000,Guatemala,2001,2001Guatemala,0,0,0,0,0,8,8,0,0,0,0,0,13,13,21
11001,Guatemala,2001,2001Guatemala,0,0,0,0,0,104,104,0,0,0,0,0,115,115,219
11002,Guatemala,2001,2001Guatemala,0,0,0,5,0,0,5,0,0,0,0,0,0,0,5
11003,Guatemala,2001,2001Guatemala,800,1477,1265,2280,273,0,6095,791,1456,1249,2712,274,0,6482,12953
11004,Guatemala,2002,2002Guatemala,0,0,0,0,0,0,0,0,0,0,0,0,0,0,3102
11005,Guatemala,2002,2002Guatemala,0,0,0,0,0,0,0,5,0,0,0,0,0,5,5
11006,Guatemala,2002,2002Guatemala,0,0,0,0,0,6,6,0,0,0,0,0,11,11,17
11007,Guatemala,2002,2002Guatemala,0,0,0,5,0,0,5,0,0,0,0,0,0,0,5
11008,Guatemala,2002,2002Guatemala,13,14,7,46,5,0,85,12,16,7,44,5,0,84,169
11009,Guatemala,2002,2002Guatemala,554,920,790,2527,200,0,4991,558,928,796,2808,196,0,5286,10594
11010,Guatemala,2003,2003Guatemala,0,0,0,0,0,0,0,0,0,0,0,0,0,0,2470
11011,Guatemala,2003,2003Guatemala,0,0,0,0,0,0,0,5,0,0,0,0,0,5,5
11012,Guatemala,2003,2003Guatemala,0,0,0,0,0,5,5,0,0,0,0,0,11,11,16
11013,Guatemala,2003,2003Guatemala,0,0,0,5,0,0,5,0,0,0,0,0,0,0,5
11014,Guatemala,2003,2003Guatemala,0,45,39,1252,297,0,1633,5,50,43,1807,261,0,2166,4116
11015,Guatemala,2003,2003Guatemala,7,10,9,8,0,0,34,10,12,11,12,5,0,50,84
11016,Guatemala,2004,2004Guatemala,0,0,0,0,0,0,0,0,0,0,0,0,0,0,1958
11017,Guatemala,2004,2004Guatemala,0,0,0,0,0,0,0,5,0,0,0,0,0,5,5
11018,Guatemala,2004,2004Guatemala,0,0,0,5,0,0,5,0,0,0,0,0,0,0,5
11019,Guatemala,2004,2004Guatemala,0,31,27,835,62,0,955,0,45,38,1282,54,0,1419,2374
11020,Guatemala,2004,2004Guatemala,5,0,0,0,0,0,5,9,7,6,5,0,0,27,32
11021,Guatemala,2005,2005Guatemala,0,0,0,0,0,0,0,0,0,0,0,0,0,0,2113
11022,Guatemala,2005,2005Guatemala,0,0,0,0,0,0,0,0,7,0,0,0,0,7,7
11023,Guatemala,2005,2005Guatemala,0,0,0,0,0,0,0,5,0,0,0,0,0,5,5
11024,Guatemala,2005,2005Guatemala,0,0,0,0,0,5,5,0,0,0,0,0,10,10,15
11025,Guatemala,2005,2005Guatemala,0,0,0,5,0,0,5,0,0,0,0,0,0,0,5
11026,Guatemala,2005,2005Guatemala,0,18,16,402,38,0,474,0,0,6,186,565,0,757,1231
11027,Guatemala,2006,2006Guatemala,0,0,0,0,0,0,0,0,0,0,0,0,0,0,5227
11028,Guatemala,2006,2006Guatemala,0,0,0,0,0,0,0,0,0,0,0,0,7,7,7
11029,Guatemala,2006,2006Guatemala,0,0,0,0,0,0,0,0,5,0,0,0,0,5,5
11030,Guatemala,2006,2006Guatemala,0,0,0,0,0,5,5,0,0,0,0,0,13,13,18
11031,Guatemala,2006,2006Guatemala,0,0,0,5,0,0,5,0,0,0,0,0,0,0,5
11032,Guatemala,2006,2006Guatemala,0,0,34,402,38,0,474,0,0,6,186,565,0,757,1231
11033,Guatemala,2007,2007Guatemala,0,0,0,0,0,0,0,0,0,0,0,0,0,0,5825
11034,Guatemala,2007,2007Guatemala,0,0,0,0,0,0,0,0,0,0,0,0,6,6,6
11035,Guatemala,2007,2007Guatemala,0,0,0,0,0,0,0,0,0,0,5,0,0,5,5
11036,Guatemala,2007,2007Guatemala,0,0,0,0,0,0,0,0,5,0,0,0,0,5,5
11037,Guatemala,2007,2007Guatemala,0,0,0,0,0,5,5,0,0,0,0,0,14,14,19
11038,Guatemala,2007,2007Guatemala,0,0,0,5,0,0,5,0,0,0,0,0,0,0,5
11039,Guatemala,2007,2007Guatemala,0,0,0,8,0,0,8,0,0,0,10,0,0,10,18
11040,Guatemala,2007,2007Guatemala,0,0,5,107,12,0,124,0,0,7,120,23,0,150,274
11041,Guatemala,2008,2008Guatemala,0,0,0,0,0,0,0,0,0,0,0,0,0,0,5605
11042,Guatemala,2008,2008Guatemala,0,0,0,0,0,0,0,0,0,0,0,0,6,6,6
11043,Guatemala,2008,2008Guatemala,0,0,0,0,0,0,0,0,5,0,0,0,0,5,5
11044,Guatemala,2008,2008Guatemala,0,0,0,0,0,5,5,0,0,0,0,0,14,14,19
11045,Guatemala,2008,2008Guatemala,0,0,0,8,0,0,8,0,0,0,10,0,0,10,18
11046,Guatemala,2008,2008Guatemala,0,10,23,55,20,0,108,0,0,50,100,16,0,166,274
11047,Guatemala,2009,2009Guatemala,0,0,0,0,0,0,0,0,0,0,0,0,0,0,5425
11048,Guatemala,2009,2009Guatemala,0,0,0,0,0,0,0,0,0,0,0,0,6,6,6
11049,Guatemala,2009,2009Guatemala,0,0,0,0,0,0,0,0,0,0,5,0,0,5,5
11050,Guatemala,2009,2009Guatemala,0,0,0,0,0,0,0,0,5,0,0,0,0,5,5
11051,Guatemala,2009,2009Guatemala,0,0,0,5,0,0,5,0,0,0,6,0,0,6,11
11052,Guatemala,2009,2009Guatemala,0,0,0,6,0,0,6,0,0,0,0,0,0,0,6
11053,Guatemala,2009,2009Guatemala,0,0,0,9,0,0,9,0,0,5,10,0,0,15,24
11054,Guatemala,2009,2009Guatemala,0,6,16,55,23,0,100,0,6,40,100,35,0,181,281
11055,Guatemala,2010,2010Guatemala,0,0,0,0,0,0,0,0,0,0,0,0,0,0,5323
11056,Guatemala,2010,2010Guatemala,0,0,0,0,0,0,0,0,0,0,0,0,5,5,5
11057,Guatemala,2010,2010Guatemala,0,0,0,0,0,0,0,0,0,0,5,0,0,5,5
11058,Guatemala,2010,2010Guatemala,0,0,0,0,0,0,0,0,5,0,0,0,0,5,5
11059,Guatemala,2010,2010Guatemala,0,0,0,5,0,0,5,0,0,0,6,0,0,6,11
11060,Guatemala,2010,2010Guatemala,0,0,5,9,0,0,14,0,0,5,13,0,0,18,32
11061,Guatemala,2010,2010Guatemala,0,5,12,82,10,0,109,0,5,16,135,19,0,175,289
11062,Guatemala,2010,2010Guatemala,5,0,0,0,0,0,5,0,0,0,0,0,0,0,5
11063,Guatemala,2011,2011Guatemala,0,0,0,0,0,0,0,0,0,0,0,0,0,0,4969
11064,Guatemala,2011,2011Guatemala,0,0,0,0,0,0,0,0,0,0,0,0,5,5,5
11065,Guatemala,2011,2011Guatemala,0,0,0,0,0,0,0,0,0,0,5,0,0,5,5
11066,Guatemala,2011,2011Guatemala,0,0,0,0,0,0,0,0,5,0,0,0,0,5,5
11067,Guatemala,2011,2011Guatemala,0,0,0,0,0,5,5,0,0,0,0,0,12,12,17
11068,Guatemala,2011,2011Guatemala,0,0,0,6,0,0,6,0,0,0,6,0,0,6,12
11069,Guatemala,2011,2011Guatemala,0,0,5,10,0,0,15,0,0,8,13,0,0,21,36
11070,Guatemala,2011,2011Guatemala,0,5,0,0,0,0,5,0,0,0,0,0,0,0,5
11071,Guatemala,2011,2011Guatemala,0,5,12,82,11,0,110,0,5,16,138,20,0,179,326
11072,Guatemala,2011,2011Guatemala,0,19,13,83,0,0,115,0,14,16,85,0,0,115,707
11073,Guatemala,2012,2012Guatemala,0,0,0,0,0,0,0,0,0,0,0,0,0,0,5218
11074,Guatemala,2012,2012Guatemala,0,0,0,0,0,0,0,0,0,0,0,0,5,5,5
11075,Guatemala,2012,2012Guatemala,0,0,0,0,0,0,0,0,0,0,6,0,0,6,6
11076,Guatemala,2012,2012Guatemala,0,0,0,0,0,0,0,0,0,0,8,0,0,8,8
11077,Guatemala,2012,2012Guatemala,0,0,0,0,0,0,0,0,5,0,0,0,0,5,5
11078,Guatemala,2012,2012Guatemala,0,0,0,0,0,5,5,0,0,0,0,0,12,12,17
11079,Guatemala,2012,2012Guatemala,0,0,0,6,0,0,6,0,0,0,6,0,0,6,12
11080,Guatemala,2012,2012Guatemala,0,0,5,10,0,0,15,0,0,8,13,0,0,21,36
11081,Guatemala,2012,2012Guatemala,6,0,0,25,0,0,31,5,5,0,33,0,0,43,770
11082,Guatemala,2012,2012Guatemala,8,14,25,89,0,0,136,0,9,19,140,0,0,168,312
11083,Guatemala,2013,2013Guatemala,0,0,0,0,0,0,0,0,0,0,0,0,0,0,5336
11084,Guatemala,2013,2013Guatemala,0,0,0,0,0,0,0,0,0,0,0,0,7,7,7
11085,Guatemala,2013,2013Guatemala,0,0,0,0,0,0,0,0,0,0,5,0,0,5,5
11086,Guatemala,2013,2013Guatemala,0,0,0,0,0,0,0,0,0,0,8,0,0,8,8
11087,Guatemala,2013,2013Guatemala,0,0,0,0,0,0,0,0,5,0,0,0,0,5,5
11088,Guatemala,2013,2013Guatemala,0,0,0,0,0,5,5,0,0,0,0,0,11,11,16
11089,Guatemala,2013,2013Guatemala,0,0,0,6,0,0,6,0,0,0,6,0,0,6,12
11090,Guatemala,2013,2013Guatemala,0,0,8,20,0,0,28,0,0,9,29,0,0,38,864
11091,Guatemala,2013,2013Guatemala,0,5,0,13,0,0,18,0,0,8,17,0,0,25,43
11092,Guatemala,2013,2013Guatemala,6,16,25,99,0,0,146,0,9,19,150,0,0,178,324
11093,Guatemala,2014,2014Guatemala,0,0,0,0,0,0,0,0,0,0,0,0,0,0,6207
11094,Guatemala,2014,2014Guatemala,0,0,0,0,0,0,0,0,0,0,5,0,0,5,5
11095,Guatemala,2014,2014Guatemala,0,0,0,0,0,0,0,0,5,0,0,0,0,5,5
11096,Guatemala,2014,2014Guatemala,0,0,0,0,0,5,5,0,0,0,0,0,10,10,15
11097,Guatemala,2014,2014Guatemala,0,0,0,5,0,0,5,0,0,0,7,0,0,7,12
11098,Guatemala,2014,2014Guatemala,0,0,0,6,0,0,6,0,0,0,6,0,0,6,12
11099,Guatemala,2014,2014Guatemala,0,0,0,19,0,0,19,0,0,6,16,0,0,22,907
11100,Guatemala,2014,2014Guatemala,6,16,25,99,0,0,146,0,9,19,150,0,0,178,324
11101,Guatemala,2015,2015Guatemala,0,0,0,0,0,0,0,0,0,0,0,0,0,0,10228
11102,Guatemala,2015,2015Guatemala,0,0,0,0,0,0,0,0,0,0,0,0,5,5,5
11103,Guatemala,2015,2015Guatemala,0,0,0,0,0,0,0,0,0,0,0,0,7,7,7
11104,Guatemala,2015,2015Guatemala,0,0,0,0,0,0,0,0,5,0,0,0,0,5,5
11105,Guatemala,2015,2015Guatemala,0,0,0,0,0,6,6,0,0,0,0,0,11,11,17
11106,Guatemala,2015,2015Guatemala,0,0,0,5,0,0,5,0,0,0,5,0,0,5,10
11107,Guatemala,2015,2015Guatemala,0,0,0,6,0,0,6,0,0,0,6,0,0,6,12
11108,Guatemala,2016,2016Guatemala,0,0,0,0,0,0,0,0,0,0,0,0,0,0,11889
11109,Guatemala,2016,2016Guatemala,0,0,0,0,0,0,0,0,0,0,0,0,6,6,6
11110,Guatemala,2016,2016Guatemala,0,0,0,0,0,0,0,0,0,5,0,0,0,5,5
11111,Guatemala,2016,2016Guatemala,0,0,0,0,0,6,6,0,0,0,0,0,11,11,17
11112,Guatemala,2016,2016Guatemala,0,0,0,0,0,10,10,0,0,0,0,0,15,15,25
11113,Guatemala,2016,2016Guatemala,0,0,0,5,0,0,5,0,0,0,5,0,0,5,10
11114,Guatemala,2016,2016Guatemala,0,0,0,6,0,0,6,0,0,0,6,0,0,6,12
11115,Guatemala,2016,2016Guatemala,0,0,0,9,0,0,9,0,0,5,5,0,0,10,585
11116,Guatemala,2017,2017Guatemala,0,0,0,0,0,0,0,0,0,0,0,0,0,0,16211
11117,Guatemala,2017,2017Guatemala,0,0,0,0,0,0,0,0,0,0,5,0,0,5,5
11118,Guatemala,2017,2017Guatemala,0,0,0,0,0,0,0,0,0,6,0,0,0,6,6
11119,Guatemala,2017,2017Guatemala,0,0,0,0,0,5,5,0,0,0,0,0,9,9,14
11120,Guatemala,2017,2017Guatemala,0,0,0,0,0,11,11,0,0,0,0,0,15,15,26
11121,Guatemala,2017,2017Guatemala,0,0,0,5,0,0,5,0,0,0,5,0,0,5,10
11122,Guatemala,2017,2017Guatemala,0,0,0,6,0,0,6,0,0,0,6,0,0,6,12
11123,Guatemala,2018,2018Guatemala,0,0,0,0,0,0,0,0,0,0,0,0,0,0,18553
11124,Guatemala,2018,2018Guatemala,0,0,0,0,0,0,0,0,0,0,5,0,0,5,5
11125,Guatemala,2018,2018Guatemala,0,0,0,0,0,0,0,0,0,0,9,0,0,9,9
11126,Guatemala,2018,2018Guatemala,0,0,0,0,0,0,0,0,0,7,0,0,0,7,7
11127,Guatemala,2018,2018Guatemala,0,0,0,0,0,5,5,0,0,0,0,0,9,9,14
11128,Guatemala,2018,2018Guatemala,0,0,5,21,0,0,26,0,6,0,32,0,0,38,540
11129,Guatemala,2019,2019Guatemala,0,0,0,0,0,0,0,0,0,0,0,0,0,0,22724
11130,Guatemala,2019,2019Guatemala,0,0,0,0,0,0,0,0,0,0,5,0,0,5,5
11131,Guatemala,2019,2019Guatemala,0,0,0,0,0,0,0,0,0,7,0,0,0,7,7
11132,Guatemala,2019,2019Guatemala,0,0,0,0,0,6,6,0,0,0,0,0,9,9,15
11133,Guatemala,2019,2019Guatemala,0,0,0,6,0,0,6,0,0,0,0,0,0,0,6
11134,Guatemala,2019,2019Guatemala,0,0,0,8,0,0,8,0,0,0,0,0,0,0,8
11135,Guatemala,2019,2019Guatemala,0,0,5,0,0,0,5,0,0,0,0,0,0,0,5
11136,Guatemala,2020,2020Guatemala,0,0,0,0,0,0,0,0,0,0,0,0,0,0,24047
11137,Guatemala,2020,2020Guatemala,0,0,0,0,0,0,0,0,0,0,5,0,0,5,5
11138,Guatemala,2020,2020Guatemala,0,0,0,0,0,0,0,0,0,0,7,0,0,7,7
11139,Guatemala,2020,2020Guatemala,0,0,0,0,0,0,0,0,0,5,0,0,0,5,5
11140,Guatemala,2020,2020Guatemala,0,0,0,0,0,17,17,0,0,0,0,0,22,22,39
11141,Guatemala,2020,2020Guatemala,0,0,0,6,0,0,6,0,0,0,0,0,0,0,6
11142,Guatemala,2020,2020Guatemala,0,0,0,7,0,0,7,0,0,0,0,0,0,0,7
11143,Guatemala,2020,2020Guatemala,0,0,0,10,0,22,32,0,0,0,0,0,16,16,423
11144,Guatemala,2020,2020Guatemala,0,0,5,0,0,0,5,0,0,0,0,0,0,0,5
11145,Guatemala,2021,2021Guatemala,0,0,0,0,0,0,0,0,0,0,0,0,0,0,23426
11146,Guatemala,2021,2021Guatemala,0,0,0,0,0,0,0,0,0,0,7,0,0,7,7
11147,Guatemala,2021,2021Guatemala,0,0,0,0,0,0,0,0,0,5,0,0,0,5,5
11148,Guatemala,2021,2021Guatemala,0,0,0,5,0,0,5,0,0,0,0,0,0,0,5
11149,Guatemala,2021,2021Guatemala,0,0,0,8,0,0,8,0,0,0,0,0,0,0,8
11150,Guatemala,2021,2021Guatemala,0,0,5,0,0,0,5,0,0,0,0,0,0,0,5
11151,Guatemala,2021,2021Guatemala,9,0,0,34,0,21,64,0,5,5,30,0,16,56,358
11152,Guatemala,2021,2021Guatemala,147,262,187,916,15,0,1527,136,252,206,964,28,0,1586,3113
11153,Guinea,2001,2001Guinea,0,0,0,0,0,0,0,0,0,0,0,0,0,0,1672
11154,Guinea,2001,2001Guinea,0,0,0,0,0,0,0,0,0,0,0,0,10,10,10
11155,Guinea,2001,2001Guinea,0,0,0,0,0,0,0,0,0,0,9,0,0,9,9
11156,Guinea,2001,2001Guinea,0,0,0,0,0,8,8,0,0,0,0,0,24,24,32
11157,Guinea,2001,2001Guinea,0,0,0,0,0,73,73,0,0,0,0,0,201,201,274
11158,Guinea,2001,2001Guinea,0,0,0,7,0,0,7,0,0,0,5,0,0,5,12
11159,Guinea,2002,2002Guinea,0,0,0,0,0,0,0,0,0,0,0,0,0,0,3041
11160,Guinea,2002,2002Guinea,0,0,0,0,0,0,0,0,0,0,0,0,5,5,13
11161,Guinea,2002,2002Guinea,0,0,0,0,0,0,0,0,0,0,5,0,0,5,5
11162,Guinea,2002,2002Guinea,0,0,0,0,0,0,0,0,0,0,7,0,0,7,7
11163,Guinea,2002,2002Guinea,0,0,0,0,0,99,99,0,0,0,0,0,231,231,330
11164,Guinea,2002,2002Guinea,0,0,9,0,0,0,9,0,0,0,0,0,0,0,9
11165,Guinea,2002,2002Guinea,0,7,0,0,0,0,7,0,0,0,5,0,0,5,12
11166,Guinea,2003,2003Guinea,0,0,0,0,0,0,0,0,0,0,0,0,0,0,3394
11167,Guinea,2003,2003Guinea,0,0,0,0,0,0,0,0,0,0,7,0,0,7,14
11168,Guinea,2003,2003Guinea,0,0,0,0,0,5,5,0,0,0,0,0,7,7,32
11169,Guinea,2003,2003Guinea,0,0,0,0,0,133,133,0,0,0,0,0,275,275,408
11170,Guinea,2003,2003Guinea,0,0,8,0,0,0,8,0,0,0,0,0,0,0,8
11171,Guinea,2003,2003Guinea,0,7,0,0,0,0,7,0,0,0,5,0,0,5,12
11172,Guinea,2004,2004Guinea,0,0,0,0,0,0,0,0,0,0,0,0,0,0,4672
11173,Guinea,2004,2004Guinea,0,0,0,0,0,0,0,0,0,0,7,0,0,7,14
11174,Guinea,2004,2004Guinea,0,0,0,5,0,0,5,0,0,0,7,0,0,7,12
11175,Guinea,2004,2004Guinea,0,0,0,7,0,0,7,0,0,0,9,0,0,9,16
11176,Guinea,2004,2004Guinea,0,0,0,7,0,10,17,0,5,0,15,0,6,26,43
11177,Guinea,2004,2004Guinea,0,0,8,0,0,0,8,0,0,0,0,0,0,0,8
11178,Guinea,2004,2004Guinea,0,7,0,0,0,0,7,0,0,0,5,0,0,5,12
11179,Guinea,2005,2005Guinea,0,0,0,0,0,0,0,0,0,0,0,0,0,0,4811
11180,Guinea,2005,2005Guinea,0,0,0,0,0,0,0,0,0,0,5,0,0,5,10
11181,Guinea,2005,2005Guinea,0,0,0,0,0,0,0,0,0,0,7,0,0,7,7
11182,Guinea,2005,2005Guinea,0,0,0,0,0,279,279,0,0,0,0,0,599,599,878
11183,Guinea,2005,2005Guinea,0,0,0,5,0,0,5,0,0,0,10,0,0,10,15
11184,Guinea,2005,2005Guinea,0,0,0,5,0,0,5,0,0,0,13,0,0,13,18
11185,Guinea,2005,2005Guinea,0,0,0,9,0,10,19,0,0,0,26,0,9,35,54
11186,Guinea,2005,2005Guinea,0,7,0,5,0,0,12,0,0,6,5,0,0,11,23
11187,Guinea,2006,2006Guinea,0,0,0,0,0,0,0,0,0,0,0,0,0,0,5318
11188,Guinea,2006,2006Guinea,0,0,0,0,0,0,0,0,0,0,5,0,0,5,5
11189,Guinea,2006,2006Guinea,0,0,0,0,0,0,0,0,0,0,7,0,0,7,7
11190,Guinea,2006,2006Guinea,0,0,0,0,0,0,0,0,0,0,9,0,0,9,9
11191,Guinea,2006,2006Guinea,0,0,0,0,0,0,0,0,0,6,0,0,0,6,6
11192,Guinea,2006,2006Guinea,0,0,0,0,0,27,27,0,0,0,0,0,40,40,67
11193,Guinea,2006,2006Guinea,0,0,0,0,0,114,114,0,0,0,0,0,104,104,218
11194,Guinea,2006,2006Guinea,0,0,0,0,0,396,396,0,0,0,0,0,740,740,1136
11195,Guinea,2006,2006Guinea,0,0,0,5,0,0,5,0,0,0,12,0,0,12,17
11196,Guinea,2006,2006Guinea,0,0,0,7,0,0,7,0,0,0,16,0,0,16,23
11197,Guinea,2006,2006Guinea,0,8,0,5,0,0,13,0,0,6,5,0,0,11,24
11198,Guinea,2007,2007Guinea,0,0,0,0,0,0,0,0,0,0,0,0,0,0,6165
11199,Guinea,2007,2007Guinea,0,0,0,0,0,0,0,0,0,0,5,0,0,5,10
11200,Guinea,2007,2007Guinea,0,0,0,0,0,0,0,0,6,0,0,0,0,6,6
11201,Guinea,2007,2007Guinea,0,0,0,0,0,160,160,0,0,0,0,0,134,134,294
11202,Guinea,2007,2007Guinea,0,0,0,0,0,673,673,0,0,0,0,0,969,969,1642
11203,Guinea,2007,2007Guinea,0,0,0,5,0,0,5,0,0,0,5,0,0,5,10
11204,Guinea,2007,2007Guinea,0,0,0,5,0,0,5,0,0,0,9,0,0,9,19
11205,Guinea,2007,2007Guinea,0,0,0,7,0,0,7,0,0,0,17,0,0,17,24
11206,Guinea,2007,2007Guinea,0,5,0,0,0,0,5,0,0,0,0,0,0,0,5
11207,Guinea,2007,2007Guinea,0,5,0,5,0,0,10,0,7,0,8,0,0,15,25
11208,Guinea,2007,2007Guinea,5,0,0,9,0,16,30,5,0,0,27,0,7,39,69
11209,Guinea,2008,2008Guinea,0,0,0,0,0,0,0,0,0,0,0,0,0,0,6731
11210,Guinea,2008,2008Guinea,0,0,0,0,0,0,0,0,0,0,5,0,0,5,10
11211,Guinea,2008,2008Guinea,0,0,0,0,0,0,0,0,0,0,9,0,0,9,9
11212,Guinea,2008,2008Guinea,0,0,0,0,0,0,0,0,5,0,0,0,0,5,5
11213,Guinea,2008,2008Guinea,0,0,0,0,0,298,298,0,0,0,0,0,202,202,500
11214,Guinea,2008,2008Guinea,0,0,0,0,0,869,869,0,0,0,0,0,1220,1220,2089
11215,Guinea,2008,2008Guinea,0,0,0,5,0,0,5,0,0,0,5,0,0,5,10
11216,Guinea,2008,2008Guinea,0,0,0,5,0,0,5,0,0,0,9,0,0,9,19
11217,Guinea,2008,2008Guinea,0,0,0,6,0,0,6,0,0,0,0,0,0,0,6
11218,Guinea,2008,2008Guinea,0,0,5,9,0,20,34,0,0,0,26,0,11,37,71
11219,Guinea,2008,2008Guinea,0,5,0,5,0,0,10,0,7,0,8,0,0,15,25
11220,Guinea,2008,2008Guinea,0,6,0,0,0,0,6,0,0,0,0,0,0,0,6
11221,Guinea,2009,2009Guinea,0,0,0,0,0,0,0,0,0,0,0,0,0,0,9444
11222,Guinea,2009,2009Guinea,0,0,0,0,0,0,0,0,0,0,0,0,20,20,20
11223,Guinea,2009,2009Guinea,0,0,0,0,0,0,0,0,0,0,5,0,0,5,5
11224,Guinea,2009,2009Guinea,0,0,0,0,0,0,0,0,0,0,6,0,0,6,6
11225,Guinea,2009,2009Guinea,0,0,0,0,0,0,0,0,0,0,7,0,0,7,14
11226,Guinea,2009,2009Guinea,0,0,0,0,0,0,0,0,5,0,0,0,0,5,5
11227,Guinea,2009,2009Guinea,0,0,0,0,0,435,435,0,0,0,0,0,261,261,696
11228,Guinea,2009,2009Guinea,0,0,0,5,0,0,5,0,0,0,0,0,0,0,5
11229,Guinea,2009,2009Guinea,0,0,0,5,0,0,5,0,0,0,5,0,0,5,10
11230,Guinea,2009,2009Guinea,0,0,0,5,0,0,5,0,0,0,6,0,0,6,11
11231,Guinea,2009,2009Guinea,0,0,0,6,0,0,6,0,0,0,13,0,0,13,19
11232,Guinea,2009,2009Guinea,0,0,5,9,0,22,36,0,0,5,23,0,11,39,75
11233,Guinea,2009,2009Guinea,0,5,0,0,0,0,5,0,0,0,0,0,0,0,5
11234,Guinea,2009,2009Guinea,0,5,0,6,0,0,11,0,8,0,6,0,0,14,25
11235,Guinea,2009,2009Guinea,23,36,22,136,0,0,217,14,21,15,293,12,0,355,572
11236,Guinea,2010,2010Guinea,0,0,0,0,0,0,0,0,0,0,0,0,0,0,6978
11237,Guinea,2010,2010Guinea,0,0,0,0,0,0,0,0,0,0,0,0,5,5,5
11238,Guinea,2010,2010Guinea,0,0,0,0,0,0,0,0,0,0,5,0,0,5,10
11239,Guinea,2010,2010Guinea,0,0,0,0,0,0,0,0,0,0,7,0,0,7,14
11240,Guinea,2010,2010Guinea,0,0,0,0,0,0,0,0,0,0,8,0,0,8,16
11241,Guinea,2010,2010Guinea,0,0,0,0,0,0,0,0,0,0,12,0,0,12,12
11242,Guinea,2010,2010Guinea,0,0,0,0,0,0,0,0,5,0,0,0,0,5,5
11243,Guinea,2010,2010Guinea,0,0,0,0,0,10,10,0,0,0,0,0,26,26,36
11244,Guinea,2010,2010Guinea,0,0,0,0,0,596,596,0,0,0,0,0,383,383,979
11245,Guinea,2010,2010Guinea,0,0,0,0,0,1482,1482,0,0,0,0,0,1643,1643,3125
11246,Guinea,2010,2010Guinea,0,0,0,5,0,0,5,0,0,0,8,0,0,8,13
11247,Guinea,2010,2010Guinea,0,0,6,8,0,22,36,0,0,5,23,0,12,40,76
11248,Guinea,2010,2010Guinea,0,5,0,0,0,0,5,0,0,0,0,0,0,0,10
11249,Guinea,2010,2010Guinea,7,0,0,0,0,0,7,0,0,0,0,0,0,0,7
11250,Guinea,2010,2010Guinea,7,0,10,11,0,0,28,0,5,5,5,0,0,15,43
11251,Guinea,2010,2010Guinea,29,39,24,172,0,0,264,23,28,22,301,11,0,385,649
11252,Guinea,2011,2011Guinea,0,0,0,0,0,0,0,0,0,0,0,0,0,0,6090
11253,Guinea,2011,2011Guinea,0,0,0,0,0,0,0,0,0,0,5,0,0,5,20
11254,Guinea,2011,2011Guinea,0,0,0,0,0,0,0,0,0,0,7,0,0,7,14
11255,Guinea,2011,2011Guinea,0,0,0,0,0,0,0,0,0,0,8,0,0,8,24
11256,Guinea,2011,2011Guinea,0,0,0,0,0,0,0,0,0,7,0,0,0,7,7
11257,Guinea,2011,2011Guinea,0,0,0,0,0,0,0,0,5,0,0,0,0,5,10
11258,Guinea,2011,2011Guinea,0,0,0,0,0,909,909,0,0,0,0,0,584,584,1493
11259,Guinea,2011,2011Guinea,0,0,0,0,0,1823,1823,0,0,0,0,0,1822,1822,3645
11260,Guinea,2011,2011Guinea,0,0,0,5,0,0,5,0,0,0,8,0,0,8,13
11261,Guinea,2011,2011Guinea,0,0,0,5,0,0,5,0,0,6,0,0,0,6,11
11262,Guinea,2011,2011Guinea,0,0,5,8,0,19,32,0,5,0,28,0,14,47,79
11263,Guinea,2011,2011Guinea,0,0,7,0,0,0,7,0,0,0,0,0,0,0,7
11264,Guinea,2011,2011Guinea,0,5,0,0,0,0,5,0,0,0,0,0,0,0,5
11265,Guinea,2011,2011Guinea,0,5,8,49,0,0,62,5,7,0,38,0,0,50,1018
11266,Guinea,2011,2011Guinea,0,7,0,0,0,0,7,0,0,0,0,0,0,0,7
11267,Guinea,2011,2011Guinea,5,0,0,0,0,0,5,0,0,0,0,0,0,0,5
11268,Guinea,2011,2011Guinea,7,0,10,11,0,0,28,0,6,5,5,0,0,16,44
11269,Guinea,2011,2011Guinea,24,46,25,178,0,0,273,27,27,22,312,11,0,399,672
11270,Guinea,2012,2012Guinea,0,0,0,0,0,0,0,0,0,0,0,0,0,0,6054
11271,Guinea,2012,2012Guinea,0,0,0,0,0,0,0,0,0,0,0,0,5,5,10
11272,Guinea,2012,2012Guinea,0,0,0,0,0,0,0,0,0,0,5,0,0,5,5
11273,Guinea,2012,2012Guinea,0,0,0,0,0,0,0,0,0,0,6,0,0,6,6
11274,Guinea,2012,2012Guinea,0,0,0,0,0,0,0,0,0,0,8,0,0,8,8
11275,Guinea,2012,2012Guinea,0,0,0,0,0,0,0,0,0,0,9,0,0,9,18
11276,Guinea,2012,2012Guinea,0,0,0,0,0,0,0,0,0,0,10,0,0,10,10
11277,Guinea,2012,2012Guinea,0,0,0,0,0,0,0,0,5,0,0,0,0,5,5
11278,Guinea,2012,2012Guinea,0,0,0,0,0,1139,1139,0,0,0,0,0,799,799,1938
11279,Guinea,2012,2012Guinea,0,0,0,0,0,2097,2097,0,0,0,0,0,2014,2014,4111
11280,Guinea,2012,2012Guinea,0,0,0,5,0,0,5,0,0,0,8,0,0,8,13
11281,Guinea,2012,2012Guinea,0,0,0,5,0,0,5,0,0,6,0,0,0,6,11
11282,Guinea,2012,2012Guinea,0,0,5,34,0,0,39,5,0,0,24,0,0,29,914
11283,Guinea,2012,2012Guinea,0,0,7,0,0,0,7,0,0,0,0,0,0,0,7
11284,Guinea,2012,2012Guinea,0,5,0,0,0,0,5,0,0,0,0,0,0,0,5
11285,Guinea,2012,2012Guinea,0,5,0,10,0,0,15,0,0,0,9,0,0,9,24
11286,Guinea,2012,2012Guinea,0,7,0,0,0,0,7,0,0,0,0,0,0,0,7
11287,Guinea,2012,2012Guinea,0,9,8,10,0,0,27,0,0,7,10,0,0,17,44
11288,Guinea,2012,2012Guinea,5,0,0,0,0,0,5,0,0,0,0,0,0,0,20
11289,Guinea,2012,2012Guinea,8,0,0,13,0,21,42,0,7,0,32,0,15,54,96
11290,Guinea,2012,2012Guinea,28,49,27,202,5,0,311,22,38,20,351,14,0,445,756
11291,Guinea,2013,2013Guinea,0,0,0,0,0,0,0,0,0,0,0,0,0,0,6000
11292,Guinea,2013,2013Guinea,0,0,0,0,0,0,0,0,0,0,5,0,0,5,10
11293,Guinea,2013,2013Guinea,0,0,0,0,0,0,0,0,0,0,6,0,0,6,6
11294,Guinea,2013,2013Guinea,0,0,0,0,0,0,0,0,0,0,9,0,0,9,18
11295,Guinea,2013,2013Guinea,0,0,0,0,0,0,0,0,0,0,10,0,0,10,10
11296,Guinea,2013,2013Guinea,0,0,0,0,0,0,0,0,0,5,9,0,0,14,14
11297,Guinea,2013,2013Guinea,0,0,0,0,0,1117,1117,0,0,0,0,0,761,761,2290
11298,Guinea,2013,2013Guinea,0,0,0,0,0,2462,2462,0,0,0,0,0,2206,2206,4668
11299,Guinea,2013,2013Guinea,0,0,0,5,0,0,5,0,0,0,9,0,0,9,14
11300,Guinea,2013,2013Guinea,0,0,0,9,0,0,9,0,0,0,8,0,0,8,17
11301,Guinea,2013,2013Guinea,0,0,5,0,0,0,5,0,0,0,5,0,0,5,10
11302,Guinea,2013,2013Guinea,0,0,5,20,0,0,25,0,0,6,13,0,0,19,839
11303,Guinea,2013,2013Guinea,0,0,6,0,0,0,6,0,0,0,0,0,0,0,6
11304,Guinea,2013,2013Guinea,0,0,6,6,0,0,12,0,0,5,6,0,0,11,23
11305,Guinea,2013,2013Guinea,0,0,9,0,0,0,9,0,0,0,0,0,0,0,9
11306,Guinea,2013,2013Guinea,0,5,0,0,0,0,5,0,0,0,0,0,0,0,5
11307,Guinea,2013,2013Guinea,0,6,0,10,0,0,16,0,0,0,0,9,0,9,25
11308,Guinea,2013,2013Guinea,0,7,0,0,0,0,7,0,0,0,0,0,0,0,7
11309,Guinea,2013,2013Guinea,5,0,0,0,0,0,5,0,0,0,0,0,0,0,15
11310,Guinea,2013,2013Guinea,7,0,0,14,0,22,43,0,9,0,34,0,15,58,101
11311,Guinea,2013,2013Guinea,30,37,23,168,5,0,263,17,7,8,171,6,0,209,472
11312,Guinea,2014,2014Guinea,0,0,0,0,0,0,0,0,0,0,0,0,0,0,8437
11313,Guinea,2014,2014Guinea,0,0,0,0,0,0,0,0,0,0,5,0,0,5,10
11314,Guinea,2014,2014Guinea,0,0,0,0,0,0,0,0,0,0,6,0,0,6,12
11315,Guinea,2014,2014Guinea,0,0,0,0,0,0,0,0,0,0,8,0,0,8,8
11316,Guinea,2014,2014Guinea,0,0,0,0,0,0,0,0,0,0,11,0,0,11,11
11317,Guinea,2014,2014Guinea,0,0,0,0,0,0,0,0,0,5,8,0,0,13,13
11318,Guinea,2014,2014Guinea,0,0,0,0,0,5,5,0,0,0,0,0,10,10,15
11319,Guinea,2014,2014Guinea,0,0,0,0,0,2919,2919,0,0,0,0,0,2282,2282,5201
11320,Guinea,2014,2014Guinea,0,0,0,5,0,0,5,0,0,0,9,0,0,9,14
11321,Guinea,2014,2014Guinea,0,0,0,7,0,0,7,0,0,5,5,0,0,10,17
11322,Guinea,2014,2014Guinea,0,0,0,8,0,0,8,0,0,0,0,0,0,0,8
11323,Guinea,2014,2014Guinea,0,0,0,10,0,0,10,0,0,0,23,0,0,23,33
11324,Guinea,2014,2014Guinea,0,0,5,0,0,0,5,0,0,0,5,0,0,5,10
11325,Guinea,2014,2014Guinea,0,0,8,23,5,0,36,0,0,7,21,0,0,28,700
11326,Guinea,2014,2014Guinea,0,5,0,0,0,0,5,0,0,0,0,0,0,0,5
11327,Guinea,2014,2014Guinea,0,6,0,10,0,0,16,0,0,0,9,0,0,9,25
11328,Guinea,2014,2014Guinea,0,9,0,0,0,0,9,0,0,0,0,0,0,0,9
11329,Guinea,2014,2014Guinea,0,11,5,0,0,0,16,0,5,8,0,0,0,13,29
11330,Guinea,2014,2014Guinea,5,0,0,0,0,0,5,0,0,0,0,0,0,0,10
11331,Guinea,2014,2014Guinea,7,0,0,12,0,24,43,0,7,7,37,0,17,68,111
11332,Guinea,2014,2014Guinea,36,38,22,203,5,0,304,16,14,13,215,7,0,265,569
11333,Guinea,2015,2015Guinea,0,0,0,0,0,0,0,0,0,0,0,0,0,0,6795
11334,Guinea,2015,2015Guinea,0,0,0,0,0,0,0,0,0,0,0,0,5,5,5
11335,Guinea,2015,2015Guinea,0,0,0,0,0,0,0,0,0,0,5,0,0,5,10
11336,Guinea,2015,2015Guinea,0,0,0,0,0,0,0,0,0,0,6,0,0,6,6
11337,Guinea,2015,2015Guinea,0,0,0,0,0,0,0,0,0,0,7,0,0,7,14
11338,Guinea,2015,2015Guinea,0,0,0,0,0,0,0,0,0,0,8,0,0,8,8
11339,Guinea,2015,2015Guinea,0,0,0,0,0,0,0,0,0,0,9,0,0,9,9
11340,Guinea,2015,2015Guinea,0,0,0,0,0,0,0,0,0,5,0,0,0,5,5
11341,Guinea,2015,2015Guinea,0,0,0,0,0,5,5,0,0,0,0,0,10,10,15
11342,Guinea,2015,2015Guinea,0,0,0,0,0,1952,1952,0,0,0,0,0,1198,1198,3150
11343,Guinea,2015,2015Guinea,0,0,0,0,0,3475,3475,0,0,0,0,0,2530,2530,6005
11344,Guinea,2015,2015Guinea,0,0,0,5,0,0,5,0,0,0,9,0,0,9,14
11345,Guinea,2015,2015Guinea,0,0,0,7,0,0,7,0,0,5,5,0,0,10,17
11346,Guinea,2015,2015Guinea,0,0,0,8,0,0,8,0,0,0,8,0,0,8,16
11347,Guinea,2015,2015Guinea,0,0,0,9,0,0,9,0,0,0,13,0,0,13,22
11348,Guinea,2015,2015Guinea,0,0,0,9,0,0,9,0,0,0,44,0,0,44,53
11349,Guinea,2015,2015Guinea,0,0,9,0,0,0,9,0,0,0,0,0,0,0,9
11350,Guinea,2015,2015Guinea,0,5,0,0,0,0,5,0,0,0,0,0,0,0,5
11351,Guinea,2015,2015Guinea,0,5,0,10,0,0,15,0,0,0,9,0,0,9,24
11352,Guinea,2015,2015Guinea,0,6,0,10,0,22,38,0,5,8,48,0,26,87,125
11353,Guinea,2015,2015Guinea,5,0,0,0,0,0,5,0,0,0,8,0,0,8,13
11354,Guinea,2015,2015Guinea,5,7,0,8,0,0,20,0,5,9,0,0,0,14,34
11355,Guinea,2015,2015Guinea,32,43,17,225,5,0,322,17,14,17,264,7,0,319,641
11356,Guinea,2016,2016Guinea,0,0,0,0,0,0,0,0,0,0,0,0,0,0,6426
11357,Guinea,2016,2016Guinea,0,0,0,0,0,0,0,0,0,0,0,0,6,6,6
11358,Guinea,2016,2016Guinea,0,0,0,0,0,0,0,0,0,0,0,0,10,10,10
11359,Guinea,2016,2016Guinea,0,0,0,0,0,0,0,0,0,0,5,0,0,5,5
11360,Guinea,2016,2016Guinea,0,0,0,0,0,0,0,0,0,0,6,0,0,6,6
11361,Guinea,2016,2016Guinea,0,0,0,0,0,0,0,0,0,0,8,0,0,8,16
11362,Guinea,2016,2016Guinea,0,0,0,0,0,0,0,0,0,0,9,0,0,9,9
11363,Guinea,2016,2016Guinea,0,0,0,0,0,0,0,0,0,7,0,0,0,7,7
11364,Guinea,2016,2016Guinea,0,0,0,0,0,0,0,6,0,0,0,0,0,6,6
11365,Guinea,2016,2016Guinea,0,0,0,0,0,1687,1687,0,0,0,0,0,1003,1003,2690
11366,Guinea,2016,2016Guinea,0,0,0,0,0,3998,3998,0,0,0,0,0,2825,2825,6823
11367,Guinea,2016,2016Guinea,0,0,0,5,0,0,5,0,0,0,9,0,0,9,14
11368,Guinea,2016,2016Guinea,0,0,0,7,0,0,7,0,0,5,5,0,0,10,17
11369,Guinea,2016,2016Guinea,0,0,0,8,0,0,8,0,0,0,10,0,0,10,18
11370,Guinea,2016,2016Guinea,0,0,0,13,0,0,13,0,0,5,62,0,0,67,80
11371,Guinea,2016,2016Guinea,0,0,5,0,0,0,5,0,0,0,5,0,0,5,10
11372,Guinea,2016,2016Guinea,0,0,5,6,0,0,11,5,0,5,5,0,0,15,26
11373,Guinea,2016,2016Guinea,0,0,5,20,0,0,25,0,0,0,18,0,0,18,423
11374,Guinea,2016,2016Guinea,0,7,0,12,0,26,45,0,9,0,50,0,22,81,126
11375,Guinea,2016,2016Guinea,0,15,0,13,0,0,28,6,0,7,10,0,0,23,51
11376,Guinea,2016,2016Guinea,5,0,0,0,0,0,5,0,0,0,6,0,0,6,11
11377,Guinea,2016,2016Guinea,48,47,23,253,5,0,376,18,21,12,322,7,0,380,756
11378,Guinea,2017,2017Guinea,0,0,0,0,0,0,0,0,0,0,0,0,0,0,10314
11379,Guinea,2017,2017Guinea,0,0,0,0,0,0,0,0,0,0,0,0,7,7,7
11380,Guinea,2017,2017Guinea,0,0,0,0,0,0,0,0,0,0,0,0,107,107,107
11381,Guinea,2017,2017Guinea,0,0,0,0,0,0,0,0,0,0,5,0,0,5,10
11382,Guinea,2017,2017Guinea,0,0,0,0,0,0,0,0,0,0,6,0,0,6,86
11383,Guinea,2017,2017Guinea,0,0,0,0,0,0,0,0,0,0,7,0,0,7,7
11384,Guinea,2017,2017Guinea,0,0,0,0,0,0,0,0,0,0,8,0,0,8,8
11385,Guinea,2017,2017Guinea,0,0,0,0,0,0,0,0,0,0,9,0,0,9,18
11386,Guinea,2017,2017Guinea,0,0,0,0,0,0,0,0,0,0,10,0,0,10,10
11387,Guinea,2017,2017Guinea,0,0,0,0,0,0,0,0,0,7,0,0,0,7,7
11388,Guinea,2017,2017Guinea,0,0,0,0,0,0,0,0,5,0,0,0,0,5,5
11389,Guinea,2017,2017Guinea,0,0,0,0,0,4612,4612,0,0,0,0,0,3176,3176,7788
11390,Guinea,2017,2017Guinea,0,0,0,7,0,0,7,0,0,5,5,0,0,10,17
11391,Guinea,2017,2017Guinea,0,0,0,8,0,0,8,0,0,0,9,0,0,9,17
11392,Guinea,2017,2017Guinea,0,5,0,0,0,0,5,0,0,0,5,0,0,5,10
11393,Guinea,2017,2017Guinea,0,5,0,0,0,0,5,0,0,0,6,0,0,6,11
11394,Guinea,2017,2017Guinea,0,8,0,11,0,25,44,5,5,18,57,0,25,110,154
11395,Guinea,2017,2017Guinea,0,15,0,13,0,0,28,0,6,6,11,0,0,23,51
11396,Guinea,2017,2017Guinea,6,0,0,0,0,0,6,0,0,0,6,0,0,6,12
11397,Guinea,2017,2017Guinea,8,0,0,5,0,0,13,5,0,5,8,0,0,18,31
11398,Guinea,2017,2017Guinea,128,91,38,507,6,0,770,90,42,91,659,11,0,893,1663
11399,Guinea,2018,2018Guinea,0,0,0,0,0,0,0,0,0,0,0,0,0,0,11018
11400,Guinea,2018,2018Guinea,0,0,0,0,0,0,0,0,0,0,5,0,0,5,5
11401,Guinea,2018,2018Guinea,0,0,0,0,0,0,0,0,0,0,6,0,0,6,6
11402,Guinea,2018,2018Guinea,0,0,0,0,0,0,0,0,0,0,9,0,0,9,9
11403,Guinea,2018,2018Guinea,0,0,0,0,0,0,0,0,0,7,0,0,0,7,7
11404,Guinea,2018,2018Guinea,0,0,0,0,0,0,0,0,5,0,0,0,0,5,5
11405,Guinea,2018,2018Guinea,0,0,0,0,0,5485,5485,0,0,0,0,0,3779,3779,9264
11406,Guinea,2018,2018Guinea,0,0,0,6,0,0,6,0,0,0,7,0,0,7,13
11407,Guinea,2018,2018Guinea,0,0,0,6,0,0,6,0,0,0,8,0,0,8,14
11408,Guinea,2018,2018Guinea,0,0,0,7,0,0,7,0,0,5,5,0,0,10,17
11409,Guinea,2018,2018Guinea,0,0,0,9,0,0,9,0,0,0,0,0,0,0,9
11410,Guinea,2018,2018Guinea,0,5,0,0,0,0,5,0,0,0,0,0,0,0,5
11411,Guinea,2018,2018Guinea,0,9,0,15,0,25,49,7,5,14,73,0,25,124,173
11412,Guinea,2018,2018Guinea,5,0,0,0,0,0,5,0,0,0,5,0,0,5,10
11413,Guinea,2018,2018Guinea,5,0,0,5,0,0,10,0,0,6,19,0,0,25,35
11414,Guinea,2018,2018Guinea,5,12,0,13,0,0,30,0,6,5,11,0,0,22,52
11415,Guinea,2018,2018Guinea,6,0,0,0,0,0,6,0,0,0,6,0,0,6,12
11416,Guinea,2018,2018Guinea,8,5,0,31,0,0,44,0,8,5,29,0,0,42,446
11417,Guinea,2018,2018Guinea,188,120,47,729,12,0,1096,154,63,113,954,13,0,1297,2393
11418,Guinea,2019,2019Guinea,0,0,0,0,0,0,0,0,0,0,0,0,0,0,12421
11419,Guinea,2019,2019Guinea,0,0,0,0,0,0,0,0,0,0,5,0,0,5,15
11420,Guinea,2019,2019Guinea,0,0,0,0,0,0,0,0,0,0,10,0,0,10,10
11421,Guinea,2019,2019Guinea,0,0,0,0,0,0,0,0,6,0,0,0,0,6,6
11422,Guinea,2019,2019Guinea,0,0,0,0,0,0,0,0,7,0,0,0,0,7,7
11423,Guinea,2019,2019Guinea,0,0,0,0,0,5,5,0,0,0,0,0,0,0,5
11424,Guinea,2019,2019Guinea,0,0,0,0,0,6350,6350,0,0,0,0,0,4688,4688,11038
11425,Guinea,2019,2019Guinea,0,0,0,5,0,0,5,0,0,0,0,0,0,0,5
11426,Guinea,2019,2019Guinea,0,0,0,5,0,0,5,0,0,0,5,0,0,5,10
11427,Guinea,2019,2019Guinea,0,0,0,6,0,0,6,0,0,0,10,0,0,10,16
11428,Guinea,2019,2019Guinea,0,0,0,7,0,0,7,0,0,5,5,0,0,10,17
11429,Guinea,2019,2019Guinea,0,0,9,10,0,0,19,0,9,0,0,0,0,9,28
11430,Guinea,2019,2019Guinea,0,5,0,0,0,0,5,0,0,0,0,0,0,0,5
11431,Guinea,2019,2019Guinea,0,6,0,0,0,0,6,0,0,0,6,0,0,6,12
11432,Guinea,2019,2019Guinea,5,5,7,13,0,0,30,0,11,0,10,0,0,21,51
11433,Guinea,2019,2019Guinea,5,6,0,15,0,0,26,7,6,12,83,0,0,108,182
11434,Guinea,2019,2019Guinea,8,6,9,13,0,0,36,0,0,9,21,0,0,30,66
11435,Guinea,2019,2019Guinea,245,162,61,948,12,0,1428,192,125,72,1134,12,0,1535,2963
11436,Guinea,2020,2020Guinea,0,0,0,0,0,0,0,0,0,0,0,0,0,0,18962
11437,Guinea,2020,2020Guinea,0,0,0,0,0,0,0,0,0,0,0,0,5,5,5
11438,Guinea,2020,2020Guinea,0,0,0,0,0,0,0,0,0,0,5,0,0,5,10
11439,Guinea,2020,2020Guinea,0,0,0,0,0,0,0,0,0,0,7,0,0,7,14
11440,Guinea,2020,2020Guinea,0,0,0,0,0,0,0,0,0,0,9,0,0,9,9
11441,Guinea,2020,2020Guinea,0,0,0,0,0,0,0,0,0,0,10,0,0,10,10
11442,Guinea,2020,2020Guinea,0,0,0,0,0,5,5,0,0,0,0,0,0,0,5
11443,Guinea,2020,2020Guinea,0,0,0,0,0,5,5,0,0,0,0,0,7,7,12
11444,Guinea,2020,2020Guinea,0,0,0,0,0,23,23,0,0,0,14,0,10,24,372
11445,Guinea,2020,2020Guinea,0,0,0,0,0,2199,2199,0,0,0,0,0,1247,1247,3446
11446,Guinea,2020,2020Guinea,0,0,0,5,0,0,5,0,0,0,0,0,0,0,5
11447,Guinea,2020,2020Guinea,0,0,0,5,0,0,5,0,5,0,0,0,0,5,10
11448,Guinea,2020,2020Guinea,0,0,0,6,0,0,6,0,0,0,10,0,0,10,16
11449,Guinea,2020,2020Guinea,0,0,0,10,0,0,10,0,0,0,7,0,0,7,17
11450,Guinea,2020,2020Guinea,0,0,5,0,0,0,5,0,0,0,0,0,0,0,5
11451,Guinea,2020,2020Guinea,0,5,0,0,0,0,5,0,0,0,6,0,0,6,11
11452,Guinea,2020,2020Guinea,0,6,0,0,0,0,6,0,0,0,0,0,0,0,6
11453,Guinea,2020,2020Guinea,0,7,0,0,0,0,7,0,0,0,7,0,0,7,14
11454,Guinea,2020,2020Guinea,5,0,5,13,0,0,23,0,9,0,0,0,0,9,32
11455,Guinea,2020,2020Guinea,5,7,7,13,0,0,32,0,11,0,11,0,0,22,54
11456,Guinea,2020,2020Guinea,5,8,0,16,0,0,29,5,6,6,87,0,0,104,180
11457,Guinea,2020,2020Guinea,19,9,8,32,0,0,68,0,5,7,29,0,0,41,109
11458,Guinea,2020,2020Guinea,323,202,60,1147,14,0,1746,285,166,59,1214,13,0,1737,3488
11459,Guinea,2021,2021Guinea,0,0,0,0,0,0,0,0,0,0,0,0,0,0,29286
11460,Guinea,2021,2021Guinea,0,0,0,0,0,0,0,0,0,0,0,0,5,5,5
11461,Guinea,2021,2021Guinea,0,0,0,0,0,0,0,0,0,0,7,0,0,7,7
11462,Guinea,2021,2021Guinea,0,0,0,0,0,0,0,0,0,0,9,0,0,9,9
11463,Guinea,2021,2021Guinea,0,0,0,0,0,0,0,0,0,0,10,0,0,10,20
11464,Guinea,2021,2021Guinea,0,0,0,0,0,0,0,0,0,6,0,0,0,6,12
11465,Guinea,2021,2021Guinea,0,0,0,0,0,0,0,0,0,7,35,0,0,42,42
11466,Guinea,2021,2021Guinea,0,0,0,0,0,5,5,0,0,0,0,0,0,0,5
11467,Guinea,2021,2021Guinea,0,0,0,5,0,0,5,0,0,0,0,0,0,0,5
11468,Guinea,2021,2021Guinea,0,0,0,5,0,0,5,0,0,0,6,0,0,6,11
11469,Guinea,2021,2021Guinea,0,0,0,8,0,0,8,0,0,0,9,0,0,9,34
11470,Guinea,2021,2021Guinea,0,0,0,10,0,0,10,0,0,0,8,0,0,8,18
11471,Guinea,2021,2021Guinea,0,0,5,0,0,0,5,0,0,0,0,0,0,0,5
11472,Guinea,2021,2021Guinea,0,5,0,0,0,0,5,0,0,0,6,0,0,6,11
11473,Guinea,2021,2021Guinea,5,8,7,13,0,0,33,0,5,5,11,0,0,21,54
11474,Guinea,2021,2021Guinea,5,13,8,55,0,23,104,5,7,5,46,0,10,73,440
11475,Guinea,2021,2021Guinea,6,10,0,17,0,0,33,5,6,5,90,0,0,106,188
11476,Guinea,2021,2021Guinea,7,0,0,0,0,0,7,0,0,0,0,0,0,0,7
11477,Guinea,2021,2021Guinea,7,0,7,20,0,0,34,5,5,0,0,0,0,10,44
11478,Guinea,2021,2021Guinea,23,13,6,48,0,0,90,7,0,7,42,0,0,56,146
11479,Guinea,2021,2021Guinea,429,269,57,1339,13,0,2107,356,213,43,1324,11,0,1947,4054
11480,Haiti,2001,2001Haiti,0,0,0,0,0,0,0,0,0,0,0,0,0,0,5782
11481,Haiti,2001,2001Haiti,0,0,0,0,0,0,0,0,0,0,5,0,0,5,5
11482,Haiti,2001,2001Haiti,0,0,0,0,0,0,0,0,0,0,8,0,0,8,8
11483,Haiti,2001,2001Haiti,0,0,0,0,0,0,0,0,7,0,0,0,0,7,7
11484,Haiti,2001,2001Haiti,0,0,0,0,0,9,9,0,0,0,0,0,0,0,9
11485,Haiti,2001,2001Haiti,0,0,0,0,0,663,663,0,0,0,0,0,744,744,1407
11486,Haiti,2001,2001Haiti,0,0,0,5,0,0,5,0,0,0,9,0,0,9,14
11487,Haiti,2001,2001Haiti,0,0,0,8,0,0,8,0,0,0,0,0,0,0,8
11488,Haiti,2001,2001Haiti,0,6,0,0,0,0,6,0,0,0,0,0,0,0,6
11489,Haiti,2002,2002Haiti,0,0,0,0,0,0,0,0,0,0,0,0,0,0,6107
11490,Haiti,2002,2002Haiti,0,0,0,0,0,0,0,0,0,0,5,0,0,5,5
11491,Haiti,2002,2002Haiti,0,0,0,0,0,0,0,0,0,0,8,0,0,8,8
11492,Haiti,2002,2002Haiti,0,0,0,0,0,0,0,0,7,0,0,0,0,7,7
11493,Haiti,2002,2002Haiti,0,0,0,0,0,696,696,0,0,0,0,0,874,874,1570
11494,Haiti,2002,2002Haiti,0,0,0,5,0,0,5,0,0,0,6,0,0,6,11
11495,Haiti,2002,2002Haiti,0,0,0,8,0,0,8,0,0,0,0,0,0,0,8
11496,Haiti,2002,2002Haiti,0,6,0,0,0,0,6,0,0,0,0,0,0,0,6
11497,Haiti,2003,2003Haiti,0,0,0,0,0,0,0,0,0,0,0,0,0,0,5855
11498,Haiti,2003,2003Haiti,0,0,0,0,0,0,0,0,0,0,5,0,0,5,5
11499,Haiti,2003,2003Haiti,0,0,0,0,0,0,0,0,0,0,8,0,0,8,16
11500,Haiti,2003,2003Haiti,0,0,0,0,0,0,0,0,7,0,0,0,0,7,7
11501,Haiti,2003,2003Haiti,0,0,0,0,0,714,714,0,0,0,0,0,947,947,1661
11502,Haiti,2003,2003Haiti,0,6,0,0,0,0,6,0,0,0,0,0,0,0,6
11503,Haiti,2004,2004Haiti,0,0,0,0,0,0,0,0,0,0,0,0,0,0,9168
11504,Haiti,2004,2004Haiti,0,0,0,0,0,0,0,0,0,0,5,0,0,5,5
11505,Haiti,2004,2004Haiti,0,0,0,0,0,0,0,0,0,0,7,0,0,7,7
11506,Haiti,2004,2004Haiti,0,0,0,0,0,0,0,0,0,0,9,0,0,9,9
11507,Haiti,2004,2004Haiti,0,0,0,5,0,0,5,0,0,0,9,0,0,9,14
11508,Haiti,2004,2004Haiti,0,6,0,0,0,0,6,0,0,0,0,0,0,0,6
11509,Haiti,2005,2005Haiti,0,0,0,0,0,0,0,0,0,0,0,0,0,0,11229
11510,Haiti,2005,2005Haiti,0,0,0,0,0,0,0,0,0,0,5,0,0,5,5
11511,Haiti,2005,2005Haiti,0,0,0,0,0,0,0,0,0,0,7,0,0,7,7
11512,Haiti,2005,2005Haiti,0,0,0,0,0,0,0,0,0,0,9,0,0,9,9
11513,Haiti,2005,2005Haiti,0,0,0,0,0,962,962,0,0,0,0,0,1275,1275,2237
11514,Haiti,2005,2005Haiti,0,0,0,7,0,0,7,0,0,0,14,0,0,14,21
11515,Haiti,2005,2005Haiti,0,0,5,0,0,0,5,0,0,0,6,0,0,6,11
11516,Haiti,2005,2005Haiti,0,5,0,5,0,0,10,0,0,0,9,0,0,9,19
11517,Haiti,2006,2006Haiti,0,0,0,0,0,0,0,0,0,0,0,0,0,0,18026
11518,Haiti,2006,2006Haiti,0,0,0,0,0,0,0,0,0,0,5,0,0,5,5
11519,Haiti,2006,2006Haiti,0,0,0,0,0,0,0,0,0,0,9,0,0,9,9
11520,Haiti,2006,2006Haiti,0,0,0,0,0,1127,1127,0,0,0,0,0,1583,1583,2710
11521,Haiti,2006,2006Haiti,0,0,0,5,0,0,5,0,0,0,0,0,0,0,5
11522,Haiti,2006,2006Haiti,0,0,0,5,0,0,5,0,0,0,5,0,0,5,10
11523,Haiti,2006,2006Haiti,0,0,0,7,0,0,7,0,0,0,16,0,0,16,23
11524,Haiti,2006,2006Haiti,0,0,5,7,0,0,12,0,0,5,15,0,0,20,32
11525,Haiti,2006,2006Haiti,0,6,0,0,0,0,6,0,0,0,8,0,0,8,14
11526,Haiti,2007,2007Haiti,0,0,0,0,0,0,0,0,0,0,0,0,0,0,19067
11527,Haiti,2007,2007Haiti,0,0,0,0,0,0,0,0,0,0,5,0,0,5,5
11528,Haiti,2007,2007Haiti,0,0,0,0,0,0,0,0,0,0,9,0,0,9,9
11529,Haiti,2007,2007Haiti,0,0,0,0,0,0,0,0,5,0,0,0,0,5,5
11530,Haiti,2007,2007Haiti,0,0,0,0,0,9,9,0,0,0,0,0,0,0,9
11531,Haiti,2007,2007Haiti,0,0,0,0,0,1261,1261,0,0,0,0,0,1743,1743,3004
11532,Haiti,2007,2007Haiti,0,0,0,5,0,0,5,0,0,0,0,0,0,0,5
11533,Haiti,2007,2007Haiti,0,0,0,5,0,0,5,0,0,0,5,0,0,5,10
11534,Haiti,2007,2007Haiti,0,0,0,6,0,0,6,0,0,0,8,0,0,8,14
11535,Haiti,2007,2007Haiti,0,0,5,8,0,0,13,0,0,5,13,0,0,18,31
11536,Haiti,2007,2007Haiti,0,0,6,21,0,0,27,0,0,7,29,0,0,36,70
11537,Haiti,2007,2007Haiti,0,6,0,0,0,0,6,0,0,0,8,0,0,8,14
11538,Haiti,2007,2007Haiti,6,0,0,8,0,0,14,0,0,0,18,0,0,18,32
11539,Haiti,2008,2008Haiti,0,0,0,0,0,0,0,0,0,0,0,0,0,0,19679
11540,Haiti,2008,2008Haiti,0,0,0,0,0,0,0,0,0,0,0,9,0,9,9
11541,Haiti,2008,2008Haiti,0,0,0,0,0,0,0,0,0,0,6,0,0,6,6
11542,Haiti,2008,2008Haiti,0,0,0,0,0,0,0,0,6,0,0,0,0,6,6
11543,Haiti,2008,2008Haiti,0,0,0,0,0,8,8,0,0,0,0,0,0,0,8
11544,Haiti,2008,2008Haiti,0,0,0,0,0,1327,1327,0,0,0,0,0,1825,1825,3152
11545,Haiti,2008,2008Haiti,0,0,0,5,0,0,5,0,0,0,5,0,0,5,10
11546,Haiti,2008,2008Haiti,0,0,0,6,0,0,6,0,0,0,8,0,0,8,14
11547,Haiti,2008,2008Haiti,0,0,5,10,0,0,15,0,0,5,14,0,0,19,34
11548,Haiti,2008,2008Haiti,0,6,0,0,0,0,6,0,0,0,9,0,0,9,15
11549,Haiti,2008,2008Haiti,5,5,8,26,0,0,44,0,6,14,62,0,0,82,126
11550,Haiti,2009,2009Haiti,0,0,0,0,0,0,0,0,0,0,0,0,0,0,23763
11551,Haiti,2009,2009Haiti,0,0,0,0,0,0,0,0,0,0,5,0,0,5,5
11552,Haiti,2009,2009Haiti,0,0,0,0,0,0,0,0,0,0,6,0,0,6,6
11553,Haiti,2009,2009Haiti,0,0,0,0,0,0,0,0,0,0,7,0,0,7,7
11554,Haiti,2009,2009Haiti,0,0,0,0,0,0,0,0,6,0,0,0,0,6,6
11555,Haiti,2009,2009Haiti,0,0,0,0,0,8,8,0,0,0,0,0,0,0,8
11556,Haiti,2009,2009Haiti,0,0,0,5,0,0,5,0,0,0,5,0,0,5,10
11557,Haiti,2009,2009Haiti,0,0,0,6,0,0,6,0,0,0,12,0,0,12,18
11558,Haiti,2009,2009Haiti,0,0,5,8,0,0,13,0,0,6,0,0,0,6,19
11559,Haiti,2009,2009Haiti,0,0,5,12,0,0,17,0,0,5,16,0,0,21,38
11560,Haiti,2009,2009Haiti,0,6,0,0,0,0,6,0,0,0,9,0,0,9,15
11561,Haiti,2009,2009Haiti,5,7,0,9,0,0,21,0,9,5,5,0,0,19,40
11562,Haiti,2009,2009Haiti,8,10,12,43,0,0,73,6,9,13,74,0,0,102,175
11563,Haiti,2010,2010Haiti,0,0,0,0,0,0,0,0,0,0,0,0,0,0,21457
11564,Haiti,2010,2010Haiti,0,0,0,0,0,0,0,0,0,0,5,0,0,5,10
11565,Haiti,2010,2010Haiti,0,0,0,0,0,0,0,0,0,0,6,0,0,6,6
11566,Haiti,2010,2010Haiti,0,0,0,0,0,6,6,0,0,0,0,0,0,0,6
11567,Haiti,2010,2010Haiti,0,0,0,0,0,298,298,0,0,0,0,0,297,297,595
11568,Haiti,2010,2010Haiti,0,0,0,0,0,1503,1503,0,0,0,0,0,1963,1963,3466
11569,Haiti,2010,2010Haiti,0,0,0,5,0,0,5,0,0,0,5,0,0,5,10
11570,Haiti,2010,2010Haiti,0,0,0,5,0,0,5,0,0,0,6,0,0,6,11
11571,Haiti,2010,2010Haiti,0,0,0,7,0,0,7,0,5,0,7,0,0,12,19
11572,Haiti,2010,2010Haiti,0,0,0,8,0,0,8,0,0,0,14,0,0,14,22
11573,Haiti,2010,2010Haiti,0,0,5,12,0,0,17,0,0,5,16,0,0,21,38
11574,Haiti,2010,2010Haiti,0,6,0,0,0,0,6,0,0,0,9,0,0,9,15
11575,Haiti,2010,2010Haiti,5,6,9,47,5,0,72,0,7,16,82,5,0,110,182
11576,Haiti,2010,2010Haiti,9,7,0,9,0,0,25,7,11,0,6,0,0,24,49
11577,Haiti,2011,2011Haiti,0,0,0,0,0,0,0,0,0,0,0,0,0,0,24039
11578,Haiti,2011,2011Haiti,0,0,0,0,0,0,0,0,0,0,0,0,6,6,6
11579,Haiti,2011,2011Haiti,0,0,0,0,0,0,0,0,0,0,5,0,0,5,5
11580,Haiti,2011,2011Haiti,0,0,0,0,0,0,0,0,0,0,6,0,0,6,6
11581,Haiti,2011,2011Haiti,0,0,0,0,0,298,298,0,0,0,0,0,297,297,595
11582,Haiti,2011,2011Haiti,0,0,0,0,0,1556,1556,0,0,0,0,0,2063,2063,3619
11583,Haiti,2011,2011Haiti,0,0,0,5,0,0,5,0,0,0,8,0,0,8,13
11584,Haiti,2011,2011Haiti,0,0,0,5,0,0,5,0,0,0,10,0,0,10,15
11585,Haiti,2011,2011Haiti,0,0,0,7,0,0,7,0,0,5,7,0,0,12,19
11586,Haiti,2011,2011Haiti,0,0,0,8,0,0,8,0,0,0,16,0,0,16,24
11587,Haiti,2011,2011Haiti,0,0,5,12,0,0,17,0,0,5,16,0,0,21,38
11588,Haiti,2011,2011Haiti,0,0,7,20,0,0,27,0,0,0,30,0,0,30,57
11589,Haiti,2011,2011Haiti,0,6,0,0,0,0,6,0,0,0,9,0,0,9,15
11590,Haiti,2011,2011Haiti,5,6,9,47,5,0,72,0,7,16,82,5,0,110,191
11591,Haiti,2011,2011Haiti,9,8,0,9,0,0,26,5,5,5,6,0,0,21,47
11592,Haiti,2011,2011Haiti,51,186,248,1519,73,0,2077,39,173,183,1079,21,0,1495,4963
11593,Haiti,2012,2012Haiti,0,0,0,0,0,0,0,0,0,0,0,0,0,0,26877
11594,Haiti,2012,2012Haiti,0,0,0,0,0,0,0,0,0,0,0,0,5,5,5
11595,Haiti,2012,2012Haiti,0,0,0,0,0,0,0,0,0,0,5,0,0,5,5
11596,Haiti,2012,2012Haiti,0,0,0,0,0,0,0,0,0,0,6,0,0,6,6
11597,Haiti,2012,2012Haiti,0,0,0,0,0,1632,1632,0,0,0,0,0,2078,2078,3710
11598,Haiti,2012,2012Haiti,0,0,0,5,0,0,5,0,0,0,11,0,0,11,16
11599,Haiti,2012,2012Haiti,0,0,0,6,0,0,6,0,0,5,6,0,0,11,17
11600,Haiti,2012,2012Haiti,0,0,0,7,0,0,7,0,0,5,7,0,0,12,19
11601,Haiti,2012,2012Haiti,0,0,0,10,0,0,10,0,0,0,17,0,0,17,27
11602,Haiti,2012,2012Haiti,0,0,5,12,0,0,17,0,0,5,16,0,0,21,38
11603,Haiti,2012,2012Haiti,0,0,6,19,0,0,25,0,0,0,28,0,0,28,58
11604,Haiti,2012,2012Haiti,0,6,0,0,0,0,6,0,0,0,9,0,0,9,15
11605,Haiti,2012,2012Haiti,0,7,10,50,0,0,67,0,5,11,90,0,0,106,173
11606,Haiti,2012,2012Haiti,5,10,0,9,0,0,24,5,9,0,7,0,0,21,45
11607,Haiti,2012,2012Haiti,8,30,29,283,41,0,391,11,24,20,120,5,0,180,6798
11608,Haiti,2012,2012Haiti,38,60,58,211,28,0,395,35,49,55,192,24,0,355,750
11609,Haiti,2013,2013Haiti,0,0,0,0,0,0,0,0,0,0,0,0,0,0,25920
11610,Haiti,2013,2013Haiti,0,0,0,0,0,0,0,0,0,0,5,0,0,5,5
11611,Haiti,2013,2013Haiti,0,0,0,0,0,0,0,0,0,0,6,0,0,6,6
11612,Haiti,2013,2013Haiti,0,0,0,0,0,1621,1621,0,0,0,0,0,2120,2120,3741
11613,Haiti,2013,2013Haiti,0,0,0,6,0,0,6,0,0,0,13,0,0,13,19
11614,Haiti,2013,2013Haiti,0,0,0,6,0,0,6,0,0,5,6,0,0,11,17
11615,Haiti,2013,2013Haiti,0,0,0,8,0,0,8,0,0,5,5,0,0,10,18
11616,Haiti,2013,2013Haiti,0,0,0,9,0,0,9,0,0,0,6,0,0,6,15
11617,Haiti,2013,2013Haiti,0,0,0,9,0,0,9,0,0,0,16,0,0,16,25
11618,Haiti,2013,2013Haiti,0,0,5,0,0,0,5,0,0,0,10,0,0,10,15
11619,Haiti,2013,2013Haiti,0,0,5,12,0,0,17,0,0,5,16,0,0,21,38
11620,Haiti,2013,2013Haiti,0,5,0,22,0,0,27,0,0,0,30,5,0,35,62
11621,Haiti,2013,2013Haiti,0,5,13,65,0,0,83,0,5,7,80,0,0,92,175
11622,Haiti,2013,2013Haiti,7,38,63,215,16,0,339,11,49,50,160,8,0,278,7872
11623,Haiti,2013,2013Haiti,38,60,58,196,28,0,380,35,49,55,173,24,0,336,716
11624,Haiti,2014,2014Haiti,0,0,0,0,0,0,0,0,0,0,0,0,0,0,24259
11625,Haiti,2014,2014Haiti,0,0,0,0,0,0,0,0,0,0,5,0,0,5,5
11626,Haiti,2014,2014Haiti,0,0,0,0,0,0,0,0,0,0,6,0,0,6,6
11627,Haiti,2014,2014Haiti,0,0,0,0,0,1550,1550,0,0,0,0,0,1973,1973,3523
11628,Haiti,2014,2014Haiti,0,0,0,5,0,0,5,0,0,5,6,0,0,11,16
11629,Haiti,2014,2014Haiti,0,0,0,7,0,0,7,0,0,0,17,0,0,17,24
11630,Haiti,2014,2014Haiti,0,0,0,8,0,0,8,0,0,5,5,0,0,10,18
11631,Haiti,2014,2014Haiti,0,0,0,9,0,0,9,0,0,0,6,0,0,6,15
11632,Haiti,2014,2014Haiti,0,0,5,0,0,0,5,0,0,0,10,0,0,10,15
11633,Haiti,2014,2014Haiti,0,6,12,65,0,0,83,0,5,7,80,0,0,92,175
11634,Haiti,2014,2014Haiti,0,7,0,24,0,0,31,0,0,0,30,5,0,35,66
11635,Haiti,2014,2014Haiti,8,14,8,96,9,0,135,5,9,5,48,0,0,67,8422
11636,Haiti,2014,2014Haiti,16,37,53,188,21,0,315,10,39,39,169,31,0,288,603
11637,Haiti,2015,2015Haiti,0,0,0,0,0,0,0,0,0,0,0,0,0,0,30559
11638,Haiti,2015,2015Haiti,0,0,0,0,0,0,0,0,0,0,0,0,5,5,5
11639,Haiti,2015,2015Haiti,0,0,0,0,0,0,0,0,0,0,5,0,0,5,5
11640,Haiti,2015,2015Haiti,0,0,0,0,0,0,0,0,0,0,6,0,0,6,6
11641,Haiti,2015,2015Haiti,0,0,0,0,0,0,0,0,0,0,8,0,0,8,8
11642,Haiti,2015,2015Haiti,0,0,0,0,0,1518,1518,0,0,0,0,0,1927,1927,3445
11643,Haiti,2015,2015Haiti,0,0,0,5,0,0,5,0,0,5,6,0,0,11,16
11644,Haiti,2015,2015Haiti,0,0,0,9,0,0,9,0,0,0,7,0,0,7,16
11645,Haiti,2015,2015Haiti,0,0,5,0,0,0,5,0,0,0,10,0,0,10,15
11646,Haiti,2015,2015Haiti,0,0,7,0,0,0,7,0,0,5,10,0,0,15,22
11647,Haiti,2015,2015Haiti,0,7,0,21,5,0,33,0,0,5,27,0,0,32,65
11648,Haiti,2015,2015Haiti,13,38,47,197,19,0,314,5,42,36,169,34,0,286,600
11649,Haiti,2016,2016Haiti,0,0,0,0,0,0,0,0,0,0,0,0,0,0,18741
11650,Haiti,2016,2016Haiti,0,0,0,0,0,0,0,0,0,0,0,0,5,5,5
11651,Haiti,2016,2016Haiti,0,0,0,0,0,0,0,0,0,0,5,0,0,5,5
11652,Haiti,2016,2016Haiti,0,0,0,0,0,0,0,0,0,0,7,0,0,7,7
11653,Haiti,2016,2016Haiti,0,0,0,0,0,0,0,0,0,0,8,0,0,8,8
11654,Haiti,2016,2016Haiti,0,0,0,0,0,5,5,0,0,0,0,0,7,7,12
11655,Haiti,2016,2016Haiti,0,0,0,0,0,1536,1536,0,0,0,0,0,1908,1908,3444
11656,Haiti,2016,2016Haiti,0,0,0,7,0,0,7,0,0,0,9,0,0,9,16
11657,Haiti,2016,2016Haiti,0,0,0,8,0,0,8,0,0,5,6,0,0,11,19
11658,Haiti,2016,2016Haiti,0,0,8,21,5,0,34,0,5,0,28,0,0,33,67
11659,Haiti,2016,2016Haiti,0,11,17,100,7,0,135,0,11,19,119,9,0,158,6774
11660,Haiti,2016,2016Haiti,0,35,43,198,22,0,298,7,30,36,163,39,0,275,573
11661,Haiti,2017,2017Haiti,0,0,0,0,0,0,0,0,0,0,0,0,0,0,24211
11662,Haiti,2017,2017Haiti,0,0,0,0,0,0,0,0,0,0,8,0,0,8,8
11663,Haiti,2017,2017Haiti,0,0,0,0,0,5,5,0,0,0,0,0,7,7,12
11664,Haiti,2017,2017Haiti,0,0,0,0,0,1575,1575,0,0,0,0,0,1922,1922,3497
11665,Haiti,2017,2017Haiti,0,0,0,6,0,0,6,0,0,0,15,0,0,15,21
11666,Haiti,2017,2017Haiti,0,0,0,8,0,0,8,0,0,5,6,0,0,11,19
11667,Haiti,2017,2017Haiti,0,0,0,9,0,0,9,0,0,0,7,0,0,7,16
11668,Haiti,2017,2017Haiti,0,0,7,21,5,0,33,0,5,0,28,0,0,33,66
11669,Haiti,2017,2017Haiti,0,35,44,197,22,0,298,9,30,36,162,39,0,276,574
11670,Haiti,2018,2018Haiti,0,0,0,0,0,0,0,0,0,0,0,0,0,0,16547
11671,Haiti,2018,2018Haiti,0,0,0,0,0,0,0,0,0,0,7,0,0,7,7
11672,Haiti,2018,2018Haiti,0,0,0,0,0,0,0,0,0,0,8,0,0,8,8
11673,Haiti,2018,2018Haiti,0,0,0,0,0,1619,1619,0,0,0,0,0,1948,1948,3567
11674,Haiti,2018,2018Haiti,0,0,0,9,0,0,9,0,0,0,8,0,0,8,17
11675,Haiti,2018,2018Haiti,0,0,7,21,5,0,33,0,0,0,28,5,0,33,66
11676,Haiti,2018,2018Haiti,5,15,18,149,16,0,203,6,19,12,119,6,0,162,7141
11677,Haiti,2018,2018Haiti,6,0,5,62,15,0,88,9,0,0,36,31,0,76,164
11678,Haiti,2019,2019Haiti,0,0,0,0,0,0,0,0,0,0,0,0,0,0,22656
11679,Haiti,2019,2019Haiti,0,0,0,0,0,0,0,0,0,0,7,0,0,7,7
11680,Haiti,2019,2019Haiti,0,0,0,0,0,1725,1725,0,0,0,0,0,2090,2090,3815
11681,Haiti,2019,2019Haiti,0,0,0,7,0,0,7,0,0,0,8,0,0,8,15
11682,Haiti,2019,2019Haiti,0,0,8,23,5,0,36,0,0,5,31,0,0,36,72
11683,Haiti,2019,2019Haiti,0,5,0,0,0,0,5,0,0,0,0,0,0,0,5
11684,Haiti,2019,2019Haiti,6,0,5,62,15,0,88,9,0,0,36,31,0,76,164
11685,Haiti,2020,2020Haiti,0,0,0,0,0,0,0,0,0,0,0,0,0,0,20774
11686,Haiti,2020,2020Haiti,0,0,0,0,0,0,0,0,0,0,0,0,5,5,5
11687,Haiti,2020,2020Haiti,0,0,0,0,0,0,0,0,0,0,7,0,0,7,7
11688,Haiti,2020,2020Haiti,0,0,0,6,0,0,6,0,0,0,15,0,0,15,21
11689,Haiti,2020,2020Haiti,0,0,0,217,0,65,282,6,0,0,139,0,87,232,4587
11690,Haiti,2020,2020Haiti,0,0,5,0,0,0,5,0,0,0,9,0,0,9,14
11691,Haiti,2020,2020Haiti,0,0,7,25,5,0,37,0,0,5,32,0,0,37,74
11692,Haiti,2020,2020Haiti,0,5,0,0,0,0,5,0,0,0,0,0,0,0,5
11693,Haiti,2020,2020Haiti,0,6,5,54,23,0,88,0,7,0,32,24,11,74,162
11694,Haiti,2021,2021Haiti,0,0,0,0,0,0,0,0,0,0,0,0,0,0,21731
11695,Haiti,2021,2021Haiti,0,0,0,5,0,0,5,0,0,0,7,0,0,7,12
11696,Haiti,2021,2021Haiti,0,0,0,5,0,0,5,0,0,0,9,0,0,9,14
11697,Haiti,2021,2021Haiti,0,0,0,6,0,0,6,0,0,0,16,0,0,16,22
11698,Haiti,2021,2021Haiti,0,0,5,0,0,0,5,0,0,0,0,0,0,0,5
11699,Haiti,2021,2021Haiti,0,0,6,26,5,0,37,0,0,5,29,5,0,39,76
11700,Haiti,2021,2021Haiti,0,5,0,0,0,0,5,0,0,0,0,0,0,0,5
11701,Haiti,2021,2021Haiti,12,49,30,721,35,65,912,9,30,23,590,8,87,747,4295
11702,Haiti,2021,2021Haiti,22,113,72,1191,0,0,1398,17,96,73,1710,0,0,1896,3294
11703,Honduras,2001,2001Honduras,0,0,0,0,0,0,0,0,0,0,0,0,0,0,668
11704,Honduras,2001,2001Honduras,0,0,0,0,0,0,0,0,0,0,7,0,0,7,7
11705,Honduras,2001,2001Honduras,0,0,0,0,0,36,36,0,0,0,0,0,39,39,75
11706,Honduras,2001,2001Honduras,0,0,5,11,0,0,16,0,5,0,12,0,0,17,33
11707,Honduras,2002,2002Honduras,0,0,0,0,0,0,0,0,0,0,0,0,0,0,556
11708,Honduras,2002,2002Honduras,0,0,0,5,0,0,5,0,0,0,7,0,0,7,12
11709,Honduras,2002,2002Honduras,0,0,0,15,0,0,15,0,5,0,17,0,0,22,37
11710,Honduras,2002,2002Honduras,0,0,15,21,0,0,36,0,0,15,19,0,0,34,70
11711,Honduras,2003,2003Honduras,0,0,0,0,0,0,0,0,0,0,0,0,0,0,503
11712,Honduras,2003,2003Honduras,0,0,0,5,0,0,5,0,0,0,8,0,0,8,13
11713,Honduras,2003,2003Honduras,0,0,0,16,0,0,16,0,5,0,17,0,0,22,38
11714,Honduras,2003,2003Honduras,5,7,6,12,0,0,30,0,7,7,8,0,0,22,52
11715,Honduras,2004,2004Honduras,0,0,0,0,0,0,0,0,0,0,0,0,0,0,418
11716,Honduras,2004,2004Honduras,0,0,0,5,0,0,5,0,0,0,8,0,0,8,13
11717,Honduras,2004,2004Honduras,0,0,0,18,0,0,18,0,0,5,19,0,0,24,42
11718,Honduras,2004,2004Honduras,7,0,0,0,0,0,7,5,0,0,0,0,0,5,12
11719,Honduras,2005,2005Honduras,0,0,0,0,0,0,0,0,0,0,0,0,0,0,477
11720,Honduras,2005,2005Honduras,0,0,0,5,0,0,5,0,0,0,7,0,0,7,12
11721,Honduras,2005,2005Honduras,0,5,0,14,0,0,19,0,5,0,23,0,0,28,47
11722,Honduras,2006,2006Honduras,0,0,0,0,0,0,0,0,0,0,0,0,0,0,976
11723,Honduras,2006,2006Honduras,0,0,0,5,0,0,5,0,0,0,7,0,0,7,12
11724,Honduras,2006,2006Honduras,0,0,0,19,0,0,19,0,0,5,23,0,0,28,47
11725,Honduras,2007,2007Honduras,0,0,0,0,0,0,0,0,0,0,0,0,0,0,1127
11726,Honduras,2007,2007Honduras,0,0,0,0,0,0,0,0,0,0,8,0,0,8,8
11727,Honduras,2007,2007Honduras,0,0,0,0,0,21,21,0,0,0,0,0,38,38,59
11728,Honduras,2007,2007Honduras,0,0,0,5,0,0,5,0,0,0,7,0,0,7,12
11729,Honduras,2007,2007Honduras,0,0,0,7,0,0,7,0,0,6,17,0,0,23,30
11730,Honduras,2008,2008Honduras,0,0,0,0,0,0,0,0,0,0,0,0,0,0,1060
11731,Honduras,2008,2008Honduras,0,0,0,0,0,0,0,0,0,0,8,0,0,8,8
11732,Honduras,2008,2008Honduras,0,0,8,19,0,0,27,0,0,5,11,0,0,16,43
11733,Honduras,2008,2008Honduras,5,0,0,0,0,0,5,0,0,0,0,0,0,0,5
11734,Honduras,2009,2009Honduras,0,0,0,0,0,0,0,0,0,0,0,0,0,0,1043
11735,Honduras,2009,2009Honduras,0,0,0,7,0,0,7,0,0,0,43,0,0,43,50
11736,Honduras,2009,2009Honduras,0,0,0,8,0,0,8,0,0,0,0,0,0,0,8
11737,Honduras,2009,2009Honduras,0,0,9,22,0,0,31,0,5,0,13,0,0,18,49
11738,Honduras,2009,2009Honduras,0,5,0,0,0,0,5,0,0,0,0,0,0,0,5
11739,Honduras,2009,2009Honduras,0,5,0,0,0,0,5,0,0,5,0,0,0,5,10
11740,Honduras,2010,2010Honduras,0,0,0,0,0,0,0,0,0,0,0,0,0,0,1174
11741,Honduras,2010,2010Honduras,0,0,0,5,0,0,5,0,0,5,18,0,0,23,28
11742,Honduras,2010,2010Honduras,0,0,0,6,0,0,6,0,0,0,7,0,0,7,13
11743,Honduras,2010,2010Honduras,0,0,7,16,0,0,23,0,5,12,29,0,0,46,69
11744,Honduras,2010,2010Honduras,0,7,0,0,0,0,7,0,0,0,0,0,0,0,7
11745,Honduras,2010,2010Honduras,0,9,0,0,0,0,9,0,0,0,0,0,0,0,9
11746,Honduras,2011,2011Honduras,0,0,0,0,0,0,0,0,0,0,0,0,0,0,1219
11747,Honduras,2011,2011Honduras,0,0,0,11,0,0,11,0,0,0,20,0,0,20,31
11748,Honduras,2011,2011Honduras,0,0,6,0,0,0,6,0,0,0,8,0,0,8,14
11749,Honduras,2011,2011Honduras,0,0,7,16,0,0,23,0,5,12,28,0,0,45,108
11750,Honduras,2011,2011Honduras,0,0,9,14,0,0,23,0,0,8,13,0,0,21,44
11751,Honduras,2011,2011Honduras,0,5,0,0,0,0,5,0,0,0,0,0,0,0,5
11752,Honduras,2011,2011Honduras,0,8,0,0,0,0,8,0,0,0,0,0,0,0,8
11753,Honduras,2011,2011Honduras,5,8,9,68,0,0,90,0,7,8,77,0,0,92,538
11754,Honduras,2012,2012Honduras,0,0,0,0,0,0,0,0,0,0,0,0,0,0,1740
11755,Honduras,2012,2012Honduras,0,0,6,5,0,0,11,0,0,6,7,0,0,13,24
11756,Honduras,2012,2012Honduras,0,0,9,14,0,0,23,0,0,8,13,0,0,21,44
11757,Honduras,2012,2012Honduras,0,5,0,0,0,0,5,0,0,0,0,0,0,0,5
11758,Honduras,2012,2012Honduras,0,5,0,0,0,0,5,0,0,0,8,0,0,8,13
11759,Honduras,2012,2012Honduras,0,6,7,47,0,0,60,0,8,5,58,0,0,71,596
11760,Honduras,2012,2012Honduras,5,0,0,7,0,0,12,0,5,0,16,0,0,21,33
11761,Honduras,2012,2012Honduras,11,11,8,40,0,0,70,10,10,9,58,0,0,87,157
11762,Honduras,2013,2013Honduras,0,0,0,0,0,0,0,0,0,0,0,0,0,0,2188
11763,Honduras,2013,2013Honduras,0,0,0,0,0,0,0,0,0,0,5,0,0,5,5
11764,Honduras,2013,2013Honduras,0,0,0,0,0,0,0,0,0,0,8,0,0,8,8
11765,Honduras,2013,2013Honduras,0,0,0,0,0,0,0,0,0,8,0,0,0,8,8
11766,Honduras,2013,2013Honduras,0,0,7,15,0,0,22,0,6,0,26,0,0,32,54
11767,Honduras,2013,2013Honduras,0,5,0,0,0,0,5,0,0,0,7,0,0,7,12
11768,Honduras,2013,2013Honduras,0,5,5,17,0,0,27,0,5,5,20,0,0,30,57
11769,Honduras,2013,2013Honduras,7,11,6,52,0,0,76,6,6,8,48,0,0,68,679
11770,Honduras,2013,2013Honduras,13,14,10,71,0,0,108,10,18,18,134,0,0,180,288
11771,Honduras,2014,2014Honduras,0,0,0,0,0,0,0,0,0,0,0,0,0,0,2962
11772,Honduras,2014,2014Honduras,0,0,0,0,0,0,0,0,0,0,5,0,0,5,5
11773,Honduras,2014,2014Honduras,0,0,6,0,0,0,6,0,0,0,8,0,0,8,14
11774,Honduras,2014,2014Honduras,0,0,7,5,0,0,12,0,0,5,5,0,0,10,22
11775,Honduras,2014,2014Honduras,0,0,8,19,0,0,27,0,6,0,25,0,0,31,58
11776,Honduras,2014,2014Honduras,5,5,9,40,0,0,59,8,15,15,49,0,0,87,808
11777,Honduras,2014,2014Honduras,13,14,10,71,0,0,108,10,18,18,134,0,0,180,288
11778,Honduras,2015,2015Honduras,0,0,0,0,0,0,0,0,0,0,0,0,0,0,6690
11779,Honduras,2015,2015Honduras,0,0,0,0,0,0,0,0,0,0,5,0,0,5,5
11780,Honduras,2015,2015Honduras,0,0,0,5,0,0,5,0,0,0,0,0,0,0,5
11781,Honduras,2015,2015Honduras,0,0,0,7,0,0,7,0,0,0,10,0,0,10,17
11782,Honduras,2015,2015Honduras,0,0,5,7,0,0,12,0,0,6,11,0,0,17,29
11783,Honduras,2015,2015Honduras,0,0,8,26,0,0,34,0,5,6,29,0,0,40,74
11784,Honduras,2015,2015Honduras,0,0,9,6,0,0,15,0,0,5,7,0,0,12,27
11785,Honduras,2016,2016Honduras,0,0,0,0,0,0,0,0,0,0,0,0,0,0,9378
11786,Honduras,2016,2016Honduras,0,0,0,0,0,0,0,0,0,0,5,0,0,5,5
11787,Honduras,2016,2016Honduras,0,0,0,0,0,5,5,0,0,0,0,0,0,0,5
11788,Honduras,2016,2016Honduras,0,0,0,0,0,35,35,0,0,0,0,0,52,52,87
11789,Honduras,2016,2016Honduras,0,0,0,5,0,0,5,0,0,0,0,0,0,0,5
11790,Honduras,2016,2016Honduras,0,0,5,7,0,0,12,0,0,7,14,0,0,21,33
11791,Honduras,2016,2016Honduras,0,0,6,0,0,0,6,0,0,0,7,0,0,7,13
11792,Honduras,2016,2016Honduras,0,0,7,16,0,0,23,0,0,7,33,0,0,40,872
11793,Honduras,2016,2016Honduras,0,0,8,7,0,0,15,0,7,0,10,0,0,17,32
11794,Honduras,2016,2016Honduras,0,0,8,26,0,0,34,0,5,6,29,0,0,40,74
11795,Honduras,2016,2016Honduras,5,0,0,0,0,0,5,0,0,0,0,0,0,0,5
11796,Honduras,2017,2017Honduras,0,0,0,0,0,0,0,0,0,0,0,0,0,0,14086
11797,Honduras,2017,2017Honduras,0,0,0,0,0,0,0,0,0,0,5,0,0,5,5
11798,Honduras,2017,2017Honduras,0,0,0,0,0,6,6,0,0,0,0,0,0,0,6
11799,Honduras,2017,2017Honduras,0,0,0,0,0,14,14,0,0,0,0,0,22,22,36
11800,Honduras,2017,2017Honduras,0,0,0,0,0,58,58,0,0,0,0,0,86,86,144
11801,Honduras,2017,2017Honduras,0,0,0,5,0,0,5,0,0,0,0,0,0,0,5
11802,Honduras,2017,2017Honduras,0,0,5,40,0,0,45,0,0,5,24,0,0,29,74
11803,Honduras,2017,2017Honduras,0,0,6,0,0,0,6,0,0,0,8,0,0,8,14
11804,Honduras,2017,2017Honduras,0,8,0,15,0,0,23,0,0,8,18,0,0,26,49
11805,Honduras,2017,2017Honduras,5,0,0,0,0,0,5,0,0,0,0,0,0,0,5
11806,Honduras,2018,2018Honduras,0,0,0,0,0,0,0,0,0,0,0,0,0,0,17681
11807,Honduras,2018,2018Honduras,0,0,0,0,0,0,0,0,0,0,5,0,0,5,5
11808,Honduras,2018,2018Honduras,0,0,0,0,0,5,5,0,0,0,0,0,5,5,10
11809,Honduras,2018,2018Honduras,0,0,0,5,0,0,5,0,0,0,0,0,0,0,5
11810,Honduras,2018,2018Honduras,0,0,0,7,0,0,7,0,0,0,10,0,0,10,17
11811,Honduras,2018,2018Honduras,0,0,5,40,0,0,45,0,0,5,24,0,0,29,74
11812,Honduras,2018,2018Honduras,0,5,0,0,0,0,5,0,0,0,0,0,0,0,5
11813,Honduras,2018,2018Honduras,0,8,0,19,0,0,27,0,7,5,25,0,0,37,64
11814,Honduras,2018,2018Honduras,5,12,9,43,5,0,74,0,11,9,72,0,0,92,996
11815,Honduras,2019,2019Honduras,0,0,0,0,0,0,0,0,0,0,0,0,0,0,26160
11816,Honduras,2019,2019Honduras,0,0,0,0,0,0,0,0,0,0,5,0,0,5,5
11817,Honduras,2019,2019Honduras,0,0,0,0,0,12,12,0,0,0,0,0,8,8,20
11818,Honduras,2019,2019Honduras,0,0,0,9,0,0,9,0,0,0,10,0,0,10,19
11819,Honduras,2019,2019Honduras,0,0,5,40,0,0,45,0,5,0,24,0,0,29,74
11820,Honduras,2019,2019Honduras,0,5,0,0,0,0,5,0,0,0,0,0,0,0,5
11821,Honduras,2019,2019Honduras,0,8,0,19,0,0,27,0,7,5,29,0,0,41,68
11822,Honduras,2020,2020Honduras,0,0,0,0,0,0,0,0,0,0,0,0,0,0,33354
11823,Honduras,2020,2020Honduras,0,0,0,0,0,0,0,0,0,0,5,0,0,5,5
11824,Honduras,2020,2020Honduras,0,0,0,0,0,12,12,0,0,0,0,0,6,6,18
11825,Honduras,2020,2020Honduras,0,0,0,0,0,44,44,0,0,0,20,0,26,46,905
11826,Honduras,2020,2020Honduras,0,0,0,9,0,0,9,0,0,0,10,0,0,10,19
11827,Honduras,2020,2020Honduras,0,0,5,0,0,0,5,0,0,0,0,0,0,0,5
11828,Honduras,2020,2020Honduras,0,0,5,40,0,0,45,0,5,0,24,0,0,29,74
11829,Honduras,2020,2020Honduras,0,5,0,0,0,0,5,0,0,0,0,0,0,0,5
11830,Honduras,2020,2020Honduras,0,7,0,22,0,0,29,0,12,0,30,0,0,42,71
11831,Honduras,2021,2021Honduras,0,0,0,0,0,0,0,0,0,0,0,0,0,0,19726
11832,Honduras,2021,2021Honduras,0,0,0,0,0,0,0,0,0,0,6,0,0,6,6
11833,Honduras,2021,2021Honduras,0,0,5,0,0,0,5,0,0,0,0,0,0,0,5
11834,Honduras,2021,2021Honduras,0,5,0,0,0,0,5,0,0,0,0,0,0,0,10
11835,Honduras,2021,2021Honduras,0,5,0,7,0,0,12,0,0,7,7,0,0,14,26
11836,Honduras,2021,2021Honduras,0,6,5,22,0,0,33,0,8,5,34,0,0,47,80
11837,Honduras,2021,2021Honduras,0,7,0,30,0,0,37,0,7,0,23,5,0,35,72
11838,Honduras,2021,2021Honduras,13,12,11,51,0,44,131,8,5,11,86,0,26,136,975
11839,Honduras,2021,2021Honduras,1309,2258,1428,8719,104,0,13818,1341,2392,1765,11279,192,0,16969,30787
11840,Hungary,2001,2001Hungary,0,0,0,0,0,0,0,0,0,0,0,0,0,0,507
11841,Hungary,2001,2001Hungary,0,0,0,0,0,23,23,0,0,0,0,0,43,43,66
11842,Hungary,2001,2001Hungary,0,0,0,0,0,27,27,0,0,0,0,0,51,51,78
11843,Hungary,2001,2001Hungary,0,0,0,0,0,52,52,0,0,0,0,0,207,207,259
11844,Hungary,2001,2001Hungary,0,0,0,5,7,0,12,0,0,0,5,12,0,17,29
11845,Hungary,2001,2001Hungary,0,0,5,0,0,0,5,0,0,0,0,5,0,5,10
11846,Hungary,2002,2002Hungary,0,0,0,0,0,0,0,0,0,0,0,0,0,0,3344
11847,Hungary,2002,2002Hungary,0,0,0,0,0,0,0,0,0,0,0,6,0,6,6
11848,Hungary,2002,2002Hungary,0,0,0,0,0,19,19,0,0,0,0,0,41,41,60
11849,Hungary,2002,2002Hungary,0,0,0,0,0,28,28,0,0,0,0,0,49,49,77
11850,Hungary,2002,2002Hungary,0,0,0,0,11,0,11,0,0,0,5,12,0,17,28
11851,Hungary,2003,2003Hungary,0,0,0,0,0,0,0,0,0,0,0,0,0,0,3249
11852,Hungary,2003,2003Hungary,0,0,0,0,0,0,0,0,0,0,0,6,0,6,6
11853,Hungary,2003,2003Hungary,0,0,0,0,0,18,18,0,0,0,0,0,30,30,48
11854,Hungary,2003,2003Hungary,0,0,0,0,0,23,23,0,0,0,0,0,40,40,63
11855,Hungary,2003,2003Hungary,0,0,0,0,11,0,11,0,0,0,5,12,0,17,28
11856,Hungary,2004,2004Hungary,0,0,0,0,0,0,0,0,0,0,0,0,0,0,2690
11857,Hungary,2004,2004Hungary,0,0,0,0,0,0,0,0,0,0,0,6,0,6,6
11858,Hungary,2004,2004Hungary,0,0,0,0,0,14,14,0,0,0,0,0,14,14,28
11859,Hungary,2004,2004Hungary,0,0,0,0,6,0,6,0,0,0,5,12,0,17,23
11860,Hungary,2005,2005Hungary,0,0,0,0,0,0,0,0,0,0,0,0,0,0,3417
11861,Hungary,2005,2005Hungary,0,0,0,0,0,0,0,0,0,0,0,6,0,6,6
11862,Hungary,2005,2005Hungary,0,0,0,0,0,0,0,0,0,0,0,10,0,10,10
11863,Hungary,2005,2005Hungary,0,0,0,0,0,13,13,0,0,0,0,0,12,12,25
11864,Hungary,2005,2005Hungary,0,0,0,0,0,22,22,0,0,0,0,0,36,36,58
11865,Hungary,2006,2006Hungary,0,0,0,0,0,0,0,0,0,0,0,0,0,0,2949
11866,Hungary,2006,2006Hungary,0,0,0,0,0,0,0,0,0,0,0,6,0,6,6
11867,Hungary,2006,2006Hungary,0,0,0,0,0,0,0,0,0,0,5,5,0,10,10
11868,Hungary,2006,2006Hungary,0,0,0,0,0,8,8,0,0,0,0,0,11,11,19
11869,Hungary,2006,2006Hungary,0,0,0,0,0,24,24,0,0,0,0,0,109,109,133
11870,Hungary,2007,2007Hungary,0,0,0,0,0,0,0,0,0,0,0,0,0,0,3221
11871,Hungary,2007,2007Hungary,0,0,0,0,0,0,0,0,0,0,0,6,0,6,6
11872,Hungary,2007,2007Hungary,0,0,0,0,0,0,0,0,0,0,5,5,0,10,10
11873,Hungary,2007,2007Hungary,0,0,0,0,0,7,7,0,0,0,0,0,13,13,20
11874,Hungary,2007,2007Hungary,0,0,0,0,0,22,22,0,0,0,0,0,105,105,127
11875,Hungary,2008,2008Hungary,0,0,0,0,0,0,0,0,0,0,0,0,0,0,1406
11876,Hungary,2008,2008Hungary,0,0,0,0,0,0,0,0,0,0,0,6,0,6,6
11877,Hungary,2008,2008Hungary,0,0,0,0,0,0,0,0,0,0,9,0,0,9,9
11878,Hungary,2008,2008Hungary,0,0,0,0,0,6,6,0,0,0,0,0,14,14,20
11879,Hungary,2008,2008Hungary,0,0,0,0,0,17,17,0,0,0,0,0,95,95,112
11880,Hungary,2008,2008Hungary,0,0,0,0,0,22,22,0,0,0,0,0,37,37,59
11881,Hungary,2009,2009Hungary,0,0,0,0,0,0,0,0,0,0,0,0,0,0,1271
11882,Hungary,2009,2009Hungary,0,0,0,0,0,0,0,0,0,0,0,6,0,6,6
11883,Hungary,2009,2009Hungary,0,0,0,0,0,0,0,0,0,0,7,0,0,7,7
11884,Hungary,2009,2009Hungary,0,0,0,0,0,5,5,0,0,0,0,0,10,10,15
11885,Hungary,2009,2009Hungary,0,0,0,0,0,14,14,0,0,0,0,0,89,89,103
11886,Hungary,2009,2009Hungary,0,0,0,17,12,0,29,0,0,0,27,77,0,104,133
11887,Hungary,2010,2010Hungary,0,0,0,0,0,0,0,0,0,0,0,0,0,0,1127
11888,Hungary,2010,2010Hungary,0,0,0,0,0,0,0,0,0,0,0,7,0,7,7
11889,Hungary,2010,2010Hungary,0,0,0,0,0,0,0,0,0,0,6,0,0,6,6
11890,Hungary,2010,2010Hungary,0,0,0,0,0,5,5,0,0,0,0,0,9,9,14
11891,Hungary,2010,2010Hungary,0,0,0,0,0,13,13,0,0,0,0,0,75,75,88
11892,Hungary,2010,2010Hungary,0,0,0,0,0,26,26,0,0,0,0,0,37,37,63
11893,Hungary,2010,2010Hungary,0,0,0,17,11,0,28,0,0,0,26,76,0,102,130
11894,Hungary,2011,2011Hungary,0,0,0,0,0,0,0,0,0,0,0,0,0,0,38
11895,Hungary,2011,2011Hungary,0,0,0,0,0,0,0,0,0,0,0,6,0,6,6
11896,Hungary,2011,2011Hungary,0,0,0,0,0,0,0,0,0,0,0,7,0,7,7
11897,Hungary,2011,2011Hungary,0,0,0,0,0,5,5,0,0,0,0,0,7,7,12
11898,Hungary,2011,2011Hungary,0,0,0,0,0,13,13,0,0,0,0,0,73,73,86
11899,Hungary,2011,2011Hungary,0,0,0,0,0,25,25,0,0,0,0,0,40,40,65
11900,Hungary,2011,2011Hungary,0,0,0,16,13,0,29,0,0,0,20,78,0,98,127
11901,Hungary,2011,2011Hungary,8,13,6,67,0,0,94,10,8,16,60,0,0,94,893
11902,Hungary,2012,2012Hungary,0,0,0,0,0,0,0,0,0,0,0,0,0,0,37
11903,Hungary,2012,2012Hungary,0,0,0,0,0,0,0,0,0,0,0,7,0,7,7
11904,Hungary,2012,2012Hungary,0,0,0,0,0,0,0,0,0,0,6,0,0,6,6
11905,Hungary,2012,2012Hungary,0,0,0,0,0,5,5,0,0,0,0,0,5,5,10
11906,Hungary,2012,2012Hungary,0,0,0,0,0,10,10,0,0,0,0,0,65,65,75
11907,Hungary,2012,2012Hungary,0,0,0,0,0,24,24,0,0,0,0,0,39,39,63
11908,Hungary,2012,2012Hungary,0,0,0,14,15,0,29,0,0,0,16,76,0,92,121
11909,Hungary,2012,2012Hungary,27,31,31,141,0,0,230,19,37,40,122,0,0,218,766
11910,Hungary,2013,2013Hungary,0,0,0,0,0,0,0,0,0,0,0,0,0,0,32
11911,Hungary,2013,2013Hungary,0,0,0,0,0,0,0,0,0,0,0,7,0,7,7
11912,Hungary,2013,2013Hungary,0,0,0,0,0,0,0,0,0,0,6,0,0,6,6
11913,Hungary,2013,2013Hungary,0,0,0,0,0,0,0,0,0,5,0,0,0,5,5
11914,Hungary,2013,2013Hungary,0,0,0,0,0,5,5,0,0,0,0,0,5,5,10
11915,Hungary,2013,2013Hungary,0,0,0,0,0,5,5,0,0,0,0,0,16,16,21
11916,Hungary,2013,2013Hungary,0,0,0,0,0,25,25,0,0,0,0,0,39,39,64
11917,Hungary,2013,2013Hungary,0,0,0,38,51,0,89,0,0,0,56,163,0,219,308
11918,Hungary,2013,2013Hungary,18,34,23,136,0,0,211,20,32,28,118,5,0,203,765
11919,Hungary,2014,2014Hungary,0,0,0,0,0,0,0,0,0,0,0,0,0,0,54
11920,Hungary,2014,2014Hungary,0,0,0,0,0,0,0,0,0,0,0,0,9,9,9
11921,Hungary,2014,2014Hungary,0,0,0,0,0,0,0,0,0,0,0,7,0,7,7
11922,Hungary,2014,2014Hungary,0,0,0,0,0,0,0,0,0,0,6,0,0,6,6
11923,Hungary,2014,2014Hungary,0,0,0,0,0,24,24,0,0,0,0,0,41,41,65
11924,Hungary,2014,2014Hungary,0,0,0,33,53,0,86,0,0,0,49,160,0,209,295
11925,Hungary,2014,2014Hungary,20,21,16,100,5,0,162,29,30,19,100,0,0,178,828
11926,Hungary,2015,2015Hungary,0,0,0,0,0,0,0,0,0,0,0,0,0,0,1015
11927,Hungary,2015,2015Hungary,0,0,0,0,0,0,0,0,0,0,0,7,0,7,7
11928,Hungary,2015,2015Hungary,0,0,0,0,0,0,0,0,0,0,5,0,0,5,5
11929,Hungary,2015,2015Hungary,0,0,0,0,0,7,7,0,0,0,0,0,47,47,54
11930,Hungary,2015,2015Hungary,0,0,0,0,0,9,9,0,0,0,0,0,0,0,9
11931,Hungary,2015,2015Hungary,0,0,0,0,0,25,25,0,0,0,0,0,41,41,66
11932,Hungary,2015,2015Hungary,0,0,0,28,57,0,85,0,0,0,48,158,0,206,291
11933,Hungary,2016,2016Hungary,0,0,0,0,0,0,0,0,0,0,0,0,0,0,38
11934,Hungary,2016,2016Hungary,0,0,0,0,0,0,0,0,0,0,0,0,7,7,7
11935,Hungary,2016,2016Hungary,0,0,0,0,0,6,6,0,0,0,0,0,43,43,49
11936,Hungary,2016,2016Hungary,0,0,0,0,0,25,25,0,0,0,0,0,41,41,66
11937,Hungary,2016,2016Hungary,0,0,0,0,7,0,7,0,0,0,0,0,0,0,7
11938,Hungary,2016,2016Hungary,0,0,0,25,56,0,81,0,0,0,46,142,0,188,269
11939,Hungary,2016,2016Hungary,6,0,0,49,5,0,60,7,0,5,125,0,0,137,2473
11940,Hungary,2017,2017Hungary,0,0,0,0,0,0,0,0,0,0,0,0,0,0,2998
11941,Hungary,2017,2017Hungary,0,0,0,0,0,7,7,0,0,0,0,0,0,0,7
11942,Hungary,2017,2017Hungary,0,0,0,0,0,25,25,0,0,0,0,0,40,40,65
11943,Hungary,2017,2017Hungary,0,0,0,0,7,0,7,0,0,0,0,0,0,0,7
11944,Hungary,2017,2017Hungary,0,0,0,20,61,0,81,0,0,0,41,137,0,178,259
11945,Hungary,2018,2018Hungary,0,0,0,0,0,0,0,0,0,0,0,0,0,0,86
11946,Hungary,2018,2018Hungary,0,0,0,0,0,0,0,0,0,0,0,0,5,5,5
11947,Hungary,2018,2018Hungary,0,0,0,0,0,0,0,0,0,0,0,6,0,6,6
11948,Hungary,2018,2018Hungary,0,0,0,0,0,20,20,0,0,0,0,0,36,36,56
11949,Hungary,2018,2018Hungary,0,0,0,17,61,0,78,0,0,0,36,136,0,172,250
11950,Hungary,2018,2018Hungary,6,20,29,120,5,0,180,8,11,27,115,5,0,166,3524
11951,Hungary,2019,2019Hungary,0,0,0,0,0,0,0,0,0,0,0,0,0,0,3707
11952,Hungary,2019,2019Hungary,0,0,0,0,0,0,0,0,0,0,0,5,0,5,5
11953,Hungary,2019,2019Hungary,0,0,0,0,0,20,20,0,0,0,0,0,34,34,54
11954,Hungary,2019,2019Hungary,0,0,0,12,65,0,77,0,0,0,30,134,0,164,241
11955,Hungary,2020,2020Hungary,0,0,0,0,0,0,0,0,0,0,0,0,0,0,89
11956,Hungary,2020,2020Hungary,0,0,0,0,0,0,0,0,0,0,0,0,29,29,29
11957,Hungary,2020,2020Hungary,0,0,0,0,0,0,0,0,0,0,0,5,0,5,5
11958,Hungary,2020,2020Hungary,0,0,0,14,64,0,78,0,0,0,24,131,0,155,233
11959,Hungary,2020,2020Hungary,26,14,14,154,0,58,266,60,55,15,203,0,52,385,4261
11960,Hungary,2021,2021Hungary,0,0,0,0,0,0,0,0,0,0,0,0,0,0,135
11961,Hungary,2021,2021Hungary,0,0,0,0,0,0,0,0,0,0,0,5,0,5,5
11962,Hungary,2021,2021Hungary,0,0,0,13,62,0,75,0,0,0,19,129,0,148,223
11963,Hungary,2021,2021Hungary,34,31,24,213,0,58,360,73,65,20,254,5,52,469,4290
11964,India,2001,2001India,0,0,0,0,0,0,0,0,0,0,0,0,0,0,11349
11965,India,2001,2001India,0,0,0,0,0,0,0,0,0,0,0,0,19,19,19
11966,India,2001,2001India,0,0,0,0,0,8,8,0,0,0,0,0,19,19,27
11967,India,2001,2001India,0,0,0,0,0,13,13,0,0,0,0,0,152,152,165
11968,India,2002,2002India,0,0,0,0,0,0,0,0,0,0,0,0,0,0,14141
11969,India,2002,2002India,0,0,0,0,0,0,0,0,0,0,5,0,0,5,5
11970,India,2002,2002India,0,0,0,0,0,8,8,0,0,0,0,0,7,7,26
11971,India,2002,2002India,0,0,0,0,0,14,14,0,0,0,0,0,163,163,177
11972,India,2003,2003India,0,0,0,0,0,0,0,0,0,0,0,0,0,0,13492
11973,India,2003,2003India,0,0,0,0,0,0,0,0,0,0,5,0,0,5,5
11974,India,2003,2003India,0,0,0,0,0,9,9,0,0,0,0,0,10,10,32
11975,India,2003,2003India,0,0,0,0,0,14,14,0,0,0,0,0,160,160,174
11976,India,2004,2004India,0,0,0,0,0,0,0,0,0,0,0,0,0,0,13269
11977,India,2004,2004India,0,0,0,5,0,0,5,0,0,0,20,0,0,20,25
11978,India,2004,2004India,0,0,0,5,0,8,13,0,0,0,10,0,13,23,36
11979,India,2004,2004India,5,0,0,0,0,0,5,0,0,0,0,0,0,0,5
11980,India,2005,2005India,0,0,0,0,0,0,0,0,0,0,0,0,0,0,15998
11981,India,2005,2005India,0,0,0,0,0,27,27,0,0,0,0,0,177,177,204
11982,India,2005,2005India,0,0,0,5,0,0,5,0,0,0,23,0,0,23,28
11983,India,2005,2005India,0,0,0,5,0,10,15,0,5,0,8,0,12,25,40
11984,India,2005,2005India,0,0,5,0,0,0,5,0,0,0,0,0,0,0,5
11985,India,2006,2006India,0,0,0,0,0,0,0,0,0,0,0,0,0,0,17508
11986,India,2006,2006India,0,0,0,0,0,0,0,0,0,0,0,0,5,5,5
11987,India,2006,2006India,0,0,0,0,0,14,14,0,0,0,0,0,24,24,38
11988,India,2006,2006India,0,0,0,0,0,35,35,0,0,0,0,0,183,183,218
11989,India,2006,2006India,0,0,0,5,0,0,5,0,0,0,23,0,0,23,28
11990,India,2007,2007India,0,0,0,0,0,0,0,0,0,0,0,0,0,0,20158
11991,India,2007,2007India,0,0,0,0,0,0,0,0,0,0,0,0,5,5,5
11992,India,2007,2007India,0,0,0,0,0,0,0,0,0,0,0,0,218,218,218
11993,India,2007,2007India,0,0,0,0,0,0,0,0,0,0,5,0,0,5,5
11994,India,2007,2007India,0,0,0,0,0,0,0,0,0,0,6,0,0,6,6
11995,India,2007,2007India,0,0,0,0,0,12,12,0,5,0,8,0,11,24,36
11996,India,2007,2007India,0,0,0,5,0,0,5,0,0,0,22,0,0,22,27
11997,India,2008,2008India,0,0,0,0,0,0,0,0,0,0,0,0,0,0,19290
11998,India,2008,2008India,0,0,0,0,0,0,0,0,0,0,5,0,0,5,5
11999,India,2008,2008India,0,0,0,0,0,0,0,0,0,0,7,0,0,7,7
12000,India,2008,2008India,0,0,0,0,0,37,37,0,0,0,0,0,176,176,213
12001,India,2008,2008India,0,0,0,6,0,8,14,0,5,0,5,0,12,22,36
12002,India,2009,2009India,0,0,0,0,0,0,0,0,0,0,0,0,0,0,16566
12003,India,2009,2009India,0,0,0,0,0,0,0,0,0,0,7,0,0,7,7
12004,India,2009,2009India,0,0,0,0,0,0,0,0,0,0,11,0,0,11,11
12005,India,2009,2009India,0,0,0,6,0,7,13,5,0,0,5,0,10,20,33
12006,India,2009,2009India,40,43,13,178,20,0,294,32,41,31,2398,83,0,2585,2879
12007,India,2010,2010India,0,0,0,0,0,0,0,0,0,0,0,0,0,0,14727
12008,India,2010,2010India,0,0,0,0,0,0,0,0,0,0,0,0,5,5,5
12009,India,2010,2010India,0,0,0,0,0,0,0,0,0,0,7,0,0,7,7
12010,India,2010,2010India,0,0,0,0,0,0,0,0,0,0,15,0,0,15,15
12011,India,2010,2010India,0,0,0,0,0,40,40,0,0,0,0,0,166,166,206
12012,India,2010,2010India,0,0,0,7,0,6,13,0,5,0,5,0,9,19,32
12013,India,2010,2010India,36,45,16,180,20,0,297,30,30,30,2287,100,0,2477,2774
12014,India,2011,2011India,0,0,0,0,0,0,0,0,0,0,0,0,0,0,7525
12015,India,2011,2011India,0,0,0,0,0,0,0,0,0,0,0,0,5,5,5
12016,India,2011,2011India,0,0,0,0,0,0,0,0,0,0,7,0,0,7,7
12017,India,2011,2011India,0,0,0,0,0,0,0,0,0,0,18,0,0,18,18
12018,India,2011,2011India,0,0,0,0,0,41,41,0,0,0,0,0,162,162,203
12019,India,2011,2011India,0,0,5,0,0,0,5,0,0,0,11,0,0,11,34
12020,India,2011,2011India,0,5,0,8,0,6,19,0,6,0,9,0,10,25,44
12021,India,2011,2011India,6,16,26,130,8,0,186,5,17,26,188,7,0,243,5621
12022,India,2011,2011India,42,43,19,186,27,0,317,34,35,31,2234,118,0,2452,2769
12023,India,2012,2012India,0,0,0,0,0,0,0,0,0,0,0,0,0,0,5864
12024,India,2012,2012India,0,0,0,0,0,0,0,0,0,0,6,0,0,6,6
12025,India,2012,2012India,0,0,0,0,0,0,0,0,0,0,7,0,0,7,7
12026,India,2012,2012India,0,0,0,0,0,5,5,0,0,0,0,0,5,5,10
12027,India,2012,2012India,0,0,0,0,0,44,44,0,0,0,0,0,155,155,199
12028,India,2012,2012India,0,0,0,5,0,0,5,0,0,0,5,0,0,5,33
12029,India,2012,2012India,0,5,0,7,0,6,18,0,7,0,7,0,11,25,43
12030,India,2012,2012India,5,0,0,36,5,0,46,7,0,0,65,0,0,72,5287
12031,India,2012,2012India,40,53,24,206,25,0,348,45,43,33,2176,151,0,2448,2796
12032,India,2013,2013India,0,0,0,0,0,0,0,0,0,0,0,0,0,0,5341
12033,India,2013,2013India,0,0,0,0,0,0,0,0,0,0,0,0,9,9,9
12034,India,2013,2013India,0,0,0,0,0,0,0,0,0,0,5,0,0,5,5
12035,India,2013,2013India,0,0,0,0,0,0,0,0,0,0,7,0,0,7,7
12036,India,2013,2013India,0,0,0,0,0,0,0,0,0,0,9,0,0,9,9
12037,India,2013,2013India,0,0,0,0,0,43,43,0,0,0,0,0,154,154,197
12038,India,2013,2013India,0,0,5,0,0,0,5,0,0,0,27,0,0,27,32
12039,India,2013,2013India,0,5,0,9,0,5,19,0,7,0,7,0,10,24,43
12040,India,2013,2013India,0,7,15,68,0,0,90,0,14,16,53,0,0,83,4988
12041,India,2013,2013India,53,49,12,23,5,0,142,58,39,17,135,10,0,259,401
12042,India,2014,2014India,0,0,0,0,0,0,0,0,0,0,0,0,0,0,5417
12043,India,2014,2014India,0,0,0,0,0,0,0,0,0,0,9,0,0,9,9
12044,India,2014,2014India,0,0,0,0,0,0,0,5,0,0,0,0,0,5,5
12045,India,2014,2014India,0,0,0,0,0,5,5,0,0,0,0,0,7,7,12
12046,India,2014,2014India,0,0,0,0,0,47,47,0,0,0,0,0,152,152,199
12047,India,2014,2014India,0,0,5,0,0,0,5,0,0,0,25,0,0,25,30
12048,India,2014,2014India,0,0,5,12,0,5,22,0,9,0,10,0,9,28,50
12049,India,2014,2014India,0,8,0,42,0,0,50,0,0,9,55,0,0,64,4292
12050,India,2014,2014India,47,53,18,34,0,0,152,65,41,18,131,10,0,265,417
12051,India,2015,2015India,0,0,0,0,0,0,0,0,0,0,0,0,0,0,9279
12052,India,2015,2015India,0,0,0,0,0,0,0,0,0,0,5,0,0,5,10
12053,India,2015,2015India,0,0,0,0,0,10,10,0,0,0,0,0,12,12,22
12054,India,2015,2015India,0,0,0,0,0,50,50,0,0,0,0,0,152,152,202
12055,India,2015,2015India,0,0,5,0,0,0,5,0,0,0,18,0,0,18,23
12056,India,2015,2015India,0,0,6,17,0,0,23,0,9,0,15,0,0,24,47
12057,India,2015,2015India,12,34,9,33,5,0,93,22,29,14,131,10,0,206,299
12058,India,2016,2016India,0,0,0,0,0,0,0,0,0,0,0,0,0,0,5576
12059,India,2016,2016India,0,0,0,0,0,0,0,0,0,0,0,0,5,5,5
12060,India,2016,2016India,0,0,0,0,0,0,0,0,0,0,5,0,0,5,5
12061,India,2016,2016India,0,0,0,0,0,8,8,0,0,0,0,0,12,12,20
12062,India,2016,2016India,0,0,0,0,0,49,49,0,0,0,0,0,151,151,200
12063,India,2016,2016India,0,0,0,5,0,0,5,0,0,0,17,0,0,17,22
12064,India,2016,2016India,0,0,5,14,0,5,24,0,8,0,12,0,6,26,50
12065,India,2016,2016India,0,7,0,41,0,0,48,0,0,8,71,0,0,79,1144
12066,India,2016,2016India,5,20,12,44,0,0,81,9,16,15,132,13,0,185,266
12067,India,2017,2017India,0,0,0,0,0,0,0,0,0,0,0,0,0,0,7291
12068,India,2017,2017India,0,0,0,0,0,0,0,0,0,0,5,0,0,5,5
12069,India,2017,2017India,0,0,0,0,0,5,5,0,0,0,0,0,0,0,5
12070,India,2017,2017India,0,0,0,0,0,53,53,0,0,0,0,0,160,160,213
12071,India,2017,2017India,0,0,0,5,0,0,5,0,0,0,17,0,0,17,22
12072,India,2017,2017India,0,5,0,9,0,9,23,0,6,0,10,0,0,16,39
12073,India,2017,2017India,11,17,17,91,5,0,141,16,16,16,149,13,0,210,351
12074,India,2018,2018India,0,0,0,0,0,0,0,0,0,0,0,0,0,0,7481
12075,India,2018,2018India,0,0,0,0,0,62,62,0,0,0,0,0,161,161,223
12076,India,2018,2018India,0,0,0,5,0,0,5,0,0,0,17,0,0,17,22
12077,India,2018,2018India,0,5,0,9,0,8,22,0,0,0,6,5,0,11,33
12078,India,2018,2018India,5,18,22,104,0,0,149,6,27,17,131,0,0,181,1457
12079,India,2018,2018India,13,11,19,106,6,0,155,17,13,15,155,15,0,215,370
12080,India,2019,2019India,0,0,0,0,0,0,0,0,0,0,0,0,0,0,11081
12081,India,2019,2019India,0,0,0,0,0,0,0,0,0,0,0,0,7,7,7
12082,India,2019,2019India,0,0,0,0,0,70,70,0,0,0,0,0,166,166,236
12083,India,2019,2019India,0,0,0,5,0,0,5,0,0,0,0,0,0,0,5
12084,India,2019,2019India,0,0,0,5,0,0,5,0,0,0,5,0,0,5,10
12085,India,2019,2019India,0,0,0,5,0,0,5,0,0,0,13,5,0,18,23
12086,India,2019,2019India,0,5,0,10,0,0,15,0,5,0,8,0,0,13,34
12087,India,2019,2019India,18,9,18,118,8,0,171,19,17,16,148,20,0,220,391
12088,India,2020,2020India,0,0,0,0,0,0,0,0,0,0,0,0,0,0,10269
12089,India,2020,2020India,0,0,0,0,0,0,0,0,0,0,0,0,7,7,7
12090,India,2020,2020India,0,0,0,0,0,0,0,0,0,0,0,5,0,5,5
12091,India,2020,2020India,0,0,0,0,0,0,0,0,0,9,0,0,0,9,9
12092,India,2020,2020India,0,0,0,0,0,5,5,0,0,0,0,0,9,9,14
12093,India,2020,2020India,0,0,0,5,0,0,5,0,0,0,0,0,0,0,10
12094,India,2020,2020India,0,0,0,5,0,0,5,0,0,0,13,5,0,18,23
12095,India,2020,2020India,0,0,0,7,0,0,7,0,0,0,7,0,0,7,14
12096,India,2020,2020India,0,0,0,66,0,70,136,8,0,0,160,0,44,212,1598
12097,India,2020,2020India,0,0,5,10,0,0,15,0,5,0,8,0,0,13,34
12098,India,2020,2020India,18,14,18,132,8,0,190,16,22,14,150,23,0,225,415
12099,India,2021,2021India,0,0,0,0,0,0,0,0,0,0,0,0,0,0,11058
12100,India,2021,2021India,0,0,0,0,0,0,0,0,0,0,0,0,7,7,7
12101,India,2021,2021India,0,0,0,0,0,0,0,0,0,0,0,5,0,5,5
12102,India,2021,2021India,0,0,0,0,0,0,0,0,0,0,7,0,0,7,7
12103,India,2021,2021India,0,0,0,5,0,0,5,0,0,0,0,0,0,0,15
12104,India,2021,2021India,0,0,0,5,0,0,5,0,0,0,13,5,0,18,23
12105,India,2021,2021India,0,0,0,6,0,0,6,0,0,0,8,0,0,8,14
12106,India,2021,2021India,0,0,0,9,0,0,9,0,0,0,7,0,0,7,16
12107,India,2021,2021India,0,0,5,9,0,0,14,5,0,0,8,0,0,13,33
12108,India,2021,2021India,18,16,14,134,8,0,190,10,25,15,152,22,0,224,414
12109,India,2021,2021India,22,39,30,463,7,70,631,26,52,36,701,7,44,866,2638
12110,Indonesia,2001,2001Indonesia,0,0,0,0,0,0,0,0,0,0,0,0,0,0,3942
12111,Indonesia,2001,2001Indonesia,0,0,0,0,0,6,6,0,0,0,0,0,0,0,6
12112,Indonesia,2001,2001Indonesia,0,0,0,0,0,2223,2223,0,0,0,0,0,2718,2718,4941
12113,Indonesia,2001,2001Indonesia,6,6,6,17,0,0,35,0,0,9,39,0,0,48,83
12114,Indonesia,2002,2002Indonesia,0,0,0,0,0,0,0,0,0,0,0,0,0,0,4816
12115,Indonesia,2002,2002Indonesia,0,0,0,0,0,6,6,0,0,0,0,0,0,0,6
12116,Indonesia,2002,2002Indonesia,0,0,0,0,0,2223,2223,0,0,0,0,0,2718,2718,4941
12117,Indonesia,2002,2002Indonesia,5,8,7,30,0,0,50,11,5,5,73,0,0,94,144
12118,Indonesia,2003,2003Indonesia,0,0,0,0,0,0,0,0,0,0,0,0,0,0,5551
12119,Indonesia,2003,2003Indonesia,74,26,23,387,0,0,510,79,32,28,2542,7,0,2688,3198
12120,Indonesia,2003,2003Indonesia,146,230,198,573,52,2400,3599,155,268,230,597,42,2600,3892,7491
12121,Indonesia,2004,2004Indonesia,0,0,0,0,0,0,0,0,0,0,0,0,0,0,5112
12122,Indonesia,2004,2004Indonesia,146,230,198,573,52,2400,3599,155,268,230,597,42,2600,3892,7626
12123,Indonesia,2004,2004Indonesia,502,94,80,2372,12,0,3060,519,137,117,11303,45,0,12121,15181
12124,Indonesia,2005,2005Indonesia,0,0,0,0,0,0,0,0,0,0,0,0,0,0,5226
12125,Indonesia,2005,2005Indonesia,0,0,5,0,0,0,5,0,0,0,0,0,0,0,5
12126,Indonesia,2005,2005Indonesia,0,8,0,0,0,0,8,0,0,0,0,0,0,0,8
12127,Indonesia,2005,2005Indonesia,152,233,196,565,56,0,1202,153,270,223,601,42,0,1289,9991
12128,Indonesia,2005,2005Indonesia,614,172,148,3053,20,0,4007,699,221,189,13992,45,0,15146,19153
12129,Indonesia,2006,2006Indonesia,0,0,0,0,0,0,0,0,0,0,0,0,0,0,9366
12130,Indonesia,2006,2006Indonesia,0,0,0,0,0,5,5,0,0,0,0,0,0,0,5
12131,Indonesia,2006,2006Indonesia,0,0,0,0,0,1305,1305,0,0,0,0,0,1372,1372,10177
12132,Indonesia,2006,2006Indonesia,618,160,174,2437,7,0,3396,575,100,301,10741,61,0,11778,15174
12133,Indonesia,2007,2007Indonesia,0,0,0,0,0,0,0,0,0,0,0,0,0,0,8328
12134,Indonesia,2007,2007Indonesia,0,0,0,0,0,6,6,0,0,0,0,0,0,0,6
12135,Indonesia,2007,2007Indonesia,32,47,7,515,5,0,606,33,30,28,1185,5,0,1281,2215
12136,Indonesia,2007,2007Indonesia,142,391,618,46,0,0,1197,142,449,661,51,0,0,1303,10000
12137,Indonesia,2008,2008Indonesia,0,0,0,0,0,0,0,0,0,0,0,0,0,0,8835
12138,Indonesia,2008,2008Indonesia,0,0,0,0,0,6,6,0,0,0,0,0,0,0,6
12139,Indonesia,2008,2008Indonesia,0,0,0,5,0,0,5,0,0,0,0,0,0,0,498
12140,Indonesia,2008,2008Indonesia,142,212,179,618,46,0,1197,142,243,206,661,51,0,1303,10000
12141,Indonesia,2009,2009Indonesia,0,0,0,0,0,0,0,0,0,0,0,0,0,0,7663
12142,Indonesia,2009,2009Indonesia,0,0,0,12,0,0,12,0,0,0,0,0,0,0,747
12143,Indonesia,2009,2009Indonesia,0,5,6,40,6,0,57,5,0,8,21,17,0,51,108
12144,Indonesia,2009,2009Indonesia,69,103,87,299,22,0,580,69,118,100,318,25,0,630,9689
12145,Indonesia,2010,2010Indonesia,0,0,0,0,0,0,0,0,0,0,0,0,0,0,6262
12146,Indonesia,2010,2010Indonesia,0,0,0,7,0,0,7,0,0,0,0,0,0,0,814
12147,Indonesia,2010,2010Indonesia,0,5,7,44,6,0,62,6,9,6,18,16,0,55,117
12148,Indonesia,2010,2010Indonesia,69,103,87,299,22,0,580,69,118,100,318,25,0,630,9689
12149,Indonesia,2011,2011Indonesia,0,0,0,0,0,0,0,0,0,0,0,0,0,0,5342
12150,Indonesia,2011,2011Indonesia,0,0,0,0,0,6,6,0,0,0,0,0,0,0,6
12151,Indonesia,2011,2011Indonesia,0,0,0,5,0,0,5,0,0,0,0,0,0,0,858
12152,Indonesia,2011,2011Indonesia,0,0,0,21,0,0,21,0,5,0,8,0,0,13,368
12153,Indonesia,2011,2011Indonesia,0,7,12,45,7,0,71,6,11,5,20,14,0,56,127
12154,Indonesia,2011,2011Indonesia,69,103,87,299,22,0,580,69,118,100,321,25,0,633,9368
12155,Indonesia,2012,2012Indonesia,0,0,0,0,0,0,0,0,0,0,0,0,0,0,4757
12156,Indonesia,2012,2012Indonesia,0,0,0,0,0,7,7,0,0,0,0,0,0,0,7
12157,Indonesia,2012,2012Indonesia,0,0,0,7,0,0,7,0,0,0,7,0,0,7,351
12158,Indonesia,2012,2012Indonesia,0,0,0,10,0,0,10,0,0,0,0,0,0,0,901
12159,Indonesia,2012,2012Indonesia,0,7,10,56,6,0,79,5,6,5,20,15,0,51,130
12160,Indonesia,2012,2012Indonesia,298,415,339,1212,85,0,2349,302,470,386,1182,98,0,2438,9368
12161,Indonesia,2013,2013Indonesia,0,0,0,0,0,0,0,0,0,0,0,0,0,0,4301
12162,Indonesia,2013,2013Indonesia,0,0,0,0,0,6,6,0,0,0,0,0,0,0,6
12163,Indonesia,2013,2013Indonesia,0,0,0,11,0,0,11,0,0,6,5,0,0,11,358
12164,Indonesia,2013,2013Indonesia,0,0,0,149,0,0,149,0,0,0,0,0,0,0,714
12165,Indonesia,2013,2013Indonesia,0,5,5,0,0,0,10,0,9,0,0,9,0,18,28
12166,Indonesia,2013,2013Indonesia,298,415,339,1212,85,0,2349,302,470,386,1182,98,0,2438,9368
12167,Indonesia,2014,2014Indonesia,0,0,0,0,0,0,0,0,0,0,0,0,0,0,13262
12168,Indonesia,2014,2014Indonesia,0,0,0,0,0,0,0,0,0,9,0,0,0,9,336
12169,Indonesia,2014,2014Indonesia,0,0,0,0,0,6,6,0,0,0,0,0,0,0,6
12170,Indonesia,2014,2014Indonesia,0,0,0,488,0,0,488,5,0,0,0,0,0,5,758
12171,Indonesia,2014,2014Indonesia,5,5,0,0,0,0,10,0,7,5,0,9,0,21,31
12172,Indonesia,2015,2015Indonesia,0,0,0,0,0,0,0,0,0,0,0,0,0,0,13139
12173,Indonesia,2015,2015Indonesia,0,0,0,0,0,6,6,0,0,0,0,0,0,0,6
12174,Indonesia,2015,2015Indonesia,0,0,6,0,0,0,6,0,6,0,0,8,0,14,20
12175,Indonesia,2015,2015Indonesia,5,0,0,658,0,0,663,5,0,0,0,0,0,5,782
12176,Indonesia,2016,2016Indonesia,0,0,0,0,0,0,0,0,0,0,0,0,0,0,12132
12177,Indonesia,2016,2016Indonesia,0,0,0,0,0,0,0,0,0,0,6,0,0,6,121
12178,Indonesia,2016,2016Indonesia,0,0,0,0,0,5,5,0,0,0,0,0,0,0,5
12179,Indonesia,2016,2016Indonesia,0,0,0,5,0,0,5,0,0,0,0,0,0,0,5
12180,Indonesia,2016,2016Indonesia,0,0,0,5,0,0,5,0,0,0,0,9,0,9,14
12181,Indonesia,2016,2016Indonesia,57,18,16,218,5,0,314,70,22,20,186,5,0,303,779
12182,Indonesia,2017,2017Indonesia,0,0,0,0,0,0,0,0,0,0,0,0,0,0,11579
12183,Indonesia,2017,2017Indonesia,0,0,0,0,0,0,0,0,5,0,0,7,0,12,12
12184,Indonesia,2017,2017Indonesia,0,0,0,0,0,6,6,0,0,0,0,0,0,0,6
12185,Indonesia,2017,2017Indonesia,0,0,0,5,0,0,5,0,0,0,0,0,0,0,5
12186,Indonesia,2017,2017Indonesia,0,0,0,17,0,0,17,0,0,0,0,0,0,0,883
12187,Indonesia,2018,2018Indonesia,0,0,0,0,0,0,0,0,0,0,0,0,0,0,11196
12188,Indonesia,2018,2018Indonesia,0,0,0,0,0,0,0,0,0,0,0,0,7,7,7
12189,Indonesia,2018,2018Indonesia,0,0,0,0,0,0,0,0,5,0,0,8,0,13,13
12190,Indonesia,2018,2018Indonesia,0,0,0,0,0,6,6,0,0,0,0,0,0,0,6
12191,Indonesia,2018,2018Indonesia,5,5,0,900,0,0,910,7,0,9,0,0,0,16,926
12192,Indonesia,2019,2019Indonesia,0,0,0,0,0,0,0,0,0,0,0,0,0,0,11014
12193,Indonesia,2019,2019Indonesia,0,0,0,0,0,0,0,0,0,0,0,0,8,8,8
12194,Indonesia,2019,2019Indonesia,0,0,0,5,0,0,5,0,0,0,0,0,0,0,5
12195,Indonesia,2019,2019Indonesia,0,0,0,5,0,0,5,0,0,0,6,5,0,11,16
12196,Indonesia,2019,2019Indonesia,7,5,0,961,5,0,978,0,13,5,0,0,0,18,996
12197,Indonesia,2020,2020Indonesia,0,0,0,0,0,0,0,0,0,0,0,0,0,0,12006
12198,Indonesia,2020,2020Indonesia,0,0,0,0,0,0,0,0,0,0,5,0,0,5,5
12199,Indonesia,2020,2020Indonesia,0,0,0,0,0,0,0,0,0,0,8,6,0,14,14
12200,Indonesia,2020,2020Indonesia,0,0,0,5,0,0,5,0,0,0,0,0,0,0,5
12201,Indonesia,2020,2020Indonesia,0,0,0,14,0,0,14,0,0,0,0,0,0,0,14
12202,Indonesia,2020,2020Indonesia,0,13,0,950,5,0,968,0,12,0,5,0,0,17,985
12203,Indonesia,2021,2021Indonesia,0,0,0,0,0,0,0,0,0,0,0,0,0,0,12872
12204,Indonesia,2021,2021Indonesia,0,0,0,0,0,0,0,0,0,0,5,0,0,5,5
12205,Indonesia,2021,2021Indonesia,0,0,0,5,0,0,5,0,0,0,0,0,0,0,5
12206,Indonesia,2021,2021Indonesia,0,0,0,5,0,0,5,0,0,0,6,5,0,11,16
12207,Indonesia,2021,2021Indonesia,0,0,0,7,0,0,7,0,0,0,5,0,0,5,12
12208,Indonesia,2021,2021Indonesia,0,0,0,10,0,0,10,0,0,5,7,0,0,12,106
12209,Indonesia,2021,2021Indonesia,0,11,0,913,5,0,929,0,12,0,5,0,0,17,946
12210,Iran (Islamic Rep. of),2001,2001Iran (Islamic Rep. of),0,0,0,0,0,0,0,0,0,0,0,0,0,0,62947
12211,Iran (Islamic Rep. of),2001,2001Iran (Islamic Rep. of),0,0,0,0,0,0,0,0,0,0,5,0,0,5,20
12212,Iran (Islamic Rep. of),2001,2001Iran (Islamic Rep. of),0,0,0,0,0,0,0,0,0,0,6,0,0,6,12
12213,Iran (Islamic Rep. of),2001,2001Iran (Islamic Rep. of),0,0,0,0,0,0,0,0,0,0,14,0,0,14,14
12214,Iran (Islamic Rep. of),2001,2001Iran (Islamic Rep. of),0,0,0,0,0,0,0,0,0,0,23,0,0,23,23
12215,Iran (Islamic Rep. of),2001,2001Iran (Islamic Rep. of),0,0,0,0,0,0,0,0,5,0,0,0,0,5,5
12216,Iran (Islamic Rep. of),2001,2001Iran (Islamic Rep. of),0,0,0,0,0,0,0,0,6,0,0,0,0,6,6
12217,Iran (Islamic Rep. of),2001,2001Iran (Islamic Rep. of),0,0,0,0,0,0,0,5,0,0,5,0,0,10,10
12218,Iran (Islamic Rep. of),2001,2001Iran (Islamic Rep. of),0,0,0,0,0,15,15,0,0,0,0,0,15,15,30
12219,Iran (Islamic Rep. of),2001,2001Iran (Islamic Rep. of),0,0,0,0,0,69,69,0,0,0,0,0,174,174,243
12220,Iran (Islamic Rep. of),2001,2001Iran (Islamic Rep. of),0,0,0,0,0,464,464,0,0,0,0,0,615,615,1079
12221,Iran (Islamic Rep. of),2001,2001Iran (Islamic Rep. of),0,0,0,0,0,708,708,0,0,0,0,0,1279,1279,1987
12222,Iran (Islamic Rep. of),2001,2001Iran (Islamic Rep. of),0,0,0,5,0,0,5,0,0,0,0,0,0,0,10
12223,Iran (Islamic Rep. of),2001,2001Iran (Islamic Rep. of),0,0,0,6,0,0,6,0,0,0,0,0,0,0,6
12224,Iran (Islamic Rep. of),2001,2001Iran (Islamic Rep. of),0,0,0,6,0,0,6,0,0,0,8,0,0,8,14
12225,Iran (Islamic Rep. of),2001,2001Iran (Islamic Rep. of),0,0,0,9,0,0,9,0,0,0,8,0,0,8,134
12226,Iran (Islamic Rep. of),2001,2001Iran (Islamic Rep. of),0,0,0,9,0,0,9,0,0,5,9,0,0,14,23
12227,Iran (Islamic Rep. of),2001,2001Iran (Islamic Rep. of),0,0,0,10,0,0,10,0,0,0,9,0,0,9,19
12228,Iran (Islamic Rep. of),2001,2001Iran (Islamic Rep. of),0,0,0,15,0,0,15,0,0,0,22,0,0,22,37
12229,Iran (Islamic Rep. of),2001,2001Iran (Islamic Rep. of),0,0,5,0,0,0,5,0,0,0,0,0,0,0,10
12230,Iran (Islamic Rep. of),2001,2001Iran (Islamic Rep. of),0,0,5,0,0,0,5,0,0,0,23,0,0,23,28
12231,Iran (Islamic Rep. of),2001,2001Iran (Islamic Rep. of),0,0,5,5,0,0,10,0,0,0,13,0,0,13,23
12232,Iran (Islamic Rep. of),2001,2001Iran (Islamic Rep. of),0,0,5,6,0,0,11,0,5,0,10,0,0,15,26
12233,Iran (Islamic Rep. of),2001,2001Iran (Islamic Rep. of),0,0,7,0,0,0,7,0,0,0,5,0,0,5,12
12234,Iran (Islamic Rep. of),2001,2001Iran (Islamic Rep. of),0,0,8,0,0,0,8,0,0,0,0,0,0,0,8
12235,Iran (Islamic Rep. of),2001,2001Iran (Islamic Rep. of),0,5,0,5,0,0,10,0,7,0,14,0,0,21,31
12236,Iran (Islamic Rep. of),2001,2001Iran (Islamic Rep. of),0,5,6,23,0,0,34,0,5,6,45,5,0,61,95
12237,Iran (Islamic Rep. of),2001,2001Iran (Islamic Rep. of),0,8,0,7,0,0,15,0,0,6,6,0,0,12,27
12238,Iran (Islamic Rep. of),2001,2001Iran (Islamic Rep. of),5,0,0,0,0,0,5,0,0,0,6,0,0,6,11
12239,Iran (Islamic Rep. of),2001,2001Iran (Islamic Rep. of),5,16,14,40,0,0,75,5,13,18,70,0,0,106,181
12240,Iran (Islamic Rep. of),2001,2001Iran (Islamic Rep. of),48,97,91,468,21,0,725,40,134,111,702,27,0,1014,1739
12241,Iran (Islamic Rep. of),2001,2001Iran (Islamic Rep. of),1550,2478,2125,4860,389,0,11402,1569,2567,2193,5068,513,0,11910,23680
12242,Iran (Islamic Rep. of),2002,2002Iran (Islamic Rep. of),0,0,0,0,0,0,0,0,0,0,0,0,0,0,112500
12243,Iran (Islamic Rep. of),2002,2002Iran (Islamic Rep. of),0,0,0,0,0,0,0,0,0,0,5,0,0,5,10
12244,Iran (Islamic Rep. of),2002,2002Iran (Islamic Rep. of),0,0,0,0,0,0,0,0,0,0,6,0,0,6,6
12245,Iran (Islamic Rep. of),2002,2002Iran (Islamic Rep. of),0,0,0,0,0,0,0,0,0,0,8,0,0,8,8
12246,Iran (Islamic Rep. of),2002,2002Iran (Islamic Rep. of),0,0,0,0,0,0,0,0,0,5,21,0,0,26,26
12247,Iran (Islamic Rep. of),2002,2002Iran (Islamic Rep. of),0,0,0,0,0,0,0,0,5,0,0,0,0,5,5
12248,Iran (Islamic Rep. of),2002,2002Iran (Islamic Rep. of),0,0,0,0,0,0,0,0,6,0,0,0,0,6,6
12249,Iran (Islamic Rep. of),2002,2002Iran (Islamic Rep. of),0,0,0,0,0,0,0,5,0,0,5,0,0,10,10
12250,Iran (Islamic Rep. of),2002,2002Iran (Islamic Rep. of),0,0,0,0,0,5,5,0,0,0,0,0,34,34,39
12251,Iran (Islamic Rep. of),2002,2002Iran (Islamic Rep. of),0,0,0,0,0,352,352,0,0,0,0,0,445,445,984
12252,Iran (Islamic Rep. of),2002,2002Iran (Islamic Rep. of),0,0,0,0,0,675,675,0,0,0,0,0,1209,1209,1884
12253,Iran (Islamic Rep. of),2002,2002Iran (Islamic Rep. of),0,0,0,5,0,0,5,0,0,0,0,0,0,0,10
12254,Iran (Islamic Rep. of),2002,2002Iran (Islamic Rep. of),0,0,0,5,0,0,5,0,0,0,13,0,0,13,18
12255,Iran (Islamic Rep. of),2002,2002Iran (Islamic Rep. of),0,0,0,6,0,0,6,0,0,0,0,0,0,0,6
12256,Iran (Islamic Rep. of),2002,2002Iran (Islamic Rep. of),0,0,0,6,0,0,6,0,0,5,0,0,0,5,11
12257,Iran (Islamic Rep. of),2002,2002Iran (Islamic Rep. of),0,0,0,6,0,0,6,0,6,0,0,0,0,6,12
12258,Iran (Islamic Rep. of),2002,2002Iran (Islamic Rep. of),0,0,0,8,0,0,8,0,0,0,0,0,0,0,8
12259,Iran (Islamic Rep. of),2002,2002Iran (Islamic Rep. of),0,0,0,8,0,0,8,0,5,0,5,0,0,10,18
12260,Iran (Islamic Rep. of),2002,2002Iran (Islamic Rep. of),0,0,0,9,0,0,9,0,5,0,9,0,0,14,23
12261,Iran (Islamic Rep. of),2002,2002Iran (Islamic Rep. of),0,0,0,10,0,0,10,0,0,0,9,0,0,9,19
12262,Iran (Islamic Rep. of),2002,2002Iran (Islamic Rep. of),0,0,0,12,0,0,12,0,5,0,13,5,0,23,392
12263,Iran (Islamic Rep. of),2002,2002Iran (Islamic Rep. of),0,0,0,15,0,0,15,0,0,0,23,0,0,23,38
12264,Iran (Islamic Rep. of),2002,2002Iran (Islamic Rep. of),0,0,5,0,0,0,5,0,0,0,23,0,0,23,28
12265,Iran (Islamic Rep. of),2002,2002Iran (Islamic Rep. of),0,0,5,0,0,0,5,0,0,5,5,0,0,10,15
12266,Iran (Islamic Rep. of),2002,2002Iran (Islamic Rep. of),0,0,8,7,0,0,15,0,0,6,6,0,0,12,27
12267,Iran (Islamic Rep. of),2002,2002Iran (Islamic Rep. of),0,5,6,19,0,0,30,0,9,0,43,5,0,57,87
12268,Iran (Islamic Rep. of),2002,2002Iran (Islamic Rep. of),0,6,0,0,0,0,6,0,0,0,11,0,0,11,17
12269,Iran (Islamic Rep. of),2002,2002Iran (Islamic Rep. of),5,0,5,28,0,0,38,5,6,5,32,0,0,48,86
12270,Iran (Islamic Rep. of),2002,2002Iran (Islamic Rep. of),47,98,102,492,15,0,754,50,127,120,747,20,0,1064,1818
12271,Iran (Islamic Rep. of),2002,2002Iran (Islamic Rep. of),1436,2118,1818,4036,413,0,9821,1422,2304,1985,4201,518,0,10430,20251
12272,Iran (Islamic Rep. of),2003,2003Iran (Islamic Rep. of),0,0,0,0,0,0,0,0,0,0,0,0,0,0,107317
12273,Iran (Islamic Rep. of),2003,2003Iran (Islamic Rep. of),0,0,0,0,0,0,0,0,0,0,0,0,6,6,6
12274,Iran (Islamic Rep. of),2003,2003Iran (Islamic Rep. of),0,0,0,0,0,0,0,0,0,0,5,0,0,5,5
12275,Iran (Islamic Rep. of),2003,2003Iran (Islamic Rep. of),0,0,0,0,0,0,0,0,0,0,6,0,0,6,18
12276,Iran (Islamic Rep. of),2003,2003Iran (Islamic Rep. of),0,0,0,0,0,0,0,0,0,0,9,0,0,9,18
12277,Iran (Islamic Rep. of),2003,2003Iran (Islamic Rep. of),0,0,0,0,0,0,0,0,0,5,0,0,0,5,5
12278,Iran (Islamic Rep. of),2003,2003Iran (Islamic Rep. of),0,0,0,0,0,0,0,0,0,5,20,0,0,25,25
12279,Iran (Islamic Rep. of),2003,2003Iran (Islamic Rep. of),0,0,0,0,0,0,0,0,5,0,0,0,0,5,5
12280,Iran (Islamic Rep. of),2003,2003Iran (Islamic Rep. of),0,0,0,0,0,0,0,0,9,0,0,0,0,9,9
12281,Iran (Islamic Rep. of),2003,2003Iran (Islamic Rep. of),0,0,0,0,0,9,9,0,0,0,0,0,10,10,19
12282,Iran (Islamic Rep. of),2003,2003Iran (Islamic Rep. of),0,0,0,0,0,18,18,0,0,0,0,0,21,21,39
12283,Iran (Islamic Rep. of),2003,2003Iran (Islamic Rep. of),0,0,0,0,0,331,331,0,0,0,0,0,424,424,928
12284,Iran (Islamic Rep. of),2003,2003Iran (Islamic Rep. of),0,0,0,0,0,600,600,0,0,0,0,0,1059,1059,1659
12285,Iran (Islamic Rep. of),2003,2003Iran (Islamic Rep. of),0,0,0,5,0,0,5,0,0,0,0,0,0,0,5
12286,Iran (Islamic Rep. of),2003,2003Iran (Islamic Rep. of),0,0,0,5,0,0,5,0,0,0,12,0,0,12,17
12287,Iran (Islamic Rep. of),2003,2003Iran (Islamic Rep. of),0,0,0,5,0,0,5,0,0,5,0,0,0,5,10
12288,Iran (Islamic Rep. of),2003,2003Iran (Islamic Rep. of),0,0,0,5,0,0,5,0,9,0,0,0,0,9,14
12289,Iran (Islamic Rep. of),2003,2003Iran (Islamic Rep. of),0,0,0,6,0,0,6,0,0,0,9,0,0,9,392
12290,Iran (Islamic Rep. of),2003,2003Iran (Islamic Rep. of),0,0,0,10,0,0,10,0,0,0,9,0,0,9,19
12291,Iran (Islamic Rep. of),2003,2003Iran (Islamic Rep. of),0,0,0,15,0,0,15,0,0,0,21,0,0,21,36
12292,Iran (Islamic Rep. of),2003,2003Iran (Islamic Rep. of),0,0,5,0,0,0,5,0,0,0,5,0,0,5,10
12293,Iran (Islamic Rep. of),2003,2003Iran (Islamic Rep. of),0,0,6,21,0,0,27,0,0,6,35,5,0,46,73
12294,Iran (Islamic Rep. of),2003,2003Iran (Islamic Rep. of),0,5,0,0,0,0,5,0,0,0,23,0,0,23,28
12295,Iran (Islamic Rep. of),2003,2003Iran (Islamic Rep. of),0,5,18,28,0,0,51,10,8,7,36,0,0,61,112
12296,Iran (Islamic Rep. of),2003,2003Iran (Islamic Rep. of),0,7,0,8,0,0,15,0,5,0,7,0,0,12,27
12297,Iran (Islamic Rep. of),2003,2003Iran (Islamic Rep. of),0,7,0,16,0,0,23,0,0,5,10,0,0,15,38
12298,Iran (Islamic Rep. of),2003,2003Iran (Islamic Rep. of),8,7,6,56,0,0,77,9,18,15,66,0,0,108,185
12299,Iran (Islamic Rep. of),2003,2003Iran (Islamic Rep. of),32,62,54,412,15,0,575,27,88,84,491,9,0,699,1274
12300,Iran (Islamic Rep. of),2003,2003Iran (Islamic Rep. of),333,1067,918,2411,211,0,4940,351,1143,981,2532,290,0,5297,10237
12301,Iran (Islamic Rep. of),2004,2004Iran (Islamic Rep. of),0,0,0,0,0,0,0,0,0,0,0,0,0,0,101466
12302,Iran (Islamic Rep. of),2004,2004Iran (Islamic Rep. of),0,0,0,0,0,0,0,0,0,0,0,0,11,11,26
12303,Iran (Islamic Rep. of),2004,2004Iran (Islamic Rep. of),0,0,0,0,0,0,0,0,0,0,5,0,0,5,15
12304,Iran (Islamic Rep. of),2004,2004Iran (Islamic Rep. of),0,0,0,0,0,0,0,0,0,0,6,0,0,6,6
12305,Iran (Islamic Rep. of),2004,2004Iran (Islamic Rep. of),0,0,0,0,0,0,0,0,0,0,7,0,0,7,7
12306,Iran (Islamic Rep. of),2004,2004Iran (Islamic Rep. of),0,0,0,0,0,0,0,0,0,5,0,0,0,5,10
12307,Iran (Islamic Rep. of),2004,2004Iran (Islamic Rep. of),0,0,0,0,0,0,0,0,0,5,19,0,0,24,24
12308,Iran (Islamic Rep. of),2004,2004Iran (Islamic Rep. of),0,0,0,0,0,0,0,0,5,0,0,0,0,5,15
12309,Iran (Islamic Rep. of),2004,2004Iran (Islamic Rep. of),0,0,0,0,0,5,5,0,0,0,0,0,5,5,10
12310,Iran (Islamic Rep. of),2004,2004Iran (Islamic Rep. of),0,0,0,0,0,15,15,0,0,0,0,0,24,24,39
12311,Iran (Islamic Rep. of),2004,2004Iran (Islamic Rep. of),0,0,0,5,0,0,5,0,0,0,0,0,0,0,10
12312,Iran (Islamic Rep. of),2004,2004Iran (Islamic Rep. of),0,0,0,5,0,0,5,0,0,0,6,0,0,6,11
12313,Iran (Islamic Rep. of),2004,2004Iran (Islamic Rep. of),0,0,0,5,0,0,5,0,0,0,7,0,0,7,12
12314,Iran (Islamic Rep. of),2004,2004Iran (Islamic Rep. of),0,0,0,5,0,0,5,0,0,0,8,0,0,8,13
12315,Iran (Islamic Rep. of),2004,2004Iran (Islamic Rep. of),0,0,0,5,0,0,5,0,0,0,13,0,0,13,18
12316,Iran (Islamic Rep. of),2004,2004Iran (Islamic Rep. of),0,0,0,5,0,0,5,0,0,0,22,0,0,22,27
12317,Iran (Islamic Rep. of),2004,2004Iran (Islamic Rep. of),0,0,0,5,0,0,5,0,0,0,23,0,0,23,28
12318,Iran (Islamic Rep. of),2004,2004Iran (Islamic Rep. of),0,0,0,7,0,0,7,0,0,0,9,0,0,9,16
12319,Iran (Islamic Rep. of),2004,2004Iran (Islamic Rep. of),0,0,0,7,0,0,7,0,0,0,12,0,0,12,383
12320,Iran (Islamic Rep. of),2004,2004Iran (Islamic Rep. of),0,0,0,9,0,0,9,0,0,0,14,0,0,14,23
12321,Iran (Islamic Rep. of),2004,2004Iran (Islamic Rep. of),0,0,0,10,0,0,10,0,0,0,9,0,0,9,19
12322,Iran (Islamic Rep. of),2004,2004Iran (Islamic Rep. of),0,0,0,13,0,0,13,0,0,0,19,0,0,19,32
12323,Iran (Islamic Rep. of),2004,2004Iran (Islamic Rep. of),0,0,0,15,0,0,15,0,0,6,29,0,0,35,125
12324,Iran (Islamic Rep. of),2004,2004Iran (Islamic Rep. of),0,0,5,11,0,0,16,0,6,0,14,0,0,20,36
12325,Iran (Islamic Rep. of),2004,2004Iran (Islamic Rep. of),0,0,6,9,0,0,15,0,0,5,7,0,0,12,27
12326,Iran (Islamic Rep. of),2004,2004Iran (Islamic Rep. of),0,5,0,14,0,0,19,0,5,0,35,0,0,40,59
12327,Iran (Islamic Rep. of),2004,2004Iran (Islamic Rep. of),0,9,0,11,0,0,20,0,0,5,22,0,0,27,47
12328,Iran (Islamic Rep. of),2004,2004Iran (Islamic Rep. of),5,10,9,72,0,326,422,12,17,15,65,5,427,541,963
12329,Iran (Islamic Rep. of),2004,2004Iran (Islamic Rep. of),5,11,9,80,0,0,105,10,26,22,91,0,0,149,254
12330,Iran (Islamic Rep. of),2004,2004Iran (Islamic Rep. of),72,126,96,490,10,0,794,78,129,101,836,12,0,1156,1950
12331,Iran (Islamic Rep. of),2004,2004Iran (Islamic Rep. of),82,326,290,951,78,0,1727,72,368,311,1065,98,0,1914,9500
12332,Iran (Islamic Rep. of),2005,2005Iran (Islamic Rep. of),0,0,0,0,0,0,0,0,0,0,0,0,0,0,80101
12333,Iran (Islamic Rep. of),2005,2005Iran (Islamic Rep. of),0,0,0,0,0,0,0,0,0,0,0,6,0,6,6
12334,Iran (Islamic Rep. of),2005,2005Iran (Islamic Rep. of),0,0,0,0,0,0,0,0,0,0,5,0,0,5,25
12335,Iran (Islamic Rep. of),2005,2005Iran (Islamic Rep. of),0,0,0,0,0,0,0,0,0,0,6,0,0,6,357
12336,Iran (Islamic Rep. of),2005,2005Iran (Islamic Rep. of),0,0,0,0,0,0,0,0,0,0,8,0,0,8,8
12337,Iran (Islamic Rep. of),2005,2005Iran (Islamic Rep. of),0,0,0,0,0,0,0,0,0,0,11,0,0,11,11
12338,Iran (Islamic Rep. of),2005,2005Iran (Islamic Rep. of),0,0,0,0,0,0,0,0,0,5,0,0,0,5,5
12339,Iran (Islamic Rep. of),2005,2005Iran (Islamic Rep. of),0,0,0,0,0,0,0,0,0,5,14,0,0,19,19
12340,Iran (Islamic Rep. of),2005,2005Iran (Islamic Rep. of),0,0,0,0,0,0,0,0,5,0,0,0,0,5,5
12341,Iran (Islamic Rep. of),2005,2005Iran (Islamic Rep. of),0,0,0,0,0,5,5,0,0,0,0,0,7,7,12
12342,Iran (Islamic Rep. of),2005,2005Iran (Islamic Rep. of),0,0,0,0,0,9,9,0,0,0,0,0,22,22,31
12343,Iran (Islamic Rep. of),2005,2005Iran (Islamic Rep. of),0,0,0,0,0,14,14,0,0,0,0,0,23,23,37
12344,Iran (Islamic Rep. of),2005,2005Iran (Islamic Rep. of),0,0,0,0,0,129,129,0,0,0,0,0,173,173,302
12345,Iran (Islamic Rep. of),2005,2005Iran (Islamic Rep. of),0,0,0,0,0,588,588,0,0,0,0,0,1046,1046,1634
12346,Iran (Islamic Rep. of),2005,2005Iran (Islamic Rep. of),0,0,0,5,0,0,5,0,0,0,0,0,0,0,5
12347,Iran (Islamic Rep. of),2005,2005Iran (Islamic Rep. of),0,0,0,5,0,0,5,0,0,0,6,0,0,6,11
12348,Iran (Islamic Rep. of),2005,2005Iran (Islamic Rep. of),0,0,0,5,0,0,5,0,0,0,23,0,0,23,28
12349,Iran (Islamic Rep. of),2005,2005Iran (Islamic Rep. of),0,0,0,5,0,0,5,0,0,0,25,0,0,25,30
12350,Iran (Islamic Rep. of),2005,2005Iran (Islamic Rep. of),0,0,0,5,5,0,10,0,0,0,0,9,0,9,19
12351,Iran (Islamic Rep. of),2005,2005Iran (Islamic Rep. of),0,0,0,6,0,0,6,0,5,0,18,0,0,23,29
12352,Iran (Islamic Rep. of),2005,2005Iran (Islamic Rep. of),0,0,0,8,0,0,8,0,5,0,13,0,0,18,125
12353,Iran (Islamic Rep. of),2005,2005Iran (Islamic Rep. of),0,0,0,9,0,0,9,0,0,0,11,0,0,11,20
12354,Iran (Islamic Rep. of),2005,2005Iran (Islamic Rep. of),0,0,0,11,0,0,11,0,0,0,25,5,0,30,41
12355,Iran (Islamic Rep. of),2005,2005Iran (Islamic Rep. of),0,0,0,11,0,0,11,0,0,5,13,0,0,18,29
12356,Iran (Islamic Rep. of),2005,2005Iran (Islamic Rep. of),0,0,0,14,0,0,14,0,0,0,20,0,0,20,34
12357,Iran (Islamic Rep. of),2005,2005Iran (Islamic Rep. of),0,5,0,10,0,0,15,0,5,0,7,0,0,12,27
12358,Iran (Islamic Rep. of),2005,2005Iran (Islamic Rep. of),0,11,0,13,0,0,24,0,0,14,11,0,0,25,49
12359,Iran (Islamic Rep. of),2005,2005Iran (Islamic Rep. of),6,0,0,19,0,0,25,0,0,6,24,0,0,30,55
12360,Iran (Islamic Rep. of),2005,2005Iran (Islamic Rep. of),8,15,13,89,0,320,445,16,23,19,114,5,412,589,1034
12361,Iran (Islamic Rep. of),2005,2005Iran (Islamic Rep. of),55,111,102,545,7,0,820,60,125,130,810,14,0,1139,1959
12362,Iran (Islamic Rep. of),2005,2005Iran (Islamic Rep. of),141,736,634,1965,171,0,3647,139,836,726,2076,234,0,4011,13382
12363,Iran (Islamic Rep. of),2006,2006Iran (Islamic Rep. of),0,0,0,0,0,0,0,0,0,0,0,0,0,0,84297
12364,Iran (Islamic Rep. of),2006,2006Iran (Islamic Rep. of),0,0,0,0,0,0,0,0,0,0,5,0,0,5,20
12365,Iran (Islamic Rep. of),2006,2006Iran (Islamic Rep. of),0,0,0,0,0,0,0,0,0,0,6,0,0,6,18
12366,Iran (Islamic Rep. of),2006,2006Iran (Islamic Rep. of),0,0,0,0,0,0,0,0,0,0,7,0,0,7,14
12367,Iran (Islamic Rep. of),2006,2006Iran (Islamic Rep. of),0,0,0,0,0,0,0,0,0,5,13,0,0,18,18
12368,Iran (Islamic Rep. of),2006,2006Iran (Islamic Rep. of),0,0,0,0,0,6,6,0,0,0,0,0,20,20,26
12369,Iran (Islamic Rep. of),2006,2006Iran (Islamic Rep. of),0,0,0,0,0,6,6,0,0,0,0,0,29,29,35
12370,Iran (Islamic Rep. of),2006,2006Iran (Islamic Rep. of),0,0,0,0,0,13,13,0,0,0,0,0,30,30,43
12371,Iran (Islamic Rep. of),2006,2006Iran (Islamic Rep. of),0,0,0,0,0,131,131,0,0,0,0,0,248,248,379
12372,Iran (Islamic Rep. of),2006,2006Iran (Islamic Rep. of),0,0,0,0,0,152,152,0,0,0,0,0,193,193,345
12373,Iran (Islamic Rep. of),2006,2006Iran (Islamic Rep. of),0,0,0,0,0,481,481,0,0,0,0,0,651,651,1132
12374,Iran (Islamic Rep. of),2006,2006Iran (Islamic Rep. of),0,0,0,0,0,578,578,0,0,0,0,0,1039,1039,1617
12375,Iran (Islamic Rep. of),2006,2006Iran (Islamic Rep. of),0,0,0,5,0,0,5,0,0,0,0,0,0,0,5
12376,Iran (Islamic Rep. of),2006,2006Iran (Islamic Rep. of),0,0,0,5,0,0,5,0,0,0,6,0,0,6,11
12377,Iran (Islamic Rep. of),2006,2006Iran (Islamic Rep. of),0,0,0,5,0,0,5,0,0,0,8,0,0,8,13
12378,Iran (Islamic Rep. of),2006,2006Iran (Islamic Rep. of),0,0,0,5,0,0,5,0,0,0,15,0,0,15,20
12379,Iran (Islamic Rep. of),2006,2006Iran (Islamic Rep. of),0,0,0,5,0,0,5,0,0,0,23,0,0,23,28
12380,Iran (Islamic Rep. of),2006,2006Iran (Islamic Rep. of),0,0,0,7,0,0,7,0,0,0,8,0,0,8,15
12381,Iran (Islamic Rep. of),2006,2006Iran (Islamic Rep. of),0,0,0,7,0,0,7,0,0,5,5,0,0,10,105
12382,Iran (Islamic Rep. of),2006,2006Iran (Islamic Rep. of),0,0,0,10,0,0,10,0,0,0,7,5,0,12,22
12383,Iran (Islamic Rep. of),2006,2006Iran (Islamic Rep. of),0,0,0,13,0,0,13,0,0,0,21,0,0,21,34
12384,Iran (Islamic Rep. of),2006,2006Iran (Islamic Rep. of),0,0,0,14,0,0,14,0,0,10,10,0,0,20,34
12385,Iran (Islamic Rep. of),2006,2006Iran (Islamic Rep. of),0,0,5,9,0,0,14,0,0,0,25,5,0,30,44
12386,Iran (Islamic Rep. of),2006,2006Iran (Islamic Rep. of),0,0,5,10,0,0,15,0,0,5,7,0,0,12,27
12387,Iran (Islamic Rep. of),2006,2006Iran (Islamic Rep. of),0,0,8,0,0,0,8,0,0,0,0,0,0,0,8
12388,Iran (Islamic Rep. of),2006,2006Iran (Islamic Rep. of),0,0,17,14,0,0,31,0,0,6,7,0,0,13,44
12389,Iran (Islamic Rep. of),2006,2006Iran (Islamic Rep. of),0,5,0,0,0,0,5,0,0,0,0,0,0,0,5
12390,Iran (Islamic Rep. of),2006,2006Iran (Islamic Rep. of),0,5,0,16,0,0,21,0,0,5,45,0,0,50,71
12391,Iran (Islamic Rep. of),2006,2006Iran (Islamic Rep. of),0,7,5,26,0,0,38,6,8,0,74,5,0,93,131
12392,Iran (Islamic Rep. of),2006,2006Iran (Islamic Rep. of),5,0,0,0,0,0,5,0,0,0,0,0,0,0,10
12393,Iran (Islamic Rep. of),2006,2006Iran (Islamic Rep. of),42,143,92,611,5,0,893,50,119,143,925,5,0,1242,2135
12394,Iran (Islamic Rep. of),2006,2006Iran (Islamic Rep. of),481,1126,959,2895,278,0,5739,500,1156,1085,3010,283,0,6034,11773
12395,Iran (Islamic Rep. of),2007,2007Iran (Islamic Rep. of),0,0,0,0,0,0,0,0,0,0,0,0,0,0,51252
12396,Iran (Islamic Rep. of),2007,2007Iran (Islamic Rep. of),0,0,0,0,0,0,0,0,0,0,5,0,0,5,20
12397,Iran (Islamic Rep. of),2007,2007Iran (Islamic Rep. of),0,0,0,0,0,0,0,0,0,0,6,0,0,6,6
12398,Iran (Islamic Rep. of),2007,2007Iran (Islamic Rep. of),0,0,0,0,0,0,0,0,0,0,7,0,0,7,21
12399,Iran (Islamic Rep. of),2007,2007Iran (Islamic Rep. of),0,0,0,0,0,0,0,0,0,0,8,0,0,8,8
12400,Iran (Islamic Rep. of),2007,2007Iran (Islamic Rep. of),0,0,0,0,0,0,0,0,0,5,15,0,0,20,20
12401,Iran (Islamic Rep. of),2007,2007Iran (Islamic Rep. of),0,0,0,0,0,0,0,0,6,0,0,0,0,6,6
12402,Iran (Islamic Rep. of),2007,2007Iran (Islamic Rep. of),0,0,0,0,0,6,6,0,0,0,0,0,28,28,34
12403,Iran (Islamic Rep. of),2007,2007Iran (Islamic Rep. of),0,0,0,0,0,15,15,0,0,0,0,0,27,27,42
12404,Iran (Islamic Rep. of),2007,2007Iran (Islamic Rep. of),0,0,0,0,0,124,124,0,0,0,0,0,223,223,347
12405,Iran (Islamic Rep. of),2007,2007Iran (Islamic Rep. of),0,0,0,0,0,571,571,0,0,0,0,0,1062,1062,1633
12406,Iran (Islamic Rep. of),2007,2007Iran (Islamic Rep. of),0,0,0,5,0,0,5,0,0,0,0,0,0,0,5
12407,Iran (Islamic Rep. of),2007,2007Iran (Islamic Rep. of),0,0,0,5,0,0,5,0,0,0,23,0,0,23,28
12408,Iran (Islamic Rep. of),2007,2007Iran (Islamic Rep. of),0,0,0,5,0,0,5,0,5,0,11,0,0,16,21
12409,Iran (Islamic Rep. of),2007,2007Iran (Islamic Rep. of),0,0,0,6,0,0,6,0,0,0,21,0,0,21,27
12410,Iran (Islamic Rep. of),2007,2007Iran (Islamic Rep. of),0,0,0,6,0,0,6,0,0,6,6,0,0,12,18
12411,Iran (Islamic Rep. of),2007,2007Iran (Islamic Rep. of),0,0,0,7,0,0,7,0,0,0,6,5,0,11,18
12412,Iran (Islamic Rep. of),2007,2007Iran (Islamic Rep. of),0,0,0,8,0,0,8,0,0,0,15,0,0,15,23
12413,Iran (Islamic Rep. of),2007,2007Iran (Islamic Rep. of),0,0,0,9,0,0,9,0,0,5,8,0,0,13,22
12414,Iran (Islamic Rep. of),2007,2007Iran (Islamic Rep. of),0,0,0,13,0,0,13,0,0,0,21,0,0,21,34
12415,Iran (Islamic Rep. of),2007,2007Iran (Islamic Rep. of),0,0,0,15,0,0,15,0,0,11,12,0,0,23,38
12416,Iran (Islamic Rep. of),2007,2007Iran (Islamic Rep. of),0,0,5,0,0,0,5,0,0,0,0,0,0,0,5
12417,Iran (Islamic Rep. of),2007,2007Iran (Islamic Rep. of),0,0,5,10,0,0,15,0,0,5,7,0,0,12,27
12418,Iran (Islamic Rep. of),2007,2007Iran (Islamic Rep. of),0,0,5,11,0,0,16,0,0,0,24,5,0,29,45
12419,Iran (Islamic Rep. of),2007,2007Iran (Islamic Rep. of),0,5,0,0,0,0,5,0,0,0,0,0,0,0,5
12420,Iran (Islamic Rep. of),2007,2007Iran (Islamic Rep. of),0,7,0,18,0,0,25,0,0,8,57,0,0,65,90
12421,Iran (Islamic Rep. of),2007,2007Iran (Islamic Rep. of),5,5,5,34,0,0,49,6,10,7,93,5,0,121,170
12422,Iran (Islamic Rep. of),2007,2007Iran (Islamic Rep. of),11,22,22,127,0,292,474,20,32,35,172,5,412,676,1150
12423,Iran (Islamic Rep. of),2007,2007Iran (Islamic Rep. of),48,112,104,623,15,0,902,38,124,131,936,17,0,1246,2148
12424,Iran (Islamic Rep. of),2007,2007Iran (Islamic Rep. of),304,1037,876,2928,241,0,5386,310,1037,1007,3092,303,0,5749,11135
12425,Iran (Islamic Rep. of),2008,2008Iran (Islamic Rep. of),0,0,0,0,0,0,0,0,0,0,0,0,0,0,50404
12426,Iran (Islamic Rep. of),2008,2008Iran (Islamic Rep. of),0,0,0,0,0,0,0,0,0,0,5,0,0,5,20
12427,Iran (Islamic Rep. of),2008,2008Iran (Islamic Rep. of),0,0,0,0,0,0,0,0,0,0,6,0,0,6,6
12428,Iran (Islamic Rep. of),2008,2008Iran (Islamic Rep. of),0,0,0,0,0,0,0,0,0,0,7,0,0,7,14
12429,Iran (Islamic Rep. of),2008,2008Iran (Islamic Rep. of),0,0,0,0,0,0,0,0,0,0,8,0,0,8,8
12430,Iran (Islamic Rep. of),2008,2008Iran (Islamic Rep. of),0,0,0,0,0,0,0,0,0,0,9,0,0,9,9
12431,Iran (Islamic Rep. of),2008,2008Iran (Islamic Rep. of),0,0,0,0,0,0,0,0,0,0,15,0,0,15,15
12432,Iran (Islamic Rep. of),2008,2008Iran (Islamic Rep. of),0,0,0,0,0,0,0,0,0,5,5,0,0,10,10
12433,Iran (Islamic Rep. of),2008,2008Iran (Islamic Rep. of),0,0,0,0,0,13,13,0,0,0,0,0,23,23,36
12434,Iran (Islamic Rep. of),2008,2008Iran (Islamic Rep. of),0,0,0,0,0,102,102,0,0,0,0,0,203,203,305
12435,Iran (Islamic Rep. of),2008,2008Iran (Islamic Rep. of),0,0,0,0,0,582,582,0,0,0,0,0,1079,1079,1661
12436,Iran (Islamic Rep. of),2008,2008Iran (Islamic Rep. of),0,0,0,5,0,0,5,0,0,0,0,0,0,0,5
12437,Iran (Islamic Rep. of),2008,2008Iran (Islamic Rep. of),0,0,0,6,0,0,6,0,0,0,21,0,0,21,27
12438,Iran (Islamic Rep. of),2008,2008Iran (Islamic Rep. of),0,0,0,6,0,0,6,0,0,0,28,0,0,28,34
12439,Iran (Islamic Rep. of),2008,2008Iran (Islamic Rep. of),0,0,0,7,0,0,7,0,0,0,6,5,0,11,18
12440,Iran (Islamic Rep. of),2008,2008Iran (Islamic Rep. of),0,0,0,8,0,0,8,0,0,0,15,0,0,15,23
12441,Iran (Islamic Rep. of),2008,2008Iran (Islamic Rep. of),0,0,0,10,0,0,10,0,0,5,15,0,0,20,30
12442,Iran (Islamic Rep. of),2008,2008Iran (Islamic Rep. of),0,0,0,10,0,0,10,0,6,0,13,0,0,19,29
12443,Iran (Islamic Rep. of),2008,2008Iran (Islamic Rep. of),0,0,0,12,0,0,12,0,0,0,11,0,0,11,23
12444,Iran (Islamic Rep. of),2008,2008Iran (Islamic Rep. of),0,0,0,13,0,0,13,0,0,0,21,0,0,21,34
12445,Iran (Islamic Rep. of),2008,2008Iran (Islamic Rep. of),0,0,5,0,0,0,5,0,0,0,0,0,0,0,5
12446,Iran (Islamic Rep. of),2008,2008Iran (Islamic Rep. of),0,0,5,14,0,0,19,0,0,5,38,0,0,43,62
12447,Iran (Islamic Rep. of),2008,2008Iran (Islamic Rep. of),0,0,6,11,0,0,17,0,0,8,19,0,0,27,44
12448,Iran (Islamic Rep. of),2008,2008Iran (Islamic Rep. of),0,5,0,0,0,0,5,0,0,0,0,0,0,0,5
12449,Iran (Islamic Rep. of),2008,2008Iran (Islamic Rep. of),0,5,0,0,0,0,5,0,0,5,9,0,0,14,19
12450,Iran (Islamic Rep. of),2008,2008Iran (Islamic Rep. of),0,5,12,27,0,0,44,0,7,11,13,0,0,31,75
12451,Iran (Islamic Rep. of),2008,2008Iran (Islamic Rep. of),0,9,0,19,0,0,28,0,5,5,59,0,0,69,97
12452,Iran (Islamic Rep. of),2008,2008Iran (Islamic Rep. of),5,9,0,37,5,0,56,0,9,7,91,6,0,113,169
12453,Iran (Islamic Rep. of),2008,2008Iran (Islamic Rep. of),9,27,23,149,5,289,502,19,39,34,209,7,424,732,2936
12454,Iran (Islamic Rep. of),2008,2008Iran (Islamic Rep. of),25,105,106,594,16,0,846,31,103,117,982,26,0,1259,2105
12455,Iran (Islamic Rep. of),2008,2008Iran (Islamic Rep. of),351,964,830,2881,241,0,5267,304,984,918,3060,290,0,5556,10823
12456,Iran (Islamic Rep. of),2009,2009Iran (Islamic Rep. of),0,0,0,0,0,0,0,0,0,0,0,0,0,0,35927
12457,Iran (Islamic Rep. of),2009,2009Iran (Islamic Rep. of),0,0,0,0,0,0,0,0,0,0,5,0,0,5,25
12458,Iran (Islamic Rep. of),2009,2009Iran (Islamic Rep. of),0,0,0,0,0,0,0,0,0,0,6,0,0,6,6
12459,Iran (Islamic Rep. of),2009,2009Iran (Islamic Rep. of),0,0,0,0,0,0,0,0,0,0,7,0,0,7,14
12460,Iran (Islamic Rep. of),2009,2009Iran (Islamic Rep. of),0,0,0,0,0,0,0,0,0,0,8,0,0,8,16
12461,Iran (Islamic Rep. of),2009,2009Iran (Islamic Rep. of),0,0,0,0,0,0,0,0,0,0,9,0,0,9,18
12462,Iran (Islamic Rep. of),2009,2009Iran (Islamic Rep. of),0,0,0,0,0,0,0,0,5,0,0,0,0,5,5
12463,Iran (Islamic Rep. of),2009,2009Iran (Islamic Rep. of),0,0,0,0,0,10,10,0,0,0,0,0,21,21,31
12464,Iran (Islamic Rep. of),2009,2009Iran (Islamic Rep. of),0,0,0,0,0,113,113,0,0,0,0,0,226,226,339
12465,Iran (Islamic Rep. of),2009,2009Iran (Islamic Rep. of),0,0,0,5,0,0,5,0,0,0,0,0,0,0,10
12466,Iran (Islamic Rep. of),2009,2009Iran (Islamic Rep. of),0,0,0,6,0,0,6,0,0,0,0,0,0,0,6
12467,Iran (Islamic Rep. of),2009,2009Iran (Islamic Rep. of),0,0,0,6,0,0,6,0,0,0,11,0,0,11,17
12468,Iran (Islamic Rep. of),2009,2009Iran (Islamic Rep. of),0,0,0,6,0,0,6,0,0,0,24,0,0,24,30
12469,Iran (Islamic Rep. of),2009,2009Iran (Islamic Rep. of),0,0,0,6,0,0,6,0,0,0,32,0,0,32,38
12470,Iran (Islamic Rep. of),2009,2009Iran (Islamic Rep. of),0,0,0,6,0,0,6,0,0,5,11,0,0,16,22
12471,Iran (Islamic Rep. of),2009,2009Iran (Islamic Rep. of),0,0,0,7,0,0,7,0,0,0,12,0,0,12,19
12472,Iran (Islamic Rep. of),2009,2009Iran (Islamic Rep. of),0,0,0,8,0,0,8,0,0,0,16,0,0,16,24
12473,Iran (Islamic Rep. of),2009,2009Iran (Islamic Rep. of),0,0,0,8,0,0,8,0,7,0,10,0,0,17,25
12474,Iran (Islamic Rep. of),2009,2009Iran (Islamic Rep. of),0,0,0,10,0,0,10,0,5,5,10,0,0,20,30
12475,Iran (Islamic Rep. of),2009,2009Iran (Islamic Rep. of),0,0,0,11,0,0,11,0,0,5,30,0,0,35,46
12476,Iran (Islamic Rep. of),2009,2009Iran (Islamic Rep. of),0,0,5,10,0,0,15,0,0,7,20,0,0,27,42
12477,Iran (Islamic Rep. of),2009,2009Iran (Islamic Rep. of),0,0,5,19,0,0,24,0,6,5,20,0,0,31,55
12478,Iran (Islamic Rep. of),2009,2009Iran (Islamic Rep. of),0,0,6,0,0,0,6,0,0,0,0,0,0,0,6
12479,Iran (Islamic Rep. of),2009,2009Iran (Islamic Rep. of),0,5,0,0,0,0,5,0,0,0,0,0,0,0,5
12480,Iran (Islamic Rep. of),2009,2009Iran (Islamic Rep. of),0,5,0,0,0,0,5,0,0,5,10,0,0,15,20
12481,Iran (Islamic Rep. of),2009,2009Iran (Islamic Rep. of),0,5,5,24,0,0,34,0,7,7,65,0,0,79,113
12482,Iran (Islamic Rep. of),2009,2009Iran (Islamic Rep. of),0,8,0,11,0,0,19,0,5,0,15,0,0,20,39
12483,Iran (Islamic Rep. of),2009,2009Iran (Islamic Rep. of),5,5,5,42,5,0,62,5,5,9,70,7,0,96,158
12484,Iran (Islamic Rep. of),2009,2009Iran (Islamic Rep. of),13,30,22,159,5,284,513,18,37,36,216,8,427,742,1255
12485,Iran (Islamic Rep. of),2009,2009Iran (Islamic Rep. of),22,92,76,544,18,0,752,17,65,107,857,5,0,1051,1803
12486,Iran (Islamic Rep. of),2009,2009Iran (Islamic Rep. of),102,418,568,5679,1274,0,8041,128,430,634,9727,1266,0,12185,20226
12487,Iran (Islamic Rep. of),2009,2009Iran (Islamic Rep. of),318,1027,996,3400,331,0,6072,310,994,993,3649,383,0,6329,12401
12488,Iran (Islamic Rep. of),2010,2010Iran (Islamic Rep. of),0,0,0,0,0,0,0,0,0,0,0,0,0,0,33915
12489,Iran (Islamic Rep. of),2010,2010Iran (Islamic Rep. of),0,0,0,0,0,0,0,0,0,0,5,0,0,5,20
12490,Iran (Islamic Rep. of),2010,2010Iran (Islamic Rep. of),0,0,0,0,0,0,0,0,0,0,6,0,0,6,6
12491,Iran (Islamic Rep. of),2010,2010Iran (Islamic Rep. of),0,0,0,0,0,0,0,0,0,0,7,0,0,7,31
12492,Iran (Islamic Rep. of),2010,2010Iran (Islamic Rep. of),0,0,0,0,0,0,0,0,0,0,15,0,0,15,15
12493,Iran (Islamic Rep. of),2010,2010Iran (Islamic Rep. of),0,0,0,0,0,0,0,0,0,8,0,0,0,8,8
12494,Iran (Islamic Rep. of),2010,2010Iran (Islamic Rep. of),0,0,0,0,0,0,0,0,5,0,0,0,0,5,5
12495,Iran (Islamic Rep. of),2010,2010Iran (Islamic Rep. of),0,0,0,0,0,0,0,5,0,0,0,0,0,5,5
12496,Iran (Islamic Rep. of),2010,2010Iran (Islamic Rep. of),0,0,0,0,0,8,8,0,0,0,0,0,43,43,51
12497,Iran (Islamic Rep. of),2010,2010Iran (Islamic Rep. of),0,0,0,0,0,10,10,0,0,0,0,0,23,23,33
12498,Iran (Islamic Rep. of),2010,2010Iran (Islamic Rep. of),0,0,0,0,0,112,112,0,0,0,0,0,229,229,341
12499,Iran (Islamic Rep. of),2010,2010Iran (Islamic Rep. of),0,0,0,0,0,676,676,0,0,0,0,0,1241,1241,1917
12500,Iran (Islamic Rep. of),2010,2010Iran (Islamic Rep. of),0,0,0,0,6,0,6,0,0,0,0,0,0,0,6
12501,Iran (Islamic Rep. of),2010,2010Iran (Islamic Rep. of),0,0,0,5,0,0,5,0,0,0,0,0,0,0,10
12502,Iran (Islamic Rep. of),2010,2010Iran (Islamic Rep. of),0,0,0,5,0,0,5,0,0,0,8,0,0,8,13
12503,Iran (Islamic Rep. of),2010,2010Iran (Islamic Rep. of),0,0,0,5,0,0,5,0,0,0,17,0,0,17,22
12504,Iran (Islamic Rep. of),2010,2010Iran (Islamic Rep. of),0,0,0,5,0,0,5,12,5,10,5,0,0,32,37
12505,Iran (Islamic Rep. of),2010,2010Iran (Islamic Rep. of),0,0,0,6,0,0,6,0,0,5,11,0,0,16,22
12506,Iran (Islamic Rep. of),2010,2010Iran (Islamic Rep. of),0,0,0,7,0,0,7,0,0,0,12,0,0,12,19
12507,Iran (Islamic Rep. of),2010,2010Iran (Islamic Rep. of),0,0,0,7,0,0,7,0,0,0,24,0,0,24,31
12508,Iran (Islamic Rep. of),2010,2010Iran (Islamic Rep. of),0,0,0,8,0,0,8,0,0,0,17,0,0,17,25
12509,Iran (Islamic Rep. of),2010,2010Iran (Islamic Rep. of),0,0,0,10,0,0,10,0,5,5,10,0,0,20,30
12510,Iran (Islamic Rep. of),2010,2010Iran (Islamic Rep. of),0,0,0,16,0,0,16,0,0,5,32,0,0,37,53
12511,Iran (Islamic Rep. of),2010,2010Iran (Islamic Rep. of),0,0,0,19,0,0,19,0,0,7,38,5,0,50,69
12512,Iran (Islamic Rep. of),2010,2010Iran (Islamic Rep. of),0,0,5,0,0,0,5,0,0,5,0,0,0,5,10
12513,Iran (Islamic Rep. of),2010,2010Iran (Islamic Rep. of),0,0,5,7,0,0,12,0,6,6,6,0,0,18,30
12514,Iran (Islamic Rep. of),2010,2010Iran (Islamic Rep. of),0,0,5,17,0,0,22,0,11,7,24,0,0,42,64
12515,Iran (Islamic Rep. of),2010,2010Iran (Islamic Rep. of),0,0,6,0,0,0,6,0,0,0,8,0,0,8,14
12516,Iran (Islamic Rep. of),2010,2010Iran (Islamic Rep. of),0,0,6,14,0,0,20,0,0,0,19,0,0,19,39
12517,Iran (Islamic Rep. of),2010,2010Iran (Islamic Rep. of),0,0,6,20,0,0,26,0,6,6,66,0,0,78,104
12518,Iran (Islamic Rep. of),2010,2010Iran (Islamic Rep. of),0,5,0,0,0,0,5,0,0,0,5,0,0,5,10
12519,Iran (Islamic Rep. of),2010,2010Iran (Islamic Rep. of),0,6,0,0,0,0,6,0,0,5,14,0,0,19,25
12520,Iran (Islamic Rep. of),2010,2010Iran (Islamic Rep. of),0,8,9,54,0,0,71,13,9,12,86,0,5,125,196
12521,Iran (Islamic Rep. of),2010,2010Iran (Islamic Rep. of),12,26,16,148,5,311,518,13,27,27,218,6,456,747,1265
12522,Iran (Islamic Rep. of),2010,2010Iran (Islamic Rep. of),49,65,76,649,20,0,859,22,68,95,838,29,0,1052,1911
12523,Iran (Islamic Rep. of),2010,2010Iran (Islamic Rep. of),96,410,539,5637,1325,0,8007,121,449,617,9907,1343,0,12437,20444
12524,Iran (Islamic Rep. of),2010,2010Iran (Islamic Rep. of),288,713,690,2086,153,0,3930,324,694,699,2158,184,0,4059,7989
12525,Iran (Islamic Rep. of),2011,2011Iran (Islamic Rep. of),0,0,0,0,0,0,0,0,0,0,0,0,0,0,32542
12526,Iran (Islamic Rep. of),2011,2011Iran (Islamic Rep. of),0,0,0,0,0,0,0,0,0,0,5,0,0,5,15
12527,Iran (Islamic Rep. of),2011,2011Iran (Islamic Rep. of),0,0,0,0,0,0,0,0,0,0,6,0,0,6,6
12528,Iran (Islamic Rep. of),2011,2011Iran (Islamic Rep. of),0,0,0,0,0,0,0,0,0,0,9,0,0,9,18
12529,Iran (Islamic Rep. of),2011,2011Iran (Islamic Rep. of),0,0,0,0,0,0,0,0,0,0,10,0,0,10,53
12530,Iran (Islamic Rep. of),2011,2011Iran (Islamic Rep. of),0,0,0,0,0,0,0,0,0,0,15,0,0,15,15
12531,Iran (Islamic Rep. of),2011,2011Iran (Islamic Rep. of),0,0,0,0,0,0,0,0,0,5,0,0,0,5,15
12532,Iran (Islamic Rep. of),2011,2011Iran (Islamic Rep. of),0,0,0,0,0,0,0,0,5,0,0,0,0,5,5
12533,Iran (Islamic Rep. of),2011,2011Iran (Islamic Rep. of),0,0,0,0,0,0,0,5,0,0,0,0,0,5,5
12534,Iran (Islamic Rep. of),2011,2011Iran (Islamic Rep. of),0,0,0,0,0,6,6,0,0,0,0,0,16,16,22
12535,Iran (Islamic Rep. of),2011,2011Iran (Islamic Rep. of),0,0,0,0,0,109,109,0,0,0,0,0,238,238,347
12536,Iran (Islamic Rep. of),2011,2011Iran (Islamic Rep. of),0,0,0,0,0,743,743,0,0,0,0,0,1321,1321,2064
12537,Iran (Islamic Rep. of),2011,2011Iran (Islamic Rep. of),0,0,0,0,6,0,6,0,0,0,0,0,0,0,6
12538,Iran (Islamic Rep. of),2011,2011Iran (Islamic Rep. of),0,0,0,5,0,0,5,0,0,0,0,0,0,0,10
12539,Iran (Islamic Rep. of),2011,2011Iran (Islamic Rep. of),0,0,0,5,0,0,5,0,0,0,8,0,0,8,13
12540,Iran (Islamic Rep. of),2011,2011Iran (Islamic Rep. of),0,0,0,5,0,0,5,0,0,0,19,0,0,19,24
12541,Iran (Islamic Rep. of),2011,2011Iran (Islamic Rep. of),0,0,0,5,0,0,5,0,0,5,8,0,0,13,18
12542,Iran (Islamic Rep. of),2011,2011Iran (Islamic Rep. of),0,0,0,7,0,0,7,0,0,0,0,0,0,0,7
12543,Iran (Islamic Rep. of),2011,2011Iran (Islamic Rep. of),0,0,0,8,0,0,8,0,0,0,0,0,0,0,8
12544,Iran (Islamic Rep. of),2011,2011Iran (Islamic Rep. of),0,0,0,9,0,0,9,0,0,0,18,0,0,18,27
12545,Iran (Islamic Rep. of),2011,2011Iran (Islamic Rep. of),0,0,0,10,0,0,10,0,0,0,23,0,0,23,33
12546,Iran (Islamic Rep. of),2011,2011Iran (Islamic Rep. of),0,0,0,13,0,0,13,0,0,0,0,0,0,0,13
12547,Iran (Islamic Rep. of),2011,2011Iran (Islamic Rep. of),0,0,0,14,0,0,14,0,0,0,14,0,0,14,42
12548,Iran (Islamic Rep. of),2011,2011Iran (Islamic Rep. of),0,0,5,5,0,0,10,0,5,6,6,0,0,17,27
12549,Iran (Islamic Rep. of),2011,2011Iran (Islamic Rep. of),0,0,5,7,0,0,12,0,0,0,16,0,0,16,28
12550,Iran (Islamic Rep. of),2011,2011Iran (Islamic Rep. of),0,0,5,18,0,0,23,0,0,5,29,5,0,39,62
12551,Iran (Islamic Rep. of),2011,2011Iran (Islamic Rep. of),0,0,7,8,0,0,15,0,5,5,9,0,0,19,34
12552,Iran (Islamic Rep. of),2011,2011Iran (Islamic Rep. of),0,0,8,24,0,0,32,5,7,0,14,0,0,26,58
12553,Iran (Islamic Rep. of),2011,2011Iran (Islamic Rep. of),0,0,9,0,0,0,9,0,0,8,0,0,0,8,17
12554,Iran (Islamic Rep. of),2011,2011Iran (Islamic Rep. of),0,0,9,45,0,0,54,5,0,6,35,5,0,51,105
12555,Iran (Islamic Rep. of),2011,2011Iran (Islamic Rep. of),0,5,0,25,0,0,30,0,5,6,49,0,0,60,90
12556,Iran (Islamic Rep. of),2011,2011Iran (Islamic Rep. of),0,5,0,30,0,0,35,0,0,6,51,7,0,64,99
12557,Iran (Islamic Rep. of),2011,2011Iran (Islamic Rep. of),0,5,5,16,0,0,26,0,6,5,48,0,0,59,85
12558,Iran (Islamic Rep. of),2011,2011Iran (Islamic Rep. of),5,0,0,5,0,0,10,0,0,0,11,0,0,11,34
12559,Iran (Islamic Rep. of),2011,2011Iran (Islamic Rep. of),9,34,40,331,44,0,458,10,24,43,499,36,0,612,3440
12560,Iran (Islamic Rep. of),2011,2011Iran (Islamic Rep. of),13,22,21,151,5,299,511,13,24,24,244,6,473,784,1295
12561,Iran (Islamic Rep. of),2011,2011Iran (Islamic Rep. of),62,121,109,953,28,0,1273,71,145,143,1332,29,0,1720,2993
12562,Iran (Islamic Rep. of),2011,2011Iran (Islamic Rep. of),97,380,494,5606,1369,0,7946,119,441,573,9996,1387,0,12516,20462
12563,Iran (Islamic Rep. of),2011,2011Iran (Islamic Rep. of),288,675,699,2245,161,0,4068,326,671,696,2253,215,0,4161,8229
12564,Iran (Islamic Rep. of),2012,2012Iran (Islamic Rep. of),0,0,0,0,0,0,0,0,0,0,0,0,0,0,34671
12565,Iran (Islamic Rep. of),2012,2012Iran (Islamic Rep. of),0,0,0,0,0,0,0,0,0,0,5,0,0,5,20
12566,Iran (Islamic Rep. of),2012,2012Iran (Islamic Rep. of),0,0,0,0,0,0,0,0,0,0,6,0,0,6,6
12567,Iran (Islamic Rep. of),2012,2012Iran (Islamic Rep. of),0,0,0,0,0,0,0,0,0,0,9,0,0,9,18
12568,Iran (Islamic Rep. of),2012,2012Iran (Islamic Rep. of),0,0,0,0,0,0,0,0,0,0,15,0,0,15,65
12569,Iran (Islamic Rep. of),2012,2012Iran (Islamic Rep. of),0,0,0,0,0,0,0,0,0,0,19,0,0,19,19
12570,Iran (Islamic Rep. of),2012,2012Iran (Islamic Rep. of),0,0,0,0,0,0,0,0,0,5,0,0,0,5,5
12571,Iran (Islamic Rep. of),2012,2012Iran (Islamic Rep. of),0,0,0,0,0,0,0,0,7,0,0,0,0,7,7
12572,Iran (Islamic Rep. of),2012,2012Iran (Islamic Rep. of),0,0,0,0,0,8,8,0,0,0,0,0,15,15,23
12573,Iran (Islamic Rep. of),2012,2012Iran (Islamic Rep. of),0,0,0,0,0,8,8,0,0,0,0,0,42,42,50
12574,Iran (Islamic Rep. of),2012,2012Iran (Islamic Rep. of),0,0,0,0,0,18,18,0,0,0,0,0,21,21,39
12575,Iran (Islamic Rep. of),2012,2012Iran (Islamic Rep. of),0,0,0,0,0,136,136,0,0,0,0,0,275,275,411
12576,Iran (Islamic Rep. of),2012,2012Iran (Islamic Rep. of),0,0,0,0,0,760,760,0,0,0,0,0,1412,1412,2172
12577,Iran (Islamic Rep. of),2012,2012Iran (Islamic Rep. of),0,0,0,0,6,0,6,0,0,0,0,0,0,0,6
12578,Iran (Islamic Rep. of),2012,2012Iran (Islamic Rep. of),0,0,0,5,0,0,5,0,0,0,0,0,0,0,15
12579,Iran (Islamic Rep. of),2012,2012Iran (Islamic Rep. of),0,0,0,5,0,0,5,0,0,0,9,0,0,9,14
12580,Iran (Islamic Rep. of),2012,2012Iran (Islamic Rep. of),0,0,0,5,0,0,5,0,0,0,11,0,0,11,22
12581,Iran (Islamic Rep. of),2012,2012Iran (Islamic Rep. of),0,0,0,5,0,0,5,0,0,6,10,0,0,16,21
12582,Iran (Islamic Rep. of),2012,2012Iran (Islamic Rep. of),0,0,0,6,0,0,6,0,0,0,8,0,0,8,14
12583,Iran (Islamic Rep. of),2012,2012Iran (Islamic Rep. of),0,0,0,6,0,0,6,0,0,0,18,0,0,18,24
12584,Iran (Islamic Rep. of),2012,2012Iran (Islamic Rep. of),0,0,0,7,0,0,7,0,0,0,0,0,0,0,7
12585,Iran (Islamic Rep. of),2012,2012Iran (Islamic Rep. of),0,0,0,9,0,0,9,0,0,0,17,0,0,17,26
12586,Iran (Islamic Rep. of),2012,2012Iran (Islamic Rep. of),0,0,0,11,0,0,11,0,0,0,24,0,0,24,35
12587,Iran (Islamic Rep. of),2012,2012Iran (Islamic Rep. of),0,0,0,12,0,0,12,0,0,0,5,0,0,5,17
12588,Iran (Islamic Rep. of),2012,2012Iran (Islamic Rep. of),0,0,0,16,0,0,16,0,0,8,54,0,0,62,78
12589,Iran (Islamic Rep. of),2012,2012Iran (Islamic Rep. of),0,0,0,16,0,0,16,0,0,11,10,0,0,21,37
12590,Iran (Islamic Rep. of),2012,2012Iran (Islamic Rep. of),0,0,5,13,0,0,18,8,0,0,22,0,0,30,48
12591,Iran (Islamic Rep. of),2012,2012Iran (Islamic Rep. of),0,0,7,10,0,0,17,0,0,0,28,0,0,28,45
12592,Iran (Islamic Rep. of),2012,2012Iran (Islamic Rep. of),0,0,9,36,0,0,45,0,0,13,17,5,0,35,80
12593,Iran (Islamic Rep. of),2012,2012Iran (Islamic Rep. of),0,0,9,48,0,0,57,5,8,6,72,0,0,91,148
12594,Iran (Islamic Rep. of),2012,2012Iran (Islamic Rep. of),0,6,0,40,0,0,46,0,0,5,63,9,0,77,123
12595,Iran (Islamic Rep. of),2012,2012Iran (Islamic Rep. of),0,9,0,82,16,0,107,0,9,5,115,9,0,138,3212
12596,Iran (Islamic Rep. of),2012,2012Iran (Islamic Rep. of),5,0,0,6,0,0,11,0,0,0,10,0,0,10,35
12597,Iran (Islamic Rep. of),2012,2012Iran (Islamic Rep. of),5,6,5,0,0,0,16,0,0,0,0,0,0,0,16
12598,Iran (Islamic Rep. of),2012,2012Iran (Islamic Rep. of),5,6,30,5,0,0,46,0,0,68,5,0,0,73,119
12599,Iran (Islamic Rep. of),2012,2012Iran (Islamic Rep. of),5,7,5,48,5,461,531,5,6,6,70,6,732,825,1356
12600,Iran (Islamic Rep. of),2012,2012Iran (Islamic Rep. of),52,123,115,967,45,0,1302,37,139,162,1358,42,0,1738,3040
12601,Iran (Islamic Rep. of),2012,2012Iran (Islamic Rep. of),129,389,533,5896,1465,0,8412,132,470,611,10505,1499,0,13217,21629
12602,Iran (Islamic Rep. of),2012,2012Iran (Islamic Rep. of),254,670,656,2322,186,0,4088,289,662,704,2292,224,0,4171,8259
12603,Iran (Islamic Rep. of),2013,2013Iran (Islamic Rep. of),0,0,0,0,0,0,0,0,0,0,0,0,0,0,38090
12604,Iran (Islamic Rep. of),2013,2013Iran (Islamic Rep. of),0,0,0,0,0,0,0,0,0,0,0,0,5,5,74
12605,Iran (Islamic Rep. of),2013,2013Iran (Islamic Rep. of),0,0,0,0,0,0,0,0,0,0,5,0,0,5,25
12606,Iran (Islamic Rep. of),2013,2013Iran (Islamic Rep. of),0,0,0,0,0,0,0,0,0,0,6,0,0,6,18
12607,Iran (Islamic Rep. of),2013,2013Iran (Islamic Rep. of),0,0,0,0,0,0,0,0,0,0,9,0,0,9,9
12608,Iran (Islamic Rep. of),2013,2013Iran (Islamic Rep. of),0,0,0,0,0,0,0,0,0,0,18,0,0,18,18
12609,Iran (Islamic Rep. of),2013,2013Iran (Islamic Rep. of),0,0,0,0,0,0,0,0,0,0,19,0,0,19,19
12610,Iran (Islamic Rep. of),2013,2013Iran (Islamic Rep. of),0,0,0,0,0,0,0,0,0,5,0,0,0,5,5
12611,Iran (Islamic Rep. of),2013,2013Iran (Islamic Rep. of),0,0,0,0,0,0,0,0,0,7,0,0,0,7,7
12612,Iran (Islamic Rep. of),2013,2013Iran (Islamic Rep. of),0,0,0,0,0,7,7,0,0,0,0,0,16,16,23
12613,Iran (Islamic Rep. of),2013,2013Iran (Islamic Rep. of),0,0,0,0,0,155,155,0,0,0,0,0,331,331,486
12614,Iran (Islamic Rep. of),2013,2013Iran (Islamic Rep. of),0,0,0,0,0,828,828,0,0,0,0,0,1483,1483,2311
12615,Iran (Islamic Rep. of),2013,2013Iran (Islamic Rep. of),0,0,0,0,5,0,5,0,0,0,8,5,0,13,18
12616,Iran (Islamic Rep. of),2013,2013Iran (Islamic Rep. of),0,0,0,0,6,0,6,0,0,0,0,0,0,0,6
12617,Iran (Islamic Rep. of),2013,2013Iran (Islamic Rep. of),0,0,0,5,0,0,5,0,0,0,0,0,0,0,5
12618,Iran (Islamic Rep. of),2013,2013Iran (Islamic Rep. of),0,0,0,5,0,0,5,0,0,0,9,0,0,9,19
12619,Iran (Islamic Rep. of),2013,2013Iran (Islamic Rep. of),0,0,0,5,0,0,5,0,0,0,20,0,0,20,25
12620,Iran (Islamic Rep. of),2013,2013Iran (Islamic Rep. of),0,0,0,5,9,0,14,0,5,8,9,0,0,22,36
12621,Iran (Islamic Rep. of),2013,2013Iran (Islamic Rep. of),0,0,0,7,0,0,7,0,0,0,22,0,0,22,29
12622,Iran (Islamic Rep. of),2013,2013Iran (Islamic Rep. of),0,0,0,8,0,0,8,0,0,0,8,0,0,8,16
12623,Iran (Islamic Rep. of),2013,2013Iran (Islamic Rep. of),0,0,0,8,0,0,8,0,0,8,11,0,0,19,27
12624,Iran (Islamic Rep. of),2013,2013Iran (Islamic Rep. of),0,0,0,9,0,0,9,0,0,0,0,0,0,0,9
12625,Iran (Islamic Rep. of),2013,2013Iran (Islamic Rep. of),0,0,0,9,0,0,9,0,0,0,17,0,0,17,26
12626,Iran (Islamic Rep. of),2013,2013Iran (Islamic Rep. of),0,0,0,11,0,0,11,0,0,0,28,0,0,28,39
12627,Iran (Islamic Rep. of),2013,2013Iran (Islamic Rep. of),0,0,0,11,0,0,11,0,0,0,31,5,0,36,47
12628,Iran (Islamic Rep. of),2013,2013Iran (Islamic Rep. of),0,0,0,15,0,0,15,0,5,0,26,0,0,31,46
12629,Iran (Islamic Rep. of),2013,2013Iran (Islamic Rep. of),0,0,0,17,0,0,17,0,5,0,55,0,0,60,77
12630,Iran (Islamic Rep. of),2013,2013Iran (Islamic Rep. of),0,0,0,28,0,0,28,0,0,8,82,0,0,90,118
12631,Iran (Islamic Rep. of),2013,2013Iran (Islamic Rep. of),0,0,6,24,0,0,30,0,0,0,10,0,0,10,40
12632,Iran (Islamic Rep. of),2013,2013Iran (Islamic Rep. of),0,5,0,42,0,0,47,0,0,5,60,9,0,74,121
12633,Iran (Islamic Rep. of),2013,2013Iran (Islamic Rep. of),0,7,10,68,0,0,85,5,11,7,89,0,0,112,197
12634,Iran (Islamic Rep. of),2013,2013Iran (Islamic Rep. of),5,6,5,0,0,0,16,0,0,0,0,0,0,0,16
12635,Iran (Islamic Rep. of),2013,2013Iran (Islamic Rep. of),5,7,8,102,9,0,131,5,9,9,127,12,0,162,3033
12636,Iran (Islamic Rep. of),2013,2013Iran (Islamic Rep. of),5,11,16,60,0,0,92,0,16,13,87,0,0,116,208
12637,Iran (Islamic Rep. of),2013,2013Iran (Islamic Rep. of),9,20,20,127,5,347,528,12,18,21,225,9,542,827,1355
12638,Iran (Islamic Rep. of),2013,2013Iran (Islamic Rep. of),54,105,108,1073,54,0,1394,54,150,154,1506,63,0,1927,3321
12639,Iran (Islamic Rep. of),2013,2013Iran (Islamic Rep. of),145,359,352,4660,776,0,6292,169,432,442,8720,1095,0,10858,17150
12640,Iran (Islamic Rep. of),2013,2013Iran (Islamic Rep. of),217,601,649,2314,196,0,3977,246,612,692,2223,242,0,4015,7992
12641,Iran (Islamic Rep. of),2014,2014Iran (Islamic Rep. of),0,0,0,0,0,0,0,0,0,0,0,0,0,0,40785
12642,Iran (Islamic Rep. of),2014,2014Iran (Islamic Rep. of),0,0,0,0,0,0,0,0,0,0,0,0,5,5,5
12643,Iran (Islamic Rep. of),2014,2014Iran (Islamic Rep. of),0,0,0,0,0,0,0,0,0,0,5,0,0,5,35
12644,Iran (Islamic Rep. of),2014,2014Iran (Islamic Rep. of),0,0,0,0,0,0,0,0,0,0,6,0,0,6,6
12645,Iran (Islamic Rep. of),2014,2014Iran (Islamic Rep. of),0,0,0,0,0,0,0,0,0,0,25,0,0,25,25
12646,Iran (Islamic Rep. of),2014,2014Iran (Islamic Rep. of),0,0,0,0,0,0,0,0,0,5,0,0,0,5,10
12647,Iran (Islamic Rep. of),2014,2014Iran (Islamic Rep. of),0,0,0,0,0,0,0,5,0,0,0,0,0,5,5
12648,Iran (Islamic Rep. of),2014,2014Iran (Islamic Rep. of),0,0,0,0,0,7,7,0,0,0,0,0,16,16,23
12649,Iran (Islamic Rep. of),2014,2014Iran (Islamic Rep. of),0,0,0,0,0,53,53,0,0,0,0,0,89,89,142
12650,Iran (Islamic Rep. of),2014,2014Iran (Islamic Rep. of),0,0,0,0,0,849,849,0,0,0,0,0,1510,1510,2359
12651,Iran (Islamic Rep. of),2014,2014Iran (Islamic Rep. of),0,0,0,0,5,0,5,0,0,0,9,5,0,14,19
12652,Iran (Islamic Rep. of),2014,2014Iran (Islamic Rep. of),0,0,0,0,6,0,6,0,0,0,0,0,0,0,6
12653,Iran (Islamic Rep. of),2014,2014Iran (Islamic Rep. of),0,0,0,5,0,0,5,0,0,0,0,0,0,0,15
12654,Iran (Islamic Rep. of),2014,2014Iran (Islamic Rep. of),0,0,0,5,0,0,5,0,0,0,5,0,0,5,10
12655,Iran (Islamic Rep. of),2014,2014Iran (Islamic Rep. of),0,0,0,5,0,0,5,0,0,0,14,0,0,14,19
12656,Iran (Islamic Rep. of),2014,2014Iran (Islamic Rep. of),0,0,0,5,0,0,5,0,0,0,20,0,0,20,25
12657,Iran (Islamic Rep. of),2014,2014Iran (Islamic Rep. of),0,0,0,5,0,0,5,0,0,0,22,0,0,22,27
12658,Iran (Islamic Rep. of),2014,2014Iran (Islamic Rep. of),0,0,0,7,0,0,7,0,0,0,0,0,0,0,7
12659,Iran (Islamic Rep. of),2014,2014Iran (Islamic Rep. of),0,0,0,8,0,0,8,0,0,5,24,0,0,29,37
12660,Iran (Islamic Rep. of),2014,2014Iran (Islamic Rep. of),0,0,0,8,0,0,8,0,0,8,11,0,0,19,27
12661,Iran (Islamic Rep. of),2014,2014Iran (Islamic Rep. of),0,0,0,10,0,0,10,0,0,0,55,0,0,55,65
12662,Iran (Islamic Rep. of),2014,2014Iran (Islamic Rep. of),0,0,0,17,0,0,17,0,5,0,54,0,0,59,76
12663,Iran (Islamic Rep. of),2014,2014Iran (Islamic Rep. of),0,0,0,23,0,0,23,0,0,0,20,0,0,20,43
12664,Iran (Islamic Rep. of),2014,2014Iran (Islamic Rep. of),0,0,0,23,0,0,23,8,0,5,20,0,0,33,56
12665,Iran (Islamic Rep. of),2014,2014Iran (Islamic Rep. of),0,0,5,0,0,0,5,0,0,0,0,0,0,0,5
12666,Iran (Islamic Rep. of),2014,2014Iran (Islamic Rep. of),0,0,5,7,0,0,12,0,0,0,0,0,0,0,12
12667,Iran (Islamic Rep. of),2014,2014Iran (Islamic Rep. of),0,0,5,11,0,0,16,0,0,5,15,0,0,20,36
12668,Iran (Islamic Rep. of),2014,2014Iran (Islamic Rep. of),0,0,5,20,0,0,25,0,0,5,12,5,0,22,47
12669,Iran (Islamic Rep. of),2014,2014Iran (Islamic Rep. of),0,5,0,36,0,0,41,0,0,5,53,8,0,66,107
12670,Iran (Islamic Rep. of),2014,2014Iran (Islamic Rep. of),0,5,7,93,16,0,121,5,6,9,104,13,0,137,2834
12671,Iran (Islamic Rep. of),2014,2014Iran (Islamic Rep. of),0,5,18,5,0,0,28,0,0,9,0,0,0,9,37
12672,Iran (Islamic Rep. of),2014,2014Iran (Islamic Rep. of),0,17,14,68,0,0,99,0,23,11,148,0,0,182,281
12673,Iran (Islamic Rep. of),2014,2014Iran (Islamic Rep. of),5,5,5,0,0,0,15,0,0,0,0,0,0,0,15
12674,Iran (Islamic Rep. of),2014,2014Iran (Islamic Rep. of),5,11,12,84,5,0,117,6,11,13,113,0,0,143,260
12675,Iran (Islamic Rep. of),2014,2014Iran (Islamic Rep. of),13,18,17,137,5,377,567,12,23,22,255,15,592,919,1486
12676,Iran (Islamic Rep. of),2014,2014Iran (Islamic Rep. of),64,110,129,1146,20,0,1469,59,163,147,1524,26,0,1919,3388
12677,Iran (Islamic Rep. of),2014,2014Iran (Islamic Rep. of),144,526,1191,2687,272,0,4820,154,561,2391,2830,297,0,6233,11053
12678,Iran (Islamic Rep. of),2014,2014Iran (Islamic Rep. of),166,427,395,5190,846,0,7024,190,489,520,9384,1207,0,11790,18814
12679,Iran (Islamic Rep. of),2015,2015Iran (Islamic Rep. of),0,0,0,0,0,0,0,0,0,0,0,0,0,0,44974
12680,Iran (Islamic Rep. of),2015,2015Iran (Islamic Rep. of),0,0,0,0,0,0,0,0,0,0,0,0,5,5,104
12681,Iran (Islamic Rep. of),2015,2015Iran (Islamic Rep. of),0,0,0,0,0,0,0,0,0,0,5,0,0,5,20
12682,Iran (Islamic Rep. of),2015,2015Iran (Islamic Rep. of),0,0,0,0,0,0,0,0,0,0,6,0,0,6,12
12683,Iran (Islamic Rep. of),2015,2015Iran (Islamic Rep. of),0,0,0,0,0,0,0,0,0,0,9,0,0,9,9
12684,Iran (Islamic Rep. of),2015,2015Iran (Islamic Rep. of),0,0,0,0,0,0,0,0,0,5,0,0,0,5,10
12685,Iran (Islamic Rep. of),2015,2015Iran (Islamic Rep. of),0,0,0,0,0,0,0,0,0,9,0,0,0,9,9
12686,Iran (Islamic Rep. of),2015,2015Iran (Islamic Rep. of),0,0,0,0,0,0,0,5,0,0,0,0,0,5,5
12687,Iran (Islamic Rep. of),2015,2015Iran (Islamic Rep. of),0,0,0,0,0,10,10,0,0,0,0,0,47,47,57
12688,Iran (Islamic Rep. of),2015,2015Iran (Islamic Rep. of),0,0,0,0,0,53,53,0,0,0,0,0,83,83,136
12689,Iran (Islamic Rep. of),2015,2015Iran (Islamic Rep. of),0,0,0,0,0,349,349,0,0,0,0,0,585,585,934
12690,Iran (Islamic Rep. of),2015,2015Iran (Islamic Rep. of),0,0,0,0,0,864,864,0,0,0,0,0,1553,1553,2417
12691,Iran (Islamic Rep. of),2015,2015Iran (Islamic Rep. of),0,0,0,0,5,0,5,0,0,0,12,5,0,17,22
12692,Iran (Islamic Rep. of),2015,2015Iran (Islamic Rep. of),0,0,0,0,6,0,6,0,0,0,0,0,0,0,6
12693,Iran (Islamic Rep. of),2015,2015Iran (Islamic Rep. of),0,0,0,5,0,0,5,0,0,0,0,0,0,0,5
12694,Iran (Islamic Rep. of),2015,2015Iran (Islamic Rep. of),0,0,0,5,0,0,5,0,0,0,11,0,0,11,35
12695,Iran (Islamic Rep. of),2015,2015Iran (Islamic Rep. of),0,0,0,6,0,0,6,0,0,0,14,0,0,14,20
12696,Iran (Islamic Rep. of),2015,2015Iran (Islamic Rep. of),0,0,0,8,0,0,8,0,0,0,0,0,0,0,8
12697,Iran (Islamic Rep. of),2015,2015Iran (Islamic Rep. of),0,0,0,8,0,0,8,0,0,0,61,0,0,61,69
12698,Iran (Islamic Rep. of),2015,2015Iran (Islamic Rep. of),0,0,0,8,0,0,8,0,0,5,11,0,0,16,24
12699,Iran (Islamic Rep. of),2015,2015Iran (Islamic Rep. of),0,0,0,9,0,0,9,0,0,0,18,0,0,18,27
12700,Iran (Islamic Rep. of),2015,2015Iran (Islamic Rep. of),0,0,0,9,0,0,9,0,0,0,22,0,0,22,31
12701,Iran (Islamic Rep. of),2015,2015Iran (Islamic Rep. of),0,0,0,10,0,0,10,0,0,0,35,0,0,35,45
12702,Iran (Islamic Rep. of),2015,2015Iran (Islamic Rep. of),0,0,0,10,0,0,10,0,0,8,12,0,0,20,30
12703,Iran (Islamic Rep. of),2015,2015Iran (Islamic Rep. of),0,0,0,10,0,0,10,5,0,11,16,0,0,32,42
12704,Iran (Islamic Rep. of),2015,2015Iran (Islamic Rep. of),0,0,0,16,0,0,16,0,0,0,50,5,0,55,71
12705,Iran (Islamic Rep. of),2015,2015Iran (Islamic Rep. of),0,0,5,0,0,0,5,0,0,0,0,0,0,0,5
12706,Iran (Islamic Rep. of),2015,2015Iran (Islamic Rep. of),0,0,5,5,0,0,10,0,0,0,0,0,0,0,10
12707,Iran (Islamic Rep. of),2015,2015Iran (Islamic Rep. of),0,0,5,7,0,6,18,0,0,0,23,0,7,30,48
12708,Iran (Islamic Rep. of),2015,2015Iran (Islamic Rep. of),0,0,5,14,0,0,19,0,5,0,28,0,0,33,52
12709,Iran (Islamic Rep. of),2015,2015Iran (Islamic Rep. of),0,0,5,21,0,0,26,0,0,0,36,10,0,46,72
12710,Iran (Islamic Rep. of),2015,2015Iran (Islamic Rep. of),0,0,5,27,0,0,32,0,0,9,103,0,0,112,144
12711,Iran (Islamic Rep. of),2015,2015Iran (Islamic Rep. of),0,0,7,0,0,0,7,0,0,13,10,0,0,23,30
12712,Iran (Islamic Rep. of),2015,2015Iran (Islamic Rep. of),0,6,0,0,0,0,6,0,0,0,0,0,0,0,6
12713,Iran (Islamic Rep. of),2015,2015Iran (Islamic Rep. of),0,18,5,87,0,0,110,0,23,14,169,0,0,206,316
12714,Iran (Islamic Rep. of),2015,2015Iran (Islamic Rep. of),5,9,10,85,0,0,109,5,11,11,111,0,0,138,247
12715,Iran (Islamic Rep. of),2015,2015Iran (Islamic Rep. of),8,0,0,21,0,0,29,0,0,0,9,0,0,9,38
12716,Iran (Islamic Rep. of),2015,2015Iran (Islamic Rep. of),14,25,26,161,0,577,803,24,25,23,333,5,391,801,1604
12717,Iran (Islamic Rep. of),2015,2015Iran (Islamic Rep. of),100,230,181,1755,58,0,2324,95,260,232,2312,39,0,2938,5262
12718,Iran (Islamic Rep. of),2015,2015Iran (Islamic Rep. of),141,473,592,2583,298,0,4087,172,491,616,2556,309,0,4144,8231
12719,Iran (Islamic Rep. of),2015,2015Iran (Islamic Rep. of),197,435,417,5567,869,0,7485,203,491,522,9769,1293,0,12278,19763
12720,Iran (Islamic Rep. of),2016,2016Iran (Islamic Rep. of),0,0,0,0,0,0,0,0,0,0,0,0,0,0,48041
12721,Iran (Islamic Rep. of),2016,2016Iran (Islamic Rep. of),0,0,0,0,0,0,0,0,0,0,0,0,5,5,5
12722,Iran (Islamic Rep. of),2016,2016Iran (Islamic Rep. of),0,0,0,0,0,0,0,0,0,0,0,9,0,9,9
12723,Iran (Islamic Rep. of),2016,2016Iran (Islamic Rep. of),0,0,0,0,0,0,0,0,0,0,5,0,0,5,20
12724,Iran (Islamic Rep. of),2016,2016Iran (Islamic Rep. of),0,0,0,0,0,0,0,0,0,0,7,0,0,7,7
12725,Iran (Islamic Rep. of),2016,2016Iran (Islamic Rep. of),0,0,0,0,0,0,0,0,0,0,17,0,0,17,17
12726,Iran (Islamic Rep. of),2016,2016Iran (Islamic Rep. of),0,0,0,0,0,0,0,0,0,5,0,0,0,5,10
12727,Iran (Islamic Rep. of),2016,2016Iran (Islamic Rep. of),0,0,0,0,0,0,0,5,0,0,0,0,0,5,5
12728,Iran (Islamic Rep. of),2016,2016Iran (Islamic Rep. of),0,0,0,0,0,11,11,0,0,0,0,0,47,47,58
12729,Iran (Islamic Rep. of),2016,2016Iran (Islamic Rep. of),0,0,0,0,0,59,59,0,0,0,0,0,89,89,148
12730,Iran (Islamic Rep. of),2016,2016Iran (Islamic Rep. of),0,0,0,0,0,367,367,0,0,0,0,0,593,593,960
12731,Iran (Islamic Rep. of),2016,2016Iran (Islamic Rep. of),0,0,0,0,0,891,891,0,0,0,0,0,1589,1589,2480
12732,Iran (Islamic Rep. of),2016,2016Iran (Islamic Rep. of),0,0,0,0,5,0,5,0,0,0,13,5,0,18,23
12733,Iran (Islamic Rep. of),2016,2016Iran (Islamic Rep. of),0,0,0,5,0,0,5,0,0,0,0,0,0,0,20
12734,Iran (Islamic Rep. of),2016,2016Iran (Islamic Rep. of),0,0,0,6,0,0,6,0,0,5,26,0,0,31,37
12735,Iran (Islamic Rep. of),2016,2016Iran (Islamic Rep. of),0,0,0,7,0,0,7,0,0,0,0,0,0,0,7
12736,Iran (Islamic Rep. of),2016,2016Iran (Islamic Rep. of),0,0,0,8,0,0,8,0,0,0,10,0,0,10,18
12737,Iran (Islamic Rep. of),2016,2016Iran (Islamic Rep. of),0,0,0,8,0,0,8,0,0,0,51,5,0,56,64
12738,Iran (Islamic Rep. of),2016,2016Iran (Islamic Rep. of),0,0,0,9,0,0,9,0,0,0,18,0,0,18,27
12739,Iran (Islamic Rep. of),2016,2016Iran (Islamic Rep. of),0,0,0,12,0,0,12,0,0,21,16,0,0,37,49
12740,Iran (Islamic Rep. of),2016,2016Iran (Islamic Rep. of),0,0,0,13,0,0,13,0,0,0,43,5,0,48,61
12741,Iran (Islamic Rep. of),2016,2016Iran (Islamic Rep. of),0,0,0,16,0,0,16,0,0,0,11,5,0,16,32
12742,Iran (Islamic Rep. of),2016,2016Iran (Islamic Rep. of),0,0,0,19,0,0,19,0,0,0,33,5,0,38,57
12743,Iran (Islamic Rep. of),2016,2016Iran (Islamic Rep. of),0,0,5,0,0,0,5,0,0,0,0,0,0,0,5
12744,Iran (Islamic Rep. of),2016,2016Iran (Islamic Rep. of),0,0,5,6,0,0,11,0,0,0,18,0,0,18,29
12745,Iran (Islamic Rep. of),2016,2016Iran (Islamic Rep. of),0,0,5,14,0,0,19,0,5,0,33,0,0,38,57
12746,Iran (Islamic Rep. of),2016,2016Iran (Islamic Rep. of),0,0,5,50,0,0,55,0,0,5,49,5,0,59,1986
12747,Iran (Islamic Rep. of),2016,2016Iran (Islamic Rep. of),0,0,6,19,5,0,30,0,0,7,89,5,0,101,131
12748,Iran (Islamic Rep. of),2016,2016Iran (Islamic Rep. of),0,0,9,0,0,0,9,0,0,14,10,0,0,24,33
12749,Iran (Islamic Rep. of),2016,2016Iran (Islamic Rep. of),0,7,0,9,0,0,16,0,5,5,31,0,0,41,57
12750,Iran (Islamic Rep. of),2016,2016Iran (Islamic Rep. of),0,8,0,0,0,0,8,0,0,0,0,0,0,0,8
12751,Iran (Islamic Rep. of),2016,2016Iran (Islamic Rep. of),0,15,5,63,0,0,83,5,7,12,139,0,0,163,246
12752,Iran (Islamic Rep. of),2016,2016Iran (Islamic Rep. of),5,0,0,7,0,0,12,0,0,8,12,0,0,20,32
12753,Iran (Islamic Rep. of),2016,2016Iran (Islamic Rep. of),5,0,0,21,0,0,26,0,0,0,31,8,0,39,65
12754,Iran (Islamic Rep. of),2016,2016Iran (Islamic Rep. of),7,19,20,136,7,447,636,13,22,31,261,22,634,983,1619
12755,Iran (Islamic Rep. of),2016,2016Iran (Islamic Rep. of),10,0,0,16,0,0,26,0,0,0,12,0,0,12,38
12756,Iran (Islamic Rep. of),2016,2016Iran (Islamic Rep. of),35,11,6,59,5,0,116,52,9,5,38,0,0,104,220
12757,Iran (Islamic Rep. of),2016,2016Iran (Islamic Rep. of),125,311,228,2419,58,0,3141,111,347,289,3030,48,0,3825,6966
12758,Iran (Islamic Rep. of),2016,2016Iran (Islamic Rep. of),132,408,534,2448,280,0,3802,161,0,509,2329,309,435,3743,7545
12759,Iran (Islamic Rep. of),2016,2016Iran (Islamic Rep. of),292,570,478,6493,964,0,8797,293,644,621,11126,1429,0,14113,22910
12760,Iran (Islamic Rep. of),2017,2017Iran (Islamic Rep. of),0,0,0,0,0,0,0,0,0,0,0,0,0,0,59207
12761,Iran (Islamic Rep. of),2017,2017Iran (Islamic Rep. of),0,0,0,0,0,0,0,0,0,0,5,0,0,5,25
12762,Iran (Islamic Rep. of),2017,2017Iran (Islamic Rep. of),0,0,0,0,0,0,0,0,0,0,6,0,0,6,6
12763,Iran (Islamic Rep. of),2017,2017Iran (Islamic Rep. of),0,0,0,0,0,0,0,0,0,0,7,0,0,7,7
12764,Iran (Islamic Rep. of),2017,2017Iran (Islamic Rep. of),0,0,0,0,0,0,0,0,0,0,9,0,0,9,9
12765,Iran (Islamic Rep. of),2017,2017Iran (Islamic Rep. of),0,0,0,0,0,0,0,0,0,0,12,0,0,12,12
12766,Iran (Islamic Rep. of),2017,2017Iran (Islamic Rep. of),0,0,0,0,0,0,0,0,0,5,0,0,0,5,5
12767,Iran (Islamic Rep. of),2017,2017Iran (Islamic Rep. of),0,0,0,0,0,5,5,0,0,0,0,0,0,0,5
12768,Iran (Islamic Rep. of),2017,2017Iran (Islamic Rep. of),0,0,0,0,0,13,13,0,0,0,0,0,45,45,58
12769,Iran (Islamic Rep. of),2017,2017Iran (Islamic Rep. of),0,0,0,0,0,929,929,0,0,0,0,0,1651,1651,2580
12770,Iran (Islamic Rep. of),2017,2017Iran (Islamic Rep. of),0,0,0,0,5,0,5,0,0,0,13,5,0,18,23
12771,Iran (Islamic Rep. of),2017,2017Iran (Islamic Rep. of),0,0,0,0,8,0,8,0,0,0,10,5,0,15,23
12772,Iran (Islamic Rep. of),2017,2017Iran (Islamic Rep. of),0,0,0,5,0,0,5,0,0,0,0,0,0,0,15
12773,Iran (Islamic Rep. of),2017,2017Iran (Islamic Rep. of),0,0,0,8,0,0,8,0,0,0,0,0,0,0,8
12774,Iran (Islamic Rep. of),2017,2017Iran (Islamic Rep. of),0,0,0,10,0,0,10,0,0,0,16,0,0,16,26
12775,Iran (Islamic Rep. of),2017,2017Iran (Islamic Rep. of),0,0,0,10,0,0,10,0,0,8,13,0,0,21,31
12776,Iran (Islamic Rep. of),2017,2017Iran (Islamic Rep. of),0,0,0,11,0,0,11,0,0,0,50,5,0,55,66
12777,Iran (Islamic Rep. of),2017,2017Iran (Islamic Rep. of),0,0,0,11,0,0,11,0,0,26,6,5,0,37,48
12778,Iran (Islamic Rep. of),2017,2017Iran (Islamic Rep. of),0,0,0,12,0,0,12,0,0,5,17,0,0,22,34
12779,Iran (Islamic Rep. of),2017,2017Iran (Islamic Rep. of),0,0,0,14,0,0,14,0,0,0,35,7,0,42,56
12780,Iran (Islamic Rep. of),2017,2017Iran (Islamic Rep. of),0,0,5,0,0,0,5,0,0,0,0,0,0,0,10
12781,Iran (Islamic Rep. of),2017,2017Iran (Islamic Rep. of),0,0,5,9,0,0,14,0,7,0,13,0,0,20,34
12782,Iran (Islamic Rep. of),2017,2017Iran (Islamic Rep. of),0,0,5,9,0,0,14,5,0,0,14,0,0,19,33
12783,Iran (Islamic Rep. of),2017,2017Iran (Islamic Rep. of),0,0,5,14,0,0,19,0,0,5,33,0,0,38,57
12784,Iran (Islamic Rep. of),2017,2017Iran (Islamic Rep. of),0,0,5,21,5,0,31,0,0,9,90,5,0,104,135
12785,Iran (Islamic Rep. of),2017,2017Iran (Islamic Rep. of),0,0,10,13,0,0,23,0,0,0,38,5,0,43,66
12786,Iran (Islamic Rep. of),2017,2017Iran (Islamic Rep. of),0,5,0,7,0,0,12,0,5,0,31,0,0,36,48
12787,Iran (Islamic Rep. of),2017,2017Iran (Islamic Rep. of),0,6,0,0,0,0,6,0,0,8,0,0,0,8,14
12788,Iran (Islamic Rep. of),2017,2017Iran (Islamic Rep. of),0,7,0,9,0,0,16,0,5,5,34,0,0,44,60
12789,Iran (Islamic Rep. of),2017,2017Iran (Islamic Rep. of),5,0,0,0,0,0,5,0,0,0,0,0,0,0,60
12790,Iran (Islamic Rep. of),2017,2017Iran (Islamic Rep. of),5,0,0,16,0,0,21,0,0,0,25,11,0,36,57
12791,Iran (Islamic Rep. of),2017,2017Iran (Islamic Rep. of),5,5,0,24,0,0,34,0,0,0,11,0,0,11,45
12792,Iran (Islamic Rep. of),2017,2017Iran (Islamic Rep. of),5,5,5,59,0,0,74,0,5,25,135,0,0,165,239
12793,Iran (Islamic Rep. of),2017,2017Iran (Islamic Rep. of),5,6,9,59,0,0,79,5,6,9,88,0,0,108,187
12794,Iran (Islamic Rep. of),2017,2017Iran (Islamic Rep. of),9,19,20,134,7,651,840,17,18,28,248,23,463,797,1637
12795,Iran (Islamic Rep. of),2017,2017Iran (Islamic Rep. of),121,341,472,2374,301,0,3609,129,370,464,2252,319,0,3534,7143
12796,Iran (Islamic Rep. of),2017,2017Iran (Islamic Rep. of),141,347,289,2942,68,0,3787,138,397,329,3601,56,0,4521,8308
12797,Iran (Islamic Rep. of),2017,2017Iran (Islamic Rep. of),763,1060,799,10415,1085,0,14122,730,1160,1024,19637,1589,0,24140,38262
12798,Iran (Islamic Rep. of),2018,2018Iran (Islamic Rep. of),0,0,0,0,0,0,0,0,0,0,0,0,0,0,64545
12799,Iran (Islamic Rep. of),2018,2018Iran (Islamic Rep. of),0,0,0,0,0,0,0,0,0,0,5,0,0,5,25
12800,Iran (Islamic Rep. of),2018,2018Iran (Islamic Rep. of),0,0,0,0,0,0,0,0,0,0,7,0,0,7,7
12801,Iran (Islamic Rep. of),2018,2018Iran (Islamic Rep. of),0,0,0,0,0,0,0,0,0,0,9,0,0,9,9
12802,Iran (Islamic Rep. of),2018,2018Iran (Islamic Rep. of),0,0,0,0,0,0,0,0,0,0,12,0,0,12,12
12803,Iran (Islamic Rep. of),2018,2018Iran (Islamic Rep. of),0,0,0,0,0,0,0,0,0,5,0,0,0,5,5
12804,Iran (Islamic Rep. of),2018,2018Iran (Islamic Rep. of),0,0,0,0,0,1005,1005,0,0,0,0,0,1752,1752,2757
12805,Iran (Islamic Rep. of),2018,2018Iran (Islamic Rep. of),0,0,0,0,5,0,5,0,0,0,13,5,0,18,23
12806,Iran (Islamic Rep. of),2018,2018Iran (Islamic Rep. of),0,0,0,5,0,0,5,0,0,0,0,0,0,0,10
12807,Iran (Islamic Rep. of),2018,2018Iran (Islamic Rep. of),0,0,0,6,0,0,6,0,0,0,0,0,0,0,6
12808,Iran (Islamic Rep. of),2018,2018Iran (Islamic Rep. of),0,0,0,6,0,0,6,0,0,0,11,0,0,11,17
12809,Iran (Islamic Rep. of),2018,2018Iran (Islamic Rep. of),0,0,0,6,0,0,6,0,0,9,23,0,0,32,38
12810,Iran (Islamic Rep. of),2018,2018Iran (Islamic Rep. of),0,0,0,8,0,0,8,0,0,0,0,0,0,0,8
12811,Iran (Islamic Rep. of),2018,2018Iran (Islamic Rep. of),0,0,0,8,0,0,8,0,5,0,5,0,0,10,41
12812,Iran (Islamic Rep. of),2018,2018Iran (Islamic Rep. of),0,0,0,12,0,0,12,0,0,0,25,6,0,31,43
12813,Iran (Islamic Rep. of),2018,2018Iran (Islamic Rep. of),0,0,0,14,0,0,14,0,0,0,15,5,0,20,34
12814,Iran (Islamic Rep. of),2018,2018Iran (Islamic Rep. of),0,0,5,0,0,0,5,0,0,0,0,0,0,0,5
12815,Iran (Islamic Rep. of),2018,2018Iran (Islamic Rep. of),0,0,5,9,0,0,14,0,0,5,6,0,0,11,25
12816,Iran (Islamic Rep. of),2018,2018Iran (Islamic Rep. of),0,0,5,11,0,0,16,0,5,0,13,0,0,18,34
12817,Iran (Islamic Rep. of),2018,2018Iran (Islamic Rep. of),0,0,5,17,0,0,22,0,0,5,36,0,0,41,63
12818,Iran (Islamic Rep. of),2018,2018Iran (Islamic Rep. of),0,0,5,19,5,0,29,0,0,9,88,0,0,97,126
12819,Iran (Islamic Rep. of),2018,2018Iran (Islamic Rep. of),0,5,0,8,0,0,13,0,0,0,5,0,0,5,18
12820,Iran (Islamic Rep. of),2018,2018Iran (Islamic Rep. of),0,5,0,16,0,0,21,0,0,0,21,11,0,32,53
12821,Iran (Islamic Rep. of),2018,2018Iran (Islamic Rep. of),0,5,0,22,0,0,27,0,0,0,37,5,0,42,69
12822,Iran (Islamic Rep. of),2018,2018Iran (Islamic Rep. of),0,5,0,22,0,0,27,0,8,0,53,5,0,66,93
12823,Iran (Islamic Rep. of),2018,2018Iran (Islamic Rep. of),0,7,0,9,0,0,16,0,5,5,34,0,0,44,66
12824,Iran (Islamic Rep. of),2018,2018Iran (Islamic Rep. of),0,8,0,0,0,0,8,0,0,0,14,0,0,14,22
12825,Iran (Islamic Rep. of),2018,2018Iran (Islamic Rep. of),0,16,12,80,0,0,108,7,10,10,173,0,0,200,308
12826,Iran (Islamic Rep. of),2018,2018Iran (Islamic Rep. of),5,0,0,7,0,0,12,0,0,8,16,0,0,24,36
12827,Iran (Islamic Rep. of),2018,2018Iran (Islamic Rep. of),5,0,0,9,0,0,14,0,0,5,36,0,0,41,55
12828,Iran (Islamic Rep. of),2018,2018Iran (Islamic Rep. of),5,5,0,25,0,0,35,0,0,0,11,0,0,11,46
12829,Iran (Islamic Rep. of),2018,2018Iran (Islamic Rep. of),5,5,11,65,0,0,86,5,7,10,97,5,0,124,210
12830,Iran (Islamic Rep. of),2018,2018Iran (Islamic Rep. of),10,37,45,321,23,0,436,21,32,46,353,26,0,478,2538
12831,Iran (Islamic Rep. of),2018,2018Iran (Islamic Rep. of),13,14,18,137,9,468,659,17,25,24,247,19,696,1028,1687
12832,Iran (Islamic Rep. of),2018,2018Iran (Islamic Rep. of),103,330,442,2371,313,0,3559,113,345,427,2262,320,0,3467,7026
12833,Iran (Islamic Rep. of),2018,2018Iran (Islamic Rep. of),151,378,297,3113,75,0,4014,145,414,344,3748,66,0,4717,8731
12834,Iran (Islamic Rep. of),2018,2018Iran (Islamic Rep. of),899,1163,903,11256,1179,0,15400,808,1276,1103,20838,1725,0,25750,41150
12835,Iran (Islamic Rep. of),2019,2019Iran (Islamic Rep. of),0,0,0,0,0,0,0,0,0,0,0,0,0,0,73949
12836,Iran (Islamic Rep. of),2019,2019Iran (Islamic Rep. of),0,0,0,0,0,0,0,0,0,0,5,0,0,5,30
12837,Iran (Islamic Rep. of),2019,2019Iran (Islamic Rep. of),0,0,0,0,0,0,0,0,0,0,6,0,0,6,6
12838,Iran (Islamic Rep. of),2019,2019Iran (Islamic Rep. of),0,0,0,0,0,0,0,0,0,0,7,0,0,7,7
12839,Iran (Islamic Rep. of),2019,2019Iran (Islamic Rep. of),0,0,0,0,0,0,0,0,0,0,9,0,0,9,9
12840,Iran (Islamic Rep. of),2019,2019Iran (Islamic Rep. of),0,0,0,0,0,0,0,0,0,0,100,0,0,100,100
12841,Iran (Islamic Rep. of),2019,2019Iran (Islamic Rep. of),0,0,0,0,0,0,0,0,0,5,0,0,0,5,5
12842,Iran (Islamic Rep. of),2019,2019Iran (Islamic Rep. of),0,0,0,0,0,10,10,0,0,0,0,0,63,63,73
12843,Iran (Islamic Rep. of),2019,2019Iran (Islamic Rep. of),0,0,0,0,0,1101,1101,0,0,0,0,0,1869,1869,2970
12844,Iran (Islamic Rep. of),2019,2019Iran (Islamic Rep. of),0,0,0,0,5,0,5,0,0,0,13,6,0,19,24
12845,Iran (Islamic Rep. of),2019,2019Iran (Islamic Rep. of),0,0,0,5,0,0,5,0,0,0,0,0,0,0,5
12846,Iran (Islamic Rep. of),2019,2019Iran (Islamic Rep. of),0,0,0,5,0,0,5,0,0,0,6,0,0,6,11
12847,Iran (Islamic Rep. of),2019,2019Iran (Islamic Rep. of),0,0,0,6,0,0,6,0,0,0,0,0,0,0,6
12848,Iran (Islamic Rep. of),2019,2019Iran (Islamic Rep. of),0,0,0,6,0,0,6,0,0,0,34,0,0,34,40
12849,Iran (Islamic Rep. of),2019,2019Iran (Islamic Rep. of),0,0,0,9,0,0,9,5,0,0,15,0,0,20,29
12850,Iran (Islamic Rep. of),2019,2019Iran (Islamic Rep. of),0,0,0,10,0,0,10,0,0,0,26,7,0,33,43
12851,Iran (Islamic Rep. of),2019,2019Iran (Islamic Rep. of),0,0,0,14,0,0,14,0,0,0,17,5,0,22,36
12852,Iran (Islamic Rep. of),2019,2019Iran (Islamic Rep. of),0,0,0,16,0,0,16,0,5,0,14,0,0,19,35
12853,Iran (Islamic Rep. of),2019,2019Iran (Islamic Rep. of),0,0,0,24,0,0,24,0,0,0,39,5,0,44,68
12854,Iran (Islamic Rep. of),2019,2019Iran (Islamic Rep. of),0,0,5,0,0,0,5,0,0,0,0,0,0,0,10
12855,Iran (Islamic Rep. of),2019,2019Iran (Islamic Rep. of),0,0,5,8,0,0,13,0,0,0,10,0,0,10,23
12856,Iran (Islamic Rep. of),2019,2019Iran (Islamic Rep. of),0,0,5,11,0,0,16,0,5,0,12,0,0,17,33
12857,Iran (Islamic Rep. of),2019,2019Iran (Islamic Rep. of),0,0,5,26,5,0,36,0,0,9,96,0,0,105,141
12858,Iran (Islamic Rep. of),2019,2019Iran (Islamic Rep. of),0,5,0,10,5,0,20,0,0,0,19,10,0,29,49
12859,Iran (Islamic Rep. of),2019,2019Iran (Islamic Rep. of),0,5,0,19,0,0,24,0,0,6,34,5,0,45,69
12860,Iran (Islamic Rep. of),2019,2019Iran (Islamic Rep. of),0,5,0,21,0,0,26,0,0,0,18,0,0,18,44
12861,Iran (Islamic Rep. of),2019,2019Iran (Islamic Rep. of),0,5,13,81,5,0,104,5,8,10,114,5,0,142,246
12862,Iran (Islamic Rep. of),2019,2019Iran (Islamic Rep. of),0,6,5,24,0,0,35,5,5,6,57,8,0,81,116
12863,Iran (Islamic Rep. of),2019,2019Iran (Islamic Rep. of),5,18,7,87,0,0,117,5,5,20,176,0,0,206,323
12864,Iran (Islamic Rep. of),2019,2019Iran (Islamic Rep. of),7,0,0,18,0,0,25,5,0,6,32,0,0,43,68
12865,Iran (Islamic Rep. of),2019,2019Iran (Islamic Rep. of),7,5,21,121,0,0,154,10,9,17,155,0,0,191,345
12866,Iran (Islamic Rep. of),2019,2019Iran (Islamic Rep. of),16,16,16,152,10,0,210,16,30,25,265,19,0,355,1800
12867,Iran (Islamic Rep. of),2019,2019Iran (Islamic Rep. of),89,213,303,1733,232,0,2570,90,237,285,1618,241,0,2471,5041
12868,Iran (Islamic Rep. of),2019,2019Iran (Islamic Rep. of),956,1273,992,11823,1266,0,16310,877,1355,1170,21655,1877,0,26934,43244
12869,Iran (Islamic Rep. of),2020,2020Iran (Islamic Rep. of),0,0,0,0,0,0,0,0,0,0,0,0,0,0,73401
12870,Iran (Islamic Rep. of),2020,2020Iran (Islamic Rep. of),0,0,0,0,0,0,0,0,0,0,5,0,0,5,15
12871,Iran (Islamic Rep. of),2020,2020Iran (Islamic Rep. of),0,0,0,0,0,0,0,0,0,0,6,0,0,6,6
12872,Iran (Islamic Rep. of),2020,2020Iran (Islamic Rep. of),0,0,0,0,0,0,0,0,0,0,7,0,0,7,7
12873,Iran (Islamic Rep. of),2020,2020Iran (Islamic Rep. of),0,0,0,0,0,0,0,0,0,0,8,0,0,8,8
12874,Iran (Islamic Rep. of),2020,2020Iran (Islamic Rep. of),0,0,0,0,0,0,0,0,0,0,9,0,0,9,27
12875,Iran (Islamic Rep. of),2020,2020Iran (Islamic Rep. of),0,0,0,0,0,0,0,0,0,0,90,0,0,90,90
12876,Iran (Islamic Rep. of),2020,2020Iran (Islamic Rep. of),0,0,0,0,0,0,0,0,0,5,0,0,0,5,10
12877,Iran (Islamic Rep. of),2020,2020Iran (Islamic Rep. of),0,0,0,0,0,0,0,0,5,0,0,0,0,5,5
12878,Iran (Islamic Rep. of),2020,2020Iran (Islamic Rep. of),0,0,0,0,0,10,10,0,0,0,0,0,62,62,72
12879,Iran (Islamic Rep. of),2020,2020Iran (Islamic Rep. of),0,0,0,0,0,14,14,0,0,0,0,0,47,47,61
12880,Iran (Islamic Rep. of),2020,2020Iran (Islamic Rep. of),0,0,0,0,0,50,50,0,0,0,0,0,134,134,184
12881,Iran (Islamic Rep. of),2020,2020Iran (Islamic Rep. of),0,0,0,0,0,81,81,0,0,0,0,0,115,115,196
12882,Iran (Islamic Rep. of),2020,2020Iran (Islamic Rep. of),0,0,0,0,0,584,584,0,0,0,0,0,1064,1064,1648
12883,Iran (Islamic Rep. of),2020,2020Iran (Islamic Rep. of),0,0,0,0,5,0,5,0,0,0,13,6,0,19,24
12884,Iran (Islamic Rep. of),2020,2020Iran (Islamic Rep. of),0,0,0,5,0,0,5,0,0,0,0,0,0,0,10
12885,Iran (Islamic Rep. of),2020,2020Iran (Islamic Rep. of),0,0,0,5,0,0,5,0,0,0,6,0,0,6,11
12886,Iran (Islamic Rep. of),2020,2020Iran (Islamic Rep. of),0,0,0,5,0,0,5,0,0,0,34,0,0,34,39
12887,Iran (Islamic Rep. of),2020,2020Iran (Islamic Rep. of),0,0,0,8,0,0,8,0,0,0,28,7,0,35,43
12888,Iran (Islamic Rep. of),2020,2020Iran (Islamic Rep. of),0,0,0,14,0,0,14,0,0,0,18,5,0,23,37
12889,Iran (Islamic Rep. of),2020,2020Iran (Islamic Rep. of),0,0,0,20,0,0,20,0,0,0,36,0,0,36,56
12890,Iran (Islamic Rep. of),2020,2020Iran (Islamic Rep. of),0,0,5,8,0,0,13,0,0,0,12,0,0,12,25
12891,Iran (Islamic Rep. of),2020,2020Iran (Islamic Rep. of),0,0,5,10,0,0,15,0,0,5,15,0,0,20,35
12892,Iran (Islamic Rep. of),2020,2020Iran (Islamic Rep. of),0,0,5,12,0,0,17,0,6,0,14,0,0,20,37
12893,Iran (Islamic Rep. of),2020,2020Iran (Islamic Rep. of),0,0,5,13,5,0,23,0,0,7,27,5,0,39,62
12894,Iran (Islamic Rep. of),2020,2020Iran (Islamic Rep. of),0,0,5,30,6,0,41,0,0,8,101,5,0,114,155
12895,Iran (Islamic Rep. of),2020,2020Iran (Islamic Rep. of),0,5,0,10,5,0,20,0,0,0,17,12,0,29,49
12896,Iran (Islamic Rep. of),2020,2020Iran (Islamic Rep. of),0,5,0,20,0,0,25,6,0,0,40,5,0,51,76
12897,Iran (Islamic Rep. of),2020,2020Iran (Islamic Rep. of),0,5,0,22,0,0,27,0,0,0,18,0,0,18,45
12898,Iran (Islamic Rep. of),2020,2020Iran (Islamic Rep. of),0,5,5,25,0,0,35,5,5,6,61,9,0,86,121
12899,Iran (Islamic Rep. of),2020,2020Iran (Islamic Rep. of),0,5,14,83,5,0,107,5,7,10,119,5,0,146,253
12900,Iran (Islamic Rep. of),2020,2020Iran (Islamic Rep. of),0,7,0,7,0,0,14,0,0,5,18,0,0,23,37
12901,Iran (Islamic Rep. of),2020,2020Iran (Islamic Rep. of),5,16,6,81,0,0,108,5,12,18,167,0,0,202,310
12902,Iran (Islamic Rep. of),2020,2020Iran (Islamic Rep. of),7,0,0,18,0,0,25,5,0,6,32,0,34,77,102
12903,Iran (Islamic Rep. of),2020,2020Iran (Islamic Rep. of),15,28,22,193,6,0,264,19,35,29,209,5,0,297,561
12904,Iran (Islamic Rep. of),2020,2020Iran (Islamic Rep. of),22,23,24,186,12,0,267,21,38,36,301,24,0,420,2089
12905,Iran (Islamic Rep. of),2020,2020Iran (Islamic Rep. of),32,66,72,566,21,11,768,0,65,76,542,0,58,741,5085
12906,Iran (Islamic Rep. of),2020,2020Iran (Islamic Rep. of),61,215,286,1750,274,0,2586,57,234,285,1634,265,0,2475,5061
12907,Iran (Islamic Rep. of),2020,2020Iran (Islamic Rep. of),978,1341,1072,12351,1328,0,17070,926,1420,1204,22301,2013,0,27864,44965
12908,Iran (Islamic Rep. of),2021,2021Iran (Islamic Rep. of),0,0,0,0,0,0,0,0,0,0,0,0,0,0,80836
12909,Iran (Islamic Rep. of),2021,2021Iran (Islamic Rep. of),0,0,0,0,0,0,0,0,0,0,0,0,6,6,6
12910,Iran (Islamic Rep. of),2021,2021Iran (Islamic Rep. of),0,0,0,0,0,0,0,0,0,0,5,0,0,5,30
12911,Iran (Islamic Rep. of),2021,2021Iran (Islamic Rep. of),0,0,0,0,0,0,0,0,0,0,7,0,0,7,14
12912,Iran (Islamic Rep. of),2021,2021Iran (Islamic Rep. of),0,0,0,0,0,0,0,0,0,0,8,0,0,8,8
12913,Iran (Islamic Rep. of),2021,2021Iran (Islamic Rep. of),0,0,0,0,0,0,0,0,0,0,9,0,0,9,18
12914,Iran (Islamic Rep. of),2021,2021Iran (Islamic Rep. of),0,0,0,0,0,0,0,0,0,0,74,0,0,74,74
12915,Iran (Islamic Rep. of),2021,2021Iran (Islamic Rep. of),0,0,0,0,0,0,0,0,0,5,0,0,0,5,10
12916,Iran (Islamic Rep. of),2021,2021Iran (Islamic Rep. of),0,0,0,0,0,0,0,0,5,0,0,0,0,5,5
12917,Iran (Islamic Rep. of),2021,2021Iran (Islamic Rep. of),0,0,0,0,0,12,12,0,0,0,0,0,62,62,74
12918,Iran (Islamic Rep. of),2021,2021Iran (Islamic Rep. of),0,0,0,0,7,0,7,0,0,0,17,6,0,23,30
12919,Iran (Islamic Rep. of),2021,2021Iran (Islamic Rep. of),0,0,0,5,0,0,5,0,0,0,0,0,0,0,10
12920,Iran (Islamic Rep. of),2021,2021Iran (Islamic Rep. of),0,0,0,5,0,0,5,0,0,0,34,0,0,34,39
12921,Iran (Islamic Rep. of),2021,2021Iran (Islamic Rep. of),0,0,0,7,0,0,7,0,0,0,10,0,0,10,17
12922,Iran (Islamic Rep. of),2021,2021Iran (Islamic Rep. of),0,0,0,9,0,0,9,0,5,0,27,0,0,32,41
12923,Iran (Islamic Rep. of),2021,2021Iran (Islamic Rep. of),0,0,0,10,5,0,15,0,0,0,18,5,0,23,38
12924,Iran (Islamic Rep. of),2021,2021Iran (Islamic Rep. of),0,0,0,11,0,0,11,0,0,0,33,8,0,41,52
12925,Iran (Islamic Rep. of),2021,2021Iran (Islamic Rep. of),0,0,0,14,0,0,14,0,0,0,10,0,0,10,24
12926,Iran (Islamic Rep. of),2021,2021Iran (Islamic Rep. of),0,0,0,15,0,0,15,0,0,5,10,5,0,20,35
12927,Iran (Islamic Rep. of),2021,2021Iran (Islamic Rep. of),0,0,0,21,0,0,21,0,0,0,47,5,0,52,73
12928,Iran (Islamic Rep. of),2021,2021Iran (Islamic Rep. of),0,0,5,0,0,0,5,0,0,0,0,0,0,0,5
12929,Iran (Islamic Rep. of),2021,2021Iran (Islamic Rep. of),0,0,5,14,5,0,24,0,6,0,32,5,0,43,67
12930,Iran (Islamic Rep. of),2021,2021Iran (Islamic Rep. of),0,0,5,16,0,0,21,0,5,0,18,0,0,23,44
12931,Iran (Islamic Rep. of),2021,2021Iran (Islamic Rep. of),0,0,5,25,7,0,37,0,0,7,106,5,0,118,155
12932,Iran (Islamic Rep. of),2021,2021Iran (Islamic Rep. of),0,0,5,26,0,0,31,0,8,0,43,5,0,56,87
12933,Iran (Islamic Rep. of),2021,2021Iran (Islamic Rep. of),0,0,8,25,0,0,33,5,6,5,65,6,0,87,120
12934,Iran (Islamic Rep. of),2021,2021Iran (Islamic Rep. of),0,5,0,15,5,0,25,0,0,0,22,11,0,33,58
12935,Iran (Islamic Rep. of),2021,2021Iran (Islamic Rep. of),0,5,0,17,0,0,22,0,0,0,21,0,0,21,43
12936,Iran (Islamic Rep. of),2021,2021Iran (Islamic Rep. of),0,5,13,98,5,0,121,5,6,10,124,8,0,153,274
12937,Iran (Islamic Rep. of),2021,2021Iran (Islamic Rep. of),0,8,0,8,0,0,16,0,0,6,19,0,0,25,41
12938,Iran (Islamic Rep. of),2021,2021Iran (Islamic Rep. of),0,11,12,79,0,0,102,5,17,11,165,0,0,198,300
12939,Iran (Islamic Rep. of),2021,2021Iran (Islamic Rep. of),7,0,0,18,0,24,49,5,0,6,32,0,47,90,139
12940,Iran (Islamic Rep. of),2021,2021Iran (Islamic Rep. of),12,23,25,174,6,0,240,14,31,27,191,5,0,268,508
12941,Iran (Islamic Rep. of),2021,2021Iran (Islamic Rep. of),20,27,30,216,12,0,305,17,39,48,327,24,0,455,2246
12942,Iran (Islamic Rep. of),2021,2021Iran (Islamic Rep. of),68,196,212,1428,227,0,2131,84,208,222,1259,212,0,1985,4116
12943,Iran (Islamic Rep. of),2021,2021Iran (Islamic Rep. of),77,171,169,1454,78,11,1960,49,172,197,1404,45,58,1925,7134
12944,Iran (Islamic Rep. of),2021,2021Iran (Islamic Rep. of),906,1474,1096,12822,1427,0,17725,827,1537,1259,22646,2182,0,28451,46223
12945,Iraq,2001,2001Iraq,0,0,0,0,0,0,0,0,0,0,0,0,0,0,127967
12946,Iraq,2001,2001Iraq,0,0,0,0,0,0,0,0,0,0,0,0,6,6,6
12947,Iraq,2001,2001Iraq,0,0,0,0,0,0,0,0,0,0,5,0,0,5,30
12948,Iraq,2001,2001Iraq,0,0,0,0,0,0,0,0,0,0,7,0,0,7,21
12949,Iraq,2001,2001Iraq,0,0,0,0,0,0,0,0,0,0,8,0,0,8,8
12950,Iraq,2001,2001Iraq,0,0,0,0,0,0,0,0,0,5,24,0,0,29,29
12951,Iraq,2001,2001Iraq,0,0,0,0,0,0,0,0,5,0,0,0,0,5,10
12952,Iraq,2001,2001Iraq,0,0,0,0,0,78,78,0,0,0,0,0,150,150,228
12953,Iraq,2001,2001Iraq,0,0,0,0,0,711,711,0,0,0,0,0,918,918,1629
12954,Iraq,2001,2001Iraq,0,0,0,0,0,982,982,0,0,0,0,0,1593,1593,2575
12955,Iraq,2001,2001Iraq,0,0,0,5,0,0,5,0,0,0,6,0,0,6,22
12956,Iraq,2001,2001Iraq,0,0,0,5,0,0,5,0,0,0,14,5,0,19,24
12957,Iraq,2001,2001Iraq,0,0,0,5,0,0,5,0,0,0,18,0,0,18,23
12958,Iraq,2001,2001Iraq,0,0,0,6,0,0,6,0,0,0,0,0,0,0,6
12959,Iraq,2001,2001Iraq,0,0,0,7,0,0,7,0,0,0,8,0,0,8,55
12960,Iraq,2001,2001Iraq,0,0,0,8,0,0,8,0,0,6,9,0,0,15,23
12961,Iraq,2001,2001Iraq,0,0,0,9,0,0,9,0,5,0,19,0,0,24,33
12962,Iraq,2001,2001Iraq,0,0,5,0,0,0,5,0,0,0,8,0,0,8,13
12963,Iraq,2001,2001Iraq,0,0,5,0,0,0,5,0,5,0,20,0,0,25,30
12964,Iraq,2001,2001Iraq,0,0,6,0,0,0,6,0,0,0,0,0,0,0,6
12965,Iraq,2001,2001Iraq,0,0,6,10,0,0,16,0,5,0,15,0,0,20,36
12966,Iraq,2001,2001Iraq,0,0,9,0,0,0,9,0,0,0,0,0,0,0,9
12967,Iraq,2001,2001Iraq,0,5,0,0,0,0,5,0,0,0,0,0,0,0,10
12968,Iraq,2001,2001Iraq,0,5,5,28,5,0,43,15,12,5,47,0,0,79,382
12969,Iraq,2001,2001Iraq,0,12,0,0,0,0,12,0,0,10,38,0,0,48,60
12970,Iraq,2001,2001Iraq,0,17,14,108,9,0,148,5,16,14,116,5,0,156,304
12971,Iraq,2001,2001Iraq,11,40,45,163,0,0,259,17,62,61,186,0,0,326,585
12972,Iraq,2001,2001Iraq,14,26,22,75,0,0,137,22,36,30,203,5,0,296,433
12973,Iraq,2001,2001Iraq,16,19,6,43,0,0,84,17,18,15,79,0,0,129,213
12974,Iraq,2001,2001Iraq,19,13,12,33,13,0,90,10,13,11,58,11,0,103,200
12975,Iraq,2001,2001Iraq,32,75,64,232,15,0,418,32,88,76,306,22,0,524,942
12976,Iraq,2001,2001Iraq,54,118,102,365,33,0,672,74,135,116,802,29,0,1156,1828
12977,Iraq,2001,2001Iraq,92,130,111,389,20,0,742,73,159,137,462,24,0,855,1677
12978,Iraq,2001,2001Iraq,297,416,357,569,51,0,1690,293,417,365,2285,41,0,3401,5091
12979,Iraq,2001,2001Iraq,1685,17445,14954,119569,11349,0,165002,1653,18611,15952,174186,10596,0,220998,386000
12980,Iraq,2002,2002Iraq,0,0,0,0,0,0,0,0,0,0,0,0,0,0,405348
12981,Iraq,2002,2002Iraq,0,0,0,0,0,0,0,0,0,0,0,0,6,6,6
12982,Iraq,2002,2002Iraq,0,0,0,0,0,0,0,0,0,0,0,0,8,8,8
12983,Iraq,2002,2002Iraq,0,0,0,0,0,0,0,0,0,0,5,0,0,5,10
12984,Iraq,2002,2002Iraq,0,0,0,0,0,0,0,0,0,0,6,0,0,6,6
12985,Iraq,2002,2002Iraq,0,0,0,0,0,0,0,0,0,0,7,0,0,7,50
12986,Iraq,2002,2002Iraq,0,0,0,0,0,0,0,0,0,0,8,0,0,8,16
12987,Iraq,2002,2002Iraq,0,0,0,0,0,0,0,0,0,0,11,0,0,11,22
12988,Iraq,2002,2002Iraq,0,0,0,0,0,0,0,0,0,5,21,0,0,26,26
12989,Iraq,2002,2002Iraq,0,0,0,0,0,0,0,0,5,0,0,0,0,5,10
12990,Iraq,2002,2002Iraq,0,0,0,0,0,0,0,0,5,0,5,0,0,10,10
12991,Iraq,2002,2002Iraq,0,0,0,0,0,0,0,0,6,0,0,0,0,6,6
12992,Iraq,2002,2002Iraq,0,0,0,0,0,695,695,0,0,0,0,0,902,902,1597
12993,Iraq,2002,2002Iraq,0,0,0,0,0,930,930,0,0,0,0,0,1230,1230,3175
12994,Iraq,2002,2002Iraq,0,0,0,5,0,0,5,0,0,0,0,0,0,0,5
12995,Iraq,2002,2002Iraq,0,0,0,5,0,0,5,0,0,0,16,5,0,21,26
12996,Iraq,2002,2002Iraq,0,0,0,6,0,0,6,0,0,0,0,0,0,0,6
12997,Iraq,2002,2002Iraq,0,0,0,8,0,0,8,0,5,0,20,0,0,25,33
12998,Iraq,2002,2002Iraq,0,0,5,5,0,0,10,0,5,0,10,0,0,15,25
12999,Iraq,2002,2002Iraq,0,0,6,9,0,0,15,0,5,0,16,0,0,21,36
13000,Iraq,2002,2002Iraq,0,0,9,0,0,0,9,0,0,0,13,0,0,13,22
13001,Iraq,2002,2002Iraq,0,5,0,0,0,0,5,0,0,0,0,0,0,0,5
13002,Iraq,2002,2002Iraq,0,5,0,6,0,0,11,0,9,0,23,0,0,32,43
13003,Iraq,2002,2002Iraq,0,8,0,17,0,0,25,0,9,0,20,5,0,34,950
13004,Iraq,2002,2002Iraq,0,13,0,0,0,0,13,0,8,5,40,0,0,53,66
13005,Iraq,2002,2002Iraq,0,27,18,43,12,0,100,0,23,15,78,13,0,129,229
13006,Iraq,2002,2002Iraq,5,0,0,7,0,0,12,0,5,0,9,0,0,14,26
13007,Iraq,2002,2002Iraq,5,19,17,149,7,0,197,7,25,22,163,5,0,222,419
13008,Iraq,2002,2002Iraq,11,56,24,90,0,0,181,11,36,47,96,5,0,195,376
13009,Iraq,2002,2002Iraq,15,19,16,50,0,0,100,22,18,16,141,0,0,197,297
13010,Iraq,2002,2002Iraq,33,94,81,265,15,0,488,33,100,86,341,21,0,581,1069
13011,Iraq,2002,2002Iraq,47,116,100,360,26,0,649,59,128,109,784,27,0,1107,1756
13012,Iraq,2002,2002Iraq,86,139,118,414,22,0,779,75,184,157,495,26,0,937,1716
13013,Iraq,2002,2002Iraq,275,440,377,582,54,0,1728,294,432,371,2235,43,0,3375,5109
13014,Iraq,2003,2003Iraq,0,0,0,0,0,0,0,0,0,0,0,0,0,0,205575
13015,Iraq,2003,2003Iraq,0,0,0,0,0,0,0,0,0,0,0,0,5,5,5
13016,Iraq,2003,2003Iraq,0,0,0,0,0,0,0,0,0,0,5,0,0,5,15
13017,Iraq,2003,2003Iraq,0,0,0,0,0,0,0,0,0,0,7,0,0,7,7
13018,Iraq,2003,2003Iraq,0,0,0,0,0,0,0,0,0,0,9,0,0,9,9
13019,Iraq,2003,2003Iraq,0,0,0,0,0,0,0,0,0,0,11,0,0,11,11
13020,Iraq,2003,2003Iraq,0,0,0,0,0,0,0,0,0,5,19,0,0,24,24
13021,Iraq,2003,2003Iraq,0,0,0,0,0,0,0,0,5,0,0,0,0,5,10
13022,Iraq,2003,2003Iraq,0,0,0,0,0,0,0,0,5,0,6,0,0,11,11
13023,Iraq,2003,2003Iraq,0,0,0,0,0,0,0,0,6,0,0,0,0,6,6
13024,Iraq,2003,2003Iraq,0,0,0,0,0,5,5,0,0,0,0,0,0,0,5
13025,Iraq,2003,2003Iraq,0,0,0,0,0,614,614,0,0,0,0,0,795,795,1409
13026,Iraq,2003,2003Iraq,0,0,0,0,0,1012,1012,0,0,0,0,0,1269,1269,3307
13027,Iraq,2003,2003Iraq,0,0,0,5,0,0,5,0,0,0,5,0,0,5,20
13028,Iraq,2003,2003Iraq,0,0,0,5,0,0,5,0,0,0,17,0,0,17,22
13029,Iraq,2003,2003Iraq,0,0,0,5,0,0,5,0,0,5,15,0,0,20,25
13030,Iraq,2003,2003Iraq,0,0,0,5,0,0,5,0,5,0,9,0,0,14,19
13031,Iraq,2003,2003Iraq,0,0,0,6,0,0,6,0,0,0,0,0,0,0,6
13032,Iraq,2003,2003Iraq,0,0,0,7,0,0,7,0,0,0,0,0,0,0,7
13033,Iraq,2003,2003Iraq,0,0,0,9,0,0,9,0,0,0,25,0,0,25,34
13034,Iraq,2003,2003Iraq,0,0,0,10,0,0,10,0,5,0,10,0,0,15,25
13035,Iraq,2003,2003Iraq,0,0,5,5,0,0,10,0,6,6,38,0,0,50,60
13036,Iraq,2003,2003Iraq,0,0,5,6,0,0,11,0,0,8,10,0,0,18,29
13037,Iraq,2003,2003Iraq,0,0,5,8,0,0,13,0,0,0,20,0,0,20,33
13038,Iraq,2003,2003Iraq,0,7,0,0,0,0,7,0,0,0,7,0,0,7,14
13039,Iraq,2003,2003Iraq,0,8,0,19,0,0,27,7,0,0,12,0,0,19,951
13040,Iraq,2003,2003Iraq,0,15,12,62,13,0,102,0,13,18,76,16,0,123,225
13041,Iraq,2003,2003Iraq,5,5,12,21,0,0,43,5,11,15,49,0,0,80,123
13042,Iraq,2003,2003Iraq,5,9,8,27,0,0,49,10,9,8,41,5,0,73,122
13043,Iraq,2003,2003Iraq,5,19,17,148,7,0,196,7,25,22,162,5,0,221,417
13044,Iraq,2003,2003Iraq,6,0,0,0,0,0,6,0,0,0,0,0,0,0,6
13045,Iraq,2003,2003Iraq,13,37,16,62,0,0,128,6,35,23,70,5,0,139,267
13046,Iraq,2003,2003Iraq,26,58,50,85,5,0,224,40,54,47,334,7,0,482,706
13047,Iraq,2003,2003Iraq,27,82,70,250,14,0,443,30,88,75,311,18,0,522,965
13048,Iraq,2003,2003Iraq,45,96,83,309,22,0,555,62,102,88,648,21,0,921,1476
13049,Iraq,2003,2003Iraq,130,205,175,604,23,0,1137,90,258,222,689,39,0,1298,2435
13050,Iraq,2003,2003Iraq,236,344,1075,1654,159,0,3468,236,365,1133,2521,159,0,4414,150196
13051,Iraq,2004,2004Iraq,0,0,0,0,0,0,0,0,0,0,0,0,0,0,195844
13052,Iraq,2004,2004Iraq,0,0,0,0,0,0,0,0,0,0,7,0,0,7,7
13053,Iraq,2004,2004Iraq,0,0,0,0,0,0,0,0,0,0,8,0,0,8,16
13054,Iraq,2004,2004Iraq,0,0,0,0,0,0,0,0,0,0,9,0,0,9,9
13055,Iraq,2004,2004Iraq,0,0,0,0,0,0,0,0,0,5,6,0,0,11,11
13056,Iraq,2004,2004Iraq,0,0,0,0,0,0,0,0,0,5,19,0,0,24,24
13057,Iraq,2004,2004Iraq,0,0,0,0,0,0,0,0,6,0,0,0,0,6,6
13058,Iraq,2004,2004Iraq,0,0,0,0,0,5,5,0,0,0,0,0,0,0,5
13059,Iraq,2004,2004Iraq,0,0,0,5,0,0,5,0,0,0,5,0,0,5,10
13060,Iraq,2004,2004Iraq,0,0,0,5,0,0,5,0,0,0,15,0,0,15,20
13061,Iraq,2004,2004Iraq,0,0,0,5,0,0,5,0,0,0,19,0,0,19,24
13062,Iraq,2004,2004Iraq,0,0,0,5,0,0,5,0,0,0,33,0,0,33,38
13063,Iraq,2004,2004Iraq,0,0,0,5,0,0,5,0,0,5,12,0,0,17,22
13064,Iraq,2004,2004Iraq,0,0,0,6,0,0,6,0,0,0,0,0,0,0,6
13065,Iraq,2004,2004Iraq,0,0,0,6,0,0,6,0,0,0,5,0,0,5,11
13066,Iraq,2004,2004Iraq,0,0,0,9,0,0,9,0,7,0,8,0,0,15,24
13067,Iraq,2004,2004Iraq,0,0,5,0,0,0,5,0,0,0,0,0,0,0,5
13068,Iraq,2004,2004Iraq,0,0,5,0,0,0,5,0,0,5,5,0,0,10,15
13069,Iraq,2004,2004Iraq,0,0,5,5,0,0,10,0,5,5,11,0,0,21,31
13070,Iraq,2004,2004Iraq,0,0,5,8,0,0,13,0,5,5,20,0,0,30,43
13071,Iraq,2004,2004Iraq,0,0,6,0,0,0,6,0,0,0,0,0,0,0,6
13072,Iraq,2004,2004Iraq,0,0,7,0,0,0,7,0,0,0,0,0,0,0,7
13073,Iraq,2004,2004Iraq,0,0,9,37,10,0,56,0,7,7,51,6,0,71,127
13074,Iraq,2004,2004Iraq,0,5,0,11,0,0,16,0,0,5,18,0,0,23,39
13075,Iraq,2004,2004Iraq,0,5,0,19,0,0,24,0,7,6,38,0,0,51,75
13076,Iraq,2004,2004Iraq,0,6,6,9,0,0,21,0,0,9,26,0,0,35,56
13077,Iraq,2004,2004Iraq,0,7,0,0,0,0,7,0,0,0,5,0,0,5,12
13078,Iraq,2004,2004Iraq,0,9,0,22,5,0,36,0,6,0,28,0,0,34,959
13079,Iraq,2004,2004Iraq,0,15,12,60,13,0,100,0,12,17,74,16,0,119,219
13080,Iraq,2004,2004Iraq,5,0,0,0,0,0,5,0,0,0,0,0,0,0,5
13081,Iraq,2004,2004Iraq,5,8,7,28,0,0,48,5,10,7,64,0,0,86,415
13082,Iraq,2004,2004Iraq,5,11,15,22,0,0,53,0,20,17,35,0,0,72,125
13083,Iraq,2004,2004Iraq,5,19,17,148,7,0,196,7,25,22,163,5,0,222,418
13084,Iraq,2004,2004Iraq,6,0,0,0,0,0,6,0,0,0,0,0,0,0,6
13085,Iraq,2004,2004Iraq,17,31,26,51,0,0,125,17,33,28,232,5,0,315,440
13086,Iraq,2004,2004Iraq,33,77,66,232,12,0,420,28,75,65,289,12,0,469,889
13087,Iraq,2004,2004Iraq,35,41,35,133,11,1076,1331,48,62,53,390,5,1319,1877,3208
13088,Iraq,2004,2004Iraq,47,71,60,233,9,0,420,53,76,65,517,17,0,728,1148
13089,Iraq,2004,2004Iraq,532,955,818,3576,249,0,6130,505,1098,942,5433,283,0,8261,14391
13090,Iraq,2004,2004Iraq,2925,3984,12464,19137,1696,0,40206,3179,4308,13372,30330,1778,0,52967,93173
13091,Iraq,2005,2005Iraq,0,0,0,0,0,0,0,0,0,0,0,0,0,0,172449
13092,Iraq,2005,2005Iraq,0,0,0,0,0,0,0,0,0,0,5,0,0,5,5
13093,Iraq,2005,2005Iraq,0,0,0,0,0,0,0,0,0,0,7,0,0,7,21
13094,Iraq,2005,2005Iraq,0,0,0,0,0,0,0,0,0,0,8,0,0,8,16
13095,Iraq,2005,2005Iraq,0,0,0,0,0,0,0,0,0,0,9,0,0,9,9
13096,Iraq,2005,2005Iraq,0,0,0,0,0,0,0,0,0,5,19,0,0,24,24
13097,Iraq,2005,2005Iraq,0,0,0,0,0,0,0,0,0,6,0,0,0,6,6
13098,Iraq,2005,2005Iraq,0,0,0,0,0,0,0,0,0,7,8,0,0,15,15
13099,Iraq,2005,2005Iraq,0,0,0,0,0,0,0,0,5,0,0,0,0,5,5
13100,Iraq,2005,2005Iraq,0,0,0,0,0,5,5,0,0,0,0,0,0,0,5
13101,Iraq,2005,2005Iraq,0,0,0,0,0,6,6,0,0,0,0,0,15,15,21
13102,Iraq,2005,2005Iraq,0,0,0,0,0,566,566,0,0,0,0,0,753,753,1319
13103,Iraq,2005,2005Iraq,0,0,0,5,0,0,5,0,0,0,0,0,0,0,34
13104,Iraq,2005,2005Iraq,0,0,0,5,0,0,5,0,0,0,5,0,0,5,10
13105,Iraq,2005,2005Iraq,0,0,0,5,0,0,5,0,0,0,8,0,0,8,13
13106,Iraq,2005,2005Iraq,0,0,0,5,0,0,5,0,0,0,10,0,0,10,15
13107,Iraq,2005,2005Iraq,0,0,0,5,0,0,5,0,0,0,12,0,0,12,17
13108,Iraq,2005,2005Iraq,0,0,0,5,0,0,5,0,0,0,19,0,0,19,24
13109,Iraq,2005,2005Iraq,0,0,0,5,0,0,5,0,5,0,9,0,0,14,19
13110,Iraq,2005,2005Iraq,0,0,0,6,0,0,6,0,0,0,0,0,0,0,6
13111,Iraq,2005,2005Iraq,0,0,0,6,0,0,6,0,0,0,34,0,0,34,40
13112,Iraq,2005,2005Iraq,0,0,5,0,0,0,5,0,0,0,0,0,0,0,10
13113,Iraq,2005,2005Iraq,0,0,5,5,0,0,10,0,0,0,6,0,0,6,16
13114,Iraq,2005,2005Iraq,0,0,5,5,0,0,10,5,0,0,17,0,0,22,32
13115,Iraq,2005,2005Iraq,0,0,5,7,0,0,12,0,0,7,8,0,0,15,27
13116,Iraq,2005,2005Iraq,0,0,5,320,27,0,352,0,5,0,372,25,0,402,754
13117,Iraq,2005,2005Iraq,0,5,0,0,0,0,5,0,0,0,0,0,0,0,5
13118,Iraq,2005,2005Iraq,0,5,0,11,0,0,16,0,0,5,14,0,0,19,35
13119,Iraq,2005,2005Iraq,0,6,5,13,0,0,24,0,5,0,19,5,0,29,907
13120,Iraq,2005,2005Iraq,0,7,6,15,0,0,28,5,6,5,49,0,0,65,448
13121,Iraq,2005,2005Iraq,0,11,8,36,0,0,55,5,13,24,29,0,0,71,126
13122,Iraq,2005,2005Iraq,0,12,11,61,21,0,105,5,12,10,77,9,0,113,218
13123,Iraq,2005,2005Iraq,0,13,12,6,0,0,31,0,18,0,28,7,0,53,84
13124,Iraq,2005,2005Iraq,12,22,18,99,5,0,156,15,46,39,159,7,0,266,422
13125,Iraq,2005,2005Iraq,14,27,23,39,5,0,108,17,30,25,178,5,0,255,363
13126,Iraq,2005,2005Iraq,35,40,35,168,6,0,284,33,58,49,364,9,0,513,797
13127,Iraq,2005,2005Iraq,47,75,63,239,14,0,438,40,77,66,410,15,0,608,1046
13128,Iraq,2005,2005Iraq,54,65,56,217,14,1079,1485,77,95,81,1016,5,1306,2580,4065
13129,Iraq,2005,2005Iraq,998,1768,1515,6491,504,0,11276,1029,1935,1659,8442,533,0,13598,24874
13130,Iraq,2005,2005Iraq,1665,2331,7294,11137,1028,0,23455,1721,2487,7724,17535,1078,0,30545,54000
13131,Iraq,2006,2006Iraq,0,0,0,0,0,0,0,0,0,0,0,0,0,0,166502
13132,Iraq,2006,2006Iraq,0,0,0,0,0,0,0,0,0,0,5,0,0,5,20
13133,Iraq,2006,2006Iraq,0,0,0,0,0,0,0,0,0,0,6,0,0,6,6
13134,Iraq,2006,2006Iraq,0,0,0,0,0,0,0,0,0,0,7,0,0,7,7
13135,Iraq,2006,2006Iraq,0,0,0,0,0,0,0,0,0,0,8,0,0,8,8
13136,Iraq,2006,2006Iraq,0,0,0,0,0,0,0,0,0,0,12,0,0,12,12
13137,Iraq,2006,2006Iraq,0,0,0,0,0,0,0,0,0,5,0,0,0,5,10
13138,Iraq,2006,2006Iraq,0,0,0,0,0,0,0,0,0,5,20,0,0,25,25
13139,Iraq,2006,2006Iraq,0,0,0,0,0,0,0,0,0,6,0,0,0,6,6
13140,Iraq,2006,2006Iraq,0,0,0,0,0,0,0,0,0,7,8,0,0,15,15
13141,Iraq,2006,2006Iraq,0,0,0,0,0,0,0,0,0,9,0,0,0,9,9
13142,Iraq,2006,2006Iraq,0,0,0,0,0,7,7,0,0,0,0,0,36,36,43
13143,Iraq,2006,2006Iraq,0,0,0,0,0,11,11,0,0,0,0,0,64,64,75
13144,Iraq,2006,2006Iraq,0,0,0,0,0,24,24,0,0,0,0,0,86,86,110
13145,Iraq,2006,2006Iraq,0,0,0,0,0,110,110,0,0,0,0,0,143,143,253
13146,Iraq,2006,2006Iraq,0,0,0,0,0,562,562,0,0,0,0,0,756,756,1318
13147,Iraq,2006,2006Iraq,0,0,0,0,0,1684,1684,0,0,0,0,0,3346,3346,5030
13148,Iraq,2006,2006Iraq,0,0,0,5,0,0,5,0,0,0,0,0,0,0,5
13149,Iraq,2006,2006Iraq,0,0,0,5,0,0,5,0,0,0,5,0,0,5,10
13150,Iraq,2006,2006Iraq,0,0,0,5,0,0,5,0,0,0,7,0,0,7,12
13151,Iraq,2006,2006Iraq,0,0,0,5,0,0,5,0,0,0,8,0,0,8,13
13152,Iraq,2006,2006Iraq,0,0,0,5,0,0,5,0,0,0,20,0,0,20,25
13153,Iraq,2006,2006Iraq,0,0,0,5,0,0,5,5,0,0,6,0,0,11,16
13154,Iraq,2006,2006Iraq,0,0,5,0,0,0,5,0,0,0,0,0,0,0,10
13155,Iraq,2006,2006Iraq,0,0,5,14,0,0,19,0,5,0,19,0,0,24,43
13156,Iraq,2006,2006Iraq,0,0,7,12,0,0,19,0,0,5,10,0,0,15,34
13157,Iraq,2006,2006Iraq,0,0,8,18,0,0,26,0,0,9,31,0,0,40,454
13158,Iraq,2006,2006Iraq,0,0,10,13,0,0,23,0,0,8,20,0,0,28,51
13159,Iraq,2006,2006Iraq,0,5,0,0,0,0,5,0,0,0,0,0,0,0,10
13160,Iraq,2006,2006Iraq,0,5,0,5,0,0,10,0,0,0,6,0,0,6,16
13161,Iraq,2006,2006Iraq,0,6,10,12,0,0,28,0,5,0,16,0,0,21,49
13162,Iraq,2006,2006Iraq,0,11,0,15,0,0,26,0,12,5,19,0,0,36,62
13163,Iraq,2006,2006Iraq,0,25,5,36,0,0,66,0,13,20,42,0,0,75,141
13164,Iraq,2006,2006Iraq,5,0,22,12,0,0,39,0,0,8,27,0,0,35,86
13165,Iraq,2006,2006Iraq,5,6,5,31,0,0,47,0,10,5,110,0,0,125,172
13166,Iraq,2006,2006Iraq,6,27,15,28,0,0,76,7,11,27,129,0,0,174,250
13167,Iraq,2006,2006Iraq,8,19,30,130,37,0,224,11,19,25,158,22,0,235,459
13168,Iraq,2006,2006Iraq,18,43,57,206,11,0,335,21,41,50,236,16,0,364,500000
13169,Iraq,2006,2006Iraq,30,26,26,138,5,0,225,26,33,41,229,7,0,336,20000
13170,Iraq,2006,2006Iraq,63,103,101,368,8,0,643,65,98,98,598,15,0,874,1517
13171,Iraq,2006,2006Iraq,1802,3050,2674,10953,882,0,19361,1906,3215,3017,13766,960,0,22864,700000
13172,Iraq,2006,2006Iraq,1916,6601,475,11934,705,0,21631,2041,7153,5307,16703,1189,0,32393,54024
13173,Iraq,2007,2007Iraq,0,0,0,0,0,0,0,0,0,0,0,0,0,0,174394
13174,Iraq,2007,2007Iraq,0,0,0,0,0,0,0,0,0,0,5,0,0,5,40
13175,Iraq,2007,2007Iraq,0,0,0,0,0,0,0,0,0,0,6,0,0,6,6
13176,Iraq,2007,2007Iraq,0,0,0,0,0,0,0,0,0,0,33,0,0,33,33
13177,Iraq,2007,2007Iraq,0,0,0,0,0,0,0,0,0,5,0,0,0,5,5
13178,Iraq,2007,2007Iraq,0,0,0,0,0,0,0,0,0,5,20,0,0,25,25
13179,Iraq,2007,2007Iraq,0,0,0,0,0,0,0,0,0,6,0,0,0,6,6
13180,Iraq,2007,2007Iraq,0,0,0,0,0,0,0,0,0,8,8,0,0,16,16
13181,Iraq,2007,2007Iraq,0,0,0,0,0,8,8,0,0,0,0,0,37,37,45
13182,Iraq,2007,2007Iraq,0,0,0,0,0,116,116,0,0,0,0,0,176,176,292
13183,Iraq,2007,2007Iraq,0,0,0,0,0,572,572,0,0,0,0,0,825,825,1397
13184,Iraq,2007,2007Iraq,0,0,0,0,0,24986,24986,0,0,0,0,0,32428,32428,57414
13185,Iraq,2007,2007Iraq,0,0,0,5,0,0,5,0,0,0,5,0,0,5,10
13186,Iraq,2007,2007Iraq,0,0,0,5,0,0,5,0,0,0,7,0,0,7,12
13187,Iraq,2007,2007Iraq,0,0,0,5,0,0,5,0,0,0,12,0,0,12,17
13188,Iraq,2007,2007Iraq,0,0,0,5,0,0,5,0,0,0,21,0,0,21,26
13189,Iraq,2007,2007Iraq,0,0,0,6,0,0,6,0,0,0,0,0,0,0,6
13190,Iraq,2007,2007Iraq,0,0,0,8,0,0,8,5,0,0,14,0,0,19,27
13191,Iraq,2007,2007Iraq,0,0,0,11,0,0,11,0,0,5,13,0,0,18,29
13192,Iraq,2007,2007Iraq,0,0,5,8,0,0,13,0,8,0,28,0,0,36,49
13193,Iraq,2007,2007Iraq,0,0,7,8,0,0,15,0,5,5,17,0,0,27,42
13194,Iraq,2007,2007Iraq,0,0,8,7,0,0,15,0,9,7,17,0,0,33,48
13195,Iraq,2007,2007Iraq,0,5,0,0,0,0,5,0,0,0,0,0,0,0,10
13196,Iraq,2007,2007Iraq,0,5,5,37,0,0,47,0,5,11,96,0,0,112,159
13197,Iraq,2007,2007Iraq,0,6,0,0,0,0,6,0,0,0,5,0,0,5,11
13198,Iraq,2007,2007Iraq,0,14,0,20,0,0,34,5,10,5,32,0,0,52,86
13199,Iraq,2007,2007Iraq,6,7,0,16,0,0,29,5,0,7,71,0,0,83,112
13200,Iraq,2007,2007Iraq,6,22,19,29,0,0,76,13,11,21,117,0,0,162,238
13201,Iraq,2007,2007Iraq,7,0,0,16,0,0,23,0,0,9,21,0,0,30,53
13202,Iraq,2007,2007Iraq,7,9,5,33,5,0,59,9,11,10,59,0,0,89,148
13203,Iraq,2007,2007Iraq,8,11,7,19,0,0,45,8,10,5,39,5,0,67,112
13204,Iraq,2007,2007Iraq,9,0,0,27,0,0,36,0,6,7,24,0,0,37,73
13205,Iraq,2007,2007Iraq,18,27,35,223,53,0,356,19,25,34,248,36,0,362,718
13206,Iraq,2007,2007Iraq,45,50,69,326,11,0,501,38,75,73,336,32,0,554,1055
13207,Iraq,2007,2007Iraq,70,108,83,333,16,1072,1682,95,131,116,1501,9,1316,3168,4850
13208,Iraq,2007,2007Iraq,154,252,221,970,60,0,1657,173,267,233,1318,99,0,2090,3747
13209,Iraq,2007,2007Iraq,164,218,186,949,52,0,1569,164,251,230,1413,35,0,2093,3662
13210,Iraq,2007,2007Iraq,421,838,704,2767,234,0,4964,420,967,779,2924,219,0,5309,10273
13211,Iraq,2007,2007Iraq,447,439,338,1621,62,0,2907,504,470,437,5422,77,0,6910,50000
13212,Iraq,2007,2007Iraq,17502,29781,25684,135684,18482,0,227133,19227,30682,26998,180006,15954,0,272867,500000
13213,Iraq,2007,2007Iraq,67772,114606,96792,396030,38079,0,713279,70622,125324,109462,441644,39669,0,786721,1500000
13214,Iraq,2008,2008Iraq,0,0,0,0,0,0,0,0,0,0,0,0,0,0,176896
13215,Iraq,2008,2008Iraq,0,0,0,0,0,0,0,0,0,0,5,0,0,5,114
13216,Iraq,2008,2008Iraq,0,0,0,0,0,0,0,0,0,0,6,0,0,6,12
13217,Iraq,2008,2008Iraq,0,0,0,0,0,0,0,0,0,0,8,0,0,8,8
13218,Iraq,2008,2008Iraq,0,0,0,0,0,0,0,0,0,0,34,0,0,34,34
13219,Iraq,2008,2008Iraq,0,0,0,0,0,0,0,0,0,5,0,0,0,5,5
13220,Iraq,2008,2008Iraq,0,0,0,0,0,0,0,0,0,8,8,0,0,16,16
13221,Iraq,2008,2008Iraq,0,0,0,0,0,0,0,7,0,0,0,0,0,7,7
13222,Iraq,2008,2008Iraq,0,0,0,0,0,142,142,0,0,0,0,0,352,352,494
13223,Iraq,2008,2008Iraq,0,0,0,0,0,696,696,0,0,0,0,0,960,960,1656
13224,Iraq,2008,2008Iraq,0,0,0,5,0,0,5,0,0,0,7,0,0,7,12
13225,Iraq,2008,2008Iraq,0,0,0,6,0,0,6,0,0,0,0,0,0,0,6
13226,Iraq,2008,2008Iraq,0,0,0,7,0,0,7,5,0,0,14,0,0,19,26
13227,Iraq,2008,2008Iraq,0,0,5,0,0,0,5,0,0,0,0,0,0,0,5
13228,Iraq,2008,2008Iraq,0,0,5,0,0,0,5,0,0,0,19,0,0,19,24
13229,Iraq,2008,2008Iraq,0,0,5,5,0,0,10,0,0,0,40,0,0,40,50
13230,Iraq,2008,2008Iraq,0,0,8,7,0,0,15,0,9,7,19,0,0,35,50
13231,Iraq,2008,2008Iraq,0,5,0,0,0,0,5,0,0,0,0,0,0,0,10
13232,Iraq,2008,2008Iraq,0,5,5,39,0,0,49,0,5,12,101,0,0,118,167
13233,Iraq,2008,2008Iraq,0,6,0,15,0,0,21,0,5,6,23,0,0,34,55
13234,Iraq,2008,2008Iraq,0,7,0,0,0,0,7,0,0,0,5,0,0,5,12
13235,Iraq,2008,2008Iraq,0,7,0,15,0,0,22,5,5,0,55,5,0,70,92
13236,Iraq,2008,2008Iraq,0,12,0,13,0,0,25,5,10,0,20,0,0,35,60
13237,Iraq,2008,2008Iraq,0,19,0,7,0,0,26,0,0,12,0,0,0,12,38
13238,Iraq,2008,2008Iraq,5,0,0,6,0,0,11,0,0,7,17,0,0,24,35
13239,Iraq,2008,2008Iraq,5,0,0,14,0,0,19,5,0,0,24,0,0,29,48
13240,Iraq,2008,2008Iraq,5,0,26,26,0,0,57,0,0,20,32,0,0,52,109
13241,Iraq,2008,2008Iraq,7,5,6,33,0,0,51,5,0,7,46,0,0,58,109
13242,Iraq,2008,2008Iraq,7,9,6,37,5,0,64,8,10,5,39,0,0,62,126
13243,Iraq,2008,2008Iraq,9,17,9,18,5,0,58,5,18,5,44,5,0,77,135
13244,Iraq,2008,2008Iraq,11,8,10,32,0,0,61,8,15,10,92,0,0,125,186
13245,Iraq,2008,2008Iraq,16,0,0,0,0,0,16,0,7,0,0,0,0,7,23
13246,Iraq,2008,2008Iraq,19,25,13,76,5,0,138,20,27,25,111,6,0,189,327
13247,Iraq,2008,2008Iraq,19,30,51,261,61,0,422,22,32,47,273,41,0,415,837
13248,Iraq,2008,2008Iraq,51,79,77,242,14,708,1171,62,95,87,776,7,840,1867,3038
13249,Iraq,2008,2008Iraq,75,118,148,701,37,0,1079,73,151,150,683,81,0,1138,2217
13250,Iraq,2008,2008Iraq,198,289,273,1139,80,0,1979,208,315,285,1538,136,0,2482,4461
13251,Iraq,2008,2008Iraq,366,452,341,2010,127,0,3296,391,483,480,2703,128,0,4185,7481
13252,Iraq,2008,2008Iraq,408,794,689,2760,264,0,4915,396,911,728,2900,241,0,5176,10091
13253,Iraq,2008,2008Iraq,435,438,323,1692,85,0,2973,522,480,415,5763,92,0,7272,50000
13254,Iraq,2008,2008Iraq,1938,3249,3894,7515,484,0,17080,2080,3787,4395,16244,858,0,27364,44444
13255,Iraq,2008,2008Iraq,21395,30642,26939,152244,27046,0,258266,22515,33471,29307,137755,18686,0,241734,500000
13256,Iraq,2008,2008Iraq,50536,86713,73484,296688,34098,0,541519,52091,92950,79645,300417,33378,0,558481,1100000
13257,Iraq,2009,2009Iraq,0,0,0,0,0,0,0,0,0,0,0,0,0,0,109606
13258,Iraq,2009,2009Iraq,0,0,0,0,0,0,0,0,0,0,5,0,0,5,50
13259,Iraq,2009,2009Iraq,0,0,0,0,0,0,0,0,0,0,6,0,0,6,12
13260,Iraq,2009,2009Iraq,0,0,0,0,0,0,0,0,0,0,9,0,0,9,9
13261,Iraq,2009,2009Iraq,0,0,0,0,0,0,0,0,0,0,35,0,0,35,35
13262,Iraq,2009,2009Iraq,0,0,0,0,0,0,0,0,0,5,0,0,0,5,5
13263,Iraq,2009,2009Iraq,0,0,0,0,0,0,0,0,0,8,8,0,0,16,16
13264,Iraq,2009,2009Iraq,0,0,0,0,0,0,0,6,0,0,0,0,0,6,6
13265,Iraq,2009,2009Iraq,0,0,0,0,0,204,204,0,0,0,0,0,514,514,718
13266,Iraq,2009,2009Iraq,0,0,0,5,0,0,5,0,0,0,0,0,0,0,10
13267,Iraq,2009,2009Iraq,0,0,0,5,0,0,5,0,0,0,11,0,0,11,16
13268,Iraq,2009,2009Iraq,0,0,0,6,0,0,6,0,0,0,0,0,0,0,6
13269,Iraq,2009,2009Iraq,0,0,0,9,0,0,9,0,0,6,7,0,0,13,22
13270,Iraq,2009,2009Iraq,0,0,0,10,0,0,10,0,0,5,23,0,0,28,38
13271,Iraq,2009,2009Iraq,0,0,5,0,0,0,5,0,0,0,0,0,0,0,5
13272,Iraq,2009,2009Iraq,0,0,5,0,0,0,5,0,0,0,16,0,0,16,21
13273,Iraq,2009,2009Iraq,0,0,5,5,0,0,10,0,0,0,45,0,0,45,55
13274,Iraq,2009,2009Iraq,0,0,5,16,5,0,26,0,6,6,55,5,0,72,98
13275,Iraq,2009,2009Iraq,0,0,8,7,0,0,15,0,9,7,19,0,0,35,50
13276,Iraq,2009,2009Iraq,0,5,0,8,0,0,13,0,0,7,17,0,0,24,37
13277,Iraq,2009,2009Iraq,0,7,0,13,0,0,20,0,6,6,12,0,0,24,44
13278,Iraq,2009,2009Iraq,0,7,6,47,0,0,60,0,7,12,118,0,0,137,197
13279,Iraq,2009,2009Iraq,0,8,10,23,0,0,41,0,8,11,38,0,0,57,98
13280,Iraq,2009,2009Iraq,0,19,0,6,0,0,25,0,0,14,0,0,0,14,39
13281,Iraq,2009,2009Iraq,5,0,0,6,0,0,11,0,0,0,8,0,0,8,19
13282,Iraq,2009,2009Iraq,5,8,6,35,0,0,54,0,5,10,61,0,0,76,130
13283,Iraq,2009,2009Iraq,5,15,10,28,5,0,63,5,12,11,61,5,0,94,157
13284,Iraq,2009,2009Iraq,5,19,17,31,0,0,72,5,18,19,61,0,0,103,175
13285,Iraq,2009,2009Iraq,7,7,0,12,5,0,31,0,0,6,17,5,0,28,89
13286,Iraq,2009,2009Iraq,8,11,9,44,0,0,72,11,23,12,91,0,0,137,209
13287,Iraq,2009,2009Iraq,9,5,5,42,0,0,61,7,5,5,56,5,0,78,139
13288,Iraq,2009,2009Iraq,12,0,5,0,0,0,17,0,7,0,10,0,0,17,34
13289,Iraq,2009,2009Iraq,19,35,56,265,62,0,437,23,36,50,281,43,0,433,870
13290,Iraq,2009,2009Iraq,22,19,11,52,5,0,109,15,14,6,61,5,0,101,210
13291,Iraq,2009,2009Iraq,22,33,22,100,8,0,185,22,31,36,169,7,0,265,450
13292,Iraq,2009,2009Iraq,75,153,192,895,50,0,1365,76,181,176,871,108,0,1412,2777
13293,Iraq,2009,2009Iraq,89,123,119,380,23,1090,1824,92,151,135,1095,12,1303,2788,4612
13294,Iraq,2009,2009Iraq,151,285,263,1164,95,0,1958,153,332,272,1558,155,0,2470,4428
13295,Iraq,2009,2009Iraq,169,538,492,1844,203,0,3246,177,586,515,1848,200,0,3326,6572
13296,Iraq,2009,2009Iraq,230,304,295,1632,117,0,2578,306,327,332,2526,125,0,3616,6194
13297,Iraq,2009,2009Iraq,443,433,336,1596,113,0,2921,492,521,378,4317,113,0,5821,50000
13298,Iraq,2009,2009Iraq,1401,2781,2498,10570,813,0,18063,1475,3096,2927,22708,764,0,30970,49033
13299,Iraq,2009,2009Iraq,2081,3554,4170,8103,507,0,18415,2233,3841,4980,17541,914,0,29509,47924
13300,Iraq,2009,2009Iraq,17805,28735,23136,129122,21510,0,220308,19861,29234,24902,137599,18096,0,229692,450000
13301,Iraq,2009,2009Iraq,44817,77304,68543,282331,37053,0,510048,46206,82040,72678,303305,35723,0,539952,1050000
13302,Iraq,2010,2010Iraq,0,0,0,0,0,0,0,0,0,0,0,0,0,0,144791
13303,Iraq,2010,2010Iraq,0,0,0,0,0,0,0,0,0,0,0,0,6,6,6
13304,Iraq,2010,2010Iraq,0,0,0,0,0,0,0,0,0,0,5,0,0,5,35
13305,Iraq,2010,2010Iraq,0,0,0,0,0,0,0,0,0,0,6,0,0,6,24
13306,Iraq,2010,2010Iraq,0,0,0,0,0,0,0,0,0,0,35,0,0,35,35
13307,Iraq,2010,2010Iraq,0,0,0,0,0,0,0,0,0,5,0,0,0,5,5
13308,Iraq,2010,2010Iraq,0,0,0,0,0,0,0,0,0,8,8,0,0,16,16
13309,Iraq,2010,2010Iraq,0,0,0,0,0,0,0,0,5,0,0,0,0,5,5
13310,Iraq,2010,2010Iraq,0,0,0,0,0,0,0,0,6,0,5,0,0,11,92
13311,Iraq,2010,2010Iraq,0,0,0,0,0,0,0,6,0,0,0,0,0,6,6
13312,Iraq,2010,2010Iraq,0,0,0,0,0,10,10,0,0,0,0,0,58,58,68
13313,Iraq,2010,2010Iraq,0,0,0,0,0,249,249,0,0,0,0,0,713,713,962
13314,Iraq,2010,2010Iraq,0,0,0,0,0,1051,1051,0,0,0,0,0,1315,1315,2366
13315,Iraq,2010,2010Iraq,0,0,0,5,0,0,5,0,0,0,11,0,0,11,16
13316,Iraq,2010,2010Iraq,0,0,0,5,0,0,5,0,0,0,18,0,0,18,23
13317,Iraq,2010,2010Iraq,0,0,0,5,0,0,5,0,0,0,36,0,0,36,41
13318,Iraq,2010,2010Iraq,0,0,0,6,0,0,6,0,0,0,0,0,0,0,6
13319,Iraq,2010,2010Iraq,0,0,0,7,0,0,7,0,0,0,8,0,0,8,15
13320,Iraq,2010,2010Iraq,0,0,0,7,0,0,7,0,0,5,11,0,0,16,23
13321,Iraq,2010,2010Iraq,0,0,5,0,0,0,5,0,0,0,0,0,0,0,5
13322,Iraq,2010,2010Iraq,0,0,5,14,0,0,19,0,0,9,43,5,0,57,76
13323,Iraq,2010,2010Iraq,0,0,8,7,0,0,15,5,7,5,19,0,0,36,51
13324,Iraq,2010,2010Iraq,0,6,0,0,0,0,6,0,6,0,5,0,0,11,17
13325,Iraq,2010,2010Iraq,0,6,10,19,0,0,35,0,5,11,36,0,0,52,87
13326,Iraq,2010,2010Iraq,0,7,0,5,0,0,12,0,6,9,5,0,0,20,32
13327,Iraq,2010,2010Iraq,0,7,7,48,0,0,62,0,0,15,120,5,0,140,202
13328,Iraq,2010,2010Iraq,0,19,0,6,0,0,25,0,0,14,0,0,0,14,39
13329,Iraq,2010,2010Iraq,5,0,0,12,0,0,17,8,0,0,13,0,0,21,38
13330,Iraq,2010,2010Iraq,5,5,5,31,0,0,46,0,5,5,61,5,0,76,122
13331,Iraq,2010,2010Iraq,5,17,9,30,5,0,66,7,14,13,63,5,0,102,168
13332,Iraq,2010,2010Iraq,6,5,7,31,0,0,49,5,23,8,61,0,0,97,146
13333,Iraq,2010,2010Iraq,8,7,0,28,0,0,43,0,9,0,14,5,0,28,71
13334,Iraq,2010,2010Iraq,8,8,5,39,0,0,60,7,11,7,33,5,0,63,123
13335,Iraq,2010,2010Iraq,13,5,9,47,5,0,79,10,5,5,61,5,0,86,165
13336,Iraq,2010,2010Iraq,17,45,25,113,8,0,208,20,35,38,188,9,0,290,498
13337,Iraq,2010,2010Iraq,19,36,57,268,65,0,445,23,37,51,288,44,0,443,888
13338,Iraq,2010,2010Iraq,25,37,121,25,0,0,208,32,52,107,33,0,0,224,432
13339,Iraq,2010,2010Iraq,73,154,186,939,55,0,1407,73,188,174,923,120,0,1478,2885
13340,Iraq,2010,2010Iraq,96,136,101,394,22,1095,1844,95,151,124,1050,14,1285,2719,4563
13341,Iraq,2010,2010Iraq,134,503,516,1988,241,0,3382,144,588,506,1928,224,0,3390,6772
13342,Iraq,2010,2010Iraq,195,369,301,947,148,0,1960,200,321,285,1452,104,0,2362,4322
13343,Iraq,2010,2010Iraq,205,270,243,1365,92,0,2175,272,336,290,2115,89,0,3102,5277
13344,Iraq,2010,2010Iraq,425,453,328,1578,130,0,2914,472,537,369,3215,123,0,4716,7630
13345,Iraq,2010,2010Iraq,1520,3136,2614,11042,929,0,19241,1633,3417,2959,22331,851,0,31191,50432
13346,Iraq,2010,2010Iraq,19951,28780,22619,125367,22707,0,219424,21469,31278,24425,134035,19369,0,230576,450000
13347,Iraq,2010,2010Iraq,39953,71808,64048,258733,35819,0,470361,41901,76697,66499,308185,0,36357,529639,1000000
13348,Iraq,2011,2011Iraq,0,0,0,0,0,0,0,0,0,0,0,0,0,0,136949
13349,Iraq,2011,2011Iraq,0,0,0,0,0,0,0,0,0,0,0,0,5,5,5
13350,Iraq,2011,2011Iraq,0,0,0,0,0,0,0,0,0,0,5,0,0,5,40
13351,Iraq,2011,2011Iraq,0,0,0,0,0,0,0,0,0,0,6,0,0,6,18
13352,Iraq,2011,2011Iraq,0,0,0,0,0,0,0,0,0,0,12,0,0,12,12
13353,Iraq,2011,2011Iraq,0,0,0,0,0,0,0,0,0,0,21,0,0,21,21
13354,Iraq,2011,2011Iraq,0,0,0,0,0,0,0,0,0,0,36,0,0,36,36
13355,Iraq,2011,2011Iraq,0,0,0,0,0,0,0,0,0,5,0,0,0,5,5
13356,Iraq,2011,2011Iraq,0,0,0,0,0,0,0,0,0,5,11,0,0,16,26
13357,Iraq,2011,2011Iraq,0,0,0,0,0,0,0,0,0,8,8,0,0,16,16
13358,Iraq,2011,2011Iraq,0,0,0,0,0,0,0,0,5,0,0,0,0,5,5
13359,Iraq,2011,2011Iraq,0,0,0,0,0,329,329,0,0,0,0,0,1000,1000,1329
13360,Iraq,2011,2011Iraq,0,0,0,0,0,1134,1134,0,0,0,0,0,1385,1385,2519
13361,Iraq,2011,2011Iraq,0,0,0,5,0,0,5,0,0,0,12,0,0,12,69
13362,Iraq,2011,2011Iraq,0,0,0,5,0,0,5,0,0,0,36,0,0,36,41
13363,Iraq,2011,2011Iraq,0,0,0,6,0,0,6,0,0,0,0,0,0,0,6
13364,Iraq,2011,2011Iraq,0,0,0,9,0,0,9,0,0,0,18,0,0,18,27
13365,Iraq,2011,2011Iraq,0,0,5,0,0,0,5,0,0,0,0,0,0,0,5
13366,Iraq,2011,2011Iraq,0,0,5,12,0,0,17,0,8,0,48,6,0,62,79
13367,Iraq,2011,2011Iraq,0,0,7,20,0,0,27,0,10,7,34,0,0,51,78
13368,Iraq,2011,2011Iraq,0,0,8,24,0,0,32,5,0,6,16,5,0,32,64
13369,Iraq,2011,2011Iraq,0,5,0,11,0,0,16,0,0,13,33,0,0,46,62
13370,Iraq,2011,2011Iraq,0,6,0,0,0,0,6,0,0,0,8,0,0,8,93
13371,Iraq,2011,2011Iraq,0,6,0,6,0,0,12,0,0,0,6,0,0,6,18
13372,Iraq,2011,2011Iraq,0,7,0,5,0,0,12,0,6,9,5,0,0,20,32
13373,Iraq,2011,2011Iraq,0,7,7,50,0,0,64,0,5,11,122,5,0,143,207
13374,Iraq,2011,2011Iraq,0,9,0,6,0,0,15,7,0,0,8,0,0,15,30
13375,Iraq,2011,2011Iraq,0,17,6,11,0,0,34,0,5,10,7,0,0,22,56
13376,Iraq,2011,2011Iraq,5,5,5,29,0,0,44,0,5,6,51,5,0,67,111
13377,Iraq,2011,2011Iraq,5,12,7,29,5,0,58,0,10,13,62,6,0,91,149
13378,Iraq,2011,2011Iraq,6,7,5,30,0,0,48,0,9,0,14,5,0,28,76
13379,Iraq,2011,2011Iraq,8,0,0,0,0,0,8,0,0,0,7,0,0,7,15
13380,Iraq,2011,2011Iraq,9,18,11,92,0,0,130,20,15,15,118,7,0,175,305
13381,Iraq,2011,2011Iraq,11,20,9,74,7,0,121,14,28,9,70,5,0,126,247
13382,Iraq,2011,2011Iraq,16,47,31,121,11,0,226,20,42,35,212,10,0,319,545
13383,Iraq,2011,2011Iraq,18,11,11,59,5,0,104,12,7,5,65,6,0,95,199
13384,Iraq,2011,2011Iraq,19,38,57,277,69,0,460,26,40,51,297,49,0,463,923
13385,Iraq,2011,2011Iraq,35,61,162,30,0,0,288,38,64,147,33,0,0,282,570
13386,Iraq,2011,2011Iraq,68,144,186,882,54,0,1334,63,182,170,872,115,0,1402,2736
13387,Iraq,2011,2011Iraq,84,123,92,478,85,0,862,62,128,109,490,61,0,850,1712
13388,Iraq,2011,2011Iraq,93,142,97,388,23,1055,1798,86,149,115,963,18,1226,2557,4355
13389,Iraq,2011,2011Iraq,103,262,219,1085,96,0,1765,94,322,238,1381,140,0,2175,3940
13390,Iraq,2011,2011Iraq,131,426,428,1829,238,0,3052,130,477,463,1721,194,0,2985,6037
13391,Iraq,2011,2011Iraq,316,432,323,1769,173,0,3013,341,529,384,2613,191,0,4058,7071
13392,Iraq,2011,2011Iraq,450,532,343,1957,0,180,3462,521,603,418,3305,182,0,5029,8491
13393,Iraq,2011,2011Iraq,1519,3099,2502,10918,990,0,19028,1576,3331,2813,21340,888,0,29948,48976
13394,Iraq,2011,2011Iraq,20325,30589,21790,126362,23858,0,222924,21882,31414,24134,132247,17399,0,227076,450000
13395,Iraq,2011,2011Iraq,32774,60140,52098,210199,29572,0,384783,35191,63618,54432,181105,30871,0,365217,750000
13396,Iraq,2012,2012Iraq,0,0,0,0,0,0,0,0,0,0,0,0,0,0,75090
13397,Iraq,2012,2012Iraq,0,0,0,0,0,0,0,0,0,0,0,0,5,5,5
13398,Iraq,2012,2012Iraq,0,0,0,0,0,0,0,0,0,0,5,0,0,5,45
13399,Iraq,2012,2012Iraq,0,0,0,0,0,0,0,0,0,0,6,0,0,6,24
13400,Iraq,2012,2012Iraq,0,0,0,0,0,0,0,0,0,0,9,0,0,9,9
13401,Iraq,2012,2012Iraq,0,0,0,0,0,0,0,0,0,0,12,0,0,12,12
13402,Iraq,2012,2012Iraq,0,0,0,0,0,0,0,0,0,0,14,0,0,14,25
13403,Iraq,2012,2012Iraq,0,0,0,0,0,0,0,0,0,0,35,0,0,35,487
13404,Iraq,2012,2012Iraq,0,0,0,0,0,0,0,0,0,0,36,0,0,36,36
13405,Iraq,2012,2012Iraq,0,0,0,0,0,0,0,0,0,5,0,0,0,5,5
13406,Iraq,2012,2012Iraq,0,0,0,0,0,0,0,0,0,8,8,0,0,16,16
13407,Iraq,2012,2012Iraq,0,0,0,0,0,0,0,0,5,0,0,0,0,5,5
13408,Iraq,2012,2012Iraq,0,0,0,0,0,15,15,0,0,0,0,0,62,62,77
13409,Iraq,2012,2012Iraq,0,0,0,0,0,55,55,0,0,0,0,0,104,104,159
13410,Iraq,2012,2012Iraq,0,0,0,0,0,393,393,0,0,0,0,0,1148,1148,1541
13411,Iraq,2012,2012Iraq,0,0,0,0,0,1179,1179,0,0,0,0,0,1441,1441,2620
13412,Iraq,2012,2012Iraq,0,0,0,5,0,0,5,0,0,0,0,0,0,0,5
13413,Iraq,2012,2012Iraq,0,0,0,5,0,0,5,0,0,0,18,0,0,18,23
13414,Iraq,2012,2012Iraq,0,0,0,6,0,0,6,0,0,9,0,0,0,9,15
13415,Iraq,2012,2012Iraq,0,0,0,10,0,0,10,0,0,0,21,0,0,21,31
13416,Iraq,2012,2012Iraq,0,0,6,6,0,0,12,0,0,6,0,0,0,6,18
13417,Iraq,2012,2012Iraq,0,0,6,19,0,0,25,0,5,8,34,0,0,47,72
13418,Iraq,2012,2012Iraq,0,0,8,24,0,0,32,5,0,6,16,5,0,32,64
13419,Iraq,2012,2012Iraq,0,5,0,0,0,0,5,0,0,0,9,0,0,9,95
13420,Iraq,2012,2012Iraq,0,5,0,0,8,0,13,0,0,7,10,0,0,17,30
13421,Iraq,2012,2012Iraq,0,5,0,13,0,0,18,0,8,0,55,5,0,68,86
13422,Iraq,2012,2012Iraq,0,6,0,5,0,0,11,0,0,0,9,0,0,9,20
13423,Iraq,2012,2012Iraq,0,6,0,6,0,0,12,5,0,0,6,0,0,11,23
13424,Iraq,2012,2012Iraq,0,6,5,25,14,0,50,0,5,0,28,7,0,40,1745
13425,Iraq,2012,2012Iraq,0,6,15,38,0,0,59,5,5,5,58,5,0,78,137
13426,Iraq,2012,2012Iraq,0,8,7,52,0,0,67,0,5,11,126,5,0,147,214
13427,Iraq,2012,2012Iraq,0,12,11,30,5,0,58,0,10,11,62,6,0,89,147
13428,Iraq,2012,2012Iraq,0,19,0,11,0,0,30,0,0,14,6,0,0,20,50
13429,Iraq,2012,2012Iraq,5,5,32,9,0,0,51,6,6,58,5,0,0,75,126
13430,Iraq,2012,2012Iraq,5,6,5,30,0,0,46,0,0,8,59,0,0,67,113
13431,Iraq,2012,2012Iraq,8,0,0,0,0,0,8,0,0,0,7,0,0,7,15
13432,Iraq,2012,2012Iraq,11,29,20,111,11,0,182,10,35,33,203,12,0,293,475
13433,Iraq,2012,2012Iraq,12,9,8,44,0,0,73,5,9,7,32,5,0,58,131
13434,Iraq,2012,2012Iraq,15,32,21,125,10,0,203,20,47,27,180,7,0,281,484
13435,Iraq,2012,2012Iraq,19,38,58,285,71,0,471,28,40,51,302,51,0,472,943
13436,Iraq,2012,2012Iraq,26,16,14,88,5,0,149,15,9,6,102,8,0,140,289
13437,Iraq,2012,2012Iraq,31,36,25,165,24,0,281,25,43,23,153,23,0,267,548
13438,Iraq,2012,2012Iraq,35,154,286,654,51,0,1180,31,186,314,565,101,0,1197,2532
13439,Iraq,2012,2012Iraq,36,69,105,317,35,0,562,42,70,88,319,22,0,541,44085
13440,Iraq,2012,2012Iraq,56,236,194,978,93,0,1557,55,274,217,1167,161,0,1874,3431
13441,Iraq,2012,2012Iraq,74,129,96,358,23,1035,1715,69,141,106,852,19,1218,2405,4120
13442,Iraq,2012,2012Iraq,79,348,421,1817,229,0,2894,85,416,446,1659,203,0,2809,5703
13443,Iraq,2012,2012Iraq,356,426,264,1462,149,0,2657,363,475,305,2539,161,0,3843,6516
13444,Iraq,2012,2012Iraq,412,672,463,2432,230,0,4209,462,704,537,3319,247,0,5269,9478
13445,Iraq,2012,2012Iraq,1570,3169,2492,11233,1101,0,19565,1643,3351,2796,21509,965,0,30264,49829
13446,Iraq,2012,2012Iraq,2659,4428,3116,17547,3551,0,31301,2753,4540,3444,18360,2639,0,31736,63037
13447,Iraq,2012,2012Iraq,18598,36099,31633,130721,17610,0,234661,19239,37675,34481,125121,20241,0,236757,471418
13448,Iraq,2013,2013Iraq,0,0,0,0,0,0,0,0,0,0,0,0,0,0,70193
13449,Iraq,2013,2013Iraq,0,0,0,0,0,0,0,0,0,0,0,0,5,5,5
13450,Iraq,2013,2013Iraq,0,0,0,0,0,0,0,0,0,0,5,0,0,5,58
13451,Iraq,2013,2013Iraq,0,0,0,0,0,0,0,0,0,0,6,0,0,6,30
13452,Iraq,2013,2013Iraq,0,0,0,0,0,0,0,0,0,0,9,0,0,9,18
13453,Iraq,2013,2013Iraq,0,0,0,0,0,0,0,0,0,0,20,5,0,25,25
13454,Iraq,2013,2013Iraq,0,0,0,0,0,0,0,0,0,0,36,0,0,36,36
13455,Iraq,2013,2013Iraq,0,0,0,0,0,0,0,0,0,8,8,0,0,16,16
13456,Iraq,2013,2013Iraq,0,0,0,0,0,0,0,0,5,0,0,0,0,5,5
13457,Iraq,2013,2013Iraq,0,0,0,0,0,0,0,0,6,8,41,5,0,60,100
13458,Iraq,2013,2013Iraq,0,0,0,0,0,5,5,0,0,0,0,0,24,24,293
13459,Iraq,2013,2013Iraq,0,0,0,0,0,370,370,0,0,0,0,0,1005,1005,3058
13460,Iraq,2013,2013Iraq,0,0,0,0,0,1202,1202,0,0,0,0,0,1475,1475,2677
13461,Iraq,2013,2013Iraq,0,0,0,5,0,0,5,0,0,0,0,0,0,0,5
13462,Iraq,2013,2013Iraq,0,0,0,6,0,0,6,0,0,0,9,0,0,9,30
13463,Iraq,2013,2013Iraq,0,0,0,6,0,0,6,0,0,0,18,0,0,18,24
13464,Iraq,2013,2013Iraq,0,0,0,7,0,0,7,0,0,0,9,0,0,9,16
13465,Iraq,2013,2013Iraq,0,0,0,8,0,0,8,0,6,0,44,5,0,55,63
13466,Iraq,2013,2013Iraq,0,0,0,10,0,0,10,0,0,0,21,0,0,21,31
13467,Iraq,2013,2013Iraq,0,0,8,10,0,0,18,0,5,5,17,0,0,27,45
13468,Iraq,2013,2013Iraq,0,0,9,0,0,0,9,0,0,6,8,0,0,14,23
13469,Iraq,2013,2013Iraq,0,5,0,0,0,0,5,0,0,0,5,0,0,5,10
13470,Iraq,2013,2013Iraq,0,6,0,11,0,0,17,0,0,5,32,0,0,37,54
13471,Iraq,2013,2013Iraq,0,7,12,12,0,0,31,5,5,0,23,0,0,33,64
13472,Iraq,2013,2013Iraq,0,7,14,81,14,0,116,0,17,10,214,23,0,264,380
13473,Iraq,2013,2013Iraq,0,8,7,52,0,0,67,0,5,11,129,5,0,150,217
13474,Iraq,2013,2013Iraq,0,13,0,5,0,0,18,0,8,0,6,0,0,14,32
13475,Iraq,2013,2013Iraq,5,0,0,0,0,0,5,0,0,0,0,0,0,0,5
13476,Iraq,2013,2013Iraq,5,5,7,39,0,0,56,8,5,5,35,5,0,58,114
13477,Iraq,2013,2013Iraq,5,6,15,25,0,0,51,6,9,0,39,0,0,54,105
13478,Iraq,2013,2013Iraq,5,7,6,36,0,0,54,5,5,5,61,0,0,76,130
13479,Iraq,2013,2013Iraq,8,0,0,0,0,0,8,0,0,0,7,0,0,7,15
13480,Iraq,2013,2013Iraq,9,0,0,33,19,0,61,6,6,5,33,15,0,65,1730
13481,Iraq,2013,2013Iraq,11,10,6,45,0,0,72,5,9,9,31,5,0,59,131
13482,Iraq,2013,2013Iraq,14,24,26,126,17,0,207,16,42,27,227,11,0,323,530
13483,Iraq,2013,2013Iraq,14,45,33,170,17,0,279,20,44,25,156,16,0,261,540
13484,Iraq,2013,2013Iraq,17,133,129,867,79,0,1225,16,156,146,836,144,0,1298,2530
13485,Iraq,2013,2013Iraq,18,31,16,118,14,0,197,25,41,29,139,8,0,242,439
13486,Iraq,2013,2013Iraq,20,41,60,292,73,0,486,28,41,52,306,54,0,481,967
13487,Iraq,2013,2013Iraq,22,16,12,91,5,0,146,16,9,6,108,9,0,148,294
13488,Iraq,2013,2013Iraq,25,47,90,252,35,0,449,27,48,71,253,22,0,421,43268
13489,Iraq,2013,2013Iraq,40,231,179,1007,113,0,1570,28,259,206,1187,166,0,1846,3416
13490,Iraq,2013,2013Iraq,66,305,406,1795,224,0,2796,69,371,437,1624,209,0,2710,5506
13491,Iraq,2013,2013Iraq,74,117,92,348,25,980,1636,64,133,102,791,15,1142,2247,3883
13492,Iraq,2013,2013Iraq,247,342,218,1042,95,0,1944,269,396,236,1981,118,0,3000,4944
13493,Iraq,2013,2013Iraq,605,961,706,3401,285,0,5958,611,1070,921,4624,283,0,7509,13467
13494,Iraq,2013,2013Iraq,1063,2297,1948,8295,1103,0,14706,1130,2342,2092,6749,1281,0,13594,146200
13495,Iraq,2013,2013Iraq,1632,2673,1948,8713,945,0,15911,1705,2765,2166,16874,809,0,24319,40230
13496,Iraq,2013,2013Iraq,2288,3958,2831,15320,3088,0,27485,2434,4061,3122,16017,2390,0,28024,55509
13497,Iraq,2014,2014Iraq,0,0,0,0,0,0,0,0,0,0,0,0,0,0,74134
13498,Iraq,2014,2014Iraq,0,0,0,0,0,0,0,0,0,0,0,0,5,5,5
13499,Iraq,2014,2014Iraq,0,0,0,0,0,0,0,0,0,0,5,0,0,5,40
13500,Iraq,2014,2014Iraq,0,0,0,0,0,0,0,0,0,0,6,0,0,6,18
13501,Iraq,2014,2014Iraq,0,0,0,0,0,0,0,0,0,0,7,0,0,7,7
13502,Iraq,2014,2014Iraq,0,0,0,0,0,0,0,0,0,0,9,0,0,9,9
13503,Iraq,2014,2014Iraq,0,0,0,0,0,0,0,0,0,0,17,0,0,17,17
13504,Iraq,2014,2014Iraq,0,0,0,0,0,0,0,0,0,0,21,0,0,21,21
13505,Iraq,2014,2014Iraq,0,0,0,0,0,0,0,0,0,0,21,5,0,26,26
13506,Iraq,2014,2014Iraq,0,0,0,0,0,0,0,0,0,5,0,0,0,5,5
13507,Iraq,2014,2014Iraq,0,0,0,0,0,0,0,0,0,7,0,0,0,7,7
13508,Iraq,2014,2014Iraq,0,0,0,0,0,0,0,0,0,8,8,0,0,16,16
13509,Iraq,2014,2014Iraq,0,0,0,0,0,0,0,5,0,0,0,0,0,5,5
13510,Iraq,2014,2014Iraq,0,0,0,0,0,6,6,0,0,0,0,0,20,20,26
13511,Iraq,2014,2014Iraq,0,0,0,0,0,78,78,0,0,0,0,0,126,126,204
13512,Iraq,2014,2014Iraq,0,0,0,0,0,1382,1382,0,0,0,0,0,1609,1609,2991
13513,Iraq,2014,2014Iraq,0,0,0,5,0,0,5,0,0,0,0,0,0,0,5
13514,Iraq,2014,2014Iraq,0,0,0,5,0,0,5,0,0,0,10,0,0,10,15
13515,Iraq,2014,2014Iraq,0,0,0,6,0,0,6,0,0,5,5,0,0,10,16
13516,Iraq,2014,2014Iraq,0,0,0,7,0,0,7,0,0,0,10,0,0,10,17
13517,Iraq,2014,2014Iraq,0,0,0,8,0,0,8,0,6,0,44,0,0,50,58
13518,Iraq,2014,2014Iraq,0,0,0,9,0,0,9,0,0,0,0,0,0,0,9
13519,Iraq,2014,2014Iraq,0,0,0,9,0,0,9,0,0,5,14,0,0,19,28
13520,Iraq,2014,2014Iraq,0,0,0,10,0,0,10,0,0,0,21,0,0,21,31
13521,Iraq,2014,2014Iraq,0,5,0,0,0,0,5,0,0,0,0,0,0,0,23
13522,Iraq,2014,2014Iraq,0,5,0,0,0,0,5,0,0,0,6,0,0,6,11
13523,Iraq,2014,2014Iraq,0,5,0,0,0,0,5,0,0,0,223,5,0,228,233
13524,Iraq,2014,2014Iraq,0,5,0,12,0,0,17,0,0,5,16,5,0,26,43
13525,Iraq,2014,2014Iraq,0,10,6,30,0,0,46,5,9,11,51,5,0,81,127
13526,Iraq,2014,2014Iraq,0,13,0,5,0,0,18,0,8,0,6,0,0,14,32
13527,Iraq,2014,2014Iraq,0,16,7,36,0,0,59,12,17,13,72,0,0,114,173
13528,Iraq,2014,2014Iraq,5,5,6,38,0,0,54,8,6,0,37,5,0,56,110
13529,Iraq,2014,2014Iraq,5,6,7,17,5,0,40,0,5,5,38,8,0,56,96
13530,Iraq,2014,2014Iraq,6,5,6,26,0,0,43,0,7,7,58,0,0,72,115
13531,Iraq,2014,2014Iraq,9,0,0,0,0,0,9,0,0,0,7,0,0,7,16
13532,Iraq,2014,2014Iraq,9,12,8,43,5,0,77,0,16,11,34,5,0,66,143
13533,Iraq,2014,2014Iraq,12,26,22,112,7,0,179,11,29,26,97,6,0,169,348
13534,Iraq,2014,2014Iraq,13,21,17,84,44,0,179,16,24,11,82,21,0,154,1643
13535,Iraq,2014,2014Iraq,14,14,21,87,6,0,142,17,11,17,105,11,0,161,303
13536,Iraq,2014,2014Iraq,14,24,24,133,19,0,214,14,44,27,251,13,0,349,563
13537,Iraq,2014,2014Iraq,14,129,103,890,98,0,1234,12,123,150,842,159,0,1286,2520
13538,Iraq,2014,2014Iraq,16,16,11,70,11,0,124,15,19,14,143,8,0,199,323
13539,Iraq,2014,2014Iraq,17,34,75,197,28,0,351,21,39,60,200,17,0,337,32000
13540,Iraq,2014,2014Iraq,21,222,170,1008,111,0,1532,33,236,190,1198,202,0,1859,3391
13541,Iraq,2014,2014Iraq,22,42,61,294,71,0,490,30,41,53,311,54,0,489,979
13542,Iraq,2014,2014Iraq,57,376,1700,282,229,0,2644,69,400,1491,321,224,0,2505,5149
13543,Iraq,2014,2014Iraq,78,121,74,354,18,971,1616,56,134,85,751,13,1096,2135,3751
13544,Iraq,2014,2014Iraq,258,460,256,1389,140,0,2503,335,497,275,2216,160,0,3483,5986
13545,Iraq,2014,2014Iraq,792,1415,954,4286,359,0,7806,882,1509,1159,5880,306,0,9736,17542
13546,Iraq,2014,2014Iraq,990,2978,5099,2651,250,0,11968,999,3149,4209,2350,305,0,11012,146200
13547,Iraq,2014,2014Iraq,1224,2097,1493,7991,1533,0,14338,1290,2294,1624,8500,1217,0,14925,29263
13548,Iraq,2014,2014Iraq,1845,2546,1842,9119,1044,0,16396,1954,2674,2156,17084,903,0,24771,41167
13549,Iraq,2015,2015Iraq,0,0,0,0,0,0,0,0,0,0,0,0,0,0,74495
13550,Iraq,2015,2015Iraq,0,0,0,0,0,0,0,0,0,0,0,0,5,5,396
13551,Iraq,2015,2015Iraq,0,0,0,0,0,0,0,0,0,0,5,0,0,5,35
13552,Iraq,2015,2015Iraq,0,0,0,0,0,0,0,0,0,0,6,0,0,6,12
13553,Iraq,2015,2015Iraq,0,0,0,0,0,0,0,0,0,0,7,0,0,7,7
13554,Iraq,2015,2015Iraq,0,0,0,0,0,0,0,0,0,0,9,0,0,9,18
13555,Iraq,2015,2015Iraq,0,0,0,0,0,0,0,0,0,0,10,0,15,25,25
13556,Iraq,2015,2015Iraq,0,0,0,0,0,0,0,0,0,0,13,0,0,13,13
13557,Iraq,2015,2015Iraq,0,0,0,0,0,0,0,0,0,5,0,0,0,5,5
13558,Iraq,2015,2015Iraq,0,0,0,0,0,0,0,0,0,5,13,0,0,18,18
13559,Iraq,2015,2015Iraq,0,0,0,0,0,0,0,0,0,8,8,0,0,16,16
13560,Iraq,2015,2015Iraq,0,0,0,0,0,0,0,0,6,0,11,0,0,17,17
13561,Iraq,2015,2015Iraq,0,0,0,0,0,20,20,0,0,0,0,0,66,66,86
13562,Iraq,2015,2015Iraq,0,0,0,0,0,82,82,0,0,0,0,0,132,132,214
13563,Iraq,2015,2015Iraq,0,0,0,0,0,558,558,0,0,0,0,0,1385,1385,1943
13564,Iraq,2015,2015Iraq,0,0,0,0,0,2220,2220,0,0,0,0,0,2567,2567,4787
13565,Iraq,2015,2015Iraq,0,0,0,5,0,0,5,0,0,0,31,0,0,31,36
13566,Iraq,2015,2015Iraq,0,0,0,6,0,0,6,0,0,5,5,0,0,10,16
13567,Iraq,2015,2015Iraq,0,0,0,7,0,0,7,0,0,0,16,0,0,16,23
13568,Iraq,2015,2015Iraq,0,0,0,9,0,0,9,0,0,0,17,5,0,22,31
13569,Iraq,2015,2015Iraq,0,0,0,15,0,0,15,0,0,0,12,0,0,12,27
13570,Iraq,2015,2015Iraq,0,0,5,11,0,0,16,5,6,0,48,0,0,59,75
13571,Iraq,2015,2015Iraq,0,0,6,0,0,0,6,0,0,0,10,0,0,10,16
13572,Iraq,2015,2015Iraq,0,0,10,11,0,0,21,0,0,0,17,0,0,17,38
13573,Iraq,2015,2015Iraq,0,5,0,0,0,0,5,0,0,0,6,0,0,6,11
13574,Iraq,2015,2015Iraq,0,5,0,6,0,0,11,0,0,6,12,0,0,18,29
13575,Iraq,2015,2015Iraq,0,6,0,0,0,0,6,0,0,0,0,6,0,6,12
13576,Iraq,2015,2015Iraq,0,6,0,5,0,0,11,0,0,0,10,0,0,10,21
13577,Iraq,2015,2015Iraq,0,7,5,57,0,0,69,0,16,15,161,0,0,192,261
13578,Iraq,2015,2015Iraq,0,8,8,94,16,0,126,0,16,12,234,21,0,283,409
13579,Iraq,2015,2015Iraq,5,0,8,34,0,0,47,0,9,0,34,5,0,48,95
13580,Iraq,2015,2015Iraq,7,10,9,24,5,0,55,0,9,8,51,9,0,77,132
13581,Iraq,2015,2015Iraq,9,22,17,70,6,0,124,12,13,14,69,5,0,113,237
13582,Iraq,2015,2015Iraq,10,20,7,70,5,0,112,15,13,7,80,10,0,125,237
13583,Iraq,2015,2015Iraq,11,200,182,1024,121,0,1538,18,209,205,1209,225,0,1866,3404
13584,Iraq,2015,2015Iraq,12,21,17,50,0,0,100,8,17,14,143,5,0,187,287
13585,Iraq,2015,2015Iraq,12,106,97,929,102,0,1246,7,101,150,834,169,0,1261,2507
13586,Iraq,2015,2015Iraq,14,29,22,142,18,0,225,11,49,29,256,21,0,366,591
13587,Iraq,2015,2015Iraq,14,58,79,245,21,0,417,23,36,76,239,22,0,396,28268
13588,Iraq,2015,2015Iraq,15,18,10,74,11,0,128,17,19,15,158,8,0,217,345
13589,Iraq,2015,2015Iraq,17,28,20,108,7,0,180,13,35,30,275,20,0,373,553
13590,Iraq,2015,2015Iraq,18,10,5,48,0,0,81,0,24,10,102,0,0,136,217
13591,Iraq,2015,2015Iraq,18,41,31,180,24,0,294,17,41,39,177,21,0,295,589
13592,Iraq,2015,2015Iraq,21,43,83,26,0,0,173,25,45,87,61,0,0,218,391
13593,Iraq,2015,2015Iraq,27,43,61,308,71,0,510,33,42,58,319,57,0,509,1019
13594,Iraq,2015,2015Iraq,45,261,299,1406,194,0,2205,61,261,338,1278,204,0,2142,4347
13595,Iraq,2015,2015Iraq,179,234,96,669,22,0,1200,163,264,178,1673,23,0,2301,3501
13596,Iraq,2015,2015Iraq,272,522,322,1742,221,0,3079,342,596,354,2641,222,0,4155,7234
13597,Iraq,2015,2015Iraq,813,1846,1888,4442,595,0,9584,885,1793,1443,3742,806,0,8669,18253
13598,Iraq,2015,2015Iraq,1077,1979,1301,6071,521,0,10949,1136,2223,1575,7783,469,0,13186,24135
13599,Iraq,2015,2015Iraq,1128,2426,1700,9206,1842,0,16302,1253,2648,1858,9736,1459,0,16954,33256
13600,Iraq,2015,2015Iraq,2154,2821,2009,11999,1253,0,20236,2303,3056,2585,22151,1065,0,31160,51396
13601,Iraq,2016,2016Iraq,0,0,0,0,0,0,0,0,0,0,0,0,0,0,80296
13602,Iraq,2016,2016Iraq,0,0,0,0,0,0,0,0,0,0,5,0,0,5,20
13603,Iraq,2016,2016Iraq,0,0,0,0,0,0,0,0,0,0,6,0,0,6,6
13604,Iraq,2016,2016Iraq,0,0,0,0,0,0,0,0,0,0,8,0,0,8,8
13605,Iraq,2016,2016Iraq,0,0,0,0,0,0,0,0,0,0,13,0,0,13,13
13606,Iraq,2016,2016Iraq,0,0,0,0,0,0,0,0,0,5,0,0,0,5,5
13607,Iraq,2016,2016Iraq,0,0,0,0,0,18,18,0,0,0,0,0,69,69,87
13608,Iraq,2016,2016Iraq,0,0,0,0,0,106,106,0,0,0,0,0,174,174,280
13609,Iraq,2016,2016Iraq,0,0,0,0,0,1000,1000,0,0,0,0,0,3000,3000,4000
13610,Iraq,2016,2016Iraq,0,0,0,0,0,2775,2775,0,0,0,0,0,3268,3268,6043
13611,Iraq,2016,2016Iraq,0,0,0,5,0,0,5,0,0,0,0,0,0,0,10
13612,Iraq,2016,2016Iraq,0,0,0,5,0,0,5,0,0,0,16,0,0,16,21
13613,Iraq,2016,2016Iraq,0,0,0,5,0,0,5,0,0,0,34,0,0,34,39
13614,Iraq,2016,2016Iraq,0,0,0,5,0,0,5,0,0,5,12,0,0,17,22
13615,Iraq,2016,2016Iraq,0,0,0,6,0,0,6,0,0,5,5,0,0,10,16
13616,Iraq,2016,2016Iraq,0,0,0,7,0,0,7,0,0,0,19,0,0,19,26
13617,Iraq,2016,2016Iraq,0,0,0,7,0,0,7,0,5,0,18,0,0,23,30
13618,Iraq,2016,2016Iraq,0,0,0,8,0,0,8,0,0,0,0,0,0,0,1353
13619,Iraq,2016,2016Iraq,0,0,0,8,0,0,8,0,0,0,10,0,0,10,18
13620,Iraq,2016,2016Iraq,0,0,5,0,0,0,5,0,0,0,8,0,0,8,13
13621,Iraq,2016,2016Iraq,0,0,5,0,0,0,5,0,0,9,0,0,0,9,14
13622,Iraq,2016,2016Iraq,0,0,5,0,0,0,5,0,5,0,0,0,0,5,10
13623,Iraq,2016,2016Iraq,0,0,6,6,0,0,12,0,0,0,6,0,0,6,18
13624,Iraq,2016,2016Iraq,0,0,9,8,0,0,17,0,0,5,19,0,0,24,41
13625,Iraq,2016,2016Iraq,0,5,0,0,0,0,5,0,0,0,6,0,0,6,11
13626,Iraq,2016,2016Iraq,0,5,0,0,0,0,5,0,9,0,12,0,0,21,26
13627,Iraq,2016,2016Iraq,0,5,0,7,0,0,12,0,0,6,13,0,0,19,31
13628,Iraq,2016,2016Iraq,0,5,0,10,0,0,15,0,8,0,11,0,0,19,34
13629,Iraq,2016,2016Iraq,0,6,0,0,0,0,6,0,0,0,7,0,0,7,13
13630,Iraq,2016,2016Iraq,0,6,10,59,21,0,96,0,8,5,165,23,0,201,2421
13631,Iraq,2016,2016Iraq,0,7,5,61,0,0,73,0,16,15,175,0,0,206,279
13632,Iraq,2016,2016Iraq,0,7,7,98,15,0,127,0,14,13,236,23,7,293,420
13633,Iraq,2016,2016Iraq,5,5,0,0,0,0,10,0,0,8,5,0,0,13,23
13634,Iraq,2016,2016Iraq,5,6,7,43,5,0,66,5,9,5,42,9,0,70,136
13635,Iraq,2016,2016Iraq,5,6,13,27,5,0,56,0,8,10,54,9,0,81,137
13636,Iraq,2016,2016Iraq,6,15,11,47,5,0,84,13,24,12,81,6,0,136,220
13637,Iraq,2016,2016Iraq,6,166,190,1031,132,0,1525,7,169,220,1224,236,0,1856,3381
13638,Iraq,2016,2016Iraq,7,92,106,881,121,0,1207,5,84,158,820,201,0,1268,2475
13639,Iraq,2016,2016Iraq,8,23,18,67,0,0,116,8,25,16,192,6,0,247,363
13640,Iraq,2016,2016Iraq,9,21,8,76,5,0,119,16,10,9,87,10,0,132,251
13641,Iraq,2016,2016Iraq,10,36,32,109,26,0,213,20,49,20,108,5,0,202,420
13642,Iraq,2016,2016Iraq,14,30,21,85,7,0,157,18,19,21,88,6,0,152,309
13643,Iraq,2016,2016Iraq,14,34,26,140,9,0,223,15,39,37,323,32,0,446,669
13644,Iraq,2016,2016Iraq,14,58,79,245,21,0,417,23,36,76,239,22,0,396,28268
13645,Iraq,2016,2016Iraq,17,44,6,81,5,0,153,17,30,17,157,0,0,221,374
13646,Iraq,2016,2016Iraq,22,22,14,93,7,0,158,23,25,15,194,11,0,268,426
13647,Iraq,2016,2016Iraq,26,79,134,118,14,0,371,26,71,141,116,16,0,370,741
13648,Iraq,2016,2016Iraq,27,43,61,307,72,0,510,33,42,58,317,57,0,507,1017
13649,Iraq,2016,2016Iraq,45,16,13,76,5,0,155,46,21,25,220,5,0,317,472
13650,Iraq,2016,2016Iraq,57,213,312,1437,208,0,2227,57,219,351,1283,225,0,2135,4362
13651,Iraq,2016,2016Iraq,77,127,72,335,20,899,1530,57,116,106,681,23,981,1964,3494
13652,Iraq,2016,2016Iraq,207,471,298,1538,200,0,2714,221,534,355,2410,220,0,3740,6454
13653,Iraq,2016,2016Iraq,722,1481,1182,4726,673,0,8784,776,1493,1219,3728,879,0,8095,16879
13654,Iraq,2016,2016Iraq,958,2403,1740,9146,1933,0,16180,1076,2659,1936,9720,1547,0,16938,33118
13655,Iraq,2016,2016Iraq,1212,2622,1649,7751,744,0,13978,1373,2771,2031,9597,648,0,16420,30398
13656,Iraq,2016,2016Iraq,3975,5743,3547,20261,1600,0,35126,4364,6374,4722,34109,1350,0,50919,86045
13657,Iraq,2017,2017Iraq,0,0,0,0,0,0,0,0,0,0,0,0,0,0,80969
13658,Iraq,2017,2017Iraq,0,0,0,0,0,0,0,0,0,0,5,0,0,5,30
13659,Iraq,2017,2017Iraq,0,0,0,0,0,0,0,0,0,0,6,0,0,6,12
13660,Iraq,2017,2017Iraq,0,0,0,0,0,0,0,0,0,0,8,0,0,8,295
13661,Iraq,2017,2017Iraq,0,0,0,0,0,0,0,0,0,0,9,0,0,9,9
13662,Iraq,2017,2017Iraq,0,0,0,0,0,0,0,0,0,0,12,0,0,12,12
13663,Iraq,2017,2017Iraq,0,0,0,0,0,0,0,0,0,0,13,0,0,13,13
13664,Iraq,2017,2017Iraq,0,0,0,0,0,0,0,0,0,0,35,0,0,35,35
13665,Iraq,2017,2017Iraq,0,0,0,0,0,0,0,5,0,0,0,0,0,5,5
13666,Iraq,2017,2017Iraq,0,0,0,0,0,20,20,0,0,0,0,0,71,71,91
13667,Iraq,2017,2017Iraq,0,0,0,0,0,3343,3343,0,0,0,0,0,3922,3922,7265
13668,Iraq,2017,2017Iraq,0,0,0,5,0,0,5,0,0,0,0,0,0,0,5
13669,Iraq,2017,2017Iraq,0,0,0,5,0,0,5,0,0,0,16,0,0,16,21
13670,Iraq,2017,2017Iraq,0,0,0,5,0,0,5,0,0,0,17,0,0,17,22
13671,Iraq,2017,2017Iraq,0,0,0,5,0,0,5,0,0,9,0,0,0,9,14
13672,Iraq,2017,2017Iraq,0,0,0,5,8,0,13,0,0,0,5,14,0,19,32
13673,Iraq,2017,2017Iraq,0,0,0,6,0,0,6,0,0,5,5,0,0,10,16
13674,Iraq,2017,2017Iraq,0,0,0,7,0,0,7,0,0,0,17,0,0,17,24
13675,Iraq,2017,2017Iraq,0,0,0,7,0,0,7,0,0,0,39,0,0,39,46
13676,Iraq,2017,2017Iraq,0,0,0,15,0,0,15,0,5,5,37,0,0,47,62
13677,Iraq,2017,2017Iraq,0,0,5,0,0,0,5,0,0,0,6,0,0,6,11
13678,Iraq,2017,2017Iraq,0,0,5,0,0,0,5,0,5,0,0,0,0,5,10
13679,Iraq,2017,2017Iraq,0,0,5,0,0,0,5,0,5,0,5,0,0,10,15
13680,Iraq,2017,2017Iraq,0,0,5,9,0,0,14,0,0,5,19,0,0,24,38
13681,Iraq,2017,2017Iraq,0,0,8,0,0,0,8,0,0,0,0,0,0,0,513
13682,Iraq,2017,2017Iraq,0,5,0,5,0,0,10,0,5,0,12,0,0,17,27
13683,Iraq,2017,2017Iraq,0,6,0,0,0,0,6,0,0,0,7,0,0,7,13
13684,Iraq,2017,2017Iraq,0,6,0,11,0,0,17,0,8,0,14,0,0,22,39
13685,Iraq,2017,2017Iraq,0,7,29,31,85,0,152,11,19,0,27,92,0,149,301
13686,Iraq,2017,2017Iraq,0,8,9,8,42,0,67,5,8,0,15,42,0,70,137
13687,Iraq,2017,2017Iraq,0,8,13,30,6,0,57,0,9,10,63,11,0,93,150
13688,Iraq,2017,2017Iraq,0,21,0,15,81,0,117,7,14,0,28,80,0,129,246
13689,Iraq,2017,2017Iraq,5,131,191,1036,149,0,1512,5,129,227,1230,248,0,1839,3351
13690,Iraq,2017,2017Iraq,7,13,9,113,16,0,158,5,24,15,256,26,0,326,491
13691,Iraq,2017,2017Iraq,8,21,23,97,12,0,161,8,23,22,106,8,0,167,328
13692,Iraq,2017,2017Iraq,9,16,12,57,5,0,99,5,27,10,191,12,0,245,344
13693,Iraq,2017,2017Iraq,9,20,17,61,5,0,112,14,37,18,116,8,0,193,305
13694,Iraq,2017,2017Iraq,9,27,26,135,8,0,205,12,39,32,307,35,0,425,630
13695,Iraq,2017,2017Iraq,10,23,20,104,17,0,174,8,39,27,188,16,0,278,452
13696,Iraq,2017,2017Iraq,11,72,106,879,140,0,1208,5,70,142,822,212,0,1251,2459
13697,Iraq,2017,2017Iraq,12,61,18,121,5,0,217,21,61,30,231,0,0,343,560
13698,Iraq,2017,2017Iraq,19,30,56,219,29,0,353,17,40,50,206,31,0,344,697
13699,Iraq,2017,2017Iraq,32,49,64,316,73,0,534,35,47,59,328,58,0,527,1061
13700,Iraq,2017,2017Iraq,39,69,31,163,12,0,314,38,66,37,333,18,0,492,806
13701,Iraq,2017,2017Iraq,49,52,94,267,25,0,487,43,45,79,247,27,0,441,28268
13702,Iraq,2017,2017Iraq,71,169,306,1401,191,0,2138,72,220,337,1298,210,0,2137,4275
13703,Iraq,2017,2017Iraq,90,147,77,394,23,1092,1823,85,153,126,817,28,983,2192,4015
13704,Iraq,2017,2017Iraq,137,423,303,1383,184,0,2430,139,495,333,2088,210,0,3265,5695
13705,Iraq,2017,2017Iraq,748,1448,1206,4406,640,0,8448,814,1435,1208,3538,882,0,7877,16325
13706,Iraq,2017,2017Iraq,830,2468,1895,9322,2129,0,16644,919,2736,2063,9998,1677,0,17393,34037
13707,Iraq,2017,2017Iraq,1303,3245,2269,9621,988,0,17426,1434,3425,2516,11639,879,0,19893,37319
13708,Iraq,2017,2017Iraq,5931,8961,5798,30410,2257,0,53357,6379,10076,7967,50977,1884,0,77283,130640
13709,Iraq,2018,2018Iraq,0,0,0,0,0,0,0,0,0,0,0,0,0,0,81350
13710,Iraq,2018,2018Iraq,0,0,0,0,0,0,0,0,0,0,5,0,0,5,25
13711,Iraq,2018,2018Iraq,0,0,0,0,0,0,0,0,0,0,6,0,0,6,6
13712,Iraq,2018,2018Iraq,0,0,0,0,0,0,0,0,0,0,9,0,0,9,9
13713,Iraq,2018,2018Iraq,0,0,0,0,0,0,0,0,0,0,13,0,0,13,13
13714,Iraq,2018,2018Iraq,0,0,0,0,0,0,0,0,0,0,22,0,0,22,22
13715,Iraq,2018,2018Iraq,0,0,0,0,0,0,0,0,5,0,0,0,0,5,10
13716,Iraq,2018,2018Iraq,0,0,0,0,0,0,0,5,0,0,0,0,0,5,5
13717,Iraq,2018,2018Iraq,0,0,0,0,0,3790,3790,0,0,0,0,0,4341,4341,8131
13718,Iraq,2018,2018Iraq,0,0,0,5,0,0,5,0,0,0,0,0,0,0,5
13719,Iraq,2018,2018Iraq,0,0,0,5,0,0,5,0,0,0,9,0,0,9,14
13720,Iraq,2018,2018Iraq,0,0,0,5,0,0,5,0,0,0,17,0,0,17,22
13721,Iraq,2018,2018Iraq,0,0,0,7,0,0,7,0,0,0,15,0,0,15,22
13722,Iraq,2018,2018Iraq,0,0,0,8,0,0,8,0,0,0,10,0,0,10,18
13723,Iraq,2018,2018Iraq,0,0,0,9,0,0,9,0,5,0,7,0,0,12,21
13724,Iraq,2018,2018Iraq,0,0,0,10,0,0,10,0,0,0,42,0,0,42,52
13725,Iraq,2018,2018Iraq,0,0,0,10,0,0,10,0,0,5,9,0,0,14,24
13726,Iraq,2018,2018Iraq,0,0,5,0,0,0,5,0,0,0,6,0,0,6,11
13727,Iraq,2018,2018Iraq,0,0,5,0,0,0,5,0,5,0,0,0,0,5,10
13728,Iraq,2018,2018Iraq,0,0,5,11,0,0,16,0,0,5,15,0,0,20,36
13729,Iraq,2018,2018Iraq,0,0,7,6,0,0,13,0,6,0,0,0,0,6,19
13730,Iraq,2018,2018Iraq,0,5,0,5,0,0,10,0,0,5,11,0,0,16,61
13731,Iraq,2018,2018Iraq,0,5,0,5,0,0,10,0,5,0,12,0,0,17,27
13732,Iraq,2018,2018Iraq,0,6,0,0,0,0,6,0,0,0,7,0,0,7,13
13733,Iraq,2018,2018Iraq,0,6,0,10,0,0,16,0,8,0,13,0,0,21,42
13734,Iraq,2018,2018Iraq,0,7,0,15,0,0,22,6,11,7,51,0,0,75,97
13735,Iraq,2018,2018Iraq,0,7,10,31,7,0,55,0,5,13,68,12,0,98,153
13736,Iraq,2018,2018Iraq,0,8,9,41,10,0,68,0,11,5,42,12,0,70,138
13737,Iraq,2018,2018Iraq,0,108,174,1063,158,0,1503,0,86,240,1227,274,0,1827,3330
13738,Iraq,2018,2018Iraq,5,17,10,79,7,0,118,8,15,10,86,16,0,135,253
13739,Iraq,2018,2018Iraq,5,23,23,106,12,0,169,6,23,25,118,10,0,182,351
13740,Iraq,2018,2018Iraq,5,25,24,86,11,0,151,6,20,16,96,9,0,147,298
13741,Iraq,2018,2018Iraq,6,14,12,49,5,0,86,9,32,16,98,7,0,162,248
13742,Iraq,2018,2018Iraq,6,18,12,73,13,0,122,6,24,17,137,9,0,193,342
13743,Iraq,2018,2018Iraq,6,20,23,124,8,0,181,5,34,26,281,33,0,379,560
13744,Iraq,2018,2018Iraq,7,13,8,47,5,0,80,6,21,7,151,12,0,197,277
13745,Iraq,2018,2018Iraq,11,23,17,111,18,0,180,6,31,30,192,19,0,278,458
13746,Iraq,2018,2018Iraq,11,49,89,717,119,0,985,5,47,107,660,190,0,1009,1994
13747,Iraq,2018,2018Iraq,20,59,26,123,6,0,234,19,69,33,225,7,0,353,587
13748,Iraq,2018,2018Iraq,23,59,47,230,34,0,393,21,62,47,220,35,0,385,778
13749,Iraq,2018,2018Iraq,32,52,64,324,72,0,544,37,47,60,338,57,0,539,1083
13750,Iraq,2018,2018Iraq,39,83,50,201,20,0,393,51,75,50,379,20,0,575,968
13751,Iraq,2018,2018Iraq,44,47,85,220,29,0,425,43,43,69,243,27,0,425,28268
13752,Iraq,2018,2018Iraq,73,184,283,1428,195,0,2163,57,236,296,1373,221,0,2183,4346
13753,Iraq,2018,2018Iraq,102,353,279,1056,144,0,1934,76,408,305,1573,162,0,2524,4458
13754,Iraq,2018,2018Iraq,107,248,155,828,157,0,1495,104,254,166,889,117,0,1530,3025
13755,Iraq,2018,2018Iraq,109,189,90,481,24,1007,1900,116,194,146,958,28,1134,2576,4476
13756,Iraq,2018,2018Iraq,569,2350,2033,9621,2311,0,16884,624,2654,2157,10473,1834,0,17742,34626
13757,Iraq,2018,2018Iraq,692,1378,1146,4225,634,0,8075,729,1412,1099,3512,872,0,7624,15699
13758,Iraq,2018,2018Iraq,1228,3325,2441,10339,1076,0,18409,1267,3566,2674,12212,960,0,20679,39088
13759,Iraq,2018,2018Iraq,5400,9889,6568,32328,2415,0,56600,5606,10999,8172,53058,2028,0,79863,136463
13760,Iraq,2019,2019Iraq,0,0,0,0,0,0,0,0,0,0,0,0,0,0,113708
13761,Iraq,2019,2019Iraq,0,0,0,0,0,0,0,0,0,0,5,0,0,5,10
13762,Iraq,2019,2019Iraq,0,0,0,0,0,0,0,0,0,0,6,0,0,6,12
13763,Iraq,2019,2019Iraq,0,0,0,0,0,0,0,0,0,0,8,0,0,8,8
13764,Iraq,2019,2019Iraq,0,0,0,0,0,0,0,0,0,0,9,0,0,9,9
13765,Iraq,2019,2019Iraq,0,0,0,0,0,0,0,0,0,0,12,0,0,12,12
13766,Iraq,2019,2019Iraq,0,0,0,0,0,0,0,0,0,0,22,0,0,22,22
13767,Iraq,2019,2019Iraq,0,0,0,0,0,0,0,0,0,0,35,0,0,35,35
13768,Iraq,2019,2019Iraq,0,0,0,0,0,0,0,0,0,7,8,0,0,15,15
13769,Iraq,2019,2019Iraq,0,0,0,0,0,0,0,0,5,0,0,0,0,5,10
13770,Iraq,2019,2019Iraq,0,0,0,0,0,20,20,0,0,0,0,0,60,60,80
13771,Iraq,2019,2019Iraq,0,0,0,0,0,4158,4158,0,0,0,0,0,4671,4671,8829
13772,Iraq,2019,2019Iraq,0,0,0,5,0,0,5,0,0,0,17,0,0,17,22
13773,Iraq,2019,2019Iraq,0,0,0,5,0,0,5,0,0,5,10,0,0,15,20
13774,Iraq,2019,2019Iraq,0,0,0,6,0,0,6,0,0,5,28,0,0,33,39
13775,Iraq,2019,2019Iraq,0,0,0,7,0,0,7,0,0,0,14,0,0,14,21
13776,Iraq,2019,2019Iraq,0,0,0,8,0,0,8,0,0,0,10,0,0,10,18
13777,Iraq,2019,2019Iraq,0,0,0,8,0,0,8,0,5,0,25,5,0,35,43
13778,Iraq,2019,2019Iraq,0,0,0,9,0,0,9,0,5,0,7,0,0,12,21
13779,Iraq,2019,2019Iraq,0,0,0,10,0,0,10,0,0,5,9,0,0,14,24
13780,Iraq,2019,2019Iraq,0,0,5,0,0,0,5,0,0,0,0,0,0,0,5
13781,Iraq,2019,2019Iraq,0,0,5,0,0,0,5,0,0,0,6,0,0,6,11
13782,Iraq,2019,2019Iraq,0,0,5,0,0,0,5,0,0,5,0,0,0,5,10
13783,Iraq,2019,2019Iraq,0,0,5,9,0,0,14,0,0,5,12,0,0,17,31
13784,Iraq,2019,2019Iraq,0,0,8,6,0,0,14,0,6,0,0,0,0,6,20
13785,Iraq,2019,2019Iraq,0,0,13,27,7,0,47,0,0,13,60,17,0,90,137
13786,Iraq,2019,2019Iraq,0,5,0,0,0,0,5,0,0,0,7,0,0,7,12
13787,Iraq,2019,2019Iraq,0,5,5,15,0,0,25,5,12,6,58,0,0,81,106
13788,Iraq,2019,2019Iraq,0,6,8,42,13,0,69,0,9,7,42,14,0,72,141
13789,Iraq,2019,2019Iraq,0,9,5,34,0,0,48,5,6,10,96,7,0,124,172
13790,Iraq,2019,2019Iraq,0,14,14,78,7,0,113,7,15,9,82,16,0,129,242
13791,Iraq,2019,2019Iraq,0,25,26,87,10,0,148,0,25,17,96,9,0,147,295
13792,Iraq,2019,2019Iraq,0,75,187,1062,173,0,1497,5,57,235,1238,289,0,1824,3321
13793,Iraq,2019,2019Iraq,5,7,6,42,0,0,60,5,22,13,72,5,0,117,177
13794,Iraq,2019,2019Iraq,5,18,18,117,11,0,169,0,28,25,271,34,0,358,527
13795,Iraq,2019,2019Iraq,5,20,11,78,17,0,131,5,21,25,161,10,0,222,398
13796,Iraq,2019,2019Iraq,6,21,21,112,12,0,172,0,23,24,114,10,0,171,343
13797,Iraq,2019,2019Iraq,7,21,34,300,52,0,414,0,10,34,285,67,0,396,810
13798,Iraq,2019,2019Iraq,10,22,20,109,16,0,177,10,27,29,173,19,0,258,435
13799,Iraq,2019,2019Iraq,11,49,51,243,41,0,395,12,54,46,232,44,0,388,783
13800,Iraq,2019,2019Iraq,14,58,32,113,5,0,222,16,63,45,200,7,0,331,553
13801,Iraq,2019,2019Iraq,23,70,44,194,20,0,351,39,77,46,349,19,0,530,881
13802,Iraq,2019,2019Iraq,33,53,64,325,72,0,547,38,47,61,337,57,0,540,1087
13803,Iraq,2019,2019Iraq,73,188,266,1469,218,0,2214,58,205,296,1418,235,0,2212,4426
13804,Iraq,2019,2019Iraq,75,356,271,1098,155,12,1967,62,392,316,1639,159,16,2584,4551
13805,Iraq,2019,2019Iraq,108,194,113,505,29,0,949,100,223,149,980,30,0,1482,4545
13806,Iraq,2019,2019Iraq,469,2235,2057,9653,2373,0,16787,512,2543,2204,10395,1895,0,17549,34336
13807,Iraq,2019,2019Iraq,592,1182,990,3510,521,0,6795,599,1213,958,2980,766,0,6516,13311
13808,Iraq,2019,2019Iraq,5052,10922,7208,33829,2556,0,59567,5465,12041,8511,53943,2123,0,82083,141650
13809,Iraq,2020,2020Iraq,0,0,0,0,0,0,0,0,0,0,0,0,0,0,109775
13810,Iraq,2020,2020Iraq,0,0,0,0,0,0,0,0,0,0,5,0,0,5,15
13811,Iraq,2020,2020Iraq,0,0,0,0,0,0,0,0,0,0,6,0,0,6,12
13812,Iraq,2020,2020Iraq,0,0,0,0,0,0,0,0,0,0,7,0,0,7,7
13813,Iraq,2020,2020Iraq,0,0,0,0,0,0,0,0,0,0,9,0,0,9,9
13814,Iraq,2020,2020Iraq,0,0,0,0,0,0,0,0,0,0,12,0,0,12,12
13815,Iraq,2020,2020Iraq,0,0,0,0,0,0,0,0,0,0,22,0,0,22,22
13816,Iraq,2020,2020Iraq,0,0,0,0,0,0,0,0,0,0,32,0,0,32,32
13817,Iraq,2020,2020Iraq,0,0,0,0,0,0,0,0,0,12,7,0,0,19,19
13818,Iraq,2020,2020Iraq,0,0,0,0,0,0,0,0,5,0,0,0,0,5,5
13819,Iraq,2020,2020Iraq,0,0,0,0,0,6,6,0,0,0,0,0,22,22,28
13820,Iraq,2020,2020Iraq,0,0,0,0,0,20,20,0,0,0,0,0,59,59,79
13821,Iraq,2020,2020Iraq,0,0,0,0,0,216,216,0,0,0,0,0,419,419,635
13822,Iraq,2020,2020Iraq,0,0,0,0,0,303,303,0,0,0,0,0,470,470,773
13823,Iraq,2020,2020Iraq,0,0,0,0,0,1713,1713,0,0,0,0,0,3802,3802,5515
13824,Iraq,2020,2020Iraq,0,0,0,5,0,0,5,0,0,0,0,0,0,0,5
13825,Iraq,2020,2020Iraq,0,0,0,5,0,0,5,0,0,0,5,0,0,5,10
13826,Iraq,2020,2020Iraq,0,0,0,5,0,0,5,0,0,0,9,0,0,9,14
13827,Iraq,2020,2020Iraq,0,0,0,5,0,0,5,0,0,0,12,0,0,12,17
13828,Iraq,2020,2020Iraq,0,0,0,5,0,0,5,0,0,0,12,5,0,17,22
13829,Iraq,2020,2020Iraq,0,0,0,8,0,0,8,0,0,0,10,0,0,10,18
13830,Iraq,2020,2020Iraq,0,0,0,8,0,0,8,0,0,5,43,0,0,48,56
13831,Iraq,2020,2020Iraq,0,0,0,10,0,0,10,0,0,0,10,5,0,15,25
13832,Iraq,2020,2020Iraq,0,0,0,15,0,9,24,0,0,0,16,0,30,46,70
13833,Iraq,2020,2020Iraq,0,0,5,0,0,0,5,0,0,0,7,0,0,7,24
13834,Iraq,2020,2020Iraq,0,0,5,0,0,0,5,0,0,5,0,0,0,5,10
13835,Iraq,2020,2020Iraq,0,0,5,0,0,0,5,0,0,5,7,0,0,12,17
13836,Iraq,2020,2020Iraq,0,0,5,5,0,0,10,0,5,0,21,0,0,26,36
13837,Iraq,2020,2020Iraq,0,0,5,9,0,0,14,0,0,5,29,0,0,34,48
13838,Iraq,2020,2020Iraq,0,0,5,10,0,0,15,0,0,5,12,0,0,17,32
13839,Iraq,2020,2020Iraq,0,0,8,6,0,0,14,0,6,0,0,0,0,6,20
13840,Iraq,2020,2020Iraq,0,5,6,30,5,0,46,0,0,8,58,19,0,85,131
13841,Iraq,2020,2020Iraq,0,6,5,16,0,0,27,6,14,6,60,0,0,86,113
13842,Iraq,2020,2020Iraq,0,6,8,42,13,0,69,0,9,7,42,14,0,72,141
13843,Iraq,2020,2020Iraq,0,8,5,33,0,0,46,5,5,7,84,6,0,107,153
13844,Iraq,2020,2020Iraq,0,9,7,36,5,0,57,0,17,15,73,6,0,111,168
13845,Iraq,2020,2020Iraq,0,14,14,78,7,0,113,7,15,9,82,16,0,129,242
13846,Iraq,2020,2020Iraq,0,18,15,94,9,0,136,0,20,17,200,33,0,270,406
13847,Iraq,2020,2020Iraq,0,25,26,87,10,0,148,0,25,17,96,9,0,147,295
13848,Iraq,2020,2020Iraq,0,40,198,1065,194,0,1497,0,40,220,1236,328,0,1824,3321
13849,Iraq,2020,2020Iraq,6,18,27,235,37,0,323,0,12,11,203,58,0,284,607
13850,Iraq,2020,2020Iraq,6,20,15,82,19,0,142,11,17,28,170,12,0,238,425
13851,Iraq,2020,2020Iraq,8,19,23,117,13,0,180,0,20,24,114,13,0,171,351
13852,Iraq,2020,2020Iraq,9,17,21,106,13,0,166,10,21,31,165,18,0,245,411
13853,Iraq,2020,2020Iraq,9,54,33,104,6,0,206,16,56,29,202,6,0,309,515
13854,Iraq,2020,2020Iraq,10,47,50,250,49,0,406,10,57,44,242,50,0,403,809
13855,Iraq,2020,2020Iraq,15,29,23,130,22,0,219,24,44,30,256,21,0,375,594
13856,Iraq,2020,2020Iraq,33,53,64,325,71,0,546,38,47,62,337,56,0,540,1086
13857,Iraq,2020,2020Iraq,49,312,262,983,152,0,1758,45,311,320,1457,158,0,2291,4049
13858,Iraq,2020,2020Iraq,57,188,276,1555,247,0,2323,50,215,303,1497,272,0,2337,4660
13859,Iraq,2020,2020Iraq,96,211,129,522,31,0,989,101,222,165,1008,37,0,1533,4635
13860,Iraq,2020,2020Iraq,336,2051,2118,9807,2470,0,16782,373,2334,2264,10577,1988,0,17536,34318
13861,Iraq,2020,2020Iraq,466,1069,960,3317,515,0,6327,487,1062,916,2824,783,0,6072,12399
13862,Iraq,2020,2020Iraq,5184,11261,7783,35112,2742,0,62082,5530,12284,8851,54973,2210,0,83848,146009
13863,Iraq,2021,2021Iraq,0,0,0,0,0,0,0,0,0,0,0,0,0,0,127714
13864,Iraq,2021,2021Iraq,0,0,0,0,0,0,0,0,0,0,5,0,0,5,10
13865,Iraq,2021,2021Iraq,0,0,0,0,0,0,0,0,0,0,6,0,0,6,6
13866,Iraq,2021,2021Iraq,0,0,0,0,0,0,0,0,0,0,8,0,0,8,8
13867,Iraq,2021,2021Iraq,0,0,0,0,0,0,0,0,0,0,9,0,0,9,9
13868,Iraq,2021,2021Iraq,0,0,0,0,0,0,0,0,0,0,21,0,0,21,21
13869,Iraq,2021,2021Iraq,0,0,0,0,0,0,0,0,0,0,32,0,0,32,32
13870,Iraq,2021,2021Iraq,0,0,0,0,0,0,0,0,0,12,7,0,0,19,19
13871,Iraq,2021,2021Iraq,0,0,0,0,0,0,0,0,5,0,0,0,0,5,5
13872,Iraq,2021,2021Iraq,0,0,0,0,0,19,19,0,0,0,0,0,55,55,74
13873,Iraq,2021,2021Iraq,0,0,0,0,0,46,46,0,0,0,0,0,43,43,89
13874,Iraq,2021,2021Iraq,0,0,0,5,0,0,5,0,0,0,0,0,0,0,5
13875,Iraq,2021,2021Iraq,0,0,0,5,0,0,5,0,0,0,5,0,0,5,10
13876,Iraq,2021,2021Iraq,0,0,0,5,0,0,5,0,0,0,6,0,0,6,11
13877,Iraq,2021,2021Iraq,0,0,0,5,0,0,5,0,0,0,9,0,0,9,14
13878,Iraq,2021,2021Iraq,0,0,0,5,0,0,5,0,0,0,12,0,0,12,17
13879,Iraq,2021,2021Iraq,0,0,0,5,0,0,5,0,0,0,17,0,0,17,22
13880,Iraq,2021,2021Iraq,0,0,0,8,0,0,8,0,0,0,10,0,0,10,18
13881,Iraq,2021,2021Iraq,0,0,0,8,0,0,8,0,0,0,42,5,0,47,55
13882,Iraq,2021,2021Iraq,0,0,0,9,0,0,9,0,5,0,30,0,0,35,44
13883,Iraq,2021,2021Iraq,0,0,0,10,0,0,10,0,0,0,9,5,0,14,24
13884,Iraq,2021,2021Iraq,0,0,5,0,0,0,5,0,0,0,0,0,0,0,5
13885,Iraq,2021,2021Iraq,0,0,5,0,0,0,5,0,0,0,7,0,0,7,12
13886,Iraq,2021,2021Iraq,0,0,5,0,0,0,5,0,0,0,8,0,0,8,13
13887,Iraq,2021,2021Iraq,0,0,5,0,0,0,5,0,0,0,11,0,0,11,16
13888,Iraq,2021,2021Iraq,0,0,5,0,0,0,5,0,0,5,0,0,0,5,10
13889,Iraq,2021,2021Iraq,0,0,5,7,0,0,12,0,5,0,33,5,0,43,55
13890,Iraq,2021,2021Iraq,0,0,5,8,0,0,13,0,0,5,24,0,0,29,42
13891,Iraq,2021,2021Iraq,0,0,5,10,0,0,15,0,0,0,17,0,0,17,32
13892,Iraq,2021,2021Iraq,0,0,7,7,0,0,14,0,0,7,0,0,0,7,21
13893,Iraq,2021,2021Iraq,0,0,9,31,6,0,46,0,0,6,56,19,0,81,127
13894,Iraq,2021,2021Iraq,0,5,5,15,0,5,30,5,14,6,59,0,5,89,119
13895,Iraq,2021,2021Iraq,0,5,7,41,14,0,67,7,6,6,50,0,0,69,136
13896,Iraq,2021,2021Iraq,0,6,7,33,5,0,51,0,12,16,72,6,0,106,157
13897,Iraq,2021,2021Iraq,0,7,7,29,5,0,48,0,6,8,80,8,0,102,150
13898,Iraq,2021,2021Iraq,0,14,14,78,7,0,113,7,15,9,82,16,0,129,242
13899,Iraq,2021,2021Iraq,0,15,23,95,7,0,140,0,20,14,98,10,0,142,282
13900,Iraq,2021,2021Iraq,0,16,12,138,24,0,190,0,5,7,96,35,0,143,333
13901,Iraq,2021,2021Iraq,0,19,15,96,9,0,139,0,17,18,192,35,0,262,401
13902,Iraq,2021,2021Iraq,0,23,171,1016,215,0,1425,0,25,191,1186,336,0,1738,3163
13903,Iraq,2021,2021Iraq,5,17,19,74,17,0,132,6,17,29,167,12,0,231,398
13904,Iraq,2021,2021Iraq,5,44,51,252,55,0,407,7,44,53,235,54,0,393,800
13905,Iraq,2021,2021Iraq,6,22,22,108,16,0,174,10,17,30,172,17,0,246,420
13906,Iraq,2021,2021Iraq,7,17,26,107,14,0,171,0,15,22,111,15,0,163,334
13907,Iraq,2021,2021Iraq,12,28,40,99,6,0,185,13,40,41,180,7,0,281,466
13908,Iraq,2021,2021Iraq,16,31,22,104,19,0,192,19,42,29,224,23,0,337,529
13909,Iraq,2021,2021Iraq,33,53,64,325,71,6,552,38,47,61,337,55,5,543,1095
13910,Iraq,2021,2021Iraq,36,190,275,1541,273,0,2315,37,189,292,1515,281,0,2314,4629
13911,Iraq,2021,2021Iraq,44,265,246,936,144,0,1635,54,259,295,1358,149,0,2115,3750
13912,Iraq,2021,2021Iraq,72,207,134,495,35,0,943,81,203,167,910,43,0,1404,4488
13913,Iraq,2021,2021Iraq,331,1830,2147,9825,2589,0,16722,370,2023,2363,10638,2088,0,17482,34204
13914,Iraq,2021,2021Iraq,413,955,897,3057,459,0,5781,445,945,853,2670,670,30,5613,11394
13915,Iraq,2021,2021Iraq,4913,11225,8133,36094,2914,0,63279,5177,12221,9131,55727,2304,0,84560,147869
13916,Kazakhstan,2001,2001Kazakhstan,0,0,0,0,0,0,0,0,0,0,0,0,0,0,2720
13917,Kazakhstan,2001,2001Kazakhstan,0,0,0,0,0,29,29,0,0,0,0,0,37,37,66
13918,Kazakhstan,2001,2001Kazakhstan,0,0,0,7,0,0,7,0,0,0,5,5,0,10,17
13919,Kazakhstan,2002,2002Kazakhstan,0,0,0,0,0,0,0,0,0,0,0,0,0,0,6198
13920,Kazakhstan,2002,2002Kazakhstan,0,0,0,0,0,49,49,0,0,0,0,0,53,53,102
13921,Kazakhstan,2002,2002Kazakhstan,0,0,0,7,0,0,7,0,0,0,5,5,0,10,17
13922,Kazakhstan,2003,2003Kazakhstan,0,0,0,0,0,0,0,0,0,0,0,0,0,0,6404
13923,Kazakhstan,2003,2003Kazakhstan,0,0,0,0,0,5,5,0,0,0,0,0,0,0,5
13924,Kazakhstan,2003,2003Kazakhstan,0,0,0,0,0,66,66,0,0,0,0,0,66,66,132
13925,Kazakhstan,2003,2003Kazakhstan,0,0,0,5,0,0,5,0,0,0,0,0,0,0,5
13926,Kazakhstan,2003,2003Kazakhstan,0,0,0,7,0,0,7,0,0,0,5,5,0,10,17
13927,Kazakhstan,2004,2004Kazakhstan,0,0,0,0,0,0,0,0,0,0,0,0,0,0,6016
13928,Kazakhstan,2004,2004Kazakhstan,0,0,0,0,0,5,5,0,0,0,0,0,5,5,10
13929,Kazakhstan,2004,2004Kazakhstan,0,0,0,5,0,0,5,0,0,0,0,0,0,0,5
13930,Kazakhstan,2004,2004Kazakhstan,0,0,0,5,0,0,5,0,5,0,78,0,0,83,88
13931,Kazakhstan,2004,2004Kazakhstan,0,0,5,0,0,0,5,0,0,0,0,0,0,0,5
13932,Kazakhstan,2005,2005Kazakhstan,0,0,0,0,0,0,0,0,0,0,0,0,0,0,3928
13933,Kazakhstan,2005,2005Kazakhstan,0,0,0,0,0,152,152,0,0,0,0,0,121,121,273
13934,Kazakhstan,2005,2005Kazakhstan,0,0,0,5,0,0,5,0,0,0,0,0,0,0,5
13935,Kazakhstan,2005,2005Kazakhstan,0,0,0,8,0,0,8,6,0,0,0,0,0,6,14
13936,Kazakhstan,2005,2005Kazakhstan,0,0,5,0,0,0,5,0,0,0,0,0,0,0,5
13937,Kazakhstan,2005,2005Kazakhstan,7,0,0,0,0,0,7,0,0,0,89,0,0,89,96
13938,Kazakhstan,2006,2006Kazakhstan,0,0,0,0,0,0,0,0,0,0,0,0,0,0,6922
13939,Kazakhstan,2006,2006Kazakhstan,0,0,0,0,0,0,0,0,0,0,0,0,8,8,8
13940,Kazakhstan,2006,2006Kazakhstan,0,0,0,0,0,13,13,0,0,0,0,0,8,8,21
13941,Kazakhstan,2006,2006Kazakhstan,0,0,0,0,0,24,24,0,0,0,0,0,13,13,37
13942,Kazakhstan,2006,2006Kazakhstan,0,0,0,0,0,164,164,0,0,0,0,0,126,126,290
13943,Kazakhstan,2006,2006Kazakhstan,0,0,0,8,0,0,8,0,0,5,83,0,0,88,96
13944,Kazakhstan,2007,2007Kazakhstan,0,0,0,0,0,0,0,0,0,0,0,0,0,0,4771
13945,Kazakhstan,2007,2007Kazakhstan,0,0,0,0,0,0,0,0,0,0,0,0,5,5,5
13946,Kazakhstan,2007,2007Kazakhstan,0,0,0,0,0,16,16,0,0,0,0,0,10,10,26
13947,Kazakhstan,2007,2007Kazakhstan,0,0,0,0,0,176,176,0,0,0,0,0,134,134,310
13948,Kazakhstan,2007,2007Kazakhstan,0,0,0,8,0,0,8,0,0,5,86,0,0,91,99
13949,Kazakhstan,2007,2007Kazakhstan,0,0,5,8,0,0,13,0,0,8,0,0,0,8,21
13950,Kazakhstan,2008,2008Kazakhstan,0,0,0,0,0,0,0,0,0,0,0,0,0,0,4460
13951,Kazakhstan,2008,2008Kazakhstan,0,0,0,0,0,0,0,0,0,0,5,0,0,5,5
13952,Kazakhstan,2008,2008Kazakhstan,0,0,0,0,0,11,11,0,0,0,0,0,7,7,18
13953,Kazakhstan,2008,2008Kazakhstan,0,0,0,0,0,184,184,0,0,0,0,0,138,138,322
13954,Kazakhstan,2008,2008Kazakhstan,0,0,0,8,0,5,13,0,0,0,7,0,0,7,20
13955,Kazakhstan,2009,2009Kazakhstan,0,0,0,0,0,0,0,0,0,0,0,0,0,0,2039
13956,Kazakhstan,2009,2009Kazakhstan,0,0,0,0,0,0,0,0,0,0,7,0,0,7,7
13957,Kazakhstan,2009,2009Kazakhstan,0,0,0,0,0,6,6,0,0,0,0,0,7,7,13
13958,Kazakhstan,2009,2009Kazakhstan,0,0,0,6,0,5,11,0,6,0,0,0,0,6,17
13959,Kazakhstan,2009,2009Kazakhstan,10,47,65,597,208,0,927,11,45,64,554,64,0,738,1665
13960,Kazakhstan,2010,2010Kazakhstan,0,0,0,0,0,0,0,0,0,0,0,0,0,0,1556
13961,Kazakhstan,2010,2010Kazakhstan,0,0,0,0,0,5,5,0,0,0,0,0,6,6,11
13962,Kazakhstan,2010,2010Kazakhstan,0,0,0,0,0,6,6,0,0,0,0,0,7,7,13
13963,Kazakhstan,2010,2010Kazakhstan,0,0,0,0,0,206,206,0,0,0,0,0,156,156,362
13964,Kazakhstan,2010,2010Kazakhstan,0,0,0,9,0,0,9,0,5,0,0,0,0,5,14
13965,Kazakhstan,2010,2010Kazakhstan,5,50,56,596,223,0,930,10,45,65,558,67,0,745,1675
13966,Kazakhstan,2011,2011Kazakhstan,0,0,0,0,0,0,0,0,0,0,0,0,0,0,1245
13967,Kazakhstan,2011,2011Kazakhstan,0,0,0,0,0,7,7,0,0,0,0,0,7,7,14
13968,Kazakhstan,2011,2011Kazakhstan,0,0,0,0,0,218,218,0,0,0,0,0,164,164,382
13969,Kazakhstan,2011,2011Kazakhstan,0,0,0,5,0,0,5,0,0,0,0,0,0,0,5
13970,Kazakhstan,2011,2011Kazakhstan,0,0,0,5,8,0,13,0,0,0,6,5,0,11,189
13971,Kazakhstan,2011,2011Kazakhstan,0,0,0,9,0,0,9,0,5,0,0,0,0,5,14
13972,Kazakhstan,2011,2011Kazakhstan,0,0,5,7,0,0,12,0,0,5,5,0,0,10,22
13973,Kazakhstan,2011,2011Kazakhstan,5,41,49,581,223,0,899,5,42,58,542,80,0,727,1626
13974,Kazakhstan,2012,2012Kazakhstan,0,0,0,0,0,0,0,0,0,0,0,0,0,0,1107
13975,Kazakhstan,2012,2012Kazakhstan,0,0,0,0,0,0,0,0,0,0,0,0,8,8,8
13976,Kazakhstan,2012,2012Kazakhstan,0,0,0,0,0,8,8,0,0,0,0,0,9,9,17
13977,Kazakhstan,2012,2012Kazakhstan,0,0,0,0,0,100,100,0,0,0,0,0,93,93,193
13978,Kazakhstan,2012,2012Kazakhstan,0,0,0,0,0,230,230,0,0,0,0,0,181,181,411
13979,Kazakhstan,2012,2012Kazakhstan,0,0,0,5,0,0,5,0,0,0,0,0,0,0,5
13980,Kazakhstan,2012,2012Kazakhstan,0,0,0,5,0,0,5,0,0,0,5,0,0,5,149
13981,Kazakhstan,2012,2012Kazakhstan,0,0,0,7,0,0,7,0,0,0,0,0,5,5,12
13982,Kazakhstan,2012,2012Kazakhstan,0,0,5,7,0,0,12,0,0,5,5,0,0,10,22
13983,Kazakhstan,2012,2012Kazakhstan,0,7,0,0,0,0,7,0,9,0,0,0,0,9,16
13984,Kazakhstan,2012,2012Kazakhstan,5,39,44,568,255,0,911,5,37,48,529,97,0,716,1627
13985,Kazakhstan,2013,2013Kazakhstan,0,0,0,0,0,0,0,0,0,0,0,0,0,0,1298
13986,Kazakhstan,2013,2013Kazakhstan,0,0,0,0,0,13,13,0,0,0,0,0,14,14,33
13987,Kazakhstan,2013,2013Kazakhstan,0,0,0,0,0,250,250,0,0,0,0,0,194,194,444
13988,Kazakhstan,2013,2013Kazakhstan,0,0,0,5,0,5,10,0,0,0,6,0,0,6,16
13989,Kazakhstan,2013,2013Kazakhstan,0,0,0,6,5,0,11,0,0,0,6,0,0,6,149
13990,Kazakhstan,2013,2013Kazakhstan,0,0,0,8,0,0,8,0,9,0,0,0,0,9,17
13991,Kazakhstan,2013,2013Kazakhstan,0,0,0,8,5,0,13,0,0,0,9,0,0,9,22
13992,Kazakhstan,2013,2013Kazakhstan,0,0,0,20,0,0,20,0,0,5,21,0,0,26,46
13993,Kazakhstan,2013,2013Kazakhstan,0,0,8,22,21,0,51,0,5,10,18,0,0,33,84
13994,Kazakhstan,2013,2013Kazakhstan,0,5,0,0,0,0,5,0,0,0,0,0,0,0,5
13995,Kazakhstan,2014,2014Kazakhstan,0,0,0,0,0,0,0,0,0,0,0,0,0,0,1462
13996,Kazakhstan,2014,2014Kazakhstan,0,0,0,0,0,8,8,0,0,0,6,0,0,6,14
13997,Kazakhstan,2014,2014Kazakhstan,0,0,0,0,0,264,264,0,0,0,0,0,211,211,475
13998,Kazakhstan,2014,2014Kazakhstan,0,0,0,7,0,0,7,0,5,0,5,0,0,10,17
13999,Kazakhstan,2014,2014Kazakhstan,0,0,0,8,5,0,13,0,0,0,9,0,0,9,22
14000,Kazakhstan,2014,2014Kazakhstan,0,0,0,9,0,0,9,0,7,0,7,0,0,14,135
14001,Kazakhstan,2014,2014Kazakhstan,0,5,0,0,0,0,5,0,0,0,0,0,0,0,5
14002,Kazakhstan,2014,2014Kazakhstan,5,0,6,20,20,0,51,5,0,13,15,5,0,38,89
14003,Kazakhstan,2015,2015Kazakhstan,0,0,0,0,0,0,0,0,0,0,0,0,0,0,1540
14004,Kazakhstan,2015,2015Kazakhstan,0,0,0,0,0,0,0,0,0,0,0,0,10,10,10
14005,Kazakhstan,2015,2015Kazakhstan,0,0,0,0,0,0,0,0,0,5,0,0,0,5,5
14006,Kazakhstan,2015,2015Kazakhstan,0,0,0,0,0,21,21,0,0,0,0,0,20,20,41
14007,Kazakhstan,2015,2015Kazakhstan,0,0,0,0,0,278,278,0,0,0,0,0,221,221,499
14008,Kazakhstan,2015,2015Kazakhstan,0,0,0,0,7,0,7,0,0,0,0,0,5,5,12
14009,Kazakhstan,2015,2015Kazakhstan,0,0,0,5,0,0,5,0,0,0,9,0,0,9,14
14010,Kazakhstan,2015,2015Kazakhstan,0,0,0,9,0,0,9,0,0,0,9,0,0,9,18
14011,Kazakhstan,2015,2015Kazakhstan,0,0,0,16,0,0,16,0,0,0,21,0,0,21,37
14012,Kazakhstan,2015,2015Kazakhstan,0,5,8,20,22,0,55,0,5,6,16,5,0,32,87
14013,Kazakhstan,2016,2016Kazakhstan,0,0,0,0,0,0,0,0,0,0,0,0,0,0,1496
14014,Kazakhstan,2016,2016Kazakhstan,0,0,0,0,0,0,0,0,0,0,0,0,10,10,10
14015,Kazakhstan,2016,2016Kazakhstan,0,0,0,0,0,0,0,0,0,5,0,0,0,5,5
14016,Kazakhstan,2016,2016Kazakhstan,0,0,0,0,0,18,18,0,0,0,0,0,20,20,38
14017,Kazakhstan,2016,2016Kazakhstan,0,0,0,0,0,299,299,0,0,0,0,0,232,232,531
14018,Kazakhstan,2016,2016Kazakhstan,0,0,0,0,6,0,6,0,0,0,6,0,0,6,12
14019,Kazakhstan,2016,2016Kazakhstan,0,0,0,0,7,0,7,0,0,0,0,0,0,0,106
14020,Kazakhstan,2016,2016Kazakhstan,0,0,0,7,0,0,7,0,5,0,7,0,0,12,19
14021,Kazakhstan,2016,2016Kazakhstan,0,0,0,9,0,0,9,0,0,0,9,0,0,9,18
14022,Kazakhstan,2016,2016Kazakhstan,0,0,0,15,0,0,15,0,0,0,20,0,0,20,35
14023,Kazakhstan,2016,2016Kazakhstan,0,5,0,0,0,0,5,0,0,0,0,0,0,0,5
14024,Kazakhstan,2016,2016Kazakhstan,0,5,6,22,25,0,58,0,5,5,18,5,0,33,91
14025,Kazakhstan,2017,2017Kazakhstan,0,0,0,0,0,0,0,0,0,0,0,0,0,0,1653
14026,Kazakhstan,2017,2017Kazakhstan,0,0,0,0,0,0,0,0,0,0,0,0,11,11,11
14027,Kazakhstan,2017,2017Kazakhstan,0,0,0,0,0,0,0,0,0,5,0,0,0,5,5
14028,Kazakhstan,2017,2017Kazakhstan,0,0,0,0,0,309,309,0,0,0,0,0,244,244,553
14029,Kazakhstan,2017,2017Kazakhstan,0,0,0,0,6,0,6,0,0,0,6,0,0,6,12
14030,Kazakhstan,2017,2017Kazakhstan,0,0,0,7,0,0,7,0,5,0,7,0,0,12,19
14031,Kazakhstan,2017,2017Kazakhstan,0,0,0,9,0,0,9,0,0,0,9,0,0,9,18
14032,Kazakhstan,2017,2017Kazakhstan,0,0,0,10,5,0,15,0,0,0,20,0,0,20,35
14033,Kazakhstan,2017,2017Kazakhstan,0,5,0,0,0,0,5,0,0,0,0,0,0,0,5
14034,Kazakhstan,2017,2017Kazakhstan,0,6,5,24,24,0,59,0,8,0,23,5,0,36,95
14035,Kazakhstan,2018,2018Kazakhstan,0,0,0,0,0,0,0,0,0,0,0,0,0,0,1586
14036,Kazakhstan,2018,2018Kazakhstan,0,0,0,0,0,0,0,0,0,5,0,0,0,5,5
14037,Kazakhstan,2018,2018Kazakhstan,0,0,0,0,0,327,327,0,0,0,0,0,257,257,584
14038,Kazakhstan,2018,2018Kazakhstan,0,0,0,0,6,0,6,0,0,0,6,0,0,6,12
14039,Kazakhstan,2018,2018Kazakhstan,0,0,0,7,0,0,7,0,0,0,12,0,0,12,19
14040,Kazakhstan,2018,2018Kazakhstan,0,0,0,7,0,0,7,0,5,0,7,0,0,12,19
14041,Kazakhstan,2018,2018Kazakhstan,0,0,0,9,0,0,9,0,0,0,9,0,0,9,18
14042,Kazakhstan,2018,2018Kazakhstan,0,0,5,9,0,0,14,0,0,0,8,0,0,8,173
14043,Kazakhstan,2018,2018Kazakhstan,0,5,0,0,0,0,5,0,0,0,0,0,0,0,5
14044,Kazakhstan,2018,2018Kazakhstan,5,7,0,26,26,0,64,0,7,0,21,7,0,35,99
14045,Kazakhstan,2019,2019Kazakhstan,0,0,0,0,0,0,0,0,0,0,0,0,0,0,1966
14046,Kazakhstan,2019,2019Kazakhstan,0,0,0,0,0,0,0,0,0,0,0,0,7,7,7
14047,Kazakhstan,2019,2019Kazakhstan,0,0,0,0,0,0,0,0,0,0,5,0,0,5,5
14048,Kazakhstan,2019,2019Kazakhstan,0,0,0,0,0,336,336,0,0,0,0,0,271,271,607
14049,Kazakhstan,2019,2019Kazakhstan,0,0,0,7,0,0,7,0,0,0,9,0,0,9,21
14050,Kazakhstan,2019,2019Kazakhstan,0,0,0,7,0,0,7,0,0,0,12,0,0,12,19
14051,Kazakhstan,2019,2019Kazakhstan,0,0,0,9,0,0,9,0,0,0,9,0,0,9,18
14052,Kazakhstan,2019,2019Kazakhstan,0,9,6,28,27,0,70,0,7,6,25,6,0,44,114
14053,Kazakhstan,2020,2020Kazakhstan,0,0,0,0,0,0,0,0,0,0,0,0,0,0,2489
14054,Kazakhstan,2020,2020Kazakhstan,0,0,0,0,0,0,0,0,0,0,0,0,5,5,5
14055,Kazakhstan,2020,2020Kazakhstan,0,0,0,0,0,0,0,0,0,0,0,0,9,9,9
14056,Kazakhstan,2020,2020Kazakhstan,0,0,0,0,0,0,0,0,0,0,5,0,0,5,5
14057,Kazakhstan,2020,2020Kazakhstan,0,0,0,0,0,32,32,0,0,0,0,0,28,28,60
14058,Kazakhstan,2020,2020Kazakhstan,0,0,0,7,0,0,7,0,0,0,8,0,0,8,20
14059,Kazakhstan,2020,2020Kazakhstan,0,0,0,7,0,0,7,0,0,0,11,0,0,11,18
14060,Kazakhstan,2020,2020Kazakhstan,0,0,0,9,0,0,9,0,0,0,9,0,0,9,18
14061,Kazakhstan,2020,2020Kazakhstan,0,10,5,31,26,0,72,0,5,7,26,7,0,45,117
14062,Kazakhstan,2021,2021Kazakhstan,0,0,0,0,0,0,0,0,0,0,0,0,0,0,2762
14063,Kazakhstan,2021,2021Kazakhstan,0,0,0,0,0,0,0,0,0,0,0,0,9,9,9
14064,Kazakhstan,2021,2021Kazakhstan,0,0,0,0,0,0,0,0,0,0,5,0,0,5,5
14065,Kazakhstan,2021,2021Kazakhstan,0,0,0,0,0,41,41,0,0,0,0,0,35,35,76
14066,Kazakhstan,2021,2021Kazakhstan,0,0,0,6,0,0,6,0,0,0,7,0,0,7,28
14067,Kazakhstan,2021,2021Kazakhstan,0,0,0,7,0,0,7,0,0,0,11,0,0,11,18
14068,Kazakhstan,2021,2021Kazakhstan,0,0,0,9,0,0,9,0,0,0,9,0,0,9,18
14069,Kazakhstan,2021,2021Kazakhstan,0,0,5,0,0,0,5,0,0,0,0,0,0,0,5
14070,Kazakhstan,2021,2021Kazakhstan,0,5,0,12,0,0,17,0,6,0,14,0,0,20,165
14071,Kazakhstan,2021,2021Kazakhstan,0,10,5,28,23,0,66,0,7,7,26,6,0,46,112
14072,Kenya,2001,2001Kenya,0,0,0,0,0,0,0,0,0,0,0,0,0,0,2398
14073,Kenya,2001,2001Kenya,0,0,0,0,0,0,0,0,0,0,0,0,9,9,9
14074,Kenya,2001,2001Kenya,0,0,0,0,0,0,0,0,0,0,5,0,0,5,5
14075,Kenya,2001,2001Kenya,0,0,0,0,0,0,0,0,0,0,7,0,0,7,7
14076,Kenya,2001,2001Kenya,0,0,0,0,0,0,0,5,0,0,0,0,0,5,5
14077,Kenya,2001,2001Kenya,0,0,0,0,0,6,6,0,0,0,0,0,0,0,12
14078,Kenya,2001,2001Kenya,15,0,5,19,0,0,39,11,5,5,55,0,0,76,115
14079,Kenya,2002,2002Kenya,0,0,0,0,0,0,0,0,0,0,0,0,0,0,2916
14080,Kenya,2002,2002Kenya,0,0,0,0,0,0,0,0,0,0,5,0,0,5,5
14081,Kenya,2002,2002Kenya,0,0,0,0,0,0,0,0,0,0,11,0,0,11,11
14082,Kenya,2002,2002Kenya,0,0,0,0,0,8,8,0,0,0,0,0,0,0,8
14083,Kenya,2002,2002Kenya,0,0,0,5,0,0,5,0,0,0,0,0,0,0,5
14084,Kenya,2002,2002Kenya,0,0,0,6,0,0,6,0,5,0,0,0,0,5,11
14085,Kenya,2002,2002Kenya,16,5,0,21,0,0,42,14,9,13,55,0,0,91,133
14086,Kenya,2003,2003Kenya,0,0,0,0,0,0,0,0,0,0,0,0,0,0,3085
14087,Kenya,2003,2003Kenya,0,0,0,0,0,0,0,0,0,0,7,0,0,7,7
14088,Kenya,2003,2003Kenya,0,0,0,0,0,5,5,0,0,0,0,0,6,6,11
14089,Kenya,2003,2003Kenya,0,0,0,5,0,0,5,0,0,0,0,0,0,0,5
14090,Kenya,2003,2003Kenya,0,0,0,7,0,0,7,0,5,0,0,0,0,5,12
14091,Kenya,2003,2003Kenya,0,5,0,15,0,0,20,5,0,0,14,0,0,19,39
14092,Kenya,2004,2004Kenya,0,0,0,0,0,0,0,0,0,0,0,0,0,0,3778
14093,Kenya,2004,2004Kenya,0,0,0,5,0,0,5,0,0,0,0,0,0,0,5
14094,Kenya,2004,2004Kenya,0,0,0,5,0,0,5,0,0,6,0,0,0,6,11
14095,Kenya,2004,2004Kenya,0,0,0,5,0,0,5,5,0,0,6,0,0,11,16
14096,Kenya,2004,2004Kenya,0,5,0,7,0,0,12,5,0,0,15,0,0,20,32
14097,Kenya,2005,2005Kenya,0,0,0,0,0,0,0,0,0,0,0,0,0,0,4571
14098,Kenya,2005,2005Kenya,0,0,0,0,0,0,0,0,0,0,8,0,0,8,8
14099,Kenya,2005,2005Kenya,0,0,0,0,0,6,6,0,0,0,0,0,6,6,12
14100,Kenya,2005,2005Kenya,0,0,0,9,0,0,9,0,0,0,9,0,0,9,18
14101,Kenya,2005,2005Kenya,10,0,0,5,0,0,15,0,7,0,7,0,0,14,29
14102,Kenya,2006,2006Kenya,0,0,0,0,0,0,0,0,0,0,0,0,0,0,5272
14103,Kenya,2006,2006Kenya,0,0,0,0,0,6,6,0,0,0,0,0,6,6,12
14104,Kenya,2006,2006Kenya,0,0,0,0,0,9,9,0,0,0,0,0,9,9,18
14105,Kenya,2006,2006Kenya,0,0,0,5,0,0,5,0,0,0,0,0,0,0,5
14106,Kenya,2006,2006Kenya,15,0,6,0,0,0,21,5,0,12,11,0,0,28,49
14107,Kenya,2007,2007Kenya,0,0,0,0,0,0,0,0,0,0,0,0,0,0,4802
14108,Kenya,2007,2007Kenya,0,0,0,0,0,10,10,0,0,0,0,0,6,6,16
14109,Kenya,2007,2007Kenya,0,0,5,7,0,0,12,0,6,0,0,0,5,11,23
14110,Kenya,2007,2007Kenya,0,5,0,0,0,0,5,0,0,0,0,0,0,0,5
14111,Kenya,2007,2007Kenya,15,6,0,0,0,0,21,6,12,0,15,0,0,33,54
14112,Kenya,2007,2007Kenya,241,0,568,504,84,0,1397,269,0,450,450,78,0,1247,2644
14113,Kenya,2008,2008Kenya,0,0,0,0,0,0,0,0,0,0,0,0,0,0,5066
14114,Kenya,2008,2008Kenya,0,0,0,0,0,0,0,0,0,0,0,0,9,9,9
14115,Kenya,2008,2008Kenya,0,0,0,0,0,13,13,0,0,0,0,0,6,6,19
14116,Kenya,2008,2008Kenya,0,0,0,5,0,0,5,0,0,0,0,0,0,0,5
14117,Kenya,2008,2008Kenya,0,0,5,8,0,0,13,0,7,0,0,0,5,12,25
14118,Kenya,2008,2008Kenya,0,5,0,0,0,0,5,0,0,0,0,0,0,0,5
14119,Kenya,2008,2008Kenya,161,232,142,387,8,0,930,136,230,135,456,21,0,978,1908
14120,Kenya,2008,2008Kenya,241,0,568,504,84,0,1397,269,0,450,451,78,0,1248,2645
14121,Kenya,2009,2009Kenya,0,0,0,0,0,0,0,0,0,0,0,0,0,0,4895
14122,Kenya,2009,2009Kenya,0,0,0,0,0,8,8,0,0,0,0,0,8,8,16
14123,Kenya,2009,2009Kenya,0,0,0,5,0,0,5,0,0,0,0,0,0,0,5
14124,Kenya,2009,2009Kenya,0,0,0,7,5,0,12,0,0,7,0,0,5,12,24
14125,Kenya,2009,2009Kenya,9,6,18,123,0,0,156,5,11,11,65,5,0,97,253
14126,Kenya,2009,2009Kenya,107,206,148,364,9,0,834,95,191,153,383,28,0,850,1684
14127,Kenya,2009,2009Kenya,211,357,254,541,92,0,1455,248,315,192,438,84,0,1277,2732
14128,Kenya,2010,2010Kenya,0,0,0,0,0,0,0,0,0,0,0,0,0,0,4384
14129,Kenya,2010,2010Kenya,0,0,0,0,0,0,0,0,0,5,0,0,0,5,5
14130,Kenya,2010,2010Kenya,0,0,0,0,0,9,9,0,0,0,0,0,9,9,18
14131,Kenya,2010,2010Kenya,0,0,0,0,0,16,16,0,0,0,0,0,9,9,25
14132,Kenya,2010,2010Kenya,0,0,0,9,0,0,9,0,0,0,0,0,0,0,9
14133,Kenya,2010,2010Kenya,0,0,0,13,0,5,18,0,0,9,0,0,5,14,32
14134,Kenya,2010,2010Kenya,5,13,22,150,0,0,190,7,14,9,65,5,0,100,290
14135,Kenya,2010,2010Kenya,82,181,105,318,9,0,695,86,163,137,293,23,0,702,1397
14136,Kenya,2010,2010Kenya,233,313,173,481,84,0,1284,269,294,123,374,81,0,1141,2425
14137,Kenya,2011,2011Kenya,0,0,0,0,0,0,0,0,0,0,0,0,0,0,3571
14138,Kenya,2011,2011Kenya,0,0,0,0,0,0,0,0,0,0,5,0,0,5,5
14139,Kenya,2011,2011Kenya,0,0,0,0,0,0,0,0,0,5,0,0,0,5,5
14140,Kenya,2011,2011Kenya,0,0,0,0,0,14,14,0,0,0,0,0,8,8,22
14141,Kenya,2011,2011Kenya,0,0,0,0,0,19,19,0,0,0,0,0,10,10,29
14142,Kenya,2011,2011Kenya,0,0,0,5,0,0,5,0,0,0,0,0,0,0,5
14143,Kenya,2011,2011Kenya,0,0,0,9,0,0,9,0,0,0,0,0,0,0,9
14144,Kenya,2011,2011Kenya,0,11,15,85,7,0,118,5,14,11,74,0,0,104,942
14145,Kenya,2011,2011Kenya,5,0,0,11,0,5,21,0,7,0,5,0,5,17,38
14146,Kenya,2011,2011Kenya,7,12,19,175,0,0,213,10,9,8,68,5,0,100,313
14147,Kenya,2011,2011Kenya,61,168,113,317,9,0,668,73,153,120,302,22,0,670,1338
14148,Kenya,2011,2011Kenya,245,305,193,477,88,0,1308,254,317,140,353,82,0,1146,2454
14149,Kenya,2012,2012Kenya,0,0,0,0,0,0,0,0,0,0,0,0,0,0,3405
14150,Kenya,2012,2012Kenya,0,0,0,0,0,0,0,0,0,0,5,0,0,5,5
14151,Kenya,2012,2012Kenya,0,0,0,0,0,0,0,0,0,5,0,0,0,5,5
14152,Kenya,2012,2012Kenya,0,0,0,0,0,17,17,0,0,0,0,0,11,11,28
14153,Kenya,2012,2012Kenya,0,0,0,0,0,28,28,0,0,0,0,0,20,20,48
14154,Kenya,2012,2012Kenya,0,0,0,5,0,0,5,0,0,0,0,0,0,0,10
14155,Kenya,2012,2012Kenya,0,0,0,9,0,0,9,0,0,0,0,0,0,0,9
14156,Kenya,2012,2012Kenya,0,5,0,0,0,0,5,0,0,0,0,0,0,0,5
14157,Kenya,2012,2012Kenya,0,5,0,27,0,0,32,0,0,5,14,0,0,19,996
14158,Kenya,2012,2012Kenya,5,0,0,0,0,0,5,0,0,0,0,0,0,0,5
14159,Kenya,2012,2012Kenya,5,0,0,12,0,8,25,0,8,0,5,0,9,22,47
14160,Kenya,2012,2012Kenya,9,17,20,197,6,0,249,9,12,11,79,5,0,116,365
14161,Kenya,2012,2012Kenya,55,149,98,235,11,0,548,58,116,127,253,22,0,576,1124
14162,Kenya,2012,2012Kenya,301,344,232,571,101,0,1549,315,359,166,413,92,0,1345,2894
14163,Kenya,2013,2013Kenya,0,0,0,0,0,0,0,0,0,0,0,0,0,0,3092
14164,Kenya,2013,2013Kenya,0,0,0,0,0,0,0,0,0,0,5,0,0,5,5
14165,Kenya,2013,2013Kenya,0,0,0,0,0,0,0,0,0,5,0,0,0,5,5
14166,Kenya,2013,2013Kenya,0,0,0,0,0,0,0,6,0,0,0,0,0,6,6
14167,Kenya,2013,2013Kenya,0,0,0,0,0,13,13,0,0,0,0,0,11,11,29
14168,Kenya,2013,2013Kenya,0,0,0,0,0,33,33,0,0,0,0,0,25,25,58
14169,Kenya,2013,2013Kenya,0,0,0,5,0,0,5,0,0,0,0,0,0,0,5
14170,Kenya,2013,2013Kenya,0,0,0,9,0,0,9,0,0,0,0,0,0,0,9
14171,Kenya,2013,2013Kenya,0,0,0,32,0,0,32,0,0,5,15,0,0,20,52
14172,Kenya,2013,2013Kenya,0,0,5,9,0,8,22,0,0,7,5,0,12,24,46
14173,Kenya,2013,2013Kenya,0,5,0,0,0,0,5,0,0,0,0,0,0,0,5
14174,Kenya,2013,2013Kenya,0,6,5,23,0,0,34,0,7,5,12,0,0,24,1019
14175,Kenya,2013,2013Kenya,6,8,6,89,0,0,109,0,8,5,36,0,0,49,158
14176,Kenya,2013,2013Kenya,66,134,111,267,13,0,591,68,121,123,270,24,0,606,1197
14177,Kenya,2013,2013Kenya,301,344,232,571,101,0,1549,315,359,166,413,92,0,1345,2894
14178,Kenya,2014,2014Kenya,0,0,0,0,0,0,0,0,0,0,0,0,0,0,3073
14179,Kenya,2014,2014Kenya,0,0,0,0,0,0,0,0,0,0,5,0,0,5,5
14180,Kenya,2014,2014Kenya,0,0,0,0,0,0,0,0,0,6,0,0,0,6,6
14181,Kenya,2014,2014Kenya,0,0,0,0,0,43,43,0,0,0,0,0,29,29,72
14182,Kenya,2014,2014Kenya,0,0,0,0,0,103,103,0,0,0,0,0,96,96,199
14183,Kenya,2014,2014Kenya,0,0,0,5,0,0,5,0,0,0,0,0,0,0,5
14184,Kenya,2014,2014Kenya,0,0,0,5,0,0,5,0,0,0,5,0,0,5,10
14185,Kenya,2014,2014Kenya,0,0,0,6,5,12,23,0,0,6,5,0,11,22,45
14186,Kenya,2014,2014Kenya,0,0,0,14,0,0,14,5,0,0,13,0,0,18,937
14187,Kenya,2014,2014Kenya,0,5,0,0,0,0,5,0,0,0,0,0,0,0,10
14188,Kenya,2014,2014Kenya,5,13,6,96,5,0,125,0,14,0,43,0,0,57,182
14189,Kenya,2014,2014Kenya,75,134,122,294,17,0,642,81,115,121,291,24,0,632,1274
14190,Kenya,2014,2014Kenya,205,286,266,587,109,0,1453,184,333,232,426,100,0,1275,2728
14191,Kenya,2015,2015Kenya,0,0,0,0,0,0,0,0,0,0,0,0,0,0,3995
14192,Kenya,2015,2015Kenya,0,0,0,0,0,0,0,0,0,0,5,0,0,5,10
14193,Kenya,2015,2015Kenya,0,0,0,0,0,0,0,7,0,0,0,0,0,7,7
14194,Kenya,2015,2015Kenya,0,0,0,0,0,18,18,0,0,0,0,0,14,14,32
14195,Kenya,2015,2015Kenya,0,0,0,0,0,46,46,0,0,0,0,0,29,29,75
14196,Kenya,2015,2015Kenya,0,0,0,5,0,0,5,0,0,0,0,0,0,0,5
14197,Kenya,2015,2015Kenya,0,0,0,5,0,0,5,0,0,0,5,0,0,5,10
14198,Kenya,2015,2015Kenya,0,0,0,7,5,0,12,0,0,5,6,0,0,11,42
14199,Kenya,2015,2015Kenya,0,0,0,32,5,0,37,0,0,5,17,0,0,22,59
14200,Kenya,2015,2015Kenya,0,5,0,0,0,0,5,0,0,0,0,0,0,0,5
14201,Kenya,2015,2015Kenya,5,7,5,100,5,0,122,5,8,0,45,0,0,58,180
14202,Kenya,2015,2015Kenya,9,28,21,64,7,0,129,11,29,29,84,7,0,160,289
14203,Kenya,2015,2015Kenya,261,338,281,684,122,0,1686,278,366,270,488,105,0,1507,3193
14204,Kenya,2016,2016Kenya,0,0,0,0,0,0,0,0,0,0,0,0,0,0,2982
14205,Kenya,2016,2016Kenya,0,0,0,0,0,0,0,0,0,0,5,0,0,5,5
14206,Kenya,2016,2016Kenya,0,0,0,0,0,0,0,6,0,0,0,0,0,6,6
14207,Kenya,2016,2016Kenya,0,0,0,0,0,12,12,0,0,0,0,0,10,10,22
14208,Kenya,2016,2016Kenya,0,0,0,0,0,60,60,0,0,0,0,0,36,36,96
14209,Kenya,2016,2016Kenya,0,0,0,0,0,74,74,0,0,0,0,0,79,79,153
14210,Kenya,2016,2016Kenya,0,0,0,5,0,0,5,0,0,0,0,0,0,0,5
14211,Kenya,2016,2016Kenya,0,0,0,5,0,0,5,0,0,0,5,0,0,5,10
14212,Kenya,2016,2016Kenya,0,0,0,7,5,10,22,0,0,9,0,0,12,21,43
14213,Kenya,2016,2016Kenya,0,0,0,30,5,0,35,0,0,0,21,0,0,21,56
14214,Kenya,2016,2016Kenya,0,0,5,13,0,0,18,0,9,0,15,0,0,24,453
14215,Kenya,2016,2016Kenya,0,5,0,0,0,0,5,0,0,0,0,0,0,0,5
14216,Kenya,2016,2016Kenya,0,7,5,102,5,0,119,5,6,0,40,0,0,51,170
14217,Kenya,2016,2016Kenya,5,16,21,36,5,0,83,8,30,18,50,5,0,111,194
14218,Kenya,2016,2016Kenya,295,335,280,707,132,0,1749,315,353,277,524,108,0,1577,3326
14219,Kenya,2017,2017Kenya,0,0,0,0,0,0,0,0,0,0,0,0,0,0,3343
14220,Kenya,2017,2017Kenya,0,0,0,0,0,0,0,6,0,0,0,0,0,6,6
14221,Kenya,2017,2017Kenya,0,0,0,0,0,64,64,0,0,0,0,0,43,43,107
14222,Kenya,2017,2017Kenya,0,0,0,0,0,74,74,0,0,0,0,0,81,81,155
14223,Kenya,2017,2017Kenya,0,0,0,5,0,0,5,0,0,0,0,0,0,0,5
14224,Kenya,2017,2017Kenya,0,0,0,5,0,0,5,0,0,0,5,0,0,5,10
14225,Kenya,2017,2017Kenya,0,0,0,6,5,13,24,0,0,9,0,0,10,19,43
14226,Kenya,2017,2017Kenya,0,0,0,30,5,0,35,0,0,0,21,0,0,21,56
14227,Kenya,2017,2017Kenya,0,0,5,0,0,0,5,0,0,0,0,0,0,0,5
14228,Kenya,2017,2017Kenya,0,5,0,0,0,0,5,0,0,0,0,0,0,0,5
14229,Kenya,2017,2017Kenya,5,5,6,102,5,0,123,7,6,0,44,0,0,57,180
14230,Kenya,2017,2017Kenya,5,13,16,42,5,0,81,15,19,18,55,5,0,112,193
14231,Kenya,2017,2017Kenya,351,330,281,705,132,0,1799,399,351,274,527,109,0,1660,3459
14232,Kenya,2018,2018Kenya,0,0,0,0,0,0,0,0,0,0,0,0,0,0,2916
14233,Kenya,2018,2018Kenya,0,0,0,0,0,70,70,0,0,0,0,0,53,53,123
14234,Kenya,2018,2018Kenya,0,0,0,5,0,0,5,0,0,0,0,0,0,0,10
14235,Kenya,2018,2018Kenya,0,0,0,5,5,10,20,0,0,9,0,0,13,22,42
14236,Kenya,2018,2018Kenya,0,0,0,6,0,0,6,0,0,0,5,0,0,5,11
14237,Kenya,2018,2018Kenya,0,0,0,29,0,0,29,0,0,0,15,0,0,15,44
14238,Kenya,2018,2018Kenya,0,0,6,33,0,0,39,5,6,5,16,0,0,32,475
14239,Kenya,2018,2018Kenya,0,5,0,0,0,0,5,0,0,0,0,0,0,0,5
14240,Kenya,2018,2018Kenya,0,6,0,0,0,0,6,0,0,0,0,0,0,0,6
14241,Kenya,2018,2018Kenya,5,6,7,99,5,0,122,0,8,6,42,5,0,61,183
14242,Kenya,2018,2018Kenya,5,6,19,48,5,0,83,13,9,33,50,6,0,111,194
14243,Kenya,2018,2018Kenya,352,330,281,712,133,0,1808,399,351,275,529,109,0,1663,3471
14244,Kenya,2019,2019Kenya,0,0,0,0,0,0,0,0,0,0,0,0,0,0,3032
14245,Kenya,2019,2019Kenya,0,0,0,0,0,78,78,0,0,0,0,0,58,58,136
14246,Kenya,2019,2019Kenya,0,0,0,0,5,0,5,0,0,0,0,0,0,0,5
14247,Kenya,2019,2019Kenya,0,0,0,5,0,0,5,0,0,0,0,0,0,0,5
14248,Kenya,2019,2019Kenya,0,0,0,6,5,0,11,0,0,0,8,0,0,8,41
14249,Kenya,2019,2019Kenya,0,5,0,0,0,0,5,0,0,0,0,0,0,0,5
14250,Kenya,2019,2019Kenya,0,7,0,0,0,0,7,0,0,0,0,0,0,0,7
14251,Kenya,2019,2019Kenya,5,0,0,30,0,0,35,0,0,0,16,0,0,16,51
14252,Kenya,2019,2019Kenya,5,7,7,105,6,0,130,5,5,5,40,5,0,60,190
14253,Kenya,2019,2019Kenya,5,10,14,51,5,0,85,5,20,21,62,7,0,115,200
14254,Kenya,2019,2019Kenya,399,430,297,841,137,0,2104,485,413,330,595,106,0,1929,4033
14255,Kenya,2020,2020Kenya,0,0,0,0,0,0,0,0,0,0,0,0,0,0,2520
14256,Kenya,2020,2020Kenya,0,0,0,0,0,0,0,0,0,0,5,0,0,5,5
14257,Kenya,2020,2020Kenya,0,0,0,0,0,5,5,0,0,0,0,0,0,0,5
14258,Kenya,2020,2020Kenya,0,0,0,0,0,5,5,0,0,0,0,0,10,10,15
14259,Kenya,2020,2020Kenya,0,0,0,0,5,0,5,0,0,0,0,0,0,0,5
14260,Kenya,2020,2020Kenya,0,0,0,7,5,0,12,0,0,0,9,0,0,9,43
14261,Kenya,2020,2020Kenya,0,0,0,46,0,25,71,0,0,0,29,0,17,46,229
14262,Kenya,2020,2020Kenya,0,0,5,0,0,0,5,0,0,0,0,0,0,0,5
14263,Kenya,2020,2020Kenya,0,0,8,55,0,0,63,0,5,6,61,5,0,77,140
14264,Kenya,2020,2020Kenya,0,8,0,0,0,0,8,0,0,0,0,0,0,0,8
14265,Kenya,2020,2020Kenya,5,0,0,30,0,0,35,0,0,0,14,0,0,14,49
14266,Kenya,2020,2020Kenya,5,5,23,50,5,0,88,0,21,23,62,10,0,116,204
14267,Kenya,2020,2020Kenya,5,6,5,98,5,0,119,0,5,8,40,0,0,53,172
14268,Kenya,2020,2020Kenya,250,479,319,896,152,0,2096,312,492,341,659,122,0,1926,4022
14269,Kenya,2021,2021Kenya,0,0,0,0,0,0,0,0,0,0,0,0,0,0,2479
14270,Kenya,2021,2021Kenya,0,0,0,0,0,0,0,0,0,0,5,0,0,5,5
14271,Kenya,2021,2021Kenya,0,0,0,0,0,0,0,5,0,0,0,0,0,5,5
14272,Kenya,2021,2021Kenya,0,0,0,0,5,0,5,0,0,0,0,0,0,0,5
14273,Kenya,2021,2021Kenya,0,0,0,5,0,0,5,0,0,0,0,0,0,0,10
14274,Kenya,2021,2021Kenya,0,0,0,11,0,0,11,0,5,0,5,0,0,10,42
14275,Kenya,2021,2021Kenya,0,0,7,57,0,0,64,0,0,8,64,5,0,77,141
14276,Kenya,2021,2021Kenya,0,0,7,146,0,25,178,0,0,8,131,0,17,156,340
14277,Kenya,2021,2021Kenya,0,5,0,0,0,0,5,0,0,0,0,0,0,0,5
14278,Kenya,2021,2021Kenya,0,6,0,29,0,0,35,0,0,0,18,0,0,18,53
14279,Kenya,2021,2021Kenya,0,9,0,0,0,0,9,0,0,0,0,0,0,0,9
14280,Kenya,2021,2021Kenya,5,6,5,87,5,0,108,5,5,6,34,5,0,55,163
14281,Kenya,2021,2021Kenya,22,5,19,53,5,0,104,20,18,20,66,11,0,135,239
14282,Kenya,2021,2021Kenya,169,525,298,947,164,0,2103,213,541,328,716,132,0,1930,4033
14283,Kyrgyzstan,2001,2001Kyrgyzstan,0,0,0,0,0,0,0,0,0,0,0,0,0,0,669
14284,Kyrgyzstan,2001,2001Kyrgyzstan,0,0,0,0,0,5,5,0,0,0,0,0,5,5,10
14285,Kyrgyzstan,2001,2001Kyrgyzstan,0,8,0,0,0,0,8,0,0,0,0,0,0,0,8
14286,Kyrgyzstan,2002,2002Kyrgyzstan,0,0,0,0,0,0,0,0,0,0,0,0,0,0,2932
14287,Kyrgyzstan,2002,2002Kyrgyzstan,0,0,0,0,0,6,6,0,0,0,0,0,6,6,12
14288,Kyrgyzstan,2002,2002Kyrgyzstan,0,8,0,0,0,0,8,0,0,0,0,0,0,0,8
14289,Kyrgyzstan,2003,2003Kyrgyzstan,0,0,0,0,0,0,0,0,0,0,0,0,0,0,3117
14290,Kyrgyzstan,2003,2003Kyrgyzstan,0,0,0,0,0,12,12,0,0,0,0,0,13,13,25
14291,Kyrgyzstan,2004,2004Kyrgyzstan,0,0,0,0,0,0,0,0,0,0,0,0,0,0,3276
14292,Kyrgyzstan,2004,2004Kyrgyzstan,0,0,0,0,0,0,0,0,5,0,0,0,0,5,10
14293,Kyrgyzstan,2005,2005Kyrgyzstan,0,0,0,0,0,0,0,0,0,0,0,0,0,0,3020
14294,Kyrgyzstan,2005,2005Kyrgyzstan,0,0,0,0,0,0,0,0,0,0,0,0,5,5,5
14295,Kyrgyzstan,2005,2005Kyrgyzstan,0,0,0,0,0,0,0,0,0,5,0,0,0,5,5
14296,Kyrgyzstan,2005,2005Kyrgyzstan,0,0,0,0,0,0,0,0,5,0,0,0,0,5,5
14297,Kyrgyzstan,2005,2005Kyrgyzstan,0,0,0,0,0,47,47,0,0,0,0,0,40,40,87
14298,Kyrgyzstan,2005,2005Kyrgyzstan,0,5,0,0,0,0,5,0,0,0,0,0,0,0,5
14299,Kyrgyzstan,2006,2006Kyrgyzstan,0,0,0,0,0,0,0,0,0,0,0,0,0,0,2327
14300,Kyrgyzstan,2006,2006Kyrgyzstan,0,0,0,0,0,0,0,0,0,0,0,0,5,5,5
14301,Kyrgyzstan,2006,2006Kyrgyzstan,0,0,0,0,0,0,0,0,0,5,0,0,0,5,5
14302,Kyrgyzstan,2006,2006Kyrgyzstan,0,0,0,0,0,0,0,0,5,0,0,0,0,5,5
14303,Kyrgyzstan,2006,2006Kyrgyzstan,0,0,0,0,0,19,19,0,0,0,0,0,17,17,36
14304,Kyrgyzstan,2006,2006Kyrgyzstan,0,0,0,0,0,58,58,0,0,0,0,0,52,52,110
14305,Kyrgyzstan,2006,2006Kyrgyzstan,0,0,5,0,0,0,5,0,0,0,0,0,0,0,5
14306,Kyrgyzstan,2007,2007Kyrgyzstan,0,0,0,0,0,0,0,0,0,0,0,0,0,0,2079
14307,Kyrgyzstan,2007,2007Kyrgyzstan,0,0,0,0,0,0,0,0,0,0,6,0,0,6,6
14308,Kyrgyzstan,2007,2007Kyrgyzstan,0,0,0,0,0,0,0,0,0,5,0,0,0,5,5
14309,Kyrgyzstan,2007,2007Kyrgyzstan,0,0,0,0,0,0,0,0,5,0,0,0,0,5,5
14310,Kyrgyzstan,2007,2007Kyrgyzstan,0,0,0,0,0,13,13,0,0,0,0,0,8,8,21
14311,Kyrgyzstan,2007,2007Kyrgyzstan,0,0,0,0,0,62,62,0,0,0,0,0,66,66,128
14312,Kyrgyzstan,2007,2007Kyrgyzstan,0,0,0,6,0,0,6,0,0,0,7,0,0,7,13
14313,Kyrgyzstan,2008,2008Kyrgyzstan,0,0,0,0,0,0,0,0,0,0,0,0,0,0,2343
14314,Kyrgyzstan,2008,2008Kyrgyzstan,0,0,0,0,0,0,0,0,0,0,5,0,0,5,5
14315,Kyrgyzstan,2008,2008Kyrgyzstan,0,0,0,0,0,0,0,0,5,0,0,0,0,5,5
14316,Kyrgyzstan,2008,2008Kyrgyzstan,0,0,0,0,0,6,6,0,0,0,7,0,0,7,13
14317,Kyrgyzstan,2008,2008Kyrgyzstan,0,0,0,0,0,10,10,0,0,0,0,0,6,6,16
14318,Kyrgyzstan,2008,2008Kyrgyzstan,0,0,0,0,0,71,71,0,0,0,0,0,73,73,144
14319,Kyrgyzstan,2009,2009Kyrgyzstan,0,0,0,0,0,0,0,0,0,0,0,0,0,0,1209
14320,Kyrgyzstan,2009,2009Kyrgyzstan,0,0,0,0,0,0,0,0,0,5,0,0,0,5,5
14321,Kyrgyzstan,2009,2009Kyrgyzstan,0,0,0,0,0,5,5,0,0,0,0,0,5,5,10
14322,Kyrgyzstan,2009,2009Kyrgyzstan,0,0,0,0,0,9,9,0,0,0,0,0,6,6,15
14323,Kyrgyzstan,2009,2009Kyrgyzstan,0,0,0,7,0,0,7,0,0,0,7,0,0,7,14
14324,Kyrgyzstan,2009,2009Kyrgyzstan,0,37,47,452,193,0,729,5,32,67,396,129,0,629,1358
14325,Kyrgyzstan,2010,2010Kyrgyzstan,0,0,0,0,0,0,0,0,0,0,0,0,0,0,1133
14326,Kyrgyzstan,2010,2010Kyrgyzstan,0,0,0,0,0,5,5,0,0,0,0,0,5,5,10
14327,Kyrgyzstan,2010,2010Kyrgyzstan,0,0,0,0,0,9,9,0,0,0,0,0,6,6,15
14328,Kyrgyzstan,2010,2010Kyrgyzstan,0,0,0,0,0,84,84,0,0,0,0,0,83,83,167
14329,Kyrgyzstan,2010,2010Kyrgyzstan,0,0,6,0,0,0,6,0,5,0,0,0,0,5,11
14330,Kyrgyzstan,2010,2010Kyrgyzstan,0,31,50,460,217,0,758,5,28,57,415,149,0,654,1412
14331,Kyrgyzstan,2011,2011Kyrgyzstan,0,0,0,0,0,0,0,0,0,0,0,0,0,0,1238
14332,Kyrgyzstan,2011,2011Kyrgyzstan,0,0,0,0,0,0,0,0,0,0,7,0,0,7,165
14333,Kyrgyzstan,2011,2011Kyrgyzstan,0,0,0,0,0,8,8,0,0,0,0,0,0,0,8
14334,Kyrgyzstan,2011,2011Kyrgyzstan,0,0,0,0,0,10,10,0,0,0,0,0,7,7,17
14335,Kyrgyzstan,2011,2011Kyrgyzstan,0,0,0,0,0,92,92,0,0,0,0,0,95,95,187
14336,Kyrgyzstan,2011,2011Kyrgyzstan,0,0,6,0,0,0,6,0,0,0,7,0,0,7,13
14337,Kyrgyzstan,2011,2011Kyrgyzstan,0,26,55,519,246,0,846,5,26,57,436,165,0,689,1535
14338,Kyrgyzstan,2012,2012Kyrgyzstan,0,0,0,0,0,0,0,0,0,0,0,0,0,0,1363
14339,Kyrgyzstan,2012,2012Kyrgyzstan,0,0,0,0,0,0,0,0,0,0,7,0,0,7,128
14340,Kyrgyzstan,2012,2012Kyrgyzstan,0,0,0,0,0,8,8,0,0,0,0,0,0,0,8
14341,Kyrgyzstan,2012,2012Kyrgyzstan,0,0,0,0,0,10,10,0,0,0,0,0,6,6,16
14342,Kyrgyzstan,2012,2012Kyrgyzstan,0,0,0,0,0,15,15,0,0,0,0,0,18,18,33
14343,Kyrgyzstan,2012,2012Kyrgyzstan,0,0,0,0,0,22,22,0,0,0,0,0,18,18,40
14344,Kyrgyzstan,2012,2012Kyrgyzstan,0,0,0,0,0,104,104,0,0,0,0,0,112,112,216
14345,Kyrgyzstan,2012,2012Kyrgyzstan,0,0,0,7,0,0,7,0,0,0,7,0,0,7,14
14346,Kyrgyzstan,2012,2012Kyrgyzstan,0,24,52,511,251,0,838,9,20,53,423,166,0,671,1509
14347,Kyrgyzstan,2012,2012Kyrgyzstan,5,14,11,50,0,0,80,20,16,8,39,0,0,83,163
14348,Kyrgyzstan,2013,2013Kyrgyzstan,0,0,0,0,0,0,0,0,0,0,0,0,0,0,1552
14349,Kyrgyzstan,2013,2013Kyrgyzstan,0,0,0,0,0,0,0,0,0,0,5,0,0,5,5
14350,Kyrgyzstan,2013,2013Kyrgyzstan,0,0,0,0,0,0,0,0,0,0,8,0,0,8,8
14351,Kyrgyzstan,2013,2013Kyrgyzstan,0,0,0,0,0,0,0,0,0,5,0,0,0,5,5
14352,Kyrgyzstan,2013,2013Kyrgyzstan,0,0,0,0,0,0,0,0,5,0,0,0,0,5,5
14353,Kyrgyzstan,2013,2013Kyrgyzstan,0,0,0,0,0,25,25,0,0,0,0,0,26,26,56
14354,Kyrgyzstan,2013,2013Kyrgyzstan,0,0,0,0,0,119,119,0,0,0,0,0,133,133,252
14355,Kyrgyzstan,2013,2013Kyrgyzstan,0,0,0,5,0,0,5,0,0,0,0,0,0,0,120
14356,Kyrgyzstan,2013,2013Kyrgyzstan,0,0,0,5,0,8,13,0,0,0,7,0,5,12,25
14357,Kyrgyzstan,2013,2013Kyrgyzstan,0,8,0,15,5,0,28,0,7,6,19,0,0,32,60
14358,Kyrgyzstan,2013,2013Kyrgyzstan,10,25,8,62,0,0,105,21,22,9,54,0,0,106,211
14359,Kyrgyzstan,2014,2014Kyrgyzstan,0,0,0,0,0,0,0,0,0,0,0,0,0,0,1822
14360,Kyrgyzstan,2014,2014Kyrgyzstan,0,0,0,0,0,0,0,0,0,0,5,0,0,5,5
14361,Kyrgyzstan,2014,2014Kyrgyzstan,0,0,0,0,0,0,0,0,0,5,0,0,0,5,5
14362,Kyrgyzstan,2014,2014Kyrgyzstan,0,0,0,0,0,0,0,0,5,0,0,0,0,5,5
14363,Kyrgyzstan,2014,2014Kyrgyzstan,0,0,0,0,0,6,6,0,0,0,0,0,0,0,6
14364,Kyrgyzstan,2014,2014Kyrgyzstan,0,0,0,0,0,13,13,0,0,0,5,0,7,12,25
14365,Kyrgyzstan,2014,2014Kyrgyzstan,0,0,0,0,0,132,132,0,0,0,0,0,150,150,282
14366,Kyrgyzstan,2014,2014Kyrgyzstan,5,23,13,55,5,0,101,20,23,6,54,0,0,103,204
14367,Kyrgyzstan,2014,2014Kyrgyzstan,6,7,0,25,6,0,44,7,9,8,27,0,0,51,95
14368,Kyrgyzstan,2015,2015Kyrgyzstan,0,0,0,0,0,0,0,0,0,0,0,0,0,0,1794
14369,Kyrgyzstan,2015,2015Kyrgyzstan,0,0,0,0,0,0,0,0,0,0,5,0,0,5,5
14370,Kyrgyzstan,2015,2015Kyrgyzstan,0,0,0,0,0,0,0,0,0,5,0,0,0,5,5
14371,Kyrgyzstan,2015,2015Kyrgyzstan,0,0,0,0,0,5,5,0,0,0,0,0,5,5,10
14372,Kyrgyzstan,2015,2015Kyrgyzstan,0,0,0,0,0,8,8,0,0,0,6,0,9,15,23
14373,Kyrgyzstan,2015,2015Kyrgyzstan,0,0,0,0,0,35,35,0,0,0,0,0,35,35,70
14374,Kyrgyzstan,2015,2015Kyrgyzstan,0,0,0,0,0,137,137,0,0,0,0,0,146,146,283
14375,Kyrgyzstan,2015,2015Kyrgyzstan,0,8,6,29,5,0,48,8,11,8,29,0,0,56,104
14376,Kyrgyzstan,2015,2015Kyrgyzstan,6,19,15,58,5,0,103,5,27,15,54,0,0,101,204
14377,Kyrgyzstan,2016,2016Kyrgyzstan,0,0,0,0,0,0,0,0,0,0,0,0,0,0,1781
14378,Kyrgyzstan,2016,2016Kyrgyzstan,0,0,0,0,0,0,0,0,0,0,5,0,0,5,5
14379,Kyrgyzstan,2016,2016Kyrgyzstan,0,0,0,0,0,0,0,0,0,0,9,0,0,9,9
14380,Kyrgyzstan,2016,2016Kyrgyzstan,0,0,0,0,0,5,5,0,0,0,0,0,5,5,10
14381,Kyrgyzstan,2016,2016Kyrgyzstan,0,0,0,0,0,10,10,0,0,0,0,0,9,9,19
14382,Kyrgyzstan,2016,2016Kyrgyzstan,0,0,0,0,0,32,32,0,0,0,0,0,32,32,64
14383,Kyrgyzstan,2016,2016Kyrgyzstan,0,0,0,0,0,140,140,0,0,0,0,0,155,155,295
14384,Kyrgyzstan,2016,2016Kyrgyzstan,0,0,0,5,0,0,5,0,0,0,0,0,0,0,5
14385,Kyrgyzstan,2016,2016Kyrgyzstan,0,0,0,5,0,0,5,0,0,0,7,0,0,7,63
14386,Kyrgyzstan,2016,2016Kyrgyzstan,5,6,5,37,6,0,59,6,14,10,30,0,0,60,119
14387,Kyrgyzstan,2016,2016Kyrgyzstan,5,26,10,55,5,0,101,0,33,15,52,0,0,100,201
14388,Kyrgyzstan,2017,2017Kyrgyzstan,0,0,0,0,0,0,0,0,0,0,0,0,0,0,2059
14389,Kyrgyzstan,2017,2017Kyrgyzstan,0,0,0,0,0,0,0,0,0,0,5,0,0,5,5
14390,Kyrgyzstan,2017,2017Kyrgyzstan,0,0,0,0,0,5,5,0,0,0,0,0,7,7,12
14391,Kyrgyzstan,2017,2017Kyrgyzstan,0,0,0,0,0,9,9,0,0,0,0,0,9,9,18
14392,Kyrgyzstan,2017,2017Kyrgyzstan,0,0,0,0,0,145,145,0,0,0,0,0,161,161,306
14393,Kyrgyzstan,2017,2017Kyrgyzstan,0,0,0,5,0,0,5,0,0,0,0,0,0,0,5
14394,Kyrgyzstan,2017,2017Kyrgyzstan,0,0,0,5,0,0,5,0,0,0,6,0,0,6,11
14395,Kyrgyzstan,2017,2017Kyrgyzstan,5,20,10,53,5,0,93,0,40,5,52,0,0,97,190
14396,Kyrgyzstan,2017,2017Kyrgyzstan,7,14,7,50,6,0,84,8,24,7,42,0,0,81,165
14397,Kyrgyzstan,2018,2018Kyrgyzstan,0,0,0,0,0,0,0,0,0,0,0,0,0,0,2172
14398,Kyrgyzstan,2018,2018Kyrgyzstan,0,0,0,0,0,0,0,0,0,0,5,0,0,5,5
14399,Kyrgyzstan,2018,2018Kyrgyzstan,0,0,0,0,0,147,147,0,0,0,0,0,162,162,309
14400,Kyrgyzstan,2018,2018Kyrgyzstan,0,0,0,5,0,0,5,0,0,0,0,0,0,0,5
14401,Kyrgyzstan,2018,2018Kyrgyzstan,0,0,0,5,0,0,5,0,0,0,6,0,0,6,11
14402,Kyrgyzstan,2018,2018Kyrgyzstan,0,5,0,0,0,7,12,0,0,0,0,0,7,7,19
14403,Kyrgyzstan,2018,2018Kyrgyzstan,0,6,5,13,0,0,24,0,5,5,10,0,0,20,71
14404,Kyrgyzstan,2018,2018Kyrgyzstan,0,16,22,42,5,0,85,0,33,10,47,0,0,90,175
14405,Kyrgyzstan,2018,2018Kyrgyzstan,5,17,8,52,8,0,90,6,21,7,43,0,0,77,167
14406,Kyrgyzstan,2019,2019Kyrgyzstan,0,0,0,0,0,0,0,0,0,0,0,0,0,0,2405
14407,Kyrgyzstan,2019,2019Kyrgyzstan,0,0,0,0,0,0,0,0,0,0,0,0,7,7,7
14408,Kyrgyzstan,2019,2019Kyrgyzstan,0,0,0,0,0,0,0,0,0,0,5,0,0,5,5
14409,Kyrgyzstan,2019,2019Kyrgyzstan,0,0,0,0,0,149,149,0,0,0,0,0,163,163,312
14410,Kyrgyzstan,2019,2019Kyrgyzstan,0,0,0,5,0,0,5,0,0,0,0,0,0,0,25
14411,Kyrgyzstan,2019,2019Kyrgyzstan,0,0,0,5,0,0,5,0,0,0,6,0,0,6,11
14412,Kyrgyzstan,2019,2019Kyrgyzstan,7,22,8,68,6,0,111,5,24,11,42,5,0,87,198
14413,Kyrgyzstan,2020,2020Kyrgyzstan,0,0,0,0,0,0,0,0,0,0,0,0,0,0,2532
14414,Kyrgyzstan,2020,2020Kyrgyzstan,0,0,0,0,0,0,0,0,0,0,5,0,0,5,10
14415,Kyrgyzstan,2020,2020Kyrgyzstan,0,0,0,0,0,9,9,0,0,0,0,0,0,0,9
14416,Kyrgyzstan,2020,2020Kyrgyzstan,0,0,0,0,0,41,41,0,0,0,0,0,24,24,65
14417,Kyrgyzstan,2020,2020Kyrgyzstan,0,0,0,5,0,0,5,0,0,0,0,0,0,0,18
14418,Kyrgyzstan,2020,2020Kyrgyzstan,0,0,0,5,0,0,5,0,0,0,6,0,0,6,11
14419,Kyrgyzstan,2020,2020Kyrgyzstan,9,26,11,75,9,0,130,6,27,14,56,5,0,108,238
14420,Kyrgyzstan,2021,2021Kyrgyzstan,0,0,0,0,0,0,0,0,0,0,0,0,0,0,2660
14421,Kyrgyzstan,2021,2021Kyrgyzstan,0,0,0,0,0,0,0,0,0,0,5,0,0,5,10
14422,Kyrgyzstan,2021,2021Kyrgyzstan,0,0,0,0,0,0,0,8,0,0,0,0,0,8,8
14423,Kyrgyzstan,2021,2021Kyrgyzstan,0,0,0,0,0,6,6,0,0,0,0,0,5,5,11
14424,Kyrgyzstan,2021,2021Kyrgyzstan,0,0,0,0,0,12,12,0,0,0,0,0,6,6,18
14425,Kyrgyzstan,2021,2021Kyrgyzstan,0,0,0,5,0,0,5,0,0,0,5,0,0,5,10
14426,Kyrgyzstan,2021,2021Kyrgyzstan,0,0,0,5,0,0,5,0,0,0,6,0,0,6,70
14427,Kyrgyzstan,2021,2021Kyrgyzstan,11,22,15,75,8,0,131,7,24,22,59,5,0,117,248
14428,Lao People's Dem. Rep.,2001,2001Lao People's Dem. Rep.,0,0,0,0,0,0,0,0,0,0,0,0,0,0,2699
14429,Lao People's Dem. Rep.,2001,2001Lao People's Dem. Rep.,0,0,0,0,0,26,26,0,0,0,0,0,36,36,62
14430,Lao People's Dem. Rep.,2001,2001Lao People's Dem. Rep.,0,0,0,0,0,95,95,0,0,0,0,0,205,205,300
14431,Lao People's Dem. Rep.,2001,2001Lao People's Dem. Rep.,0,0,0,0,0,106,106,0,0,0,0,0,132,132,238
14432,Lao People's Dem. Rep.,2001,2001Lao People's Dem. Rep.,0,0,0,0,0,4483,4483,0,0,0,0,0,4809,4809,9292
14433,Lao People's Dem. Rep.,2001,2001Lao People's Dem. Rep.,0,0,7,5,0,0,12,5,6,5,6,0,0,22,34
14434,Lao People's Dem. Rep.,2002,2002Lao People's Dem. Rep.,0,0,0,0,0,0,0,0,0,0,0,0,0,0,2119
14435,Lao People's Dem. Rep.,2002,2002Lao People's Dem. Rep.,0,0,0,0,0,74,74,0,0,0,0,0,86,86,160
14436,Lao People's Dem. Rep.,2002,2002Lao People's Dem. Rep.,0,0,0,0,0,97,97,0,0,0,0,0,120,120,217
14437,Lao People's Dem. Rep.,2002,2002Lao People's Dem. Rep.,0,0,0,0,0,4227,4227,0,0,0,0,0,4476,4476,8703
14438,Lao People's Dem. Rep.,2002,2002Lao People's Dem. Rep.,0,0,7,5,0,0,12,5,6,5,6,0,0,22,34
14439,Lao People's Dem. Rep.,2003,2003Lao People's Dem. Rep.,0,0,0,0,0,0,0,0,0,0,0,0,0,0,2102
14440,Lao People's Dem. Rep.,2003,2003Lao People's Dem. Rep.,0,0,0,0,0,25,25,0,0,0,0,0,40,40,65
14441,Lao People's Dem. Rep.,2003,2003Lao People's Dem. Rep.,0,0,0,0,0,93,93,0,0,0,0,0,111,111,204
14442,Lao People's Dem. Rep.,2003,2003Lao People's Dem. Rep.,0,0,0,0,0,3853,3853,0,0,0,0,0,4095,4095,7948
14443,Lao People's Dem. Rep.,2003,2003Lao People's Dem. Rep.,0,0,8,5,0,0,13,0,8,7,7,0,0,22,41
14444,Lao People's Dem. Rep.,2004,2004Lao People's Dem. Rep.,0,0,0,0,0,0,0,0,0,0,0,0,0,0,14570
14445,Lao People's Dem. Rep.,2004,2004Lao People's Dem. Rep.,0,0,0,0,0,9,9,0,0,0,0,0,14,14,23
14446,Lao People's Dem. Rep.,2004,2004Lao People's Dem. Rep.,0,0,0,0,0,83,83,0,0,0,0,0,109,109,192
14447,Lao People's Dem. Rep.,2004,2004Lao People's Dem. Rep.,8,10,9,524,0,0,551,23,11,10,716,18,0,778,1329
14448,Lao People's Dem. Rep.,2005,2005Lao People's Dem. Rep.,0,0,0,0,0,0,0,0,0,0,0,0,0,0,15102
14449,Lao People's Dem. Rep.,2005,2005Lao People's Dem. Rep.,0,0,0,0,0,82,82,0,0,0,0,0,106,106,188
14450,Lao People's Dem. Rep.,2005,2005Lao People's Dem. Rep.,0,0,0,0,0,3723,3723,0,0,0,0,0,3945,3945,7668
14451,Lao People's Dem. Rep.,2005,2005Lao People's Dem. Rep.,10,10,8,526,0,0,554,23,11,10,715,20,0,779,1333
14452,Lao People's Dem. Rep.,2005,2005Lao People's Dem. Rep.,11,13,11,29,5,0,69,15,15,13,33,5,0,81,150
14453,Lao People's Dem. Rep.,2006,2006Lao People's Dem. Rep.,0,0,0,0,0,0,0,0,0,0,0,0,0,0,16947
14454,Lao People's Dem. Rep.,2006,2006Lao People's Dem. Rep.,0,0,0,0,0,10,10,0,0,0,0,0,20,20,30
14455,Lao People's Dem. Rep.,2006,2006Lao People's Dem. Rep.,0,0,0,0,0,79,79,0,0,0,0,0,103,103,182
14456,Lao People's Dem. Rep.,2006,2006Lao People's Dem. Rep.,0,0,0,0,0,3678,3678,0,0,0,0,0,3921,3921,7599
14457,Lao People's Dem. Rep.,2006,2006Lao People's Dem. Rep.,8,10,8,526,0,0,552,22,5,17,716,21,0,781,1333
14458,Lao People's Dem. Rep.,2006,2006Lao People's Dem. Rep.,19,44,25,62,5,0,155,34,40,33,87,5,0,199,354
14459,Lao People's Dem. Rep.,2007,2007Lao People's Dem. Rep.,0,0,0,0,0,0,0,0,0,0,0,0,0,0,506
14460,Lao People's Dem. Rep.,2007,2007Lao People's Dem. Rep.,0,0,0,0,0,10,10,0,0,0,0,0,17,17,27
14461,Lao People's Dem. Rep.,2007,2007Lao People's Dem. Rep.,0,0,0,0,0,78,78,0,0,0,0,0,101,101,179
14462,Lao People's Dem. Rep.,2007,2007Lao People's Dem. Rep.,0,0,0,0,0,3624,3624,0,0,0,0,0,3926,3926,7550
14463,Lao People's Dem. Rep.,2007,2007Lao People's Dem. Rep.,8,10,8,526,0,0,552,22,5,17,716,21,0,781,1333
14464,Lao People's Dem. Rep.,2007,2007Lao People's Dem. Rep.,26,46,31,74,5,0,182,34,52,34,108,7,0,235,417
14465,Lao People's Dem. Rep.,2008,2008Lao People's Dem. Rep.,0,0,0,0,0,0,0,0,0,0,0,0,0,0,473
14466,Lao People's Dem. Rep.,2008,2008Lao People's Dem. Rep.,0,0,0,0,0,9,9,0,0,0,0,0,14,14,23
14467,Lao People's Dem. Rep.,2008,2008Lao People's Dem. Rep.,0,0,0,0,0,73,73,0,0,0,0,0,99,99,172
14468,Lao People's Dem. Rep.,2008,2008Lao People's Dem. Rep.,0,0,0,0,0,3617,3617,0,0,0,0,0,3879,3879,7496
14469,Lao People's Dem. Rep.,2008,2008Lao People's Dem. Rep.,22,50,34,78,5,0,189,34,51,34,117,7,0,243,432
14470,Lao People's Dem. Rep.,2009,2009Lao People's Dem. Rep.,0,0,0,0,0,0,0,0,0,0,0,0,0,0,7768
14471,Lao People's Dem. Rep.,2009,2009Lao People's Dem. Rep.,0,0,0,0,0,8,8,0,0,0,0,0,13,13,21
14472,Lao People's Dem. Rep.,2009,2009Lao People's Dem. Rep.,0,0,0,0,0,71,71,0,0,0,0,0,93,93,164
14473,Lao People's Dem. Rep.,2009,2009Lao People's Dem. Rep.,0,5,0,50,12,0,67,0,0,5,93,8,0,106,173
14474,Lao People's Dem. Rep.,2009,2009Lao People's Dem. Rep.,17,28,23,49,5,0,122,24,32,21,66,6,0,149,271
14475,Lao People's Dem. Rep.,2010,2010Lao People's Dem. Rep.,0,0,0,0,0,0,0,0,0,0,0,0,0,0,323
14476,Lao People's Dem. Rep.,2010,2010Lao People's Dem. Rep.,0,0,0,0,0,6,6,0,0,0,0,0,10,10,16
14477,Lao People's Dem. Rep.,2010,2010Lao People's Dem. Rep.,0,0,0,0,0,67,67,0,0,0,0,0,93,93,160
14478,Lao People's Dem. Rep.,2010,2010Lao People's Dem. Rep.,0,0,0,0,0,3579,3579,0,0,0,0,0,3866,3866,7445
14479,Lao People's Dem. Rep.,2010,2010Lao People's Dem. Rep.,0,0,5,49,12,0,66,0,0,5,97,8,0,110,176
14480,Lao People's Dem. Rep.,2010,2010Lao People's Dem. Rep.,6,15,14,25,5,0,65,14,24,15,26,5,0,84,149
14481,Lao People's Dem. Rep.,2010,2010Lao People's Dem. Rep.,7,14,9,33,0,0,63,11,24,12,28,5,0,80,143
14482,Lao People's Dem. Rep.,2011,2011Lao People's Dem. Rep.,0,0,0,0,0,0,0,0,0,0,0,0,0,0,323
14483,Lao People's Dem. Rep.,2011,2011Lao People's Dem. Rep.,0,0,0,0,0,6,6,0,0,0,0,0,10,10,16
14484,Lao People's Dem. Rep.,2011,2011Lao People's Dem. Rep.,0,0,0,0,0,63,63,0,0,0,0,0,94,94,157
14485,Lao People's Dem. Rep.,2011,2011Lao People's Dem. Rep.,0,0,0,0,0,3543,3543,0,0,0,0,0,3839,3839,7382
14486,Lao People's Dem. Rep.,2011,2011Lao People's Dem. Rep.,0,0,0,8,0,0,8,0,5,0,5,0,0,10,18
14487,Lao People's Dem. Rep.,2011,2011Lao People's Dem. Rep.,0,0,0,9,0,0,9,0,9,0,0,0,0,9,18
14488,Lao People's Dem. Rep.,2011,2011Lao People's Dem. Rep.,0,5,0,48,11,0,64,0,0,0,95,13,0,108,172
14489,Lao People's Dem. Rep.,2012,2012Lao People's Dem. Rep.,0,0,0,0,0,0,0,0,0,0,0,0,0,0,302
14490,Lao People's Dem. Rep.,2012,2012Lao People's Dem. Rep.,0,0,0,0,0,5,5,0,0,0,0,0,11,11,16
14491,Lao People's Dem. Rep.,2012,2012Lao People's Dem. Rep.,0,0,0,0,0,62,62,0,0,0,0,0,92,92,154
14492,Lao People's Dem. Rep.,2012,2012Lao People's Dem. Rep.,0,0,0,0,0,3521,3521,0,0,0,0,0,3814,3814,7335
14493,Lao People's Dem. Rep.,2012,2012Lao People's Dem. Rep.,0,0,5,47,14,0,66,0,0,0,96,12,0,108,174
14494,Lao People's Dem. Rep.,2013,2013Lao People's Dem. Rep.,0,0,0,0,0,0,0,0,0,0,0,0,0,0,264
14495,Lao People's Dem. Rep.,2013,2013Lao People's Dem. Rep.,0,0,0,0,0,0,0,0,0,0,0,0,7,7,7
14496,Lao People's Dem. Rep.,2013,2013Lao People's Dem. Rep.,0,0,0,0,0,60,60,0,0,0,0,0,89,89,149
14497,Lao People's Dem. Rep.,2013,2013Lao People's Dem. Rep.,0,0,0,0,0,3462,3462,0,0,0,0,0,3799,3799,7261
14498,Lao People's Dem. Rep.,2013,2013Lao People's Dem. Rep.,0,0,5,7,0,0,12,0,0,0,38,5,0,43,55
14499,Lao People's Dem. Rep.,2014,2014Lao People's Dem. Rep.,0,0,0,0,0,0,0,0,0,0,0,0,0,0,245
14500,Lao People's Dem. Rep.,2014,2014Lao People's Dem. Rep.,0,0,0,0,0,57,57,0,0,0,0,0,86,86,143
14501,Lao People's Dem. Rep.,2014,2014Lao People's Dem. Rep.,0,0,0,0,0,3354,3354,0,0,0,0,0,3682,3682,7036
14502,Lao People's Dem. Rep.,2014,2014Lao People's Dem. Rep.,0,0,0,6,5,0,11,0,0,0,36,5,0,41,52
14503,Lao People's Dem. Rep.,2015,2015Lao People's Dem. Rep.,0,0,0,0,0,0,0,0,0,0,0,0,0,0,216
14504,Lao People's Dem. Rep.,2015,2015Lao People's Dem. Rep.,0,0,0,0,0,5,5,0,0,0,0,0,8,8,13
14505,Lao People's Dem. Rep.,2015,2015Lao People's Dem. Rep.,0,0,0,0,0,81,81,0,0,0,0,0,55,55,136
14506,Lao People's Dem. Rep.,2015,2015Lao People's Dem. Rep.,0,0,0,0,0,3297,3297,0,0,0,0,0,3647,3647,6944
14507,Lao People's Dem. Rep.,2015,2015Lao People's Dem. Rep.,0,0,0,5,6,0,11,0,0,0,33,6,0,39,50
14508,Lao People's Dem. Rep.,2016,2016Lao People's Dem. Rep.,0,0,0,0,0,0,0,0,0,0,0,0,0,0,194
14509,Lao People's Dem. Rep.,2016,2016Lao People's Dem. Rep.,0,0,0,0,0,5,5,0,0,0,0,0,8,8,13
14510,Lao People's Dem. Rep.,2016,2016Lao People's Dem. Rep.,0,0,0,0,0,54,54,0,0,0,0,0,79,79,133
14511,Lao People's Dem. Rep.,2016,2016Lao People's Dem. Rep.,0,0,0,0,0,3242,3242,0,0,0,0,0,3599,3599,6841
14512,Lao People's Dem. Rep.,2016,2016Lao People's Dem. Rep.,0,0,0,0,9,0,9,0,0,0,33,6,0,39,48
14513,Lao People's Dem. Rep.,2017,2017Lao People's Dem. Rep.,0,0,0,0,0,0,0,0,0,0,0,0,0,0,164
14514,Lao People's Dem. Rep.,2017,2017Lao People's Dem. Rep.,0,0,0,0,0,76,76,0,0,0,0,0,51,51,127
14515,Lao People's Dem. Rep.,2017,2017Lao People's Dem. Rep.,0,0,0,0,0,3180,3180,0,0,0,0,0,3541,3541,6721
14516,Lao People's Dem. Rep.,2017,2017Lao People's Dem. Rep.,0,0,0,0,8,0,8,0,0,0,30,6,0,36,44
14517,Lao People's Dem. Rep.,2018,2018Lao People's Dem. Rep.,0,0,0,0,0,0,0,0,0,0,0,0,0,0,153
14518,Lao People's Dem. Rep.,2018,2018Lao People's Dem. Rep.,0,0,0,0,0,0,0,0,0,0,5,0,0,5,10
14519,Lao People's Dem. Rep.,2018,2018Lao People's Dem. Rep.,0,0,0,0,0,51,51,0,0,0,0,0,71,71,122
14520,Lao People's Dem. Rep.,2018,2018Lao People's Dem. Rep.,0,0,0,0,0,3126,3126,0,0,0,0,0,3491,3491,6617
14521,Lao People's Dem. Rep.,2018,2018Lao People's Dem. Rep.,0,0,0,0,8,0,8,0,0,0,26,7,0,33,41
14522,Lao People's Dem. Rep.,2019,2019Lao People's Dem. Rep.,0,0,0,0,0,0,0,0,0,0,0,0,0,0,246
14523,Lao People's Dem. Rep.,2019,2019Lao People's Dem. Rep.,0,0,0,0,0,0,0,0,0,0,6,0,0,6,6
14524,Lao People's Dem. Rep.,2019,2019Lao People's Dem. Rep.,0,0,0,0,0,3045,3045,0,0,0,0,0,3419,3419,6464
14525,Lao People's Dem. Rep.,2019,2019Lao People's Dem. Rep.,0,0,0,0,7,0,7,0,0,0,26,8,0,34,41
14526,Lao People's Dem. Rep.,2020,2020Lao People's Dem. Rep.,0,0,0,0,0,0,0,0,0,0,0,0,0,0,6606
14527,Lao People's Dem. Rep.,2020,2020Lao People's Dem. Rep.,0,0,0,0,0,0,0,0,0,0,0,0,10,10,10
14528,Lao People's Dem. Rep.,2020,2020Lao People's Dem. Rep.,0,0,0,0,0,0,0,0,0,0,8,0,0,8,8
14529,Lao People's Dem. Rep.,2020,2020Lao People's Dem. Rep.,0,0,0,0,7,0,7,0,0,0,22,12,0,34,41
14530,Lao People's Dem. Rep.,2021,2021Lao People's Dem. Rep.,0,0,0,0,0,0,0,0,0,0,0,0,0,0,6730
14531,Lao People's Dem. Rep.,2021,2021Lao People's Dem. Rep.,0,0,0,0,0,0,0,0,0,0,8,0,0,8,8
14532,Lao People's Dem. Rep.,2021,2021Lao People's Dem. Rep.,0,0,0,0,6,0,6,0,0,0,21,13,0,34,40
14533,Lebanon,2001,2001Lebanon,0,0,0,0,0,0,0,0,0,0,0,0,0,0,8573
14534,Lebanon,2001,2001Lebanon,0,0,0,0,0,0,0,0,0,0,5,0,0,5,5
14535,Lebanon,2001,2001Lebanon,0,0,0,0,0,0,0,0,0,0,12,0,0,12,12
14536,Lebanon,2001,2001Lebanon,0,0,0,0,0,11,11,0,0,0,0,0,15,15,26
14537,Lebanon,2001,2001Lebanon,0,0,0,0,0,21,21,0,0,0,0,0,53,53,74
14538,Lebanon,2001,2001Lebanon,0,0,0,0,0,26,26,0,0,0,0,0,38,38,64
14539,Lebanon,2002,2002Lebanon,0,0,0,0,0,0,0,0,0,0,0,0,0,0,26092
14540,Lebanon,2002,2002Lebanon,0,0,0,0,0,0,0,0,0,0,12,0,0,12,12
14541,Lebanon,2002,2002Lebanon,0,0,0,0,0,0,0,0,6,0,0,0,0,6,6
14542,Lebanon,2002,2002Lebanon,0,0,0,0,0,7,7,0,0,0,0,0,13,13,63
14543,Lebanon,2002,2002Lebanon,0,0,0,0,0,21,21,0,0,0,0,0,55,55,76
14544,Lebanon,2002,2002Lebanon,0,0,0,5,0,0,5,0,0,0,0,0,0,0,64
14545,Lebanon,2003,2003Lebanon,0,0,0,0,0,0,0,0,0,0,0,0,0,0,24718
14546,Lebanon,2003,2003Lebanon,0,0,0,0,0,0,0,0,0,0,6,0,0,6,6
14547,Lebanon,2003,2003Lebanon,0,0,0,0,0,0,0,0,0,0,12,0,0,12,12
14548,Lebanon,2003,2003Lebanon,0,0,0,0,0,0,0,0,5,0,0,0,0,5,62
14549,Lebanon,2003,2003Lebanon,0,0,0,0,0,7,7,0,0,0,0,0,11,11,55
14550,Lebanon,2003,2003Lebanon,0,0,0,0,0,21,21,0,0,0,0,0,55,55,76
14551,Lebanon,2004,2004Lebanon,0,0,0,0,0,0,0,0,0,0,0,0,0,0,19704
14552,Lebanon,2004,2004Lebanon,0,0,0,0,0,0,0,0,0,0,5,0,0,5,10
14553,Lebanon,2004,2004Lebanon,0,0,0,0,0,0,0,0,5,0,0,0,0,5,5
14554,Lebanon,2004,2004Lebanon,0,0,0,5,0,0,5,0,0,0,7,0,0,7,12
14555,Lebanon,2004,2004Lebanon,0,0,0,5,0,0,5,0,0,0,9,0,0,9,14
14556,Lebanon,2004,2004Lebanon,0,0,0,6,0,0,6,5,0,0,0,0,0,5,64
14557,Lebanon,2004,2004Lebanon,0,0,0,7,0,0,7,0,0,0,0,0,0,0,7
14558,Lebanon,2004,2004Lebanon,0,5,0,5,0,5,15,0,0,0,11,0,12,23,38
14559,Lebanon,2005,2005Lebanon,0,0,0,0,0,0,0,0,0,0,0,0,0,0,18115
14560,Lebanon,2005,2005Lebanon,0,0,0,0,0,0,0,0,0,0,5,0,0,5,15
14561,Lebanon,2005,2005Lebanon,0,0,0,0,0,6,6,0,0,0,0,0,10,10,16
14562,Lebanon,2005,2005Lebanon,0,0,0,0,0,22,22,0,0,0,0,0,61,61,83
14563,Lebanon,2005,2005Lebanon,0,0,0,5,0,0,5,0,0,0,0,0,0,0,5
14564,Lebanon,2005,2005Lebanon,0,0,0,9,5,0,14,0,0,0,9,0,0,9,57
14565,Lebanon,2005,2005Lebanon,0,6,0,6,0,0,12,0,0,5,10,0,7,22,34
14566,Lebanon,2006,2006Lebanon,0,0,0,0,0,0,0,0,0,0,0,0,0,0,12037
14567,Lebanon,2006,2006Lebanon,0,0,0,0,0,0,0,0,0,0,0,0,14,14,14
14568,Lebanon,2006,2006Lebanon,0,0,0,0,0,0,0,0,0,0,5,0,0,5,15
14569,Lebanon,2006,2006Lebanon,0,0,0,0,0,6,6,0,0,0,0,0,10,10,16
14570,Lebanon,2006,2006Lebanon,0,0,0,0,0,8,8,0,0,0,0,0,19,19,27
14571,Lebanon,2006,2006Lebanon,0,0,0,0,0,11,11,0,0,0,0,0,21,21,32
14572,Lebanon,2006,2006Lebanon,0,0,0,0,0,22,22,0,0,0,0,0,62,62,84
14573,Lebanon,2006,2006Lebanon,0,0,0,5,0,0,5,0,0,0,0,0,0,0,5
14574,Lebanon,2006,2006Lebanon,0,0,0,6,0,0,6,0,0,0,8,0,0,8,14
14575,Lebanon,2006,2006Lebanon,0,0,5,0,0,0,5,0,0,0,0,0,0,0,5
14576,Lebanon,2007,2007Lebanon,0,0,0,0,0,0,0,0,0,0,0,0,0,0,12881
14577,Lebanon,2007,2007Lebanon,0,0,0,0,0,0,0,0,0,0,0,0,5,5,5
14578,Lebanon,2007,2007Lebanon,0,0,0,0,0,0,0,0,0,0,5,0,0,5,5
14579,Lebanon,2007,2007Lebanon,0,0,0,0,0,6,6,0,0,0,0,0,22,22,28
14580,Lebanon,2007,2007Lebanon,0,0,0,0,0,20,20,0,0,0,0,0,66,66,86
14581,Lebanon,2007,2007Lebanon,0,0,0,5,0,0,5,0,0,0,0,0,0,0,10
14582,Lebanon,2007,2007Lebanon,0,0,0,6,0,0,6,0,0,0,8,0,0,8,14
14583,Lebanon,2007,2007Lebanon,0,0,0,6,0,5,11,0,5,0,9,0,8,22,33
14584,Lebanon,2007,2007Lebanon,0,0,0,9,0,0,9,0,0,0,18,0,0,18,27
14585,Lebanon,2008,2008Lebanon,0,0,0,0,0,0,0,0,0,0,0,0,0,0,12723
14586,Lebanon,2008,2008Lebanon,0,0,0,0,0,0,0,0,0,0,5,0,0,5,15
14587,Lebanon,2008,2008Lebanon,0,0,0,0,0,10,10,0,0,0,0,0,31,31,41
14588,Lebanon,2008,2008Lebanon,0,0,0,0,0,23,23,0,0,0,0,0,66,66,89
14589,Lebanon,2008,2008Lebanon,0,0,0,5,0,0,5,0,0,0,0,0,0,0,10
14590,Lebanon,2008,2008Lebanon,0,0,0,6,0,0,6,0,0,0,8,0,0,8,14
14591,Lebanon,2008,2008Lebanon,0,0,0,9,0,0,9,0,0,0,18,0,0,18,27
14592,Lebanon,2008,2008Lebanon,0,7,0,8,0,5,20,0,0,6,11,0,10,27,47
14593,Lebanon,2009,2009Lebanon,0,0,0,0,0,0,0,0,0,0,0,0,0,0,3121
14594,Lebanon,2009,2009Lebanon,0,0,0,0,0,0,0,0,0,0,5,0,0,5,10
14595,Lebanon,2009,2009Lebanon,0,0,0,0,0,0,0,0,0,0,9,0,0,9,9
14596,Lebanon,2009,2009Lebanon,0,0,0,0,0,0,0,5,0,0,0,0,0,5,5
14597,Lebanon,2009,2009Lebanon,0,0,0,0,0,14,14,0,0,0,0,0,36,36,50
14598,Lebanon,2009,2009Lebanon,0,0,0,5,0,0,5,0,0,0,0,0,0,0,5
14599,Lebanon,2009,2009Lebanon,0,0,0,6,0,0,6,0,0,0,8,0,0,8,14
14600,Lebanon,2009,2009Lebanon,0,0,0,9,0,0,9,0,0,0,20,0,0,20,29
14601,Lebanon,2009,2009Lebanon,0,0,9,10,0,5,24,0,5,6,15,0,7,33,57
14602,Lebanon,2009,2009Lebanon,90,357,608,4073,547,0,5675,126,411,637,5564,537,0,7275,12950
14603,Lebanon,2010,2010Lebanon,0,0,0,0,0,0,0,0,0,0,0,0,0,0,3053
14604,Lebanon,2010,2010Lebanon,0,0,0,0,0,0,0,0,0,0,0,0,5,5,5
14605,Lebanon,2010,2010Lebanon,0,0,0,0,0,0,0,0,0,0,5,0,0,5,5
14606,Lebanon,2010,2010Lebanon,0,0,0,0,0,0,0,0,0,0,8,0,0,8,8
14607,Lebanon,2010,2010Lebanon,0,0,0,0,0,0,0,0,5,0,0,0,0,5,5
14608,Lebanon,2010,2010Lebanon,0,0,0,0,0,18,18,0,0,0,0,0,44,44,62
14609,Lebanon,2010,2010Lebanon,0,0,0,0,0,28,28,0,0,0,0,0,73,73,101
14610,Lebanon,2010,2010Lebanon,0,0,0,6,0,0,6,0,0,0,8,0,0,8,14
14611,Lebanon,2010,2010Lebanon,0,0,0,11,0,0,11,0,0,0,18,0,0,18,29
14612,Lebanon,2010,2010Lebanon,0,0,6,9,0,5,20,0,0,7,15,0,8,30,50
14613,Lebanon,2010,2010Lebanon,5,0,0,13,0,0,18,0,0,0,0,0,0,0,18
14614,Lebanon,2010,2010Lebanon,86,328,531,3901,592,0,5438,137,409,587,5365,578,0,7076,12514
14615,Lebanon,2011,2011Lebanon,0,0,0,0,0,0,0,0,0,0,0,0,0,0,1890
14616,Lebanon,2011,2011Lebanon,0,0,0,0,0,0,0,0,0,0,5,0,0,5,5
14617,Lebanon,2011,2011Lebanon,0,0,0,0,0,0,0,0,5,0,0,0,0,5,5
14618,Lebanon,2011,2011Lebanon,0,0,0,0,0,25,25,0,0,0,0,0,64,64,89
14619,Lebanon,2011,2011Lebanon,0,0,0,0,0,28,28,0,0,0,0,0,72,72,100
14620,Lebanon,2011,2011Lebanon,0,0,0,6,0,0,6,0,0,0,8,0,0,8,14
14621,Lebanon,2011,2011Lebanon,0,0,0,11,0,0,11,0,0,0,18,0,0,18,29
14622,Lebanon,2011,2011Lebanon,0,0,5,6,0,5,16,0,0,6,15,0,7,28,44
14623,Lebanon,2011,2011Lebanon,0,5,7,62,10,0,84,0,5,6,65,10,0,86,1104
14624,Lebanon,2011,2011Lebanon,5,0,5,17,0,0,27,0,0,0,0,0,0,0,27
14625,Lebanon,2011,2011Lebanon,87,287,449,3619,623,0,5065,92,352,495,5077,616,0,6632,11697
14626,Lebanon,2012,2012Lebanon,0,0,0,0,0,0,0,0,0,0,0,0,0,0,1839
14627,Lebanon,2012,2012Lebanon,0,0,0,0,0,0,0,0,0,0,0,0,6,6,6
14628,Lebanon,2012,2012Lebanon,0,0,0,0,0,0,0,0,0,0,6,0,0,6,12
14629,Lebanon,2012,2012Lebanon,0,0,0,0,0,0,0,0,5,0,0,0,0,5,5
14630,Lebanon,2012,2012Lebanon,0,0,0,0,0,0,0,0,6,0,0,0,0,6,6
14631,Lebanon,2012,2012Lebanon,0,0,0,0,0,26,26,0,0,0,0,0,61,61,87
14632,Lebanon,2012,2012Lebanon,0,0,0,0,0,29,29,0,0,0,0,0,74,74,103
14633,Lebanon,2012,2012Lebanon,0,0,0,5,0,0,5,0,0,0,0,0,0,0,5
14634,Lebanon,2012,2012Lebanon,0,0,0,6,0,0,6,0,0,0,8,0,0,8,14
14635,Lebanon,2012,2012Lebanon,0,0,0,11,0,0,11,0,0,0,18,0,0,18,29
14636,Lebanon,2012,2012Lebanon,0,0,5,6,0,5,16,0,0,6,12,0,7,25,41
14637,Lebanon,2012,2012Lebanon,0,0,5,15,0,0,20,0,0,5,22,0,0,27,1104
14638,Lebanon,2012,2012Lebanon,0,5,5,20,0,0,30,0,0,0,0,0,0,0,30
14639,Lebanon,2012,2012Lebanon,73,284,435,3711,687,0,5190,60,316,483,5088,682,0,6629,11819
14640,Lebanon,2013,2013Lebanon,0,0,0,0,0,0,0,0,0,0,0,0,0,0,1932
14641,Lebanon,2013,2013Lebanon,0,0,0,0,0,0,0,0,0,0,5,0,0,5,5
14642,Lebanon,2013,2013Lebanon,0,0,0,0,0,0,0,0,0,0,6,0,0,6,6
14643,Lebanon,2013,2013Lebanon,0,0,0,0,0,0,0,0,5,0,0,0,0,5,10
14644,Lebanon,2013,2013Lebanon,0,0,0,0,0,0,0,7,0,0,0,0,0,7,7
14645,Lebanon,2013,2013Lebanon,0,0,0,0,0,20,20,0,0,0,0,0,46,46,66
14646,Lebanon,2013,2013Lebanon,0,0,0,0,0,29,29,0,0,0,0,0,76,76,105
14647,Lebanon,2013,2013Lebanon,0,0,0,6,0,0,6,0,0,0,9,0,0,9,15
14648,Lebanon,2013,2013Lebanon,0,0,0,7,0,0,7,0,0,0,10,0,0,10,17
14649,Lebanon,2013,2013Lebanon,0,0,0,7,0,5,12,0,0,5,12,0,6,23,35
14650,Lebanon,2013,2013Lebanon,0,0,0,11,0,0,11,0,0,0,23,0,0,23,34
14651,Lebanon,2013,2013Lebanon,0,0,8,24,5,0,37,0,5,12,20,5,0,42,1103
14652,Lebanon,2013,2013Lebanon,0,10,0,15,0,0,25,0,0,0,0,0,0,0,25
14653,Lebanon,2013,2013Lebanon,6,16,25,125,25,0,197,8,17,21,185,21,0,252,449
14654,Lebanon,2014,2014Lebanon,0,0,0,0,0,0,0,0,0,0,0,0,0,0,2131
14655,Lebanon,2014,2014Lebanon,0,0,0,0,0,0,0,0,0,0,0,0,5,5,5
14656,Lebanon,2014,2014Lebanon,0,0,0,0,0,0,0,0,0,0,5,0,0,5,5
14657,Lebanon,2014,2014Lebanon,0,0,0,0,0,0,0,0,0,0,6,0,0,6,6
14658,Lebanon,2014,2014Lebanon,0,0,0,0,0,0,0,0,0,0,7,0,0,7,7
14659,Lebanon,2014,2014Lebanon,0,0,0,0,0,0,0,0,5,0,0,0,0,5,5
14660,Lebanon,2014,2014Lebanon,0,0,0,0,0,0,0,0,7,0,0,0,0,7,7
14661,Lebanon,2014,2014Lebanon,0,0,0,0,0,30,30,0,0,0,0,0,78,78,108
14662,Lebanon,2014,2014Lebanon,0,0,0,7,0,0,7,0,0,0,11,0,0,11,18
14663,Lebanon,2014,2014Lebanon,0,0,0,77,0,0,77,0,0,5,312,0,0,317,394
14664,Lebanon,2014,2014Lebanon,0,0,5,5,0,5,15,0,0,5,15,0,6,26,41
14665,Lebanon,2014,2014Lebanon,0,0,12,5,0,0,17,0,0,5,0,0,0,5,22
14666,Lebanon,2014,2014Lebanon,5,8,0,24,5,0,42,5,7,6,27,0,0,45,1024
14667,Lebanon,2014,2014Lebanon,6,18,29,135,30,0,218,11,23,29,183,25,0,271,489
14668,Lebanon,2015,2015Lebanon,0,0,0,0,0,0,0,0,0,0,0,0,0,0,3051
14669,Lebanon,2015,2015Lebanon,0,0,0,0,0,0,0,0,0,0,0,0,7,7,7
14670,Lebanon,2015,2015Lebanon,0,0,0,0,0,0,0,0,0,0,5,0,0,5,5
14671,Lebanon,2015,2015Lebanon,0,0,0,0,0,0,0,0,0,0,6,0,0,6,6
14672,Lebanon,2015,2015Lebanon,0,0,0,0,0,0,0,0,0,6,0,0,0,6,6
14673,Lebanon,2015,2015Lebanon,0,0,0,0,0,0,0,7,0,0,0,0,0,7,7
14674,Lebanon,2015,2015Lebanon,0,0,0,0,0,33,33,0,0,0,0,0,84,84,117
14675,Lebanon,2015,2015Lebanon,0,0,0,0,0,42,42,0,0,0,0,0,67,67,109
14676,Lebanon,2015,2015Lebanon,0,0,0,0,5,0,5,0,0,0,0,0,0,0,5
14677,Lebanon,2015,2015Lebanon,0,0,0,5,0,0,5,0,0,0,0,0,0,0,5
14678,Lebanon,2015,2015Lebanon,0,0,0,5,0,0,5,0,0,0,8,0,0,8,13
14679,Lebanon,2015,2015Lebanon,0,0,0,6,0,0,6,0,0,0,0,0,0,0,6
14680,Lebanon,2015,2015Lebanon,0,0,0,8,0,0,8,0,0,0,11,0,0,11,19
14681,Lebanon,2015,2015Lebanon,0,0,0,16,5,0,21,0,0,5,0,0,0,5,26
14682,Lebanon,2015,2015Lebanon,0,7,0,0,0,0,7,0,0,0,0,0,0,0,7
14683,Lebanon,2015,2015Lebanon,0,7,0,31,0,0,38,0,5,6,350,0,0,361,399
14684,Lebanon,2015,2015Lebanon,0,8,0,14,0,0,22,0,0,5,17,0,0,22,44
14685,Lebanon,2015,2015Lebanon,8,22,22,147,34,0,233,12,33,20,199,24,0,288,521
14686,Lebanon,2016,2016Lebanon,0,0,0,0,0,0,0,0,0,0,0,0,0,0,2366
14687,Lebanon,2016,2016Lebanon,0,0,0,0,0,0,0,0,0,0,0,0,9,9,9
14688,Lebanon,2016,2016Lebanon,0,0,0,0,0,0,0,0,0,0,5,0,0,5,10
14689,Lebanon,2016,2016Lebanon,0,0,0,0,0,0,0,0,0,0,6,0,0,6,6
14690,Lebanon,2016,2016Lebanon,0,0,0,0,0,0,0,7,0,0,0,0,0,7,7
14691,Lebanon,2016,2016Lebanon,0,0,0,0,0,37,37,0,0,0,0,0,62,62,99
14692,Lebanon,2016,2016Lebanon,0,0,0,0,0,39,39,0,0,0,0,0,95,95,134
14693,Lebanon,2016,2016Lebanon,0,0,0,0,5,0,5,0,0,0,0,0,0,0,5
14694,Lebanon,2016,2016Lebanon,0,0,0,5,0,0,5,0,0,0,0,0,0,0,5
14695,Lebanon,2016,2016Lebanon,0,0,0,5,0,0,5,0,0,0,8,0,0,8,13
14696,Lebanon,2016,2016Lebanon,0,0,0,6,0,0,6,0,0,0,0,0,0,0,6
14697,Lebanon,2016,2016Lebanon,0,0,0,6,0,0,6,0,0,0,6,0,0,6,12
14698,Lebanon,2016,2016Lebanon,0,0,0,8,0,0,8,0,0,0,11,0,0,11,19
14699,Lebanon,2016,2016Lebanon,0,0,0,17,5,0,22,0,5,0,0,0,0,5,27
14700,Lebanon,2016,2016Lebanon,0,0,0,26,0,0,26,0,0,0,32,0,0,32,741
14701,Lebanon,2016,2016Lebanon,0,0,5,7,0,6,18,0,0,0,19,0,7,26,44
14702,Lebanon,2016,2016Lebanon,0,6,0,0,0,0,6,0,0,0,7,0,0,7,13
14703,Lebanon,2016,2016Lebanon,0,7,0,28,5,0,40,0,5,6,348,0,0,359,399
14704,Lebanon,2016,2016Lebanon,20,46,34,248,38,0,386,33,44,39,276,26,0,418,804
14705,Lebanon,2017,2017Lebanon,0,0,0,0,0,0,0,0,0,0,0,0,0,0,3210
14706,Lebanon,2017,2017Lebanon,0,0,0,0,0,0,0,0,0,0,0,0,9,9,9
14707,Lebanon,2017,2017Lebanon,0,0,0,0,0,0,0,0,0,0,5,0,0,5,5
14708,Lebanon,2017,2017Lebanon,0,0,0,0,0,0,0,0,0,0,7,0,0,7,406
14709,Lebanon,2017,2017Lebanon,0,0,0,0,0,0,0,7,0,0,0,0,0,7,7
14710,Lebanon,2017,2017Lebanon,0,0,0,0,0,37,37,0,0,0,0,0,98,98,135
14711,Lebanon,2017,2017Lebanon,0,0,0,0,5,0,5,0,0,0,0,0,0,0,5
14712,Lebanon,2017,2017Lebanon,0,0,0,0,6,0,6,0,0,0,0,0,0,0,6
14713,Lebanon,2017,2017Lebanon,0,0,0,5,0,0,5,0,0,0,8,0,0,8,13
14714,Lebanon,2017,2017Lebanon,0,0,0,6,0,0,6,0,0,0,0,0,0,0,12
14715,Lebanon,2017,2017Lebanon,0,0,0,8,0,0,8,0,0,0,11,0,0,11,19
14716,Lebanon,2017,2017Lebanon,0,0,5,8,0,8,21,0,0,0,12,0,8,20,41
14717,Lebanon,2017,2017Lebanon,0,0,6,0,0,0,6,0,0,0,0,0,0,0,6
14718,Lebanon,2017,2017Lebanon,0,0,6,0,0,0,6,0,0,0,7,0,0,7,13
14719,Lebanon,2017,2017Lebanon,0,5,5,14,0,0,24,0,0,0,0,0,0,0,24
14720,Lebanon,2017,2017Lebanon,67,86,67,450,48,0,718,74,98,70,397,33,0,672,1390
14721,Lebanon,2018,2018Lebanon,0,0,0,0,0,0,0,0,0,0,0,0,0,0,2864
14722,Lebanon,2018,2018Lebanon,0,0,0,0,0,0,0,0,0,0,5,0,0,5,10
14723,Lebanon,2018,2018Lebanon,0,0,0,0,0,0,0,0,6,0,0,0,0,6,6
14724,Lebanon,2018,2018Lebanon,0,0,0,0,0,0,0,0,8,0,0,0,0,8,8
14725,Lebanon,2018,2018Lebanon,0,0,0,0,0,40,40,0,0,0,0,0,100,100,140
14726,Lebanon,2018,2018Lebanon,0,0,0,0,9,0,9,0,0,0,0,0,0,0,9
14727,Lebanon,2018,2018Lebanon,0,0,0,5,0,0,5,0,0,0,0,0,0,0,15
14728,Lebanon,2018,2018Lebanon,0,0,0,6,0,0,6,0,0,0,0,0,0,0,6
14729,Lebanon,2018,2018Lebanon,0,0,0,6,0,0,6,0,0,0,6,0,0,6,12
14730,Lebanon,2018,2018Lebanon,0,0,0,7,0,0,7,0,0,0,8,0,0,8,15
14731,Lebanon,2018,2018Lebanon,0,0,0,8,0,0,8,0,0,0,11,0,0,11,19
14732,Lebanon,2018,2018Lebanon,0,0,5,9,0,7,21,0,0,0,10,0,5,15,36
14733,Lebanon,2018,2018Lebanon,0,0,6,0,0,0,6,0,0,0,7,0,0,7,13
14734,Lebanon,2018,2018Lebanon,0,5,0,14,5,0,24,0,0,0,0,0,0,0,24
14735,Lebanon,2018,2018Lebanon,5,8,5,121,0,0,139,0,14,6,37,0,0,57,886
14736,Lebanon,2018,2018Lebanon,79,104,69,499,54,0,805,78,116,81,438,39,0,752,1557
14737,Lebanon,2019,2019Lebanon,0,0,0,0,0,0,0,0,0,0,0,0,0,0,3647
14738,Lebanon,2019,2019Lebanon,0,0,0,0,0,0,0,0,0,0,0,0,8,8,8
14739,Lebanon,2019,2019Lebanon,0,0,0,0,0,0,0,0,0,0,5,0,0,5,5
14740,Lebanon,2019,2019Lebanon,0,0,0,0,0,0,0,0,0,5,0,0,0,5,5
14741,Lebanon,2019,2019Lebanon,0,0,0,0,0,0,0,0,6,0,0,0,0,6,6
14742,Lebanon,2019,2019Lebanon,0,0,0,0,0,0,0,0,8,0,0,0,0,8,8
14743,Lebanon,2019,2019Lebanon,0,0,0,0,0,45,45,0,0,0,0,0,102,102,147
14744,Lebanon,2019,2019Lebanon,0,0,0,0,6,0,6,0,0,0,0,0,0,0,6
14745,Lebanon,2019,2019Lebanon,0,0,0,5,0,0,5,0,0,0,0,0,0,0,15
14746,Lebanon,2019,2019Lebanon,0,0,0,6,0,0,6,0,0,0,0,0,0,0,12
14747,Lebanon,2019,2019Lebanon,0,0,0,6,0,0,6,0,0,0,6,0,0,6,12
14748,Lebanon,2019,2019Lebanon,0,0,0,6,0,0,6,0,0,0,8,0,0,8,14
14749,Lebanon,2019,2019Lebanon,0,0,0,7,0,0,7,0,0,0,9,0,0,9,16
14750,Lebanon,2019,2019Lebanon,0,0,0,9,0,0,9,0,5,0,10,0,0,15,24
14751,Lebanon,2019,2019Lebanon,0,0,5,8,0,0,13,0,5,0,9,0,0,14,43
14752,Lebanon,2019,2019Lebanon,0,0,5,13,5,0,23,0,0,0,0,0,0,0,23
14753,Lebanon,2019,2019Lebanon,86,99,84,530,53,0,852,79,139,84,461,41,0,804,1656
14754,Lebanon,2020,2020Lebanon,0,0,0,0,0,0,0,0,0,0,0,0,0,0,2640
14755,Lebanon,2020,2020Lebanon,0,0,0,0,0,0,0,0,0,0,0,0,8,8,8
14756,Lebanon,2020,2020Lebanon,0,0,0,0,0,0,0,0,0,0,5,0,0,5,10
14757,Lebanon,2020,2020Lebanon,0,0,0,0,0,0,0,0,0,5,0,0,0,5,10
14758,Lebanon,2020,2020Lebanon,0,0,0,0,0,0,0,0,6,0,0,0,0,6,6
14759,Lebanon,2020,2020Lebanon,0,0,0,0,0,0,0,0,8,0,0,0,0,8,8
14760,Lebanon,2020,2020Lebanon,0,0,0,0,0,5,5,0,0,0,0,0,0,0,10
14761,Lebanon,2020,2020Lebanon,0,0,0,0,0,44,44,0,0,0,0,0,61,61,105
14762,Lebanon,2020,2020Lebanon,0,0,0,0,6,0,6,0,0,0,0,0,0,0,6
14763,Lebanon,2020,2020Lebanon,0,0,0,5,0,0,5,0,0,0,0,0,0,0,5
14764,Lebanon,2020,2020Lebanon,0,0,0,6,0,0,6,0,0,0,0,0,0,0,6
14765,Lebanon,2020,2020Lebanon,0,0,0,6,0,0,6,0,0,0,6,0,0,6,12
14766,Lebanon,2020,2020Lebanon,0,0,0,6,0,0,6,0,0,0,8,0,0,8,14
14767,Lebanon,2020,2020Lebanon,0,0,0,6,0,0,6,0,0,5,8,0,0,13,19
14768,Lebanon,2020,2020Lebanon,0,0,0,8,0,0,8,0,5,0,5,0,0,10,18
14769,Lebanon,2020,2020Lebanon,0,0,0,9,0,0,9,0,0,0,0,0,0,0,9
14770,Lebanon,2020,2020Lebanon,0,0,0,10,0,0,10,0,0,0,10,5,0,15,25
14771,Lebanon,2020,2020Lebanon,0,0,0,11,0,0,11,0,5,0,12,0,0,17,44
14772,Lebanon,2020,2020Lebanon,0,0,0,16,6,0,22,0,0,0,0,0,0,0,22
14773,Lebanon,2020,2020Lebanon,0,0,0,43,0,21,64,0,0,0,24,0,31,55,743
14774,Lebanon,2020,2020Lebanon,97,106,101,547,60,0,911,81,144,105,494,40,0,864,1775
14775,Lebanon,2021,2021Lebanon,0,0,0,0,0,0,0,0,0,0,0,0,0,0,2936
14776,Lebanon,2021,2021Lebanon,0,0,0,0,0,0,0,0,0,0,0,0,9,9,9
14777,Lebanon,2021,2021Lebanon,0,0,0,0,0,0,0,0,0,0,5,0,0,5,10
14778,Lebanon,2021,2021Lebanon,0,0,0,0,0,0,0,0,0,0,11,0,0,11,11
14779,Lebanon,2021,2021Lebanon,0,0,0,0,0,0,0,0,0,5,0,0,0,5,10
14780,Lebanon,2021,2021Lebanon,0,0,0,0,0,0,0,0,6,0,0,0,0,6,6
14781,Lebanon,2021,2021Lebanon,0,0,0,0,0,0,0,0,8,0,0,0,0,8,8
14782,Lebanon,2021,2021Lebanon,0,0,0,0,0,5,5,0,0,0,0,0,0,0,5
14783,Lebanon,2021,2021Lebanon,0,0,0,0,5,0,5,0,0,0,0,0,0,0,5
14784,Lebanon,2021,2021Lebanon,0,0,0,5,0,0,5,0,0,0,0,0,0,0,10
14785,Lebanon,2021,2021Lebanon,0,0,0,5,0,0,5,0,0,0,5,0,0,5,10
14786,Lebanon,2021,2021Lebanon,0,0,0,6,0,0,6,0,0,0,6,0,0,6,24
14787,Lebanon,2021,2021Lebanon,0,0,0,6,0,0,6,0,0,5,8,0,0,13,19
14788,Lebanon,2021,2021Lebanon,0,0,0,8,0,0,8,0,0,0,8,0,0,8,16
14789,Lebanon,2021,2021Lebanon,0,0,0,9,0,0,9,0,0,0,0,0,0,0,9
14790,Lebanon,2021,2021Lebanon,0,0,0,10,0,0,10,0,0,0,11,5,0,16,26
14791,Lebanon,2021,2021Lebanon,0,0,0,12,0,0,12,0,7,0,7,5,0,19,47
14792,Lebanon,2021,2021Lebanon,0,0,5,0,0,0,5,0,0,0,0,0,0,0,5
14793,Lebanon,2021,2021Lebanon,0,0,5,5,0,0,10,0,0,0,0,0,0,0,10
14794,Lebanon,2021,2021Lebanon,0,5,0,13,6,0,24,0,0,0,0,0,0,0,24
14795,Lebanon,2021,2021Lebanon,16,22,9,128,14,20,209,8,37,23,126,5,31,230,989
14796,Lebanon,2021,2021Lebanon,76,141,122,580,72,0,991,63,164,112,493,49,0,881,1872
14797,Liberia,2001,2001Liberia,0,0,0,0,0,0,0,0,0,0,0,0,0,0,27851
14798,Liberia,2001,2001Liberia,0,0,0,0,0,0,0,0,0,0,5,0,0,5,175
14799,Liberia,2001,2001Liberia,0,0,0,0,0,0,0,0,0,0,6,0,0,6,6
14800,Liberia,2001,2001Liberia,0,0,0,0,0,0,0,0,0,0,7,0,0,7,7
14801,Liberia,2001,2001Liberia,0,0,0,0,0,0,0,0,0,0,8,0,0,8,8
14802,Liberia,2001,2001Liberia,0,0,0,0,0,0,0,0,0,5,0,0,0,5,5
14803,Liberia,2001,2001Liberia,0,0,0,0,0,0,0,0,0,5,38,0,0,43,43
14804,Liberia,2001,2001Liberia,0,0,0,0,0,9,9,0,0,0,0,0,26,26,35
14805,Liberia,2001,2001Liberia,0,0,0,0,0,51,51,0,0,0,0,0,100,100,151
14806,Liberia,2001,2001Liberia,0,0,0,5,0,0,5,0,0,0,7,0,0,7,12
14807,Liberia,2001,2001Liberia,0,0,5,0,0,0,5,0,0,0,5,0,0,5,10
14808,Liberia,2001,2001Liberia,0,5,6,0,0,0,11,0,11,10,9,0,0,30,41
14809,Liberia,2001,2001Liberia,5,6,0,5,0,0,16,0,0,6,5,0,0,11,27
14810,Liberia,2001,2001Liberia,5,8,7,58,0,0,78,7,8,6,125,0,0,146,224
14811,Liberia,2001,2001Liberia,34,53,41,511,11,0,650,36,82,70,653,14,0,855,1505
14812,Liberia,2001,2001Liberia,159,956,820,2260,0,0,4195,156,954,818,2742,0,0,4670,8865
14813,Liberia,2001,2001Liberia,3608,5247,4498,11109,2718,0,27180,5476,6140,5263,8762,2775,0,28416,82792
14814,Liberia,2001,2001Liberia,9106,14606,12518,25647,4856,0,66733,6560,12861,11024,21758,3910,0,56113,122846
14815,Liberia,2002,2002Liberia,0,0,0,0,0,0,0,0,0,0,0,0,0,0,18924
14816,Liberia,2002,2002Liberia,0,0,0,0,0,0,0,0,0,0,5,0,0,5,15
14817,Liberia,2002,2002Liberia,0,0,0,0,0,0,0,0,0,0,6,0,0,6,12
14818,Liberia,2002,2002Liberia,0,0,0,0,0,0,0,0,0,0,8,0,0,8,8
14819,Liberia,2002,2002Liberia,0,0,0,0,0,46,46,0,0,0,0,0,102,102,148
14820,Liberia,2002,2002Liberia,0,0,0,5,0,0,5,0,0,0,5,0,0,5,10
14821,Liberia,2002,2002Liberia,0,0,0,5,0,0,5,0,0,0,44,0,0,44,49
14822,Liberia,2002,2002Liberia,0,0,0,5,0,0,5,0,5,0,5,0,0,10,15
14823,Liberia,2002,2002Liberia,0,0,5,0,0,0,5,0,0,5,5,0,0,10,15
14824,Liberia,2002,2002Liberia,0,5,6,0,0,0,11,0,11,10,9,0,0,30,41
14825,Liberia,2002,2002Liberia,0,7,0,0,0,0,7,0,0,0,0,0,0,0,7
14826,Liberia,2002,2002Liberia,0,9,0,0,0,0,9,0,0,9,9,0,0,18,27
14827,Liberia,2002,2002Liberia,5,0,0,10,0,0,15,5,0,0,14,0,0,19,34
14828,Liberia,2002,2002Liberia,5,8,7,66,0,0,86,7,8,6,128,0,0,149,235
14829,Liberia,2002,2002Liberia,63,65,55,598,11,0,792,60,97,84,745,14,0,1000,1792
14830,Liberia,2002,2002Liberia,393,2349,2012,5536,6,0,10296,379,2344,2009,6668,0,0,11400,28298
14831,Liberia,2002,2002Liberia,3046,3976,3404,11615,928,0,22969,2935,3809,3268,9263,756,0,20031,43000
14832,Liberia,2002,2002Liberia,3838,4284,3672,11824,2485,0,26103,3734,3952,3387,11282,2909,0,25264,63491
14833,Liberia,2002,2002Liberia,7766,10188,8732,20708,4352,0,51746,10419,11774,10089,14929,3944,0,51155,119293
14834,Liberia,2003,2003Liberia,0,0,0,0,0,0,0,0,0,0,0,0,0,0,20129
14835,Liberia,2003,2003Liberia,0,0,0,0,0,0,0,0,0,0,5,0,0,5,10
14836,Liberia,2003,2003Liberia,0,0,0,0,0,0,0,0,0,0,10,0,0,10,10
14837,Liberia,2003,2003Liberia,0,0,0,0,0,0,0,0,7,0,0,0,0,7,7
14838,Liberia,2003,2003Liberia,0,0,0,0,0,46,46,0,0,0,0,0,108,108,154
14839,Liberia,2003,2003Liberia,0,0,0,5,0,0,5,0,0,0,0,0,0,0,5
14840,Liberia,2003,2003Liberia,0,0,0,5,0,0,5,0,0,0,8,0,0,8,13
14841,Liberia,2003,2003Liberia,0,0,0,5,0,0,5,0,0,0,14,0,0,14,19
14842,Liberia,2003,2003Liberia,0,0,0,5,0,0,5,0,0,0,17,0,0,17,22
14843,Liberia,2003,2003Liberia,0,0,0,5,0,0,5,0,0,0,20,0,0,20,25
14844,Liberia,2003,2003Liberia,0,0,0,6,0,0,6,0,0,0,0,0,0,0,6
14845,Liberia,2003,2003Liberia,0,0,0,7,0,0,7,0,0,0,0,0,0,0,7
14846,Liberia,2003,2003Liberia,0,0,0,7,0,0,7,0,5,0,6,0,0,11,18
14847,Liberia,2003,2003Liberia,0,6,0,0,0,0,6,0,0,0,0,0,0,0,6
14848,Liberia,2003,2003Liberia,0,7,0,5,0,0,12,0,7,0,8,0,0,15,36
14849,Liberia,2003,2003Liberia,0,7,6,5,0,0,18,0,12,11,129,0,0,152,170
14850,Liberia,2003,2003Liberia,5,0,0,6,0,0,11,8,0,0,18,0,0,26,37
14851,Liberia,2003,2003Liberia,5,5,5,32,0,0,47,5,5,5,37,0,0,52,99
14852,Liberia,2003,2003Liberia,8,9,8,66,0,0,91,14,8,6,130,0,0,158,249
14853,Liberia,2003,2003Liberia,16,36,30,97,5,0,184,28,29,24,126,6,0,213,397
14854,Liberia,2003,2003Liberia,41,48,35,226,5,0,355,33,45,34,303,0,0,415,770
14855,Liberia,2003,2003Liberia,146,188,160,1155,23,0,1672,128,184,158,1512,20,0,2002,3674
14856,Liberia,2003,2003Liberia,2079,4082,3499,11484,536,0,21680,2016,3609,3093,11813,255,0,20786,42466
14857,Liberia,2003,2003Liberia,4388,3847,3297,11437,2903,0,25872,4338,3398,2913,11051,0,3148,24848,61192
14858,Liberia,2003,2003Liberia,6576,6940,5948,18600,1577,0,39641,6608,6930,5939,13898,1164,0,34539,74180
14859,Liberia,2003,2003Liberia,12243,13595,11651,27631,5087,0,70207,14754,15153,12983,19901,4457,0,67248,149639
14860,Liberia,2004,2004Liberia,0,0,0,0,0,0,0,0,0,0,0,0,0,0,26854
14861,Liberia,2004,2004Liberia,0,0,0,0,0,0,0,0,0,0,5,0,0,5,15
14862,Liberia,2004,2004Liberia,0,0,0,0,0,0,0,0,0,0,6,0,0,6,6
14863,Liberia,2004,2004Liberia,0,0,0,0,0,0,0,0,0,0,9,0,0,9,9
14864,Liberia,2004,2004Liberia,0,0,0,0,0,0,0,0,0,0,10,0,0,10,10
14865,Liberia,2004,2004Liberia,0,0,0,0,0,0,0,0,0,0,41,0,0,41,41
14866,Liberia,2004,2004Liberia,0,0,0,0,0,0,0,0,0,5,0,0,0,5,5
14867,Liberia,2004,2004Liberia,0,0,0,0,0,0,0,0,0,8,0,0,0,8,8
14868,Liberia,2004,2004Liberia,0,0,0,0,0,0,0,0,5,0,0,0,0,5,5
14869,Liberia,2004,2004Liberia,0,0,0,0,0,7,7,0,0,0,5,0,0,5,12
14870,Liberia,2004,2004Liberia,0,0,0,6,0,0,6,0,0,0,9,0,0,9,15
14871,Liberia,2004,2004Liberia,0,0,0,8,0,0,8,0,0,0,5,0,0,5,13
14872,Liberia,2004,2004Liberia,0,0,0,9,0,0,9,0,0,0,9,0,0,9,18
14873,Liberia,2004,2004Liberia,0,0,5,5,0,0,10,0,0,6,6,0,0,12,22
14874,Liberia,2004,2004Liberia,0,0,6,9,0,0,15,0,5,0,43,0,0,48,63
14875,Liberia,2004,2004Liberia,0,0,8,13,0,0,21,17,20,18,40,0,0,95,116
14876,Liberia,2004,2004Liberia,0,5,5,0,0,0,10,0,8,0,0,0,0,8,18
14877,Liberia,2004,2004Liberia,0,7,0,5,0,0,12,5,6,0,13,0,0,24,36
14878,Liberia,2004,2004Liberia,0,8,0,66,0,0,74,0,5,5,165,0,0,175,290
14879,Liberia,2004,2004Liberia,5,0,0,21,0,0,26,6,0,0,120,0,0,126,152
14880,Liberia,2004,2004Liberia,8,0,0,0,0,0,8,0,0,0,8,0,0,8,16
14881,Liberia,2004,2004Liberia,8,8,6,46,0,0,68,8,8,7,45,0,0,68,136
14882,Liberia,2004,2004Liberia,9,8,7,12,0,0,36,6,5,0,237,0,0,248,284
14883,Liberia,2004,2004Liberia,18,40,34,111,5,0,208,31,32,28,140,7,0,238,446
14884,Liberia,2004,2004Liberia,129,146,125,933,5,0,1338,106,88,75,1311,14,0,1594,2932
14885,Liberia,2004,2004Liberia,2151,3821,3273,11008,486,0,20739,2163,3383,2900,11444,224,0,20114,40853
14886,Liberia,2004,2004Liberia,5095,6027,5165,14007,1182,0,31476,5216,6115,5242,12732,1018,0,30323,65433
14887,Liberia,2004,2004Liberia,6753,6640,5690,16216,1834,0,37133,6610,6407,5493,13171,1588,0,33269,70402
14888,Liberia,2004,2004Liberia,8135,14922,12791,24747,2915,0,63510,11015,15631,13410,20923,2767,0,63746,127256
14889,Liberia,2005,2005Liberia,0,0,0,0,0,0,0,0,0,0,0,0,0,0,30382
14890,Liberia,2005,2005Liberia,0,0,0,0,0,0,0,0,0,0,5,0,0,5,25
14891,Liberia,2005,2005Liberia,0,0,0,0,0,0,0,0,0,0,13,0,0,13,13
14892,Liberia,2005,2005Liberia,0,0,0,0,0,0,0,0,0,7,0,0,0,7,7
14893,Liberia,2005,2005Liberia,0,0,0,0,0,52,52,0,0,0,0,0,140,140,192
14894,Liberia,2005,2005Liberia,0,0,0,5,0,0,5,0,0,0,12,0,0,12,17
14895,Liberia,2005,2005Liberia,0,0,0,5,0,6,11,0,0,0,10,0,6,16,27
14896,Liberia,2005,2005Liberia,0,0,0,6,0,0,6,0,0,0,9,0,0,9,15
14897,Liberia,2005,2005Liberia,0,0,0,7,0,0,7,0,0,0,44,0,0,44,51
14898,Liberia,2005,2005Liberia,0,0,0,9,0,0,9,0,0,0,5,0,0,5,14
14899,Liberia,2005,2005Liberia,0,0,0,9,0,0,9,0,0,0,6,0,0,6,15
14900,Liberia,2005,2005Liberia,0,0,0,83,5,0,88,0,0,8,185,0,0,193,281
14901,Liberia,2005,2005Liberia,0,0,6,11,0,0,17,0,0,9,44,0,0,53,70
14902,Liberia,2005,2005Liberia,0,0,9,0,0,0,9,0,0,5,5,0,0,10,19
14903,Liberia,2005,2005Liberia,0,5,0,0,0,0,5,0,0,0,23,0,0,23,28
14904,Liberia,2005,2005Liberia,0,7,0,5,0,0,12,5,6,0,13,0,0,24,36
14905,Liberia,2005,2005Liberia,0,9,0,0,0,0,9,0,0,0,0,0,0,0,9
14906,Liberia,2005,2005Liberia,5,5,5,13,0,0,28,0,6,6,22,0,0,34,62
14907,Liberia,2005,2005Liberia,6,0,0,20,0,0,26,0,0,0,8,0,0,8,34
14908,Liberia,2005,2005Liberia,18,40,34,102,5,0,199,31,30,26,130,7,0,224,423
14909,Liberia,2005,2005Liberia,235,385,330,1799,71,0,2820,377,486,416,1910,42,0,3231,6051
14910,Liberia,2005,2005Liberia,2247,3550,3043,10291,415,0,19546,2287,3149,2699,10825,178,0,19138,38684
14911,Liberia,2005,2005Liberia,3586,3464,2968,11149,497,0,21664,3647,3067,2628,8480,433,0,18255,39919
14912,Liberia,2005,2005Liberia,3810,6489,5563,12750,1077,0,29689,3881,6499,5570,8651,520,0,25121,54810
14913,Liberia,2005,2005Liberia,3902,6111,5236,14067,1209,0,30525,4060,6134,5257,12957,1019,0,29427,59952
14914,Liberia,2006,2006Liberia,0,0,0,0,0,0,0,0,0,0,0,0,0,0,41601
14915,Liberia,2006,2006Liberia,0,0,0,0,0,0,0,0,0,0,5,0,0,5,25
14916,Liberia,2006,2006Liberia,0,0,0,0,0,0,0,0,0,0,7,0,0,7,7
14917,Liberia,2006,2006Liberia,0,0,0,0,0,0,0,0,0,0,9,0,0,9,9
14918,Liberia,2006,2006Liberia,0,0,0,0,0,0,0,0,0,0,28,0,0,28,28
14919,Liberia,2006,2006Liberia,0,0,0,0,0,9,9,0,0,0,0,0,6,6,15
14920,Liberia,2006,2006Liberia,0,0,0,0,0,13,13,0,0,0,0,0,243,243,256
14921,Liberia,2006,2006Liberia,0,0,0,0,0,15,15,0,0,0,0,0,15,15,30
14922,Liberia,2006,2006Liberia,0,0,0,0,0,52,52,0,0,0,0,0,151,151,203
14923,Liberia,2006,2006Liberia,0,0,0,5,0,0,5,0,0,0,10,0,0,10,15
14924,Liberia,2006,2006Liberia,0,0,0,7,0,0,7,0,0,0,56,0,0,56,63
14925,Liberia,2006,2006Liberia,0,0,0,86,0,0,86,0,0,0,182,0,0,182,268
14926,Liberia,2006,2006Liberia,0,0,5,0,0,0,5,0,0,0,0,0,0,0,5
14927,Liberia,2006,2006Liberia,0,0,6,11,0,0,17,0,0,9,48,0,0,57,74
14928,Liberia,2006,2006Liberia,0,0,7,5,0,0,12,5,0,6,13,0,0,24,36
14929,Liberia,2006,2006Liberia,0,5,5,0,0,0,10,0,5,0,5,0,0,10,20
14930,Liberia,2006,2006Liberia,0,6,0,14,0,0,20,0,0,6,59,0,0,65,85
14931,Liberia,2006,2006Liberia,0,8,0,0,0,0,8,0,0,0,0,0,0,0,8
14932,Liberia,2006,2006Liberia,5,8,0,15,0,0,28,5,9,7,39,0,0,60,88
14933,Liberia,2006,2006Liberia,6,0,0,6,0,0,12,0,0,0,24,0,0,24,36
14934,Liberia,2006,2006Liberia,8,0,0,15,0,0,23,6,0,0,124,0,0,130,153
14935,Liberia,2006,2006Liberia,12,10,5,52,0,0,79,10,8,6,60,0,0,84,163
14936,Liberia,2006,2006Liberia,17,57,17,98,5,0,194,30,21,33,126,7,0,217,411
14937,Liberia,2006,2006Liberia,70,65,50,109,115,0,409,82,57,42,70,111,0,362,771
14938,Liberia,2006,2006Liberia,266,248,417,1599,69,0,2599,357,202,650,1930,40,0,3179,5778
14939,Liberia,2006,2006Liberia,537,3507,2976,10705,550,0,18275,457,2636,2393,11632,260,0,17378,35653
14940,Liberia,2006,2006Liberia,1103,2785,1874,5416,286,0,11464,1282,2666,1905,4301,198,0,10352,21816
14941,Liberia,2006,2006Liberia,1699,3367,2016,6506,382,0,13970,1734,3224,2074,5950,359,0,13341,27311
14942,Liberia,2006,2006Liberia,1945,2789,2162,7010,306,0,14212,2032,1801,1874,5421,275,0,11403,25615
14943,Liberia,2007,2007Liberia,0,0,0,0,0,0,0,0,0,0,0,0,0,0,9260
14944,Liberia,2007,2007Liberia,0,0,0,0,0,0,0,0,0,0,5,0,0,5,35
14945,Liberia,2007,2007Liberia,0,0,0,0,0,0,0,0,0,0,6,0,0,6,6
14946,Liberia,2007,2007Liberia,0,0,0,0,0,0,0,0,0,0,8,0,0,8,8
14947,Liberia,2007,2007Liberia,0,0,0,0,0,5,5,0,0,0,0,0,7,7,12
14948,Liberia,2007,2007Liberia,0,0,0,0,0,54,54,0,0,0,0,0,154,154,208
14949,Liberia,2007,2007Liberia,0,0,0,5,0,0,5,0,0,0,0,0,0,0,5
14950,Liberia,2007,2007Liberia,0,0,0,11,0,7,18,0,0,0,10,0,7,17,35
14951,Liberia,2007,2007Liberia,0,0,0,66,0,0,66,0,0,0,170,0,0,170,236
14952,Liberia,2007,2007Liberia,0,0,6,0,0,0,6,0,0,0,0,0,0,0,6
14953,Liberia,2007,2007Liberia,0,0,6,11,0,0,17,0,0,9,49,0,0,58,75
14954,Liberia,2007,2007Liberia,0,0,7,5,0,0,12,5,0,6,13,0,0,24,36
14955,Liberia,2007,2007Liberia,0,5,0,0,0,0,5,0,0,5,19,0,0,24,29
14956,Liberia,2007,2007Liberia,0,5,0,12,0,0,17,0,5,27,205,0,0,237,254
14957,Liberia,2007,2007Liberia,0,5,5,0,0,0,10,0,5,0,5,0,0,10,20
14958,Liberia,2007,2007Liberia,0,6,0,14,0,0,20,0,0,6,59,0,0,65,85
14959,Liberia,2007,2007Liberia,0,6,8,33,0,0,47,7,0,0,21,5,0,33,80
14960,Liberia,2007,2007Liberia,0,8,0,0,0,0,8,0,0,0,0,0,0,0,8
14961,Liberia,2007,2007Liberia,5,0,0,0,0,0,5,0,0,0,0,0,0,0,5
14962,Liberia,2007,2007Liberia,5,8,0,20,0,0,33,5,9,8,41,0,0,63,96
14963,Liberia,2007,2007Liberia,6,0,0,6,0,0,12,0,0,0,26,0,0,26,38
14964,Liberia,2007,2007Liberia,8,0,0,0,0,0,8,0,0,0,10,0,0,10,23
14965,Liberia,2007,2007Liberia,8,0,0,16,0,0,24,7,0,0,113,0,0,120,144
14966,Liberia,2007,2007Liberia,12,10,5,57,0,0,84,11,8,6,66,0,0,91,175
14967,Liberia,2007,2007Liberia,70,65,50,119,115,0,419,82,57,42,84,111,0,376,795
14968,Liberia,2007,2007Liberia,70,252,256,1843,48,0,2469,88,252,352,2320,47,0,3059,5528
14969,Liberia,2007,2007Liberia,396,896,739,2198,82,0,4311,409,819,784,2303,112,0,4427,8738
14970,Liberia,2007,2007Liberia,649,1656,1372,3726,156,0,7559,737,1544,1391,3130,128,0,6930,14489
14971,Liberia,2007,2007Liberia,845,3059,2257,7779,326,0,14266,737,2671,2127,6991,175,0,12701,26967
14972,Liberia,2007,2007Liberia,2259,2402,1413,6568,296,0,12938,2347,2426,1174,5006,255,0,11208,24146
14973,Liberia,2008,2008Liberia,0,0,0,0,0,0,0,0,0,0,0,0,0,0,8652
14974,Liberia,2008,2008Liberia,0,0,0,0,0,0,0,0,0,0,5,0,0,5,40
14975,Liberia,2008,2008Liberia,0,0,0,0,0,0,0,0,0,0,6,0,0,6,12
14976,Liberia,2008,2008Liberia,0,0,0,0,0,0,0,0,0,0,7,0,0,7,7
14977,Liberia,2008,2008Liberia,0,0,0,0,0,0,0,0,0,0,9,0,0,9,9
14978,Liberia,2008,2008Liberia,0,0,0,0,0,6,6,0,0,0,0,0,7,7,13
14979,Liberia,2008,2008Liberia,0,0,0,0,0,56,56,0,0,0,0,0,155,155,211
14980,Liberia,2008,2008Liberia,0,0,0,5,0,0,5,0,0,0,0,0,0,0,5
14981,Liberia,2008,2008Liberia,0,0,0,7,0,0,7,0,0,0,6,0,0,6,13
14982,Liberia,2008,2008Liberia,0,0,0,63,0,0,63,0,0,0,170,0,0,170,233
14983,Liberia,2008,2008Liberia,0,0,5,0,0,0,5,0,5,0,12,0,0,17,22
14984,Liberia,2008,2008Liberia,0,0,7,5,0,0,12,5,0,6,13,0,0,24,36
14985,Liberia,2008,2008Liberia,0,5,0,12,0,0,17,0,5,27,200,0,0,232,249
14986,Liberia,2008,2008Liberia,0,6,8,34,0,0,48,7,0,0,22,5,0,34,82
14987,Liberia,2008,2008Liberia,0,7,0,14,0,0,21,0,0,6,59,0,0,65,86
14988,Liberia,2008,2008Liberia,0,8,0,0,0,0,8,0,0,0,0,0,0,0,8
14989,Liberia,2008,2008Liberia,0,8,0,18,0,0,26,0,6,0,115,0,0,121,147
14990,Liberia,2008,2008Liberia,0,9,0,0,0,0,9,0,0,0,16,0,0,16,25
14991,Liberia,2008,2008Liberia,5,0,0,0,0,0,5,0,0,0,0,0,0,0,10
14992,Liberia,2008,2008Liberia,5,0,0,5,0,0,10,0,0,0,16,0,0,16,26
14993,Liberia,2008,2008Liberia,5,0,0,11,0,9,25,5,0,0,11,0,7,23,48
14994,Liberia,2008,2008Liberia,5,8,0,23,0,0,36,5,9,8,51,0,0,73,109
14995,Liberia,2008,2008Liberia,13,11,5,61,0,0,90,11,10,6,68,0,0,95,185
14996,Liberia,2008,2008Liberia,60,193,266,1895,0,0,2414,38,172,300,2379,0,0,2889,5303
14997,Liberia,2008,2008Liberia,67,62,48,107,114,0,398,79,55,41,78,111,0,364,762
14998,Liberia,2008,2008Liberia,398,1359,971,2951,134,0,5813,451,1278,991,2459,105,0,5284,11097
14999,Liberia,2008,2008Liberia,484,835,623,2295,105,0,4342,360,730,565,1659,122,0,3436,7778
15000,Liberia,2008,2008Liberia,655,1315,913,4600,175,0,7658,769,1311,850,5123,86,0,8139,15797
15001,Liberia,2008,2008Liberia,1814,2531,1418,6934,312,0,13009,1825,2658,1239,5249,276,0,11247,24256
15002,Liberia,2009,2009Liberia,0,0,0,0,0,0,0,0,0,0,0,0,0,0,7821
15003,Liberia,2009,2009Liberia,0,0,0,0,0,0,0,0,0,0,5,0,0,5,25
15004,Liberia,2009,2009Liberia,0,0,0,0,0,0,0,0,0,0,6,0,0,6,18
15005,Liberia,2009,2009Liberia,0,0,0,0,0,0,0,0,0,0,7,0,0,7,14
15006,Liberia,2009,2009Liberia,0,0,0,0,0,6,6,0,0,0,0,0,8,8,14
15007,Liberia,2009,2009Liberia,0,0,0,0,0,13,13,0,0,0,0,0,60,60,73
15008,Liberia,2009,2009Liberia,0,0,0,5,0,0,5,0,0,0,0,0,0,0,10
15009,Liberia,2009,2009Liberia,0,0,0,7,0,0,7,0,0,0,7,0,0,7,14
15010,Liberia,2009,2009Liberia,0,0,0,8,0,0,8,0,7,0,7,5,0,19,27
15011,Liberia,2009,2009Liberia,0,0,0,63,0,0,63,0,0,0,170,0,0,170,233
15012,Liberia,2009,2009Liberia,0,0,5,0,0,0,5,5,0,0,7,0,0,12,17
15013,Liberia,2009,2009Liberia,0,5,0,0,0,0,5,0,0,0,0,0,0,0,5
15014,Liberia,2009,2009Liberia,0,5,0,14,0,0,19,0,5,27,208,0,0,240,259
15015,Liberia,2009,2009Liberia,0,6,0,0,0,0,6,0,0,0,0,0,0,0,6
15016,Liberia,2009,2009Liberia,0,6,6,0,0,0,12,5,6,13,0,0,0,24,36
15017,Liberia,2009,2009Liberia,0,7,0,16,0,0,23,0,5,0,106,0,0,111,134
15018,Liberia,2009,2009Liberia,0,7,13,73,0,0,93,0,10,11,238,5,0,264,357
15019,Liberia,2009,2009Liberia,0,8,0,13,0,0,21,0,8,0,59,0,0,67,88
15020,Liberia,2009,2009Liberia,5,0,0,5,0,0,10,0,0,0,16,0,0,16,26
15021,Liberia,2009,2009Liberia,5,0,0,12,0,8,25,0,5,0,10,0,7,22,47
15022,Liberia,2009,2009Liberia,5,8,0,24,0,0,37,5,9,8,56,0,0,78,115
15023,Liberia,2009,2009Liberia,13,11,5,60,0,0,89,11,10,6,68,0,0,95,184
15024,Liberia,2009,2009Liberia,18,34,40,102,5,0,199,31,26,30,130,7,0,224,423
15025,Liberia,2009,2009Liberia,67,58,45,98,114,0,382,79,55,33,68,111,0,346,728
15026,Liberia,2009,2009Liberia,69,258,249,1960,33,0,2569,63,172,400,1926,131,0,2692,5261
15027,Liberia,2009,2009Liberia,185,814,762,2625,84,0,4470,182,780,737,2725,136,0,4560,9037
15028,Liberia,2009,2009Liberia,313,1256,1055,3068,138,0,5830,346,1195,1089,2551,109,0,5290,11120
15029,Liberia,2009,2009Liberia,592,741,688,3477,110,0,5608,613,752,632,3811,60,0,5868,11476
15030,Liberia,2009,2009Liberia,1353,2652,1567,7033,315,0,12920,1365,2756,1403,5300,289,0,11113,24033
15031,Liberia,2010,2010Liberia,0,0,0,0,0,0,0,0,0,0,0,0,0,0,6798
15032,Liberia,2010,2010Liberia,0,0,0,0,0,0,0,0,0,0,0,0,5,5,5
15033,Liberia,2010,2010Liberia,0,0,0,0,0,0,0,0,0,0,5,0,0,5,30
15034,Liberia,2010,2010Liberia,0,0,0,0,0,0,0,0,0,0,6,0,0,6,12
15035,Liberia,2010,2010Liberia,0,0,0,0,0,0,0,0,0,0,7,0,0,7,7
15036,Liberia,2010,2010Liberia,0,0,0,0,0,13,13,0,0,0,0,0,8,8,21
15037,Liberia,2010,2010Liberia,0,0,0,0,0,13,13,0,0,0,0,0,62,62,75
15038,Liberia,2010,2010Liberia,0,0,0,0,0,65,65,0,0,0,0,0,160,160,225
15039,Liberia,2010,2010Liberia,0,0,0,5,0,0,5,0,0,0,0,0,0,0,10
15040,Liberia,2010,2010Liberia,0,0,0,5,0,0,5,0,0,0,6,0,0,6,11
15041,Liberia,2010,2010Liberia,0,0,0,6,0,0,6,0,5,0,12,5,0,22,28
15042,Liberia,2010,2010Liberia,0,0,0,18,0,0,18,0,0,23,217,0,0,240,258
15043,Liberia,2010,2010Liberia,0,0,0,63,0,0,63,0,0,0,170,0,0,170,233
15044,Liberia,2010,2010Liberia,0,0,5,0,0,0,5,5,0,0,6,0,0,11,16
15045,Liberia,2010,2010Liberia,0,5,0,0,0,0,5,0,0,0,0,0,0,0,10
15046,Liberia,2010,2010Liberia,0,5,0,9,0,0,14,5,0,0,22,0,0,27,41
15047,Liberia,2010,2010Liberia,0,6,0,0,0,0,6,0,0,0,0,0,0,0,6
15048,Liberia,2010,2010Liberia,0,7,13,70,0,0,90,0,8,8,212,6,0,234,324
15049,Liberia,2010,2010Liberia,0,8,0,12,0,0,20,0,9,0,42,0,0,51,71
15050,Liberia,2010,2010Liberia,5,0,0,0,0,0,5,0,0,0,0,0,0,0,5
15051,Liberia,2010,2010Liberia,5,0,0,5,0,0,10,0,0,0,16,0,0,16,26
15052,Liberia,2010,2010Liberia,5,0,0,11,0,9,25,0,5,0,10,0,7,22,47
15053,Liberia,2010,2010Liberia,8,0,0,9,0,0,17,0,6,0,28,0,0,34,51
15054,Liberia,2010,2010Liberia,9,17,0,27,0,0,53,8,6,0,25,0,0,39,92
15055,Liberia,2010,2010Liberia,18,34,40,102,5,0,199,31,26,30,131,7,0,225,424
15056,Liberia,2010,2010Liberia,61,52,53,178,6,0,350,47,60,44,207,0,5,363,713
15057,Liberia,2010,2010Liberia,69,258,249,1990,33,0,2599,73,182,405,1926,131,0,2717,5316
15058,Liberia,2010,2010Liberia,127,754,734,2477,71,0,4163,124,718,700,2513,123,0,4178,8341
15059,Liberia,2010,2010Liberia,365,1349,1570,1768,43,0,5095,387,1310,1491,1423,83,0,4694,9789
15060,Liberia,2010,2010Liberia,595,726,674,3532,113,0,5640,648,757,647,3820,73,0,5945,11585
15061,Liberia,2010,2010Liberia,1832,2783,1654,7134,330,0,13733,1712,2976,1489,5328,299,0,11804,25563
15062,Liberia,2011,2011Liberia,0,0,0,0,0,0,0,0,0,0,0,0,0,0,5816
15063,Liberia,2011,2011Liberia,0,0,0,0,0,0,0,0,0,0,5,0,0,5,35
15064,Liberia,2011,2011Liberia,0,0,0,0,0,0,0,0,0,0,6,0,0,6,12
15065,Liberia,2011,2011Liberia,0,0,0,0,0,0,0,0,0,0,7,0,0,7,14
15066,Liberia,2011,2011Liberia,0,0,0,0,0,0,0,0,0,0,9,0,0,9,9
15067,Liberia,2011,2011Liberia,0,0,0,0,0,0,0,0,0,0,28,0,0,28,65
15068,Liberia,2011,2011Liberia,0,0,0,0,0,0,0,0,5,0,0,8,0,13,13
15069,Liberia,2011,2011Liberia,0,0,0,0,0,16,16,0,0,0,0,0,7,7,23
15070,Liberia,2011,2011Liberia,0,0,0,0,0,66,66,0,0,0,0,0,162,162,228
15071,Liberia,2011,2011Liberia,0,0,0,5,0,0,5,0,0,0,0,0,0,0,10
15072,Liberia,2011,2011Liberia,0,0,0,5,0,0,5,0,0,5,6,0,0,11,16
15073,Liberia,2011,2011Liberia,0,0,0,9,0,0,9,0,5,0,10,0,0,15,24
15074,Liberia,2011,2011Liberia,0,0,0,18,0,0,18,0,0,23,217,0,0,240,258
15075,Liberia,2011,2011Liberia,0,0,0,63,0,0,63,0,0,0,170,0,0,170,233
15076,Liberia,2011,2011Liberia,0,0,9,64,0,0,73,0,0,8,189,6,0,203,276
15077,Liberia,2011,2011Liberia,0,5,0,0,0,0,5,0,0,0,0,0,0,0,10
15078,Liberia,2011,2011Liberia,0,5,0,9,0,0,14,5,0,0,21,0,0,26,40
15079,Liberia,2011,2011Liberia,0,5,0,10,0,12,27,0,5,0,11,0,8,24,51
15080,Liberia,2011,2011Liberia,0,6,0,7,0,0,13,0,7,0,36,0,0,43,56
15081,Liberia,2011,2011Liberia,5,6,5,41,0,0,57,0,16,7,26,0,0,49,106
15082,Liberia,2011,2011Liberia,5,17,5,28,0,0,55,6,8,0,20,0,0,34,89
15083,Liberia,2011,2011Liberia,18,34,40,102,5,0,199,31,26,30,131,7,0,225,424
15084,Liberia,2011,2011Liberia,61,52,53,178,6,0,350,48,60,43,203,5,0,359,709
15085,Liberia,2011,2011Liberia,69,258,249,1690,33,0,2299,73,182,405,2209,131,0,3000,5299
15086,Liberia,2011,2011Liberia,69,824,638,2306,139,0,3976,110,760,799,2272,129,0,4070,8046
15087,Liberia,2011,2011Liberia,191,907,1077,2904,124,0,5203,199,942,999,2522,107,0,4769,9972
15088,Liberia,2011,2011Liberia,572,704,686,3464,111,0,5537,581,738,622,3744,73,0,5758,11295
15089,Liberia,2011,2011Liberia,975,2521,1593,7001,331,0,12421,882,2756,1457,5841,293,0,11229,23650
15090,Liberia,2012,2012Liberia,0,0,0,0,0,0,0,0,0,0,0,0,0,0,4877
15091,Liberia,2012,2012Liberia,0,0,0,0,0,0,0,0,0,0,0,0,5,5,10
15092,Liberia,2012,2012Liberia,0,0,0,0,0,0,0,0,0,0,5,0,0,5,35
15093,Liberia,2012,2012Liberia,0,0,0,0,0,0,0,0,0,0,6,0,0,6,18
15094,Liberia,2012,2012Liberia,0,0,0,0,0,0,0,0,0,0,7,0,0,7,7
15095,Liberia,2012,2012Liberia,0,0,0,0,0,0,0,0,0,0,27,0,0,27,69
15096,Liberia,2012,2012Liberia,0,0,0,0,0,0,0,0,5,0,5,0,0,10,10
15097,Liberia,2012,2012Liberia,0,0,0,0,0,16,16,0,0,0,0,0,6,6,22
15098,Liberia,2012,2012Liberia,0,0,0,0,0,68,68,0,0,0,0,0,159,159,227
15099,Liberia,2012,2012Liberia,0,0,0,5,0,0,5,0,0,0,0,0,0,0,15
15100,Liberia,2012,2012Liberia,0,0,0,5,0,0,5,0,0,0,5,0,0,5,10
15101,Liberia,2012,2012Liberia,0,0,0,7,0,0,7,0,5,0,9,0,0,14,21
15102,Liberia,2012,2012Liberia,0,0,0,17,0,0,17,0,0,0,44,0,0,44,61
15103,Liberia,2012,2012Liberia,0,0,0,18,0,0,18,0,0,23,206,0,0,229,247
15104,Liberia,2012,2012Liberia,0,0,5,0,0,0,5,0,0,5,7,6,0,18,23
15105,Liberia,2012,2012Liberia,0,0,5,5,0,0,10,0,0,0,5,0,0,5,120
15106,Liberia,2012,2012Liberia,0,0,8,64,0,0,72,0,5,6,194,7,0,212,284
15107,Liberia,2012,2012Liberia,0,5,0,0,0,0,5,0,0,0,0,0,0,0,5
15108,Liberia,2012,2012Liberia,0,5,0,9,0,0,14,0,0,5,13,0,0,18,32
15109,Liberia,2012,2012Liberia,0,6,0,10,0,12,28,0,5,0,9,0,8,22,50
15110,Liberia,2012,2012Liberia,7,16,7,35,0,0,65,12,8,15,24,0,0,59,124
15111,Liberia,2012,2012Liberia,9,0,0,0,0,0,9,0,0,0,0,0,0,0,9
15112,Liberia,2012,2012Liberia,10,44,36,145,5,0,240,15,37,36,236,0,0,324,564
15113,Liberia,2012,2012Liberia,14,18,18,92,5,0,147,20,29,17,107,5,0,178,325
15114,Liberia,2012,2012Liberia,32,185,237,2178,22,0,2654,29,148,230,2046,49,0,2502,5156
15115,Liberia,2012,2012Liberia,61,519,469,954,82,0,2085,76,450,505,968,79,0,2078,4163
15116,Liberia,2012,2012Liberia,108,262,301,1029,54,0,1754,108,287,311,987,73,0,1766,3520
15117,Liberia,2012,2012Liberia,199,337,242,896,48,0,1722,215,356,245,845,41,0,1702,3424
15118,Liberia,2013,2013Liberia,0,0,0,0,0,0,0,0,0,0,0,0,0,0,4134
15119,Liberia,2013,2013Liberia,0,0,0,0,0,0,0,0,0,0,5,0,0,5,25
15120,Liberia,2013,2013Liberia,0,0,0,0,0,0,0,0,0,0,6,0,0,6,18
15121,Liberia,2013,2013Liberia,0,0,0,0,0,0,0,0,0,0,7,0,0,7,7
15122,Liberia,2013,2013Liberia,0,0,0,0,0,0,0,0,0,0,49,20,0,69,69
15123,Liberia,2013,2013Liberia,0,0,0,0,0,0,0,0,5,0,0,0,0,5,5
15124,Liberia,2013,2013Liberia,0,0,0,0,0,12,12,0,0,0,0,0,5,5,17
15125,Liberia,2013,2013Liberia,0,0,0,0,0,67,67,0,0,0,0,0,161,161,228
15126,Liberia,2013,2013Liberia,0,0,0,5,0,0,5,0,0,0,0,0,0,0,10
15127,Liberia,2013,2013Liberia,0,0,0,5,0,0,5,0,0,0,9,0,0,9,14
15128,Liberia,2013,2013Liberia,0,0,0,7,0,0,7,0,0,0,19,0,0,19,26
15129,Liberia,2013,2013Liberia,0,0,0,10,0,0,10,0,7,0,0,0,0,7,17
15130,Liberia,2013,2013Liberia,0,0,0,17,0,0,17,0,0,0,44,0,0,44,61
15131,Liberia,2013,2013Liberia,0,0,0,46,0,0,46,0,0,23,189,0,0,212,258
15132,Liberia,2013,2013Liberia,0,0,5,0,0,0,5,0,0,5,0,9,0,14,19
15133,Liberia,2013,2013Liberia,0,0,5,14,0,0,19,0,0,5,44,0,0,49,68
15134,Liberia,2013,2013Liberia,0,0,8,0,0,0,8,0,0,0,0,0,0,0,134
15135,Liberia,2013,2013Liberia,0,5,0,0,0,0,5,0,0,0,0,0,0,0,5
15136,Liberia,2013,2013Liberia,0,5,0,0,0,0,5,0,0,0,12,0,0,12,32
15137,Liberia,2013,2013Liberia,0,6,0,8,0,12,26,0,5,0,10,0,9,24,50
15138,Liberia,2013,2013Liberia,5,8,8,32,0,0,53,5,8,11,46,0,0,70,123
15139,Liberia,2013,2013Liberia,6,0,8,27,0,0,41,5,5,0,25,0,0,35,76
15140,Liberia,2013,2013Liberia,55,191,235,2179,19,0,2679,41,166,229,2083,51,0,2570,5249
15141,Liberia,2013,2013Liberia,60,308,360,579,53,0,1360,60,323,346,645,42,0,1416,2776
15142,Liberia,2013,2013Liberia,62,136,143,505,26,0,872,62,155,162,452,58,0,889,1761
15143,Liberia,2013,2013Liberia,155,220,185,663,26,0,1249,163,227,168,535,24,0,1117,2366
15144,Liberia,2014,2014Liberia,0,0,0,0,0,0,0,0,0,0,0,0,0,0,3073
15145,Liberia,2014,2014Liberia,0,0,0,0,0,0,0,0,0,0,5,0,0,5,25
15146,Liberia,2014,2014Liberia,0,0,0,0,0,0,0,0,0,0,8,0,0,8,8
15147,Liberia,2014,2014Liberia,0,0,0,0,0,0,0,0,0,0,47,20,0,67,67
15148,Liberia,2014,2014Liberia,0,0,0,0,0,0,0,0,0,5,0,0,0,5,5
15149,Liberia,2014,2014Liberia,0,0,0,0,0,0,0,0,0,9,0,0,0,9,9
15150,Liberia,2014,2014Liberia,0,0,0,0,0,0,0,0,5,0,0,0,0,5,5
15151,Liberia,2014,2014Liberia,0,0,0,0,0,22,22,0,0,0,0,0,63,63,85
15152,Liberia,2014,2014Liberia,0,0,0,0,0,66,66,0,0,0,0,0,155,155,221
15153,Liberia,2014,2014Liberia,0,0,0,5,0,0,5,0,0,5,9,0,0,14,19
15154,Liberia,2014,2014Liberia,0,0,0,7,0,0,7,0,0,0,0,0,0,0,7
15155,Liberia,2014,2014Liberia,0,0,0,8,0,0,8,0,0,0,0,0,0,0,8
15156,Liberia,2014,2014Liberia,0,0,0,17,0,0,17,0,0,0,44,0,0,44,61
15157,Liberia,2014,2014Liberia,0,0,0,50,0,0,50,0,0,6,202,0,0,208,258
15158,Liberia,2014,2014Liberia,0,0,5,12,0,0,17,0,0,5,42,0,0,47,64
15159,Liberia,2014,2014Liberia,0,0,6,7,0,0,13,0,0,0,9,0,0,9,22
15160,Liberia,2014,2014Liberia,0,5,0,6,0,0,11,0,0,0,12,0,0,12,23
15161,Liberia,2014,2014Liberia,0,6,0,0,0,0,6,0,0,0,0,0,0,0,6
15162,Liberia,2014,2014Liberia,0,6,0,9,0,8,23,0,5,0,10,0,10,25,48
15163,Liberia,2014,2014Liberia,5,0,0,0,0,0,5,0,0,0,5,0,0,5,10
15164,Liberia,2014,2014Liberia,6,0,8,27,0,0,41,5,5,0,25,0,0,35,76
15165,Liberia,2014,2014Liberia,48,104,205,304,36,0,697,44,139,146,259,41,0,629,1326
15166,Liberia,2014,2014Liberia,58,118,87,324,11,0,598,45,99,94,244,6,0,488,1086
15167,Liberia,2014,2014Liberia,64,137,147,510,26,0,884,64,158,166,457,58,0,903,1787
15168,Liberia,2014,2014Liberia,190,378,331,1657,58,0,2614,201,391,327,1677,52,0,2648,5262
15169,Liberia,2015,2015Liberia,0,0,0,0,0,0,0,0,0,0,0,0,0,0,2702
15170,Liberia,2015,2015Liberia,0,0,0,0,0,0,0,0,0,0,0,0,5,5,5
15171,Liberia,2015,2015Liberia,0,0,0,0,0,0,0,0,0,0,5,0,0,5,15
15172,Liberia,2015,2015Liberia,0,0,0,0,0,0,0,0,0,0,6,0,0,6,6
15173,Liberia,2015,2015Liberia,0,0,0,0,0,0,0,0,0,0,8,0,0,8,8
15174,Liberia,2015,2015Liberia,0,0,0,0,0,0,0,0,0,0,32,19,0,51,51
15175,Liberia,2015,2015Liberia,0,0,0,0,0,13,13,0,0,0,0,0,5,5,18
15176,Liberia,2015,2015Liberia,0,0,0,0,0,65,65,0,0,0,0,0,153,153,218
15177,Liberia,2015,2015Liberia,0,0,0,5,0,0,5,0,0,0,8,6,0,14,19
15178,Liberia,2015,2015Liberia,0,0,0,5,0,0,5,0,0,5,0,0,0,5,10
15179,Liberia,2015,2015Liberia,0,0,0,5,0,0,5,0,9,0,0,0,0,9,14
15180,Liberia,2015,2015Liberia,0,0,0,6,0,0,6,0,0,0,19,0,0,19,25
15181,Liberia,2015,2015Liberia,0,0,0,7,0,0,7,0,0,0,0,0,0,0,7
15182,Liberia,2015,2015Liberia,0,0,0,9,0,0,9,0,0,0,0,0,0,0,9
15183,Liberia,2015,2015Liberia,0,0,0,14,0,0,14,0,0,0,42,5,0,47,61
15184,Liberia,2015,2015Liberia,0,0,0,17,0,0,17,0,0,0,44,0,0,44,61
15185,Liberia,2015,2015Liberia,0,0,0,27,0,0,27,0,0,5,226,0,0,231,258
15186,Liberia,2015,2015Liberia,0,0,5,0,0,0,5,0,0,5,0,0,0,5,10
15187,Liberia,2015,2015Liberia,0,5,0,0,0,0,5,0,0,0,0,0,0,0,5
15188,Liberia,2015,2015Liberia,0,5,0,6,0,0,11,0,0,0,12,0,0,12,23
15189,Liberia,2015,2015Liberia,0,7,0,10,0,11,28,0,6,0,7,0,8,21,49
15190,Liberia,2015,2015Liberia,5,0,0,0,0,0,5,0,0,0,0,0,0,0,5
15191,Liberia,2015,2015Liberia,6,0,6,24,0,0,36,6,0,0,25,0,0,31,67
15192,Liberia,2015,2015Liberia,36,57,76,204,10,0,383,20,58,79,180,10,0,347,730
15193,Liberia,2015,2015Liberia,54,113,80,305,11,0,563,43,95,94,239,6,0,477,1040
15194,Liberia,2015,2015Liberia,54,117,118,562,21,0,872,55,135,142,511,53,0,896,1768
15195,Liberia,2015,2015Liberia,105,205,172,955,34,0,1471,114,198,183,803,19,0,1317,2788
15196,Liberia,2016,2016Liberia,0,0,0,0,0,0,0,0,0,0,0,0,0,0,2315
15197,Liberia,2016,2016Liberia,0,0,0,0,0,0,0,0,0,0,0,0,5,5,5
15198,Liberia,2016,2016Liberia,0,0,0,0,0,0,0,0,0,0,5,0,0,5,20
15199,Liberia,2016,2016Liberia,0,0,0,0,0,0,0,0,0,0,9,0,0,9,9
15200,Liberia,2016,2016Liberia,0,0,0,0,0,0,0,0,0,0,40,5,0,45,45
15201,Liberia,2016,2016Liberia,0,0,0,0,0,0,0,0,0,9,0,0,0,9,9
15202,Liberia,2016,2016Liberia,0,0,0,0,0,10,10,0,0,0,0,0,5,5,15
15203,Liberia,2016,2016Liberia,0,0,0,0,0,18,18,0,0,0,0,0,40,40,58
15204,Liberia,2016,2016Liberia,0,0,0,0,0,69,69,0,0,0,0,0,160,160,229
15205,Liberia,2016,2016Liberia,0,0,0,5,0,0,5,0,0,0,5,0,0,5,82
15206,Liberia,2016,2016Liberia,0,0,0,5,0,0,5,0,0,0,8,6,0,14,19
15207,Liberia,2016,2016Liberia,0,0,0,6,0,0,6,0,0,0,17,0,0,17,23
15208,Liberia,2016,2016Liberia,0,0,0,7,0,0,7,0,0,0,0,0,0,0,7
15209,Liberia,2016,2016Liberia,0,0,0,9,0,0,9,0,0,0,0,0,0,0,9
15210,Liberia,2016,2016Liberia,0,0,0,15,0,0,15,0,0,0,45,0,0,45,60
15211,Liberia,2016,2016Liberia,0,0,0,17,0,0,17,0,0,0,44,0,0,44,61
15212,Liberia,2016,2016Liberia,0,0,0,27,0,0,27,0,0,5,227,0,0,232,259
15213,Liberia,2016,2016Liberia,0,0,5,0,0,0,5,0,0,0,0,0,0,0,5
15214,Liberia,2016,2016Liberia,0,0,5,5,0,0,10,0,0,12,0,0,0,12,22
15215,Liberia,2016,2016Liberia,0,5,0,0,0,0,5,0,0,0,0,0,0,0,5
15216,Liberia,2016,2016Liberia,0,5,0,0,0,0,5,0,0,0,5,0,0,5,10
15217,Liberia,2016,2016Liberia,0,5,0,7,0,9,21,0,5,0,9,0,10,24,45
15218,Liberia,2016,2016Liberia,5,0,0,0,0,0,5,0,0,0,0,0,0,0,5
15219,Liberia,2016,2016Liberia,6,0,0,0,0,0,6,0,0,0,0,0,0,0,6
15220,Liberia,2016,2016Liberia,7,0,6,24,0,0,37,6,0,0,25,0,0,31,68
15221,Liberia,2016,2016Liberia,15,31,74,590,30,0,740,19,32,73,478,16,0,618,1358
15222,Liberia,2016,2016Liberia,20,17,24,90,0,0,151,18,35,26,65,0,0,144,295
15223,Liberia,2016,2016Liberia,23,40,79,185,10,0,337,21,47,73,171,5,0,317,654
15224,Liberia,2016,2016Liberia,55,90,74,215,14,0,448,58,94,60,195,5,0,412,860
15225,Liberia,2017,2017Liberia,0,0,0,0,0,0,0,0,0,0,0,0,0,0,2103
15226,Liberia,2017,2017Liberia,0,0,0,0,0,0,0,0,0,0,0,0,155,155,155
15227,Liberia,2017,2017Liberia,0,0,0,0,0,0,0,0,0,0,0,6,0,6,6
15228,Liberia,2017,2017Liberia,0,0,0,0,0,0,0,0,0,0,5,0,0,5,30
15229,Liberia,2017,2017Liberia,0,0,0,0,0,0,0,0,0,0,38,6,0,44,44
15230,Liberia,2017,2017Liberia,0,0,0,0,0,0,0,0,0,9,0,0,0,9,9
15231,Liberia,2017,2017Liberia,0,0,0,0,0,20,20,0,0,0,0,0,40,40,60
15232,Liberia,2017,2017Liberia,0,0,0,0,0,73,73,0,0,0,0,0,159,159,232
15233,Liberia,2017,2017Liberia,0,0,0,6,0,0,6,0,0,0,17,0,0,17,23
15234,Liberia,2017,2017Liberia,0,0,0,9,0,0,9,0,0,0,0,0,0,0,9
15235,Liberia,2017,2017Liberia,0,0,0,17,0,0,17,0,0,5,51,0,0,56,73
15236,Liberia,2017,2017Liberia,0,0,5,0,0,0,5,0,0,5,0,0,0,5,10
15237,Liberia,2017,2017Liberia,0,0,5,5,0,0,10,0,0,5,7,0,0,12,22
15238,Liberia,2017,2017Liberia,0,0,9,0,0,0,9,0,0,0,0,0,0,0,9
15239,Liberia,2017,2017Liberia,0,0,17,0,0,0,17,0,0,0,44,0,0,44,61
15240,Liberia,2017,2017Liberia,0,5,0,0,0,0,5,0,0,0,0,0,0,0,5
15241,Liberia,2017,2017Liberia,0,5,0,8,0,9,22,0,5,0,8,0,9,22,44
15242,Liberia,2017,2017Liberia,5,0,0,0,0,0,5,0,0,0,0,0,0,0,10
15243,Liberia,2017,2017Liberia,6,0,6,24,0,0,36,6,0,0,25,0,0,31,67
15244,Liberia,2017,2017Liberia,11,27,53,535,33,0,659,13,34,54,431,18,0,550,1209
15245,Liberia,2017,2017Liberia,12,19,28,90,0,0,149,16,40,25,68,0,0,149,298
15246,Liberia,2017,2017Liberia,22,28,82,200,5,0,337,32,52,67,165,0,0,316,653
15247,Liberia,2017,2017Liberia,57,88,83,229,14,0,471,61,90,69,210,6,0,436,907
15248,Liberia,2018,2018Liberia,0,0,0,0,0,0,0,0,0,0,0,0,0,0,2901
15249,Liberia,2018,2018Liberia,0,0,0,0,0,0,0,0,0,0,0,7,0,7,7
15250,Liberia,2018,2018Liberia,0,0,0,0,0,0,0,0,0,0,5,0,0,5,10
15251,Liberia,2018,2018Liberia,0,0,0,0,0,0,0,0,0,0,9,0,0,9,18
15252,Liberia,2018,2018Liberia,0,0,0,0,0,0,0,0,0,0,37,7,0,44,44
15253,Liberia,2018,2018Liberia,0,0,0,0,0,0,0,0,0,5,0,0,0,5,5
15254,Liberia,2018,2018Liberia,0,0,0,0,0,0,0,0,0,9,0,0,0,9,9
15255,Liberia,2018,2018Liberia,0,0,0,0,0,74,74,0,0,0,0,0,165,165,239
15256,Liberia,2018,2018Liberia,0,0,0,5,0,0,5,0,0,0,0,0,0,0,5
15257,Liberia,2018,2018Liberia,0,0,0,5,0,0,5,0,0,5,0,0,0,5,10
15258,Liberia,2018,2018Liberia,0,0,0,6,0,0,6,0,0,0,5,0,0,5,11
15259,Liberia,2018,2018Liberia,0,0,0,6,0,0,6,0,0,0,7,0,0,7,13
15260,Liberia,2018,2018Liberia,0,0,0,7,0,0,7,0,0,0,0,0,0,0,7
15261,Liberia,2018,2018Liberia,0,0,0,7,0,0,7,0,0,0,9,0,0,9,16
15262,Liberia,2018,2018Liberia,0,0,0,9,0,0,9,0,0,0,0,0,0,0,9
15263,Liberia,2018,2018Liberia,0,0,0,9,0,0,9,5,0,0,0,0,0,5,14
15264,Liberia,2018,2018Liberia,0,0,5,8,0,8,21,0,5,0,7,0,8,20,41
15265,Liberia,2018,2018Liberia,0,5,0,0,0,0,5,0,0,0,0,0,0,0,10
15266,Liberia,2018,2018Liberia,0,5,17,55,0,0,77,5,10,11,46,5,0,77,302
15267,Liberia,2018,2018Liberia,0,6,0,29,0,0,35,0,0,5,55,5,0,65,100
15268,Liberia,2018,2018Liberia,0,6,9,33,0,0,48,9,6,5,18,0,0,38,91
15269,Liberia,2018,2018Liberia,5,0,0,0,0,0,5,0,0,0,0,0,0,0,5
15270,Liberia,2018,2018Liberia,11,47,42,308,25,0,433,16,44,39,194,9,0,302,735
15271,Liberia,2018,2018Liberia,57,71,80,245,17,0,470,55,90,65,221,5,0,436,906
15272,Liberia,2019,2019Liberia,0,0,0,0,0,0,0,0,0,0,0,0,0,0,2399
15273,Liberia,2019,2019Liberia,0,0,0,0,0,0,0,0,0,0,0,8,0,8,8
15274,Liberia,2019,2019Liberia,0,0,0,0,0,0,0,0,0,0,5,0,0,5,10
15275,Liberia,2019,2019Liberia,0,0,0,0,0,0,0,0,0,0,9,0,0,9,9
15276,Liberia,2019,2019Liberia,0,0,0,0,0,0,0,0,0,0,35,7,0,42,42
15277,Liberia,2019,2019Liberia,0,0,0,0,0,0,0,0,0,7,0,0,0,7,7
15278,Liberia,2019,2019Liberia,0,0,0,0,0,0,0,0,0,9,0,0,0,9,18
15279,Liberia,2019,2019Liberia,0,0,0,0,0,76,76,0,0,0,0,0,171,171,247
15280,Liberia,2019,2019Liberia,0,0,0,6,0,0,6,0,0,0,7,0,0,7,13
15281,Liberia,2019,2019Liberia,0,0,0,7,0,0,7,0,0,0,0,0,0,0,7
15282,Liberia,2019,2019Liberia,0,0,0,9,0,0,9,0,0,0,0,0,0,0,9
15283,Liberia,2019,2019Liberia,0,0,5,0,0,0,5,0,0,0,0,0,0,0,5
15284,Liberia,2019,2019Liberia,0,0,5,5,0,0,10,0,0,0,11,0,0,11,37
15285,Liberia,2019,2019Liberia,0,0,9,0,0,0,9,0,0,0,0,0,0,0,9
15286,Liberia,2019,2019Liberia,0,5,0,5,0,0,10,5,0,0,0,0,0,5,15
15287,Liberia,2019,2019Liberia,0,6,0,0,0,0,6,0,0,0,0,0,0,0,6
15288,Liberia,2019,2019Liberia,5,0,0,6,0,0,11,8,0,0,0,0,0,8,19
15289,Liberia,2019,2019Liberia,8,0,0,30,0,0,38,8,0,0,51,5,0,64,102
15290,Liberia,2019,2019Liberia,9,41,41,310,25,0,426,15,41,42,202,8,0,308,734
15291,Liberia,2019,2019Liberia,11,22,29,81,5,0,148,14,28,25,87,10,0,164,312
15292,Liberia,2019,2019Liberia,13,27,43,154,0,0,237,13,36,35,99,5,0,188,425
15293,Liberia,2019,2019Liberia,63,76,80,251,18,0,488,54,75,79,228,8,0,444,932
15294,Liberia,2020,2020Liberia,0,0,0,0,0,0,0,0,0,0,0,0,0,0,2432
15295,Liberia,2020,2020Liberia,0,0,0,0,0,0,0,0,0,0,0,8,0,8,8
15296,Liberia,2020,2020Liberia,0,0,0,0,0,0,0,0,0,0,5,0,0,5,5
15297,Liberia,2020,2020Liberia,0,0,0,0,0,0,0,0,0,0,6,0,0,6,6
15298,Liberia,2020,2020Liberia,0,0,0,0,0,0,0,0,0,0,9,0,0,9,18
15299,Liberia,2020,2020Liberia,0,0,0,0,0,0,0,0,0,0,33,9,0,42,42
15300,Liberia,2020,2020Liberia,0,0,0,0,0,0,0,0,0,7,0,0,0,7,7
15301,Liberia,2020,2020Liberia,0,0,0,0,0,7,7,0,0,0,0,0,5,5,12
15302,Liberia,2020,2020Liberia,0,0,0,0,0,10,10,0,0,0,0,0,5,5,15
15303,Liberia,2020,2020Liberia,0,0,0,5,0,0,5,0,0,0,0,0,0,0,5
15304,Liberia,2020,2020Liberia,0,0,0,5,0,0,5,0,0,0,5,0,0,5,10
15305,Liberia,2020,2020Liberia,0,0,0,6,0,0,6,0,0,0,7,0,0,7,13
15306,Liberia,2020,2020Liberia,0,0,0,7,0,0,7,0,0,0,0,0,0,0,7
15307,Liberia,2020,2020Liberia,0,0,0,7,0,0,7,0,0,0,10,0,0,10,33
15308,Liberia,2020,2020Liberia,0,0,5,5,0,0,10,5,0,0,0,0,0,5,15
15309,Liberia,2020,2020Liberia,0,0,5,11,0,0,16,0,0,5,21,5,0,31,47
15310,Liberia,2020,2020Liberia,0,0,9,0,0,0,9,0,0,0,0,0,0,0,9
15311,Liberia,2020,2020Liberia,0,5,0,0,0,0,5,0,0,0,0,0,0,0,5
15312,Liberia,2020,2020Liberia,0,7,0,0,0,0,7,0,0,0,0,0,0,0,7
15313,Liberia,2020,2020Liberia,0,18,20,132,5,0,175,0,27,21,109,0,0,157,332
15314,Liberia,2020,2020Liberia,5,0,0,7,0,0,12,0,0,8,0,0,0,8,20
15315,Liberia,2020,2020Liberia,7,5,0,39,0,0,51,9,0,0,63,0,0,72,123
15316,Liberia,2020,2020Liberia,7,40,40,285,25,0,397,10,39,39,200,9,0,297,694
15317,Liberia,2020,2020Liberia,19,18,22,122,5,0,186,10,28,26,96,11,0,171,357
15318,Liberia,2020,2020Liberia,41,93,79,276,15,0,504,37,98,79,240,15,0,469,973
15319,Liberia,2021,2021Liberia,0,0,0,0,0,0,0,0,0,0,0,0,0,0,2500
15320,Liberia,2021,2021Liberia,0,0,0,0,0,0,0,0,0,0,0,8,0,8,8
15321,Liberia,2021,2021Liberia,0,0,0,0,0,0,0,0,0,0,5,0,0,5,10
15322,Liberia,2021,2021Liberia,0,0,0,0,0,0,0,0,0,0,6,0,0,6,6
15323,Liberia,2021,2021Liberia,0,0,0,0,0,0,0,0,0,0,8,0,0,8,8
15324,Liberia,2021,2021Liberia,0,0,0,0,0,0,0,0,0,0,9,0,0,9,18
15325,Liberia,2021,2021Liberia,0,0,0,0,0,0,0,0,0,0,32,10,0,42,42
15326,Liberia,2021,2021Liberia,0,0,0,0,0,0,0,0,0,5,0,0,0,5,10
15327,Liberia,2021,2021Liberia,0,0,0,0,0,0,0,0,0,7,0,0,0,7,7
15328,Liberia,2021,2021Liberia,0,0,0,6,0,0,6,0,0,0,6,0,0,6,12
15329,Liberia,2021,2021Liberia,0,0,0,7,0,0,7,0,0,0,0,0,0,0,7
15330,Liberia,2021,2021Liberia,0,0,0,7,0,0,7,0,0,0,9,0,0,9,32
15331,Liberia,2021,2021Liberia,0,0,0,9,0,0,9,0,0,0,0,0,0,0,9
15332,Liberia,2021,2021Liberia,0,0,0,10,0,0,10,5,0,0,0,0,0,5,15
15333,Liberia,2021,2021Liberia,0,0,0,24,0,0,24,0,0,0,40,0,0,40,64
15334,Liberia,2021,2021Liberia,0,0,5,0,0,0,5,0,0,0,0,0,0,0,5
15335,Liberia,2021,2021Liberia,0,0,5,6,0,0,11,0,0,0,0,0,0,0,11
15336,Liberia,2021,2021Liberia,0,0,5,11,0,0,16,0,0,0,25,6,0,31,47
15337,Liberia,2021,2021Liberia,0,0,7,0,0,0,7,0,0,0,0,0,0,0,7
15338,Liberia,2021,2021Liberia,0,5,0,0,0,0,5,0,0,0,0,0,0,0,5
15339,Liberia,2021,2021Liberia,0,18,16,138,5,0,177,0,26,22,105,5,0,158,335
15340,Liberia,2021,2021Liberia,5,0,0,7,0,0,12,0,0,0,9,0,0,9,21
15341,Liberia,2021,2021Liberia,5,30,34,276,29,0,374,10,31,35,201,10,0,287,661
15342,Liberia,2021,2021Liberia,9,7,0,42,0,0,58,9,0,0,63,5,0,77,135
15343,Liberia,2021,2021Liberia,14,31,15,112,0,0,172,5,20,35,98,8,0,166,338
15344,Liberia,2021,2021Liberia,57,99,78,313,22,0,569,42,91,82,267,20,0,502,1071
15345,Libya,2001,2001Libya,0,0,0,0,0,0,0,0,0,0,0,0,0,0,496
15346,Libya,2001,2001Libya,0,0,0,0,0,0,0,0,0,0,5,0,0,5,5
15347,Libya,2001,2001Libya,0,0,0,0,0,0,0,0,8,0,0,0,0,8,8
15348,Libya,2001,2001Libya,0,0,0,0,0,144,144,0,0,0,0,0,218,218,362
15349,Libya,2001,2001Libya,0,0,6,0,0,0,6,0,0,0,0,0,0,0,6
15350,Libya,2002,2002Libya,0,0,0,0,0,0,0,0,0,0,0,0,0,0,1029
15351,Libya,2002,2002Libya,0,0,0,0,0,0,0,0,0,0,0,0,8,8,8
15352,Libya,2002,2002Libya,0,0,0,0,0,0,0,0,0,0,5,0,0,5,5
15353,Libya,2002,2002Libya,0,0,0,0,0,154,154,0,0,0,0,0,223,223,395
15354,Libya,2002,2002Libya,0,0,6,0,0,0,6,0,0,0,0,0,0,0,6
15355,Libya,2003,2003Libya,0,0,0,0,0,0,0,0,0,0,0,0,0,0,1120
15356,Libya,2003,2003Libya,0,0,0,0,0,0,0,0,0,0,0,0,9,9,9
15357,Libya,2003,2003Libya,0,0,0,0,0,171,171,0,0,0,0,0,232,232,418
15358,Libya,2003,2003Libya,0,0,6,0,0,0,6,0,0,0,0,0,0,0,6
15359,Libya,2004,2004Libya,0,0,0,0,0,0,0,0,0,0,0,0,0,0,1275
15360,Libya,2004,2004Libya,0,0,5,0,0,176,181,0,0,5,5,0,230,240,421
15361,Libya,2005,2005Libya,0,0,0,0,0,0,0,0,0,0,0,0,0,0,1128
15362,Libya,2005,2005Libya,0,0,0,0,0,0,0,0,0,0,0,0,9,9,9
15363,Libya,2005,2005Libya,0,5,0,0,0,176,181,0,0,5,5,0,228,238,419
15364,Libya,2006,2006Libya,0,0,0,0,0,0,0,0,0,0,0,0,0,0,1148
15365,Libya,2006,2006Libya,0,0,0,0,0,0,0,0,0,0,0,0,9,9,9
15366,Libya,2006,2006Libya,0,0,0,0,0,0,0,0,0,0,5,0,0,5,5
15367,Libya,2006,2006Libya,0,0,0,0,0,0,0,0,6,0,0,0,0,6,6
15368,Libya,2006,2006Libya,0,0,0,0,0,168,168,0,0,0,0,0,221,221,389
15369,Libya,2007,2007Libya,0,0,0,0,0,0,0,0,0,0,0,0,0,0,1597
15370,Libya,2007,2007Libya,0,0,0,0,0,0,0,0,0,0,0,0,11,11,11
15371,Libya,2007,2007Libya,0,0,0,0,0,0,0,0,0,0,5,0,0,5,5
15372,Libya,2007,2007Libya,0,0,0,0,0,5,5,0,0,0,0,0,0,0,5
15373,Libya,2007,2007Libya,5,0,0,5,0,119,129,0,5,0,6,0,181,192,321
15374,Libya,2008,2008Libya,0,0,0,0,0,0,0,0,0,0,0,0,0,0,1738
15375,Libya,2008,2008Libya,0,0,0,0,0,0,0,0,0,0,0,0,14,14,14
15376,Libya,2008,2008Libya,0,0,0,0,0,0,0,0,0,0,5,0,0,5,5
15377,Libya,2008,2008Libya,0,0,0,0,0,6,6,0,0,0,0,0,7,7,13
15378,Libya,2008,2008Libya,6,0,0,5,0,106,117,0,5,0,6,0,170,181,298
15379,Libya,2009,2009Libya,0,0,0,0,0,0,0,0,0,0,0,0,0,0,1295
15380,Libya,2009,2009Libya,0,0,0,0,0,0,0,0,0,0,5,0,0,5,5
15381,Libya,2009,2009Libya,0,0,0,0,0,0,0,0,0,6,0,0,0,6,6
15382,Libya,2009,2009Libya,0,0,0,0,0,6,6,0,0,0,0,0,7,7,13
15383,Libya,2009,2009Libya,9,0,0,5,0,104,118,5,6,0,8,0,162,181,299
15384,Libya,2009,2009Libya,21,26,26,120,9,0,202,15,31,14,275,34,0,369,571
15385,Libya,2010,2010Libya,0,0,0,0,0,0,0,0,0,0,0,0,0,0,1353
15386,Libya,2010,2010Libya,0,0,0,0,0,0,0,0,0,0,5,0,0,5,10
15387,Libya,2010,2010Libya,0,0,0,0,0,0,0,0,0,6,0,0,0,6,6
15388,Libya,2010,2010Libya,0,0,0,0,0,5,5,0,0,0,0,0,5,5,10
15389,Libya,2010,2010Libya,0,0,0,0,0,5,5,0,0,0,0,0,13,13,18
15390,Libya,2010,2010Libya,6,0,5,5,0,88,104,5,6,0,8,0,141,160,264
15391,Libya,2010,2010Libya,16,28,25,135,20,0,224,15,35,16,301,45,0,412,636
15392,Libya,2011,2011Libya,0,0,0,0,0,0,0,0,0,0,0,0,0,0,3169
15393,Libya,2011,2011Libya,0,0,0,0,0,0,0,0,0,0,0,0,9,9,9
15394,Libya,2011,2011Libya,0,0,0,0,0,0,0,0,0,0,8,0,0,8,8
15395,Libya,2011,2011Libya,0,0,0,0,0,0,0,0,0,6,0,0,0,6,6
15396,Libya,2011,2011Libya,0,0,0,0,0,0,0,5,0,0,0,0,0,5,5
15397,Libya,2011,2011Libya,0,0,0,0,0,5,5,0,0,0,0,0,15,15,20
15398,Libya,2011,2011Libya,0,5,0,5,0,75,85,0,7,0,5,0,126,138,223
15399,Libya,2011,2011Libya,5,0,0,11,0,0,16,5,0,0,32,0,0,37,246
15400,Libya,2011,2011Libya,16,26,20,133,23,0,218,13,31,19,356,49,0,468,686
15401,Libya,2012,2012Libya,0,0,0,0,0,0,0,0,0,0,0,0,0,0,2440
15402,Libya,2012,2012Libya,0,0,0,0,0,0,0,0,0,0,0,0,9,9,9
15403,Libya,2012,2012Libya,0,0,0,0,0,0,0,0,0,7,5,0,0,12,12
15404,Libya,2012,2012Libya,0,0,0,0,0,0,0,0,5,0,0,0,0,5,5
15405,Libya,2012,2012Libya,0,0,0,0,0,0,0,0,8,0,0,0,0,8,8
15406,Libya,2012,2012Libya,0,0,0,0,0,8,8,0,0,0,0,0,17,17,25
15407,Libya,2012,2012Libya,0,0,0,5,0,0,5,0,0,0,0,0,0,0,5
15408,Libya,2012,2012Libya,0,0,0,6,0,0,6,0,0,0,28,0,0,28,241
15409,Libya,2012,2012Libya,5,0,0,5,0,77,87,0,0,0,7,0,114,121,208
15410,Libya,2012,2012Libya,52,70,26,391,56,0,595,57,67,51,1396,114,0,1685,2280
15411,Libya,2013,2013Libya,0,0,0,0,0,0,0,0,0,0,0,0,0,0,2487
15412,Libya,2013,2013Libya,0,0,0,0,0,0,0,0,0,0,0,0,5,5,5
15413,Libya,2013,2013Libya,0,0,0,0,0,0,0,0,0,0,5,0,0,5,5
15414,Libya,2013,2013Libya,0,0,0,0,0,0,0,0,5,0,0,0,0,5,10
15415,Libya,2013,2013Libya,0,0,0,0,0,12,12,0,0,0,0,0,30,30,42
15416,Libya,2013,2013Libya,0,0,0,5,0,0,5,0,0,0,0,0,0,0,5
15417,Libya,2013,2013Libya,0,0,0,7,0,0,7,5,0,0,13,0,0,18,230
15418,Libya,2013,2013Libya,0,0,9,44,5,0,58,0,0,12,104,0,0,116,174
15419,Libya,2013,2013Libya,0,5,0,5,0,71,81,0,5,0,11,0,102,118,199
15420,Libya,2013,2013Libya,0,11,5,25,0,0,41,5,7,7,76,5,0,100,141
15421,Libya,2014,2014Libya,0,0,0,0,0,0,0,0,0,0,0,0,0,0,3363
15422,Libya,2014,2014Libya,0,0,0,0,0,0,0,0,0,0,0,0,5,5,5
15423,Libya,2014,2014Libya,0,0,0,0,0,0,0,0,0,0,5,0,0,5,5
15424,Libya,2014,2014Libya,0,0,0,0,0,0,0,0,0,5,0,0,0,5,5
15425,Libya,2014,2014Libya,0,0,0,0,0,18,18,0,0,0,0,0,49,49,67
15426,Libya,2014,2014Libya,0,0,0,6,0,0,6,0,0,0,0,0,0,0,6
15427,Libya,2014,2014Libya,0,0,5,0,0,0,5,0,0,0,5,0,0,5,10
15428,Libya,2014,2014Libya,0,0,8,9,0,68,85,0,13,0,23,0,95,131,216
15429,Libya,2014,2014Libya,8,13,6,24,0,0,51,11,8,6,31,0,0,56,243
15430,Libya,2014,2014Libya,10,21,11,51,0,0,93,14,26,14,111,9,0,174,267
15431,Libya,2015,2015Libya,0,0,0,0,0,0,0,0,0,0,0,0,0,0,5044
15432,Libya,2015,2015Libya,0,0,0,0,0,0,0,0,0,0,0,0,5,5,5
15433,Libya,2015,2015Libya,0,0,0,0,0,0,0,0,0,0,5,0,0,5,5
15434,Libya,2015,2015Libya,0,0,0,0,0,0,0,0,0,0,10,0,0,10,10
15435,Libya,2015,2015Libya,0,0,0,0,0,0,0,0,0,0,11,0,0,11,11
15436,Libya,2015,2015Libya,0,0,0,0,0,0,0,0,0,8,0,0,0,8,8
15437,Libya,2015,2015Libya,0,0,0,0,0,0,0,0,5,0,0,0,0,5,10
15438,Libya,2015,2015Libya,0,0,0,0,0,12,12,0,0,0,0,0,27,27,39
15439,Libya,2015,2015Libya,0,0,0,0,0,44,44,0,0,0,0,0,99,99,143
15440,Libya,2015,2015Libya,0,0,0,6,0,0,6,0,0,0,0,0,0,0,6
15441,Libya,2015,2015Libya,0,0,0,54,0,0,54,0,0,5,115,0,0,120,174
15442,Libya,2015,2015Libya,0,0,5,0,0,0,5,0,0,0,0,0,0,0,5
15443,Libya,2015,2015Libya,0,5,8,15,0,96,124,5,6,5,37,0,68,121,250
15444,Libya,2015,2015Libya,5,0,0,0,0,0,5,0,0,0,8,0,0,8,13
15445,Libya,2015,2015Libya,5,0,10,0,0,0,15,0,0,0,5,0,0,5,20
15446,Libya,2015,2015Libya,10,28,17,74,0,0,129,15,34,18,128,10,0,205,334
15447,Libya,2016,2016Libya,0,0,0,0,0,0,0,0,0,0,0,0,0,0,6219
15448,Libya,2016,2016Libya,0,0,0,0,0,0,0,0,0,0,0,0,5,5,5
15449,Libya,2016,2016Libya,0,0,0,0,0,0,0,0,0,0,5,0,0,5,20
15450,Libya,2016,2016Libya,0,0,0,0,0,0,0,0,0,0,6,0,0,6,6
15451,Libya,2016,2016Libya,0,0,0,0,0,0,0,0,0,0,9,0,0,9,9
15452,Libya,2016,2016Libya,0,0,0,0,0,0,0,0,0,6,0,0,0,6,6
15453,Libya,2016,2016Libya,0,0,0,0,0,0,0,0,0,6,10,0,0,16,16
15454,Libya,2016,2016Libya,0,0,0,0,0,18,18,0,0,0,0,0,42,42,60
15455,Libya,2016,2016Libya,0,0,0,0,0,93,93,0,0,0,0,0,229,229,322
15456,Libya,2016,2016Libya,0,0,0,5,0,0,5,0,0,0,0,0,0,0,5
15457,Libya,2016,2016Libya,0,0,0,5,0,0,5,0,5,0,0,0,0,5,10
15458,Libya,2016,2016Libya,0,0,0,8,0,0,8,0,0,0,15,0,0,15,23
15459,Libya,2016,2016Libya,0,0,0,8,0,0,8,0,0,0,99,0,0,99,869
15460,Libya,2016,2016Libya,0,0,5,0,0,0,5,0,0,0,0,0,0,0,5
15461,Libya,2016,2016Libya,0,0,7,5,0,0,12,0,0,0,0,0,0,0,12
15462,Libya,2016,2016Libya,0,5,0,6,0,0,11,0,0,0,5,0,0,5,16
15463,Libya,2016,2016Libya,0,6,0,0,0,0,6,0,0,5,5,0,0,10,16
15464,Libya,2016,2016Libya,0,6,5,5,0,0,16,0,0,0,7,0,0,7,23
15465,Libya,2016,2016Libya,5,5,6,17,0,71,104,6,10,5,53,0,99,173,277
15466,Libya,2016,2016Libya,6,6,0,58,0,5,75,0,6,5,140,0,0,151,226
15467,Libya,2016,2016Libya,33,48,31,158,0,0,270,41,68,29,267,11,0,416,686
15468,Libya,2017,2017Libya,0,0,0,0,0,0,0,0,0,0,0,0,0,0,8524
15469,Libya,2017,2017Libya,0,0,0,0,0,0,0,0,0,0,6,0,0,6,12
15470,Libya,2017,2017Libya,0,0,0,0,0,0,0,0,0,0,9,0,0,9,9
15471,Libya,2017,2017Libya,0,0,0,0,0,0,0,0,5,0,0,0,0,5,5
15472,Libya,2017,2017Libya,0,0,0,0,0,171,171,0,0,0,0,0,369,369,540
15473,Libya,2017,2017Libya,0,0,0,5,0,0,5,0,0,0,0,0,0,0,5
15474,Libya,2017,2017Libya,0,0,0,6,0,0,6,0,0,0,0,0,0,0,6
15475,Libya,2017,2017Libya,0,0,0,6,0,0,6,0,5,5,16,0,0,26,32
15476,Libya,2017,2017Libya,0,0,0,8,0,0,8,0,6,0,0,0,0,6,14
15477,Libya,2017,2017Libya,0,0,0,9,0,0,9,0,0,0,0,0,0,0,9
15478,Libya,2017,2017Libya,0,0,0,10,0,0,10,0,0,0,22,0,0,22,32
15479,Libya,2017,2017Libya,0,0,5,0,0,0,5,0,0,0,0,0,0,0,5
15480,Libya,2017,2017Libya,0,0,7,5,0,0,12,0,0,0,0,0,0,0,12
15481,Libya,2017,2017Libya,0,6,5,5,0,0,16,0,0,0,7,0,0,7,23
15482,Libya,2017,2017Libya,0,10,0,7,0,0,17,0,5,0,5,0,0,10,27
15483,Libya,2017,2017Libya,5,7,5,63,0,0,80,5,8,5,152,0,0,170,255
15484,Libya,2017,2017Libya,6,0,0,0,0,0,6,0,6,0,7,0,0,13,19
15485,Libya,2017,2017Libya,7,0,7,20,0,111,145,0,12,5,58,0,77,152,297
15486,Libya,2017,2017Libya,88,105,56,308,9,0,566,90,137,61,504,21,0,813,1379
15487,Libya,2018,2018Libya,0,0,0,0,0,0,0,0,0,0,0,0,0,0,9407
15488,Libya,2018,2018Libya,0,0,0,0,0,0,0,0,0,0,5,0,0,5,20
15489,Libya,2018,2018Libya,0,0,0,0,0,0,0,0,0,0,6,0,0,6,6
15490,Libya,2018,2018Libya,0,0,0,0,0,0,0,0,0,0,7,0,0,7,7
15491,Libya,2018,2018Libya,0,0,0,0,0,0,0,0,0,0,9,0,0,9,9
15492,Libya,2018,2018Libya,0,0,0,0,0,0,0,0,5,0,0,0,0,5,5
15493,Libya,2018,2018Libya,0,0,0,0,0,0,0,5,0,0,0,0,0,5,5
15494,Libya,2018,2018Libya,0,0,0,0,0,231,231,0,0,0,0,0,490,490,721
15495,Libya,2018,2018Libya,0,0,0,5,0,0,5,0,0,0,0,0,0,0,10
15496,Libya,2018,2018Libya,0,0,0,5,0,0,5,0,7,0,0,0,0,7,12
15497,Libya,2018,2018Libya,0,0,0,7,0,0,7,0,0,0,7,0,0,7,14
15498,Libya,2018,2018Libya,0,0,0,7,0,0,7,5,0,5,18,0,0,28,35
15499,Libya,2018,2018Libya,0,0,0,9,0,0,9,0,0,0,0,0,0,0,9
15500,Libya,2018,2018Libya,0,0,5,7,0,0,12,5,0,0,0,0,0,5,17
15501,Libya,2018,2018Libya,0,6,0,0,0,0,6,0,6,0,7,0,0,13,19
15502,Libya,2018,2018Libya,0,6,5,8,0,0,19,0,0,0,8,0,0,8,27
15503,Libya,2018,2018Libya,0,26,14,55,0,0,95,0,26,6,95,0,0,127,1330
15504,Libya,2018,2018Libya,5,5,0,7,0,0,17,0,0,5,8,0,0,13,30
15505,Libya,2018,2018Libya,5,6,6,21,0,73,111,5,7,5,61,5,109,192,303
15506,Libya,2018,2018Libya,7,14,0,25,0,0,46,8,14,5,77,0,0,104,150
15507,Libya,2018,2018Libya,92,140,78,385,11,0,706,104,169,84,644,25,0,1026,1732
15508,Libya,2019,2019Libya,0,0,0,0,0,0,0,0,0,0,0,0,0,0,12284
15509,Libya,2019,2019Libya,0,0,0,0,0,0,0,0,0,0,5,0,0,5,5
15510,Libya,2019,2019Libya,0,0,0,0,0,0,0,0,0,0,7,0,0,7,14
15511,Libya,2019,2019Libya,0,0,0,0,0,0,0,0,0,0,8,0,0,8,16
15512,Libya,2019,2019Libya,0,0,0,0,0,0,0,5,0,0,0,0,0,5,5
15513,Libya,2019,2019Libya,0,0,0,0,0,310,310,0,0,0,0,0,718,718,1028
15514,Libya,2019,2019Libya,0,0,0,5,0,0,5,0,0,0,0,0,0,0,15
15515,Libya,2019,2019Libya,0,0,0,5,0,0,5,0,0,0,5,0,0,5,10
15516,Libya,2019,2019Libya,0,0,0,5,0,0,5,0,0,6,0,0,0,6,11
15517,Libya,2019,2019Libya,0,0,0,5,0,0,5,0,0,8,19,0,0,27,32
15518,Libya,2019,2019Libya,0,0,0,5,0,0,5,0,5,0,0,0,0,5,10
15519,Libya,2019,2019Libya,0,0,0,7,0,0,7,0,0,0,7,0,0,7,14
15520,Libya,2019,2019Libya,0,0,5,8,0,0,13,8,0,0,0,0,0,8,21
15521,Libya,2019,2019Libya,0,0,6,0,0,0,6,0,7,0,6,0,0,13,19
15522,Libya,2019,2019Libya,0,5,5,8,0,0,18,0,5,0,7,0,0,12,30
15523,Libya,2019,2019Libya,7,8,6,21,0,0,42,0,9,11,66,5,0,91,312
15524,Libya,2019,2019Libya,7,16,5,35,0,0,63,9,28,7,113,0,0,157,220
15525,Libya,2019,2019Libya,81,174,89,438,16,0,798,115,201,88,755,30,0,1189,1987
15526,Libya,2020,2020Libya,0,0,0,0,0,0,0,0,0,0,0,0,0,0,12343
15527,Libya,2020,2020Libya,0,0,0,0,0,0,0,0,0,0,0,0,5,5,10
15528,Libya,2020,2020Libya,0,0,0,0,0,0,0,0,0,0,0,0,7,7,7
15529,Libya,2020,2020Libya,0,0,0,0,0,0,0,0,0,0,0,0,9,9,9
15530,Libya,2020,2020Libya,0,0,0,0,0,0,0,0,0,0,0,8,0,8,8
15531,Libya,2020,2020Libya,0,0,0,0,0,0,0,0,0,0,5,0,0,5,10
15532,Libya,2020,2020Libya,0,0,0,0,0,0,0,0,0,0,7,0,0,7,7
15533,Libya,2020,2020Libya,0,0,0,0,0,0,0,0,0,0,8,0,0,8,8
15534,Libya,2020,2020Libya,0,0,0,0,0,0,0,0,5,0,0,0,0,5,15
15535,Libya,2020,2020Libya,0,0,0,0,0,28,28,0,0,0,0,0,47,47,75
15536,Libya,2020,2020Libya,0,0,0,5,0,0,5,0,0,0,0,0,0,0,10
15537,Libya,2020,2020Libya,0,0,0,5,0,0,5,0,0,0,6,0,0,6,11
15538,Libya,2020,2020Libya,0,0,0,5,0,0,5,0,0,6,0,0,0,6,11
15539,Libya,2020,2020Libya,0,0,0,5,0,0,5,0,5,0,0,0,0,5,10
15540,Libya,2020,2020Libya,0,0,0,40,0,30,70,0,0,0,70,0,42,112,1719
15541,Libya,2020,2020Libya,0,0,5,8,0,0,13,5,0,0,6,0,0,11,24
15542,Libya,2020,2020Libya,0,0,6,0,0,0,6,0,7,0,7,0,0,14,20
15543,Libya,2020,2020Libya,0,0,7,0,0,0,7,0,0,0,0,0,0,0,7
15544,Libya,2020,2020Libya,0,0,9,5,0,0,14,0,0,0,0,0,0,0,14
15545,Libya,2020,2020Libya,0,5,10,11,0,0,26,0,8,0,12,0,0,20,46
15546,Libya,2020,2020Libya,0,6,5,6,0,0,17,0,6,5,20,0,0,31,48
15547,Libya,2020,2020Libya,0,8,0,0,0,0,8,0,0,0,7,0,0,7,15
15548,Libya,2020,2020Libya,6,17,5,37,0,0,65,7,31,10,128,0,0,176,241
15549,Libya,2020,2020Libya,9,11,5,23,0,0,48,0,8,9,69,5,0,91,310
15550,Libya,2020,2020Libya,95,234,109,554,26,0,1018,124,243,127,989,44,0,1527,2545
15551,Libya,2021,2021Libya,0,0,0,0,0,0,0,0,0,0,0,0,0,0,13672
15552,Libya,2021,2021Libya,0,0,0,0,0,0,0,0,0,0,0,0,5,5,5
15553,Libya,2021,2021Libya,0,0,0,0,0,0,0,0,0,0,0,6,0,6,6
15554,Libya,2021,2021Libya,0,0,0,0,0,0,0,0,0,0,5,0,0,5,15
15555,Libya,2021,2021Libya,0,0,0,0,0,0,0,0,0,0,7,0,0,7,7
15556,Libya,2021,2021Libya,0,0,0,0,0,0,0,0,0,0,8,0,0,8,8
15557,Libya,2021,2021Libya,0,0,0,0,0,0,0,0,0,9,0,0,0,9,9
15558,Libya,2021,2021Libya,0,0,0,0,0,0,0,0,5,0,0,0,0,5,15
15559,Libya,2021,2021Libya,0,0,0,0,0,5,5,0,0,0,0,0,17,17,22
15560,Libya,2021,2021Libya,0,0,0,5,0,0,5,0,0,0,0,0,0,0,10
15561,Libya,2021,2021Libya,0,0,0,5,0,0,5,0,0,0,6,0,0,6,11
15562,Libya,2021,2021Libya,0,0,0,6,0,0,6,0,0,0,5,0,0,5,11
15563,Libya,2021,2021Libya,0,0,6,0,0,0,6,0,7,0,8,0,0,15,21
15564,Libya,2021,2021Libya,0,0,7,0,0,0,7,0,0,0,0,0,0,0,7
15565,Libya,2021,2021Libya,0,0,8,0,0,0,8,0,0,0,0,0,0,0,8
15566,Libya,2021,2021Libya,0,5,0,9,0,0,14,5,0,0,6,0,0,11,25
15567,Libya,2021,2021Libya,0,5,7,10,0,0,22,0,0,7,17,0,0,24,46
15568,Libya,2021,2021Libya,0,6,0,17,0,0,23,0,0,6,11,0,0,17,40
15569,Libya,2021,2021Libya,0,6,5,6,0,0,17,0,5,5,22,0,0,32,49
15570,Libya,2021,2021Libya,0,9,0,0,0,0,9,0,0,0,5,0,0,5,14
15571,Libya,2021,2021Libya,0,13,5,79,0,30,127,6,16,5,155,5,42,229,1862
15572,Libya,2021,2021Libya,5,15,8,35,0,0,63,10,27,13,123,0,0,173,236
15573,Libya,2021,2021Libya,7,14,7,21,0,0,49,0,11,6,62,5,0,84,304
15574,Libya,2021,2021Libya,85,239,121,606,28,0,1079,110,271,146,1034,47,0,1608,2687
15575,Mali,2001,2001Mali,0,0,0,0,0,0,0,0,0,0,0,0,0,0,183
15576,Mali,2001,2001Mali,0,0,0,0,0,18,18,0,0,0,0,0,90,90,108
15577,Mali,2001,2001Mali,0,0,0,9,0,0,9,0,5,0,6,0,0,11,20
15578,Mali,2002,2002Mali,0,0,0,0,0,0,0,0,0,0,0,0,0,0,390
15579,Mali,2002,2002Mali,0,0,0,0,0,21,21,0,0,0,0,0,94,94,115
15580,Mali,2002,2002Mali,0,0,0,9,0,0,9,0,5,6,0,0,0,11,20
15581,Mali,2003,2003Mali,0,0,0,0,0,0,0,0,0,0,0,0,0,0,328
15582,Mali,2003,2003Mali,0,0,0,0,0,25,25,0,0,0,0,0,83,83,108
15583,Mali,2003,2003Mali,0,0,0,9,0,0,9,0,5,6,0,0,0,11,20
15584,Mali,2004,2004Mali,0,0,0,0,0,0,0,0,0,0,0,0,0,0,448
15585,Mali,2004,2004Mali,0,0,0,6,0,0,6,0,0,0,0,0,0,0,6
15586,Mali,2004,2004Mali,0,0,0,7,0,0,7,0,5,0,10,0,0,15,22
15587,Mali,2005,2005Mali,0,0,0,0,0,0,0,0,0,0,0,0,0,0,341
15588,Mali,2005,2005Mali,0,0,0,0,0,0,0,0,0,0,5,0,0,5,5
15589,Mali,2005,2005Mali,0,0,0,0,0,0,0,0,9,0,0,0,0,9,9
15590,Mali,2005,2005Mali,0,0,0,0,0,42,42,0,0,0,0,0,87,87,129
15591,Mali,2005,2005Mali,0,0,0,5,0,0,5,0,5,0,9,0,0,14,19
15592,Mali,2005,2005Mali,0,0,0,9,0,0,9,0,0,0,0,0,0,0,9
15593,Mali,2006,2006Mali,0,0,0,0,0,0,0,0,0,0,0,0,0,0,378
15594,Mali,2006,2006Mali,0,0,0,0,0,0,0,0,0,0,5,0,0,5,5
15595,Mali,2006,2006Mali,0,0,0,0,0,0,0,0,0,9,0,0,0,9,9
15596,Mali,2006,2006Mali,0,0,0,0,0,7,7,0,0,0,0,0,5,5,12
15597,Mali,2006,2006Mali,0,0,0,0,0,65,65,0,0,0,0,0,98,98,163
15598,Mali,2006,2006Mali,0,0,0,5,0,0,5,0,5,0,9,0,0,14,19
15599,Mali,2007,2007Mali,0,0,0,0,0,0,0,0,0,0,0,0,0,0,4065
15600,Mali,2007,2007Mali,0,0,0,0,0,0,0,0,0,0,5,0,0,5,5
15601,Mali,2007,2007Mali,0,0,0,0,0,0,0,0,0,9,0,0,0,9,9
15602,Mali,2007,2007Mali,0,0,0,0,0,241,241,0,0,0,0,0,137,137,378
15603,Mali,2007,2007Mali,0,0,0,5,0,0,5,0,5,0,9,0,0,14,19
15604,Mali,2007,2007Mali,0,0,0,8,0,0,8,0,0,0,5,0,0,5,13
15605,Mali,2008,2008Mali,0,0,0,0,0,0,0,0,0,0,0,0,0,0,680
15606,Mali,2008,2008Mali,0,0,0,0,0,0,0,0,0,0,5,0,0,5,5
15607,Mali,2008,2008Mali,0,0,0,0,0,5,5,0,0,0,0,0,0,0,5
15608,Mali,2008,2008Mali,0,0,0,0,0,640,640,0,0,0,0,0,409,409,1049
15609,Mali,2008,2008Mali,0,0,0,7,0,0,7,0,0,0,5,0,0,5,12
15610,Mali,2009,2009Mali,0,0,0,0,0,0,0,0,0,0,0,0,0,0,2829
15611,Mali,2009,2009Mali,0,0,0,0,0,0,0,0,0,0,5,0,0,5,10
15612,Mali,2009,2009Mali,0,0,0,0,0,5,5,0,0,0,0,0,0,0,5
15613,Mali,2009,2009Mali,0,0,0,6,0,0,6,0,0,0,5,0,0,5,11
15614,Mali,2009,2009Mali,0,0,7,13,0,0,20,5,5,0,37,5,0,52,72
15615,Mali,2010,2010Mali,0,0,0,0,0,0,0,0,0,0,0,0,0,0,945
15616,Mali,2010,2010Mali,0,0,0,0,0,0,0,0,0,0,5,0,0,5,5
15617,Mali,2010,2010Mali,0,0,0,0,0,0,0,0,0,5,0,0,0,5,5
15618,Mali,2010,2010Mali,0,0,0,0,0,5,5,0,0,0,0,0,0,0,5
15619,Mali,2010,2010Mali,0,0,0,0,0,1892,1892,0,0,0,0,0,722,722,2614
15620,Mali,2010,2010Mali,0,0,0,5,0,0,5,0,5,0,0,0,0,5,10
15621,Mali,2010,2010Mali,0,8,0,15,0,0,23,5,5,0,37,5,0,52,75
15622,Mali,2011,2011Mali,0,0,0,0,0,0,0,0,0,0,0,0,0,0,999
15623,Mali,2011,2011Mali,0,0,0,0,0,0,0,0,0,0,5,0,0,5,5
15624,Mali,2011,2011Mali,0,0,0,0,0,0,0,0,0,5,0,0,0,5,10
15625,Mali,2011,2011Mali,0,0,0,0,0,9,9,0,0,0,0,0,0,0,18
15626,Mali,2011,2011Mali,0,0,0,0,0,2250,2250,0,0,0,0,0,832,832,3082
15627,Mali,2011,2011Mali,0,0,0,5,0,0,5,0,0,0,0,0,0,0,109
15628,Mali,2011,2011Mali,0,7,0,14,0,0,21,0,5,0,35,5,0,45,66
15629,Mali,2012,2012Mali,0,0,0,0,0,0,0,0,0,0,0,0,0,0,3099
15630,Mali,2012,2012Mali,0,0,0,0,0,0,0,0,0,0,5,0,0,5,5
15631,Mali,2012,2012Mali,0,0,0,0,0,0,0,0,0,0,6,0,0,6,6
15632,Mali,2012,2012Mali,0,0,0,0,0,0,0,0,0,0,7,0,0,7,99
15633,Mali,2012,2012Mali,0,0,0,0,0,0,0,0,9,0,0,0,0,9,9
15634,Mali,2012,2012Mali,0,0,0,0,0,6,6,0,0,0,0,0,5,5,11
15635,Mali,2012,2012Mali,0,0,0,0,0,9,9,0,0,0,0,0,0,0,9
15636,Mali,2012,2012Mali,0,0,0,0,0,2537,2537,0,0,0,0,0,891,891,3428
15637,Mali,2012,2012Mali,0,0,0,5,0,0,5,0,0,0,16,5,0,21,26
15638,Mali,2012,2012Mali,0,5,6,40,0,0,51,0,6,18,62,0,0,86,137
15639,Mali,2012,2012Mali,0,6,0,0,0,0,6,0,0,0,0,0,0,0,6
15640,Mali,2012,2012Mali,9,0,0,19,0,0,28,0,8,5,40,5,0,58,86
15641,Mali,2012,2012Mali,3242,4392,2316,7978,643,0,18571,3570,4930,2656,8269,780,0,20205,38776
15642,Mali,2012,2012Mali,4542,7520,3738,10522,1068,0,27390,4199,6959,3295,7228,1133,0,22814,50204
15643,Mali,2012,2012Mali,6289,6544,2972,12953,866,0,29624,6299,6633,2633,8119,721,0,24405,54029
15644,Mali,2013,2013Mali,0,0,0,0,0,0,0,0,0,0,0,0,0,0,4711
15645,Mali,2013,2013Mali,0,0,0,0,0,0,0,0,0,0,5,0,0,5,5
15646,Mali,2013,2013Mali,0,0,0,0,0,0,0,0,0,0,10,5,0,15,15
15647,Mali,2013,2013Mali,0,0,0,0,0,0,0,0,0,0,14,5,0,19,19
15648,Mali,2013,2013Mali,0,0,0,0,0,0,0,0,0,0,23,0,0,23,23
15649,Mali,2013,2013Mali,0,0,0,0,0,0,0,0,0,5,0,0,0,5,5
15650,Mali,2013,2013Mali,0,0,0,0,0,0,0,0,5,0,0,0,0,5,5
15651,Mali,2013,2013Mali,0,0,0,0,0,5,5,0,0,0,0,0,7,7,17
15652,Mali,2013,2013Mali,0,0,0,0,0,2787,2787,0,0,0,0,0,932,932,3719
15653,Mali,2013,2013Mali,0,0,0,0,6,0,6,0,0,0,0,6,0,6,12
15654,Mali,2013,2013Mali,0,0,0,5,0,0,5,0,0,0,5,0,0,5,10
15655,Mali,2013,2013Mali,0,0,5,5,0,0,10,0,0,0,5,0,0,5,87
15656,Mali,2013,2013Mali,0,0,7,0,0,0,7,0,0,0,0,0,0,0,7
15657,Mali,2013,2013Mali,0,0,7,6,0,0,13,0,0,7,17,0,0,24,37
15658,Mali,2013,2013Mali,0,5,0,0,0,0,5,0,0,0,0,0,0,0,5
15659,Mali,2013,2013Mali,0,6,0,0,0,0,6,0,0,0,0,0,0,0,6
15660,Mali,2013,2013Mali,5,0,0,0,0,0,5,0,0,0,0,0,0,0,5
15661,Mali,2013,2013Mali,5,0,0,5,0,0,10,0,0,5,6,0,0,11,21
15662,Mali,2013,2013Mali,6,6,0,12,0,0,24,0,6,7,61,0,0,74,98
15663,Mali,2013,2013Mali,2658,3674,1552,6367,582,0,14833,2640,3740,1608,5222,641,0,13851,28684
15664,Mali,2013,2013Mali,4750,7482,2924,10698,972,0,26826,4861,7235,2653,6573,780,0,22102,48928
15665,Mali,2013,2013Mali,5482,9555,3708,15693,1910,0,36348,5483,9391,3830,9925,1416,0,30045,66393
15666,Mali,2014,2014Mali,0,0,0,0,0,0,0,0,0,0,0,0,0,0,6887
15667,Mali,2014,2014Mali,0,0,0,0,0,0,0,0,0,0,0,0,6,6,6
15668,Mali,2014,2014Mali,0,0,0,0,0,0,0,0,0,0,5,0,0,5,15
15669,Mali,2014,2014Mali,0,0,0,0,0,0,0,0,0,0,10,5,0,15,15
15670,Mali,2014,2014Mali,0,0,0,0,0,0,0,0,0,0,14,5,0,19,19
15671,Mali,2014,2014Mali,0,0,0,0,0,0,0,0,5,0,0,0,0,5,5
15672,Mali,2014,2014Mali,0,0,0,0,0,0,0,6,0,0,0,0,0,6,6
15673,Mali,2014,2014Mali,0,0,0,0,0,3030,3030,0,0,0,0,0,904,904,3934
15674,Mali,2014,2014Mali,0,0,0,5,0,0,5,0,0,0,0,0,0,0,5
15675,Mali,2014,2014Mali,0,0,0,7,0,0,7,0,0,8,0,0,0,8,15
15676,Mali,2014,2014Mali,0,0,5,10,0,0,15,0,0,5,14,0,0,19,34
15677,Mali,2014,2014Mali,0,0,7,6,0,0,13,0,6,0,15,5,0,26,39
15678,Mali,2014,2014Mali,0,0,8,0,0,0,8,0,0,0,0,0,0,0,8
15679,Mali,2014,2014Mali,0,5,0,7,0,0,12,0,0,0,9,0,0,9,73
15680,Mali,2014,2014Mali,0,5,0,26,0,0,31,0,0,0,34,0,0,34,65
15681,Mali,2014,2014Mali,0,6,0,5,0,0,11,0,0,8,0,0,0,8,19
15682,Mali,2014,2014Mali,5,0,0,0,0,0,5,0,0,0,0,0,0,0,5
15683,Mali,2014,2014Mali,5,7,0,16,0,0,28,0,6,6,77,0,0,89,117
15684,Mali,2014,2014Mali,2611,4160,1945,7022,574,0,16312,2618,4366,2071,5560,677,0,15292,31604
15685,Mali,2014,2014Mali,3241,8020,3265,10595,854,0,25975,3370,7832,3171,6398,720,0,21491,47466
15686,Mali,2014,2014Mali,4581,6851,2692,11641,1440,0,27205,4586,6640,2628,6790,1063,0,21707,48912
15687,Mali,2015,2015Mali,0,0,0,0,0,0,0,0,0,0,0,0,0,0,9807
15688,Mali,2015,2015Mali,0,0,0,0,0,0,0,0,0,0,5,0,0,5,15
15689,Mali,2015,2015Mali,0,0,0,0,0,0,0,0,0,0,7,0,0,7,7
15690,Mali,2015,2015Mali,0,0,0,0,0,0,0,0,0,0,10,5,0,15,15
15691,Mali,2015,2015Mali,0,0,0,0,0,0,0,0,0,0,11,0,0,11,11
15692,Mali,2015,2015Mali,0,0,0,0,0,0,0,0,0,5,0,0,0,5,5
15693,Mali,2015,2015Mali,0,0,0,0,0,0,0,0,6,0,0,0,0,6,6
15694,Mali,2015,2015Mali,0,0,0,0,0,28,28,0,0,0,0,0,34,34,62
15695,Mali,2015,2015Mali,0,0,0,0,0,3167,3167,0,0,0,0,0,883,883,4050
15696,Mali,2015,2015Mali,0,0,0,5,0,0,5,0,0,0,0,0,0,0,5
15697,Mali,2015,2015Mali,0,0,0,6,0,0,6,0,0,0,61,0,0,61,67
15698,Mali,2015,2015Mali,0,0,5,13,0,0,18,0,0,5,26,0,0,31,49
15699,Mali,2015,2015Mali,0,0,7,41,0,0,48,0,6,0,26,5,0,37,85
15700,Mali,2015,2015Mali,0,0,9,0,0,0,9,0,0,0,0,0,0,0,9
15701,Mali,2015,2015Mali,0,5,0,0,0,0,5,0,0,0,0,0,0,0,5
15702,Mali,2015,2015Mali,0,6,0,5,0,0,11,0,0,8,0,0,0,8,19
15703,Mali,2015,2015Mali,0,9,0,0,0,0,9,0,0,0,0,0,0,0,9
15704,Mali,2015,2015Mali,5,0,0,0,0,0,5,0,0,0,0,0,0,0,5
15705,Mali,2015,2015Mali,5,0,0,0,0,0,5,0,0,0,11,0,0,11,16
15706,Mali,2015,2015Mali,5,5,5,17,0,0,32,5,8,5,81,5,0,104,136
15707,Mali,2015,2015Mali,2196,4468,2364,7677,619,0,17324,2269,4629,2512,6096,744,0,16250,33574
15708,Mali,2015,2015Mali,4029,9073,4219,12347,952,0,30620,4175,9016,4013,7321,867,0,25392,56012
15709,Mali,2015,2015Mali,4077,7227,3034,12069,1458,0,27865,4138,6982,2987,7134,1127,0,22368,50233
15710,Mali,2016,2016Mali,0,0,0,0,0,0,0,0,0,0,0,0,0,0,12692
15711,Mali,2016,2016Mali,0,0,0,0,0,0,0,0,0,0,5,0,0,5,10
15712,Mali,2016,2016Mali,0,0,0,0,0,0,0,0,0,0,10,0,0,10,10
15713,Mali,2016,2016Mali,0,0,0,0,0,0,0,0,0,6,8,0,0,14,14
15714,Mali,2016,2016Mali,0,0,0,0,0,0,0,0,5,0,0,0,0,5,5
15715,Mali,2016,2016Mali,0,0,0,0,0,0,0,0,6,0,0,0,0,6,6
15716,Mali,2016,2016Mali,0,0,0,0,0,29,29,0,0,0,0,0,32,32,61
15717,Mali,2016,2016Mali,0,0,0,0,0,3331,3331,0,0,0,0,0,891,891,4222
15718,Mali,2016,2016Mali,0,0,0,5,0,6,11,0,0,5,7,0,0,12,23
15719,Mali,2016,2016Mali,0,0,0,6,0,0,6,0,0,0,61,0,0,61,67
15720,Mali,2016,2016Mali,0,0,0,15,0,0,15,0,0,0,21,0,0,21,125
15721,Mali,2016,2016Mali,0,0,8,0,0,0,8,0,0,0,0,0,0,0,8
15722,Mali,2016,2016Mali,0,5,0,0,0,0,5,0,0,0,0,0,0,0,5
15723,Mali,2016,2016Mali,0,5,0,0,0,0,5,0,0,5,19,0,0,24,29
15724,Mali,2016,2016Mali,0,5,0,22,0,0,27,0,8,0,43,0,0,51,78
15725,Mali,2016,2016Mali,0,6,0,5,0,0,11,0,0,8,0,0,0,8,19
15726,Mali,2016,2016Mali,0,8,0,0,0,0,8,0,0,0,0,0,0,0,8
15727,Mali,2016,2016Mali,5,5,5,18,0,0,33,5,9,5,80,5,0,104,137
15728,Mali,2016,2016Mali,6,9,7,16,0,0,38,6,5,6,21,5,0,43,81
15729,Mali,2016,2016Mali,2322,4217,2234,7152,537,0,16462,2365,4320,2384,5808,678,0,15555,32017
15730,Mali,2016,2016Mali,3252,6208,3093,11149,1384,0,25086,3298,6069,3143,7899,1149,0,21558,46644
15731,Mali,2016,2016Mali,4225,5010,13246,9345,1011,0,32837,4332,4774,7786,9479,946,0,27317,60154
15732,Mali,2017,2017Mali,0,0,0,0,0,0,0,0,0,0,0,0,0,0,14798
15733,Mali,2017,2017Mali,0,0,0,0,0,0,0,0,0,0,5,0,0,5,10
15734,Mali,2017,2017Mali,0,0,0,0,0,0,0,0,0,0,7,0,0,7,74
15735,Mali,2017,2017Mali,0,0,0,0,0,0,0,0,0,0,9,0,0,9,9
15736,Mali,2017,2017Mali,0,0,0,0,0,0,0,0,0,0,16,0,0,16,16
15737,Mali,2017,2017Mali,0,0,0,0,0,0,0,0,0,6,0,0,0,6,12
15738,Mali,2017,2017Mali,0,0,0,0,0,0,0,0,5,0,0,0,0,5,5
15739,Mali,2017,2017Mali,0,0,0,0,0,3486,3486,0,0,0,0,0,895,895,4381
15740,Mali,2017,2017Mali,0,0,0,5,0,0,5,0,0,5,12,0,7,24,29
15741,Mali,2017,2017Mali,0,0,8,0,0,0,8,0,0,0,0,0,0,0,8
15742,Mali,2017,2017Mali,0,0,9,0,0,0,9,0,0,0,0,0,0,0,9
15743,Mali,2017,2017Mali,0,0,9,0,0,0,9,0,0,5,5,0,0,10,19
15744,Mali,2017,2017Mali,0,6,0,0,0,0,6,0,0,0,0,0,0,0,6
15745,Mali,2017,2017Mali,0,7,0,0,0,0,7,0,0,6,0,0,0,6,13
15746,Mali,2017,2017Mali,5,0,0,0,0,0,5,0,0,0,0,0,0,0,5
15747,Mali,2017,2017Mali,5,5,5,18,0,0,33,5,9,5,80,5,0,104,137
15748,Mali,2017,2017Mali,7,0,0,0,0,0,7,0,0,5,22,0,0,27,34
15749,Mali,2017,2017Mali,7,9,8,18,0,0,42,5,7,8,24,5,0,49,91
15750,Mali,2017,2017Mali,17,11,0,47,0,0,75,10,9,8,114,0,0,141,216
15751,Mali,2017,2017Mali,2358,3174,1681,4939,347,0,12499,2360,3284,1853,3360,410,0,11267,23766
15752,Mali,2017,2017Mali,5025,6555,3178,11148,1124,0,27030,5071,6211,3056,7439,1022,0,22799,49829
15753,Mali,2017,2017Mali,5271,8083,4708,12341,920,0,31323,5302,8324,4563,6409,917,0,25515,56838
15754,Mali,2018,2018Mali,0,0,0,0,0,0,0,0,0,0,0,0,0,0,16570
15755,Mali,2018,2018Mali,0,0,0,0,0,0,0,0,0,0,5,0,0,5,10
15756,Mali,2018,2018Mali,0,0,0,0,0,0,0,0,0,0,7,0,0,7,7
15757,Mali,2018,2018Mali,0,0,0,0,0,0,0,0,0,0,9,0,0,9,9
15758,Mali,2018,2018Mali,0,0,0,0,0,0,0,0,7,0,0,0,0,7,7
15759,Mali,2018,2018Mali,0,0,0,0,0,0,0,5,0,0,0,0,0,5,5
15760,Mali,2018,2018Mali,0,0,0,0,0,0,0,6,0,0,0,0,0,6,6
15761,Mali,2018,2018Mali,0,0,0,0,0,3797,3797,0,0,0,0,0,976,976,4773
15762,Mali,2018,2018Mali,0,0,0,5,0,5,10,0,0,7,15,0,5,27,37
15763,Mali,2018,2018Mali,0,0,0,6,0,0,6,0,0,0,13,0,0,13,19
15764,Mali,2018,2018Mali,0,0,0,7,0,0,7,0,0,7,0,0,0,7,14
15765,Mali,2018,2018Mali,0,0,0,9,0,0,9,0,5,0,5,0,0,10,19
15766,Mali,2018,2018Mali,0,0,8,0,0,0,8,0,0,0,0,0,0,0,8
15767,Mali,2018,2018Mali,0,5,0,0,0,0,5,0,0,0,0,0,0,0,5
15768,Mali,2018,2018Mali,0,8,7,19,0,0,34,0,10,5,83,5,0,103,137
15769,Mali,2018,2018Mali,0,9,0,0,0,0,9,0,0,5,6,0,0,11,20
15770,Mali,2018,2018Mali,5,0,0,0,0,0,5,0,0,0,0,0,0,0,5
15771,Mali,2018,2018Mali,5,7,5,26,0,0,43,0,9,0,29,0,0,38,163
15772,Mali,2018,2018Mali,5,12,6,20,0,0,43,5,5,5,27,6,0,48,91
15773,Mali,2018,2018Mali,7,0,5,8,0,0,20,0,0,6,29,0,0,35,55
15774,Mali,2018,2018Mali,22,16,0,54,0,0,92,18,11,7,144,0,0,180,272
15775,Mali,2018,2018Mali,1876,3216,2131,5453,393,0,13069,1987,3128,2243,3818,465,0,11641,24710
15776,Mali,2018,2018Mali,4697,7787,4981,12386,902,0,30753,4735,8102,4791,6267,892,0,24787,55540
15777,Mali,2018,2018Mali,4949,7053,4127,12691,1274,0,30094,5089,6730,3951,8712,1209,0,25691,55785
15778,Mali,2019,2019Mali,0,0,0,0,0,0,0,0,0,0,0,0,0,0,17649
15779,Mali,2019,2019Mali,0,0,0,0,0,0,0,0,0,0,6,0,0,6,6
15780,Mali,2019,2019Mali,0,0,0,0,0,0,0,0,0,0,9,0,0,9,9
15781,Mali,2019,2019Mali,0,0,0,0,0,0,0,0,7,0,0,0,0,7,7
15782,Mali,2019,2019Mali,0,0,0,0,0,4040,4040,0,0,0,0,0,1129,1129,5169
15783,Mali,2019,2019Mali,0,0,0,5,0,0,5,0,0,5,15,0,0,20,34
15784,Mali,2019,2019Mali,0,0,0,5,0,0,5,0,5,0,7,0,0,12,17
15785,Mali,2019,2019Mali,0,0,0,5,0,0,5,7,0,0,0,0,0,7,12
15786,Mali,2019,2019Mali,0,0,0,6,0,0,6,0,0,7,0,0,0,7,13
15787,Mali,2019,2019Mali,0,0,0,9,0,0,9,0,5,0,5,0,0,10,19
15788,Mali,2019,2019Mali,0,0,0,9,0,0,9,0,8,0,14,0,0,22,31
15789,Mali,2019,2019Mali,0,0,5,6,0,0,11,0,0,5,9,0,0,14,25
15790,Mali,2019,2019Mali,0,0,8,0,0,0,8,0,0,0,0,0,0,0,8
15791,Mali,2019,2019Mali,0,5,0,0,0,0,5,0,0,0,0,0,0,0,10
15792,Mali,2019,2019Mali,0,5,0,0,0,0,5,0,0,0,8,0,0,8,13
15793,Mali,2019,2019Mali,0,12,7,19,0,0,38,5,7,5,82,7,0,106,144
15794,Mali,2019,2019Mali,0,13,6,16,0,0,35,0,6,6,20,5,0,37,72
15795,Mali,2019,2019Mali,7,5,0,13,0,0,25,0,0,8,41,0,0,49,74
15796,Mali,2019,2019Mali,24,20,5,71,0,0,120,21,14,5,160,0,0,200,320
15797,Mali,2019,2019Mali,1862,3505,2190,5606,385,0,13548,1902,3434,2266,3843,449,0,11894,25442
15798,Mali,2019,2019Mali,4089,8130,5470,13395,1012,0,32096,4205,8357,5360,6971,1011,0,25904,58000
15799,Mali,2019,2019Mali,5380,7270,4586,12774,1182,0,31192,5284,6956,4315,8524,1121,0,26200,57392
15800,Mali,2020,2020Mali,0,0,0,0,0,0,0,0,0,0,0,0,0,0,17524
15801,Mali,2020,2020Mali,0,0,0,0,0,0,0,0,0,0,0,0,7,7,7
15802,Mali,2020,2020Mali,0,0,0,0,0,0,0,0,0,0,5,0,0,5,10
15803,Mali,2020,2020Mali,0,0,0,0,0,0,0,0,0,0,6,0,0,6,12
15804,Mali,2020,2020Mali,0,0,0,0,0,0,0,0,0,0,9,0,0,9,9
15805,Mali,2020,2020Mali,0,0,0,0,0,0,0,0,5,0,16,0,0,21,31
15806,Mali,2020,2020Mali,0,0,0,0,0,0,0,0,7,0,0,0,0,7,7
15807,Mali,2020,2020Mali,0,0,0,0,0,0,0,5,0,0,5,0,0,10,10
15808,Mali,2020,2020Mali,0,0,0,0,0,54,54,0,0,0,0,0,45,45,99
15809,Mali,2020,2020Mali,0,0,0,5,0,0,5,0,0,7,0,0,0,7,12
15810,Mali,2020,2020Mali,0,0,0,5,0,0,5,0,7,0,0,0,0,7,12
15811,Mali,2020,2020Mali,0,0,0,9,0,0,9,0,5,0,5,0,0,10,19
15812,Mali,2020,2020Mali,0,0,7,0,0,0,7,0,0,0,0,0,0,0,7
15813,Mali,2020,2020Mali,0,5,0,0,0,0,5,0,0,0,0,0,0,0,10
15814,Mali,2020,2020Mali,0,6,8,20,0,0,34,0,13,7,84,7,0,111,145
15815,Mali,2020,2020Mali,0,7,0,0,0,0,7,0,5,0,9,0,0,14,21
15816,Mali,2020,2020Mali,0,9,0,8,0,0,17,0,0,5,14,0,0,19,36
15817,Mali,2020,2020Mali,0,12,7,18,0,0,37,0,6,6,22,7,0,41,78
15818,Mali,2020,2020Mali,5,0,0,10,0,0,15,0,9,0,18,0,0,27,42
15819,Mali,2020,2020Mali,10,8,0,21,0,0,39,7,5,0,80,0,0,92,131
15820,Mali,2020,2020Mali,28,34,0,79,0,0,141,19,23,9,166,0,0,217,358
15821,Mali,2020,2020Mali,1050,2863,1820,4519,319,0,10571,1006,2809,1834,3253,343,0,9245,19816
15822,Mali,2020,2020Mali,4122,8507,5728,13904,1050,0,33311,4169,8761,5595,7364,1045,0,26934,60245
15823,Mali,2020,2020Mali,5838,8219,5392,14686,1519,0,35654,5634,7959,4959,10351,1390,0,30293,65947
15824,Mali,2021,2021Mali,0,0,0,0,0,0,0,0,0,0,0,0,0,0,21794
15825,Mali,2021,2021Mali,0,0,0,0,0,0,0,0,0,0,5,0,0,5,25
15826,Mali,2021,2021Mali,0,0,0,0,0,0,0,0,0,0,6,0,0,6,6
15827,Mali,2021,2021Mali,0,0,0,0,0,0,0,0,0,0,9,0,0,9,18
15828,Mali,2021,2021Mali,0,0,0,0,0,0,0,0,0,0,14,0,0,14,14
15829,Mali,2021,2021Mali,0,0,0,0,0,0,0,0,7,0,0,0,0,7,7
15830,Mali,2021,2021Mali,0,0,0,5,0,0,5,0,0,0,18,0,0,18,33
15831,Mali,2021,2021Mali,0,0,0,5,0,0,5,0,0,8,0,0,0,8,13
15832,Mali,2021,2021Mali,0,0,0,9,0,0,9,0,5,0,5,0,0,10,19
15833,Mali,2021,2021Mali,0,0,0,29,0,0,29,0,0,0,18,0,0,18,238
15834,Mali,2021,2021Mali,0,0,5,0,0,0,5,0,0,0,0,0,0,0,5
15835,Mali,2021,2021Mali,0,5,0,0,0,0,5,0,0,0,0,0,0,0,10
15836,Mali,2021,2021Mali,0,6,0,15,0,0,21,0,6,7,14,0,0,27,48
15837,Mali,2021,2021Mali,0,7,0,0,0,0,7,0,0,0,9,0,0,9,16
15838,Mali,2021,2021Mali,0,10,7,18,0,0,35,0,7,5,23,6,0,41,76
15839,Mali,2021,2021Mali,0,11,0,0,0,0,11,0,7,0,7,0,0,14,25
15840,Mali,2021,2021Mali,5,5,5,20,0,0,35,0,7,12,82,7,0,108,143
15841,Mali,2021,2021Mali,6,0,0,14,0,0,20,7,7,0,24,0,0,38,58
15842,Mali,2021,2021Mali,16,8,0,30,0,0,54,8,7,0,137,0,0,152,206
15843,Mali,2021,2021Mali,27,36,5,82,0,0,150,16,29,7,190,0,0,242,392
15844,Mali,2021,2021Mali,1232,3503,2286,5765,439,0,13225,1263,3297,2338,3995,442,0,11335,24560
15845,Mali,2021,2021Mali,3200,8768,6339,14616,1091,0,34014,3235,8990,6173,7989,1089,0,27476,61490
15846,Mali,2021,2021Mali,6699,9331,5875,16189,1540,0,39634,6493,9028,5453,12151,1437,0,34562,74196
15847,Mauritania,2001,2001Mauritania,0,0,0,0,0,0,0,0,0,0,0,0,0,0,2111
15848,Mauritania,2001,2001Mauritania,0,0,0,0,0,0,0,0,0,0,0,0,33,33,33
15849,Mauritania,2001,2001Mauritania,0,0,0,0,0,0,0,0,0,0,5,0,0,5,5
15850,Mauritania,2001,2001Mauritania,0,0,0,0,0,287,287,0,0,0,0,0,1514,1514,1801
15851,Mauritania,2001,2001Mauritania,802,622,535,571,90,0,2620,324,990,849,1208,126,0,3497,6117
15852,Mauritania,2001,2001Mauritania,2337,3012,2582,3344,590,0,11865,1564,2007,1721,2232,394,0,7918,19783
15853,Mauritania,2002,2002Mauritania,0,0,0,0,0,0,0,0,0,0,0,0,0,0,2056
15854,Mauritania,2002,2002Mauritania,0,0,0,0,0,0,0,0,0,0,28,0,0,28,28
15855,Mauritania,2002,2002Mauritania,0,0,0,0,0,0,0,0,0,5,0,0,0,5,5
15856,Mauritania,2002,2002Mauritania,0,0,0,0,0,362,362,0,0,0,0,0,1781,1781,2143
15857,Mauritania,2002,2002Mauritania,802,622,534,572,90,0,2620,324,990,848,1207,126,0,3495,6121
15858,Mauritania,2002,2002Mauritania,2337,3012,2582,3344,590,0,11865,1564,2004,1719,2231,394,0,7912,19777
15859,Mauritania,2003,2003Mauritania,0,0,0,0,0,0,0,0,0,0,0,0,0,0,1790
15860,Mauritania,2003,2003Mauritania,0,0,0,0,0,0,0,0,0,0,5,0,0,5,5
15861,Mauritania,2003,2003Mauritania,0,0,0,0,0,0,0,0,0,5,0,0,0,5,5
15862,Mauritania,2003,2003Mauritania,0,0,0,0,0,427,427,0,0,0,0,0,2336,2336,2763
15863,Mauritania,2003,2003Mauritania,0,5,0,0,0,0,5,0,0,0,25,0,0,25,30
15864,Mauritania,2003,2003Mauritania,817,622,534,571,90,0,2634,344,990,848,1206,126,0,3514,6148
15865,Mauritania,2003,2003Mauritania,2337,3012,2582,3344,590,0,11865,1564,2004,1719,2231,394,0,7912,19777
15866,Mauritania,2004,2004Mauritania,0,0,0,0,0,0,0,0,0,0,0,0,0,0,5101
15867,Mauritania,2004,2004Mauritania,0,0,0,0,0,0,0,0,0,0,5,0,0,5,5
15868,Mauritania,2004,2004Mauritania,0,0,0,0,0,0,0,0,0,5,0,0,0,5,5
15869,Mauritania,2004,2004Mauritania,0,5,0,0,0,0,5,0,0,0,25,0,0,25,30
15870,Mauritania,2004,2004Mauritania,819,628,538,571,90,0,2646,349,995,853,1216,126,0,3539,6185
15871,Mauritania,2004,2004Mauritania,2337,3012,2582,3344,590,0,11865,1564,2004,1719,2232,394,0,7913,19778
15872,Mauritania,2005,2005Mauritania,0,0,0,0,0,0,0,0,0,0,0,0,0,0,1963
15873,Mauritania,2005,2005Mauritania,0,0,0,0,0,0,0,0,0,0,5,0,0,5,10
15874,Mauritania,2005,2005Mauritania,0,0,0,0,0,0,0,0,0,0,7,0,0,7,7
15875,Mauritania,2005,2005Mauritania,0,0,0,0,0,576,576,0,0,0,0,0,3195,3195,3771
15876,Mauritania,2005,2005Mauritania,0,5,0,0,0,0,5,0,0,0,17,0,0,17,22
15877,Mauritania,2005,2005Mauritania,819,622,534,571,90,0,2636,349,989,848,1217,126,0,3529,6165
15878,Mauritania,2005,2005Mauritania,2334,3002,2573,3327,590,0,11826,1562,1996,1711,2223,394,0,7886,19712
15879,Mauritania,2006,2006Mauritania,0,0,0,0,0,0,0,0,0,0,0,0,0,0,3595
15880,Mauritania,2006,2006Mauritania,0,0,0,0,0,0,0,0,0,0,0,0,5,5,5
15881,Mauritania,2006,2006Mauritania,0,0,0,0,0,0,0,0,0,0,5,0,0,5,5
15882,Mauritania,2006,2006Mauritania,0,0,0,0,0,14,14,0,0,0,0,0,78,78,92
15883,Mauritania,2006,2006Mauritania,0,0,0,0,0,629,629,0,0,0,0,0,3275,3275,3904
15884,Mauritania,2006,2006Mauritania,0,0,0,5,0,0,5,0,0,0,5,0,0,5,10
15885,Mauritania,2006,2006Mauritania,0,6,0,0,0,0,6,0,0,0,8,0,0,8,14
15886,Mauritania,2006,2006Mauritania,819,731,425,571,90,0,2636,349,623,1214,1217,126,0,3529,6165
15887,Mauritania,2006,2006Mauritania,2331,2981,2581,3298,590,0,11781,1558,2106,1585,2206,394,0,7849,19630
15888,Mauritania,2007,2007Mauritania,0,0,0,0,0,0,0,0,0,0,0,0,0,0,3323
15889,Mauritania,2007,2007Mauritania,0,0,0,0,0,0,0,0,0,0,7,0,0,7,7
15890,Mauritania,2007,2007Mauritania,0,0,0,0,0,12,12,0,0,0,0,0,59,59,71
15891,Mauritania,2007,2007Mauritania,0,0,0,0,0,681,681,0,0,0,0,0,3327,3327,4008
15892,Mauritania,2007,2007Mauritania,0,5,0,0,0,0,5,0,0,0,13,0,0,13,18
15893,Mauritania,2007,2007Mauritania,819,731,425,571,90,0,2636,349,623,1214,1217,126,0,3529,6165
15894,Mauritania,2007,2007Mauritania,2320,2951,2581,3269,590,0,11711,1555,2088,1585,2171,393,0,7792,19503
15895,Mauritania,2008,2008Mauritania,0,0,0,0,0,0,0,0,0,0,0,0,0,0,2914
15896,Mauritania,2008,2008Mauritania,0,0,0,0,0,0,0,0,0,0,5,0,0,5,10
15897,Mauritania,2008,2008Mauritania,0,0,0,0,0,14,14,0,0,0,0,0,62,62,76
15898,Mauritania,2008,2008Mauritania,0,0,0,0,0,749,749,0,0,0,0,0,3376,3376,4125
15899,Mauritania,2008,2008Mauritania,0,0,5,0,0,0,5,0,0,0,13,0,0,13,18
15900,Mauritania,2008,2008Mauritania,819,730,425,568,90,0,2632,349,623,1212,1215,126,0,3525,6157
15901,Mauritania,2008,2008Mauritania,2944,3812,3517,6274,1316,0,17863,2181,3476,2266,5379,1127,0,14429,32292
15902,Mauritania,2009,2009Mauritania,0,0,0,0,0,0,0,0,0,0,0,0,0,0,7020
15903,Mauritania,2009,2009Mauritania,0,0,0,0,0,0,0,0,0,0,5,0,0,5,5
15904,Mauritania,2009,2009Mauritania,0,0,0,0,0,0,0,0,0,0,8,0,0,8,8
15905,Mauritania,2009,2009Mauritania,0,0,0,0,0,5,5,0,0,0,0,0,59,59,64
15906,Mauritania,2009,2009Mauritania,0,0,0,0,0,17,17,0,0,0,0,0,99,99,116
15907,Mauritania,2009,2009Mauritania,0,0,5,0,0,0,5,0,0,0,10,0,0,10,15
15908,Mauritania,2009,2009Mauritania,0,0,5,6,0,0,11,5,0,0,31,0,0,36,47
15909,Mauritania,2009,2009Mauritania,797,1400,686,2026,144,0,5053,864,1457,698,2192,218,0,5429,10482
15910,Mauritania,2009,2009Mauritania,1682,2143,1801,4835,480,0,10941,1875,1640,1849,4589,483,0,10436,21377
15911,Mauritania,2010,2010Mauritania,0,0,0,0,0,0,0,0,0,0,0,0,0,0,2467
15912,Mauritania,2010,2010Mauritania,0,0,0,0,0,0,0,0,0,0,5,0,0,5,5
15913,Mauritania,2010,2010Mauritania,0,0,0,0,0,0,0,0,0,0,9,0,0,9,9
15914,Mauritania,2010,2010Mauritania,0,0,0,0,0,0,0,0,0,0,10,0,0,10,10
15915,Mauritania,2010,2010Mauritania,0,0,0,0,0,0,0,0,0,8,0,0,0,8,8
15916,Mauritania,2010,2010Mauritania,0,0,0,0,0,13,13,0,0,0,0,0,70,70,83
15917,Mauritania,2010,2010Mauritania,0,0,0,0,0,16,16,0,0,0,0,0,112,112,128
15918,Mauritania,2010,2010Mauritania,0,0,0,0,0,954,954,0,0,0,0,0,3588,3588,4542
15919,Mauritania,2010,2010Mauritania,0,0,5,0,0,0,5,0,0,0,10,0,0,10,15
15920,Mauritania,2010,2010Mauritania,0,0,5,6,0,0,11,0,5,0,33,0,0,38,49
15921,Mauritania,2010,2010Mauritania,795,1400,686,2021,144,0,5046,864,1455,698,2187,218,0,5422,10468
15922,Mauritania,2010,2010Mauritania,1520,2141,1519,4505,460,0,10145,1715,1631,1604,4379,463,0,9792,19937
15923,Mauritania,2011,2011Mauritania,0,0,0,0,0,0,0,0,0,0,0,0,0,0,2301
15924,Mauritania,2011,2011Mauritania,0,0,0,0,0,0,0,0,0,0,5,0,0,5,10
15925,Mauritania,2011,2011Mauritania,0,0,0,0,0,0,0,0,0,0,7,0,0,7,7
15926,Mauritania,2011,2011Mauritania,0,0,0,0,0,0,0,0,0,8,0,0,0,8,8
15927,Mauritania,2011,2011Mauritania,0,0,0,0,0,0,0,0,5,0,0,0,0,5,5
15928,Mauritania,2011,2011Mauritania,0,0,0,0,0,22,22,0,0,0,0,0,112,112,139
15929,Mauritania,2011,2011Mauritania,0,0,0,0,0,994,994,0,0,0,0,0,3740,3740,4734
15930,Mauritania,2011,2011Mauritania,0,0,0,6,0,0,6,0,0,0,9,0,0,9,292
15931,Mauritania,2011,2011Mauritania,0,0,0,9,0,0,9,0,5,0,35,0,0,40,49
15932,Mauritania,2011,2011Mauritania,0,0,5,0,0,0,5,0,0,0,10,0,0,10,15
15933,Mauritania,2011,2011Mauritania,1272,1649,1036,1879,149,0,5985,1435,1743,1061,2024,194,0,6457,12442
15934,Mauritania,2011,2011Mauritania,2065,2522,1202,4319,410,0,10518,2118,2390,1135,3397,359,0,9399,19917
15935,Mauritania,2012,2012Mauritania,0,0,0,0,0,0,0,0,0,0,0,0,0,0,2166
15936,Mauritania,2012,2012Mauritania,0,0,0,0,0,0,0,0,0,0,5,0,0,5,5
15937,Mauritania,2012,2012Mauritania,0,0,0,0,0,0,0,0,0,0,7,0,0,7,7
15938,Mauritania,2012,2012Mauritania,0,0,0,0,0,0,0,0,0,8,0,0,0,8,8
15939,Mauritania,2012,2012Mauritania,0,0,0,0,0,0,0,0,5,0,0,0,0,5,5
15940,Mauritania,2012,2012Mauritania,0,0,0,0,0,26,26,0,0,0,0,0,130,130,156
15941,Mauritania,2012,2012Mauritania,0,0,0,0,0,1078,1078,0,0,0,0,0,3821,3821,4899
15942,Mauritania,2012,2012Mauritania,0,0,0,8,0,0,8,0,0,0,9,0,0,9,299
15943,Mauritania,2012,2012Mauritania,0,0,5,0,0,0,5,0,0,0,10,0,0,10,15
15944,Mauritania,2012,2012Mauritania,0,5,0,6,0,0,11,0,5,0,33,0,0,38,49
15945,Mauritania,2012,2012Mauritania,1272,1648,1037,1873,149,0,5979,1435,1743,1061,2019,199,0,6457,12436
15946,Mauritania,2012,2012Mauritania,1401,1726,832,2968,275,0,7202,1440,1639,799,2376,246,0,6500,13702
15947,Mauritania,2013,2013Mauritania,0,0,0,0,0,0,0,0,0,0,0,0,0,0,2035
15948,Mauritania,2013,2013Mauritania,0,0,0,0,0,0,0,0,0,0,5,0,0,5,10
15949,Mauritania,2013,2013Mauritania,0,0,0,0,0,0,0,0,0,0,7,0,0,7,7
15950,Mauritania,2013,2013Mauritania,0,0,0,0,0,0,0,0,5,0,0,0,0,5,5
15951,Mauritania,2013,2013Mauritania,0,0,0,0,0,18,18,0,0,0,0,0,109,109,155
15952,Mauritania,2013,2013Mauritania,0,0,0,0,0,1155,1155,0,0,0,0,0,3946,3946,5101
15953,Mauritania,2013,2013Mauritania,0,0,0,5,0,0,5,0,0,5,5,0,0,10,15
15954,Mauritania,2013,2013Mauritania,0,0,5,0,0,0,5,0,0,0,12,0,0,12,17
15955,Mauritania,2013,2013Mauritania,0,8,0,0,0,0,8,0,0,0,12,0,0,12,294
15956,Mauritania,2013,2013Mauritania,1401,1726,832,2968,275,0,7202,1440,1639,799,2377,246,0,6501,13703
15957,Mauritania,2013,2013Mauritania,1494,1651,1037,1873,149,0,6204,1672,1746,1061,2017,197,0,6693,12897
15958,Mauritania,2014,2014Mauritania,0,0,0,0,0,0,0,0,0,0,0,0,0,0,2138
15959,Mauritania,2014,2014Mauritania,0,0,0,0,0,0,0,0,0,0,5,0,0,5,10
15960,Mauritania,2014,2014Mauritania,0,0,0,0,0,0,0,0,0,0,7,0,0,7,7
15961,Mauritania,2014,2014Mauritania,0,0,0,0,0,0,0,0,0,0,8,0,0,8,8
15962,Mauritania,2014,2014Mauritania,0,0,0,0,0,0,0,0,0,0,9,0,0,9,265
15963,Mauritania,2014,2014Mauritania,0,0,0,0,0,1162,1162,0,0,0,0,0,3896,3896,5058
15964,Mauritania,2014,2014Mauritania,0,0,0,5,0,0,5,0,0,0,9,0,0,9,14
15965,Mauritania,2014,2014Mauritania,6,0,0,0,0,0,6,0,0,0,0,0,0,0,6
15966,Mauritania,2014,2014Mauritania,1401,1726,832,2966,275,0,7200,1440,1637,799,2377,246,0,6499,13699
15967,Mauritania,2014,2014Mauritania,1494,1651,1037,1873,149,0,6204,1672,1746,1061,2018,197,0,6694,12898
15968,Mauritania,2015,2015Mauritania,0,0,0,0,0,0,0,0,0,0,0,0,0,0,2103
15969,Mauritania,2015,2015Mauritania,0,0,0,0,0,0,0,0,0,0,0,5,0,5,5
15970,Mauritania,2015,2015Mauritania,0,0,0,0,0,0,0,0,0,0,5,0,0,5,15
15971,Mauritania,2015,2015Mauritania,0,0,0,0,0,0,0,0,0,0,8,0,0,8,8
15972,Mauritania,2015,2015Mauritania,0,0,0,0,0,50,50,0,0,0,0,0,161,161,211
15973,Mauritania,2015,2015Mauritania,0,0,0,0,0,1189,1189,0,0,0,0,0,3877,3877,5066
15974,Mauritania,2015,2015Mauritania,0,0,0,5,0,0,5,0,0,0,10,0,0,10,15
15975,Mauritania,2015,2015Mauritania,7,0,0,0,0,0,7,0,0,0,0,0,0,0,7
15976,Mauritania,2015,2015Mauritania,1121,1712,1145,2467,169,0,6614,1175,1843,1094,2542,271,0,6925,13539
15977,Mauritania,2015,2015Mauritania,1400,1725,832,2961,275,0,7193,1439,1637,799,2373,246,0,6494,13687
15978,Mauritania,2016,2016Mauritania,0,0,0,0,0,0,0,0,0,0,0,0,0,0,1716
15979,Mauritania,2016,2016Mauritania,0,0,0,0,0,0,0,0,0,0,5,0,0,5,20
15980,Mauritania,2016,2016Mauritania,0,0,0,0,0,0,0,0,0,0,8,0,0,8,8
15981,Mauritania,2016,2016Mauritania,0,0,0,0,0,0,0,0,0,0,24,0,0,24,124
15982,Mauritania,2016,2016Mauritania,0,0,0,0,0,46,46,0,0,0,0,0,160,160,206
15983,Mauritania,2016,2016Mauritania,0,0,0,0,0,1219,1219,0,0,0,0,0,3964,3964,5183
15984,Mauritania,2016,2016Mauritania,0,0,0,6,0,0,6,0,0,0,6,5,0,11,17
15985,Mauritania,2016,2016Mauritania,8,0,0,0,0,0,8,0,0,0,0,0,0,0,8
15986,Mauritania,2016,2016Mauritania,1261,1966,1261,2763,189,0,7440,1322,2107,1249,2862,318,0,7858,15298
15987,Mauritania,2016,2016Mauritania,1399,1725,832,2961,275,0,7192,1439,1636,799,2371,246,0,6491,13683
15988,Mauritania,2017,2017Mauritania,0,0,0,0,0,0,0,0,0,0,0,0,0,0,1731
15989,Mauritania,2017,2017Mauritania,0,0,0,0,0,0,0,0,0,0,0,0,306,306,306
15990,Mauritania,2017,2017Mauritania,0,0,0,0,0,0,0,0,0,0,5,0,0,5,15
15991,Mauritania,2017,2017Mauritania,0,0,0,0,0,0,0,0,0,0,6,0,0,6,6
15992,Mauritania,2017,2017Mauritania,0,0,0,0,0,0,0,0,0,0,8,0,0,8,8
15993,Mauritania,2017,2017Mauritania,0,0,0,0,0,1258,1258,0,0,0,0,0,4062,4062,5320
15994,Mauritania,2017,2017Mauritania,0,0,0,11,0,0,11,5,0,0,12,5,0,22,33
15995,Mauritania,2017,2017Mauritania,8,0,0,0,0,0,8,0,0,0,0,0,0,0,8
15996,Mauritania,2017,2017Mauritania,989,1993,1319,2952,196,0,7449,1033,2123,1321,3058,335,0,7870,15319
15997,Mauritania,2017,2017Mauritania,1012,1756,1041,3006,372,0,7187,1061,1720,958,2503,350,0,6592,13779
15998,Mauritania,2018,2018Mauritania,0,0,0,0,0,0,0,0,0,0,0,0,0,0,1955
15999,Mauritania,2018,2018Mauritania,0,0,0,0,0,0,0,0,0,0,5,0,0,5,20
16000,Mauritania,2018,2018Mauritania,0,0,0,0,0,1320,1320,0,0,0,0,0,4099,4099,5419
16001,Mauritania,2018,2018Mauritania,0,0,0,7,0,0,7,0,0,0,0,0,0,0,7
16002,Mauritania,2018,2018Mauritania,0,0,0,7,0,0,7,5,0,0,22,0,0,27,159
16003,Mauritania,2018,2018Mauritania,0,0,0,11,0,0,11,6,0,0,17,0,0,23,34
16004,Mauritania,2018,2018Mauritania,0,9,0,0,0,0,9,0,0,0,0,0,0,0,9
16005,Mauritania,2018,2018Mauritania,8,0,0,0,0,0,8,0,0,0,0,0,0,0,8
16006,Mauritania,2018,2018Mauritania,387,2068,1440,3306,247,0,7448,405,2178,1508,3392,388,0,7871,15319
16007,Mauritania,2018,2018Mauritania,795,1816,1147,3235,403,0,7396,856,1765,1058,2657,388,0,6724,14120
16008,Mauritania,2019,2019Mauritania,0,0,0,0,0,0,0,0,0,0,0,0,0,0,2203
16009,Mauritania,2019,2019Mauritania,0,0,0,0,0,0,0,0,0,0,5,0,0,5,15
16010,Mauritania,2019,2019Mauritania,0,0,0,0,0,0,0,0,0,0,6,0,0,6,6
16011,Mauritania,2019,2019Mauritania,0,0,0,0,0,0,0,0,0,0,7,0,0,7,7
16012,Mauritania,2019,2019Mauritania,0,0,0,0,0,1389,1389,0,0,0,0,0,4286,4286,5675
16013,Mauritania,2019,2019Mauritania,0,0,0,14,0,0,14,0,8,0,19,0,0,27,41
16014,Mauritania,2019,2019Mauritania,0,0,5,0,0,0,5,0,0,0,5,0,0,5,10
16015,Mauritania,2019,2019Mauritania,384,2070,1439,3307,245,0,7445,402,2179,1507,3396,387,0,7871,15316
16016,Mauritania,2019,2019Mauritania,562,1784,1267,3313,476,0,7402,639,1749,1175,2758,427,0,6748,14150
16017,Mauritania,2020,2020Mauritania,0,0,0,0,0,0,0,0,0,0,0,0,0,0,7756
16018,Mauritania,2020,2020Mauritania,0,0,0,0,0,0,0,0,0,0,5,0,0,5,15
16019,Mauritania,2020,2020Mauritania,0,0,0,0,0,0,0,0,0,0,6,0,0,6,6
16020,Mauritania,2020,2020Mauritania,0,0,0,0,0,0,0,0,0,0,7,0,0,7,7
16021,Mauritania,2020,2020Mauritania,0,0,0,0,0,0,0,0,0,0,8,0,0,8,8
16022,Mauritania,2020,2020Mauritania,0,0,0,0,0,88,88,0,0,0,0,0,181,181,269
16023,Mauritania,2020,2020Mauritania,0,6,0,17,0,0,23,8,6,0,16,5,0,35,58
16024,Mauritania,2020,2020Mauritania,21,2155,2393,2809,263,0,7641,22,2267,2458,2881,428,0,8056,15697
16025,Mauritania,2020,2020Mauritania,232,1631,1424,3556,548,0,7391,260,1721,1295,2951,497,0,6724,14115
16026,Mauritania,2021,2021Mauritania,0,0,0,0,0,0,0,0,0,0,0,0,0,0,9828
16027,Mauritania,2021,2021Mauritania,0,0,0,0,0,0,0,0,0,0,5,0,0,5,15
16028,Mauritania,2021,2021Mauritania,0,0,0,0,0,0,0,0,0,0,6,0,0,6,12
16029,Mauritania,2021,2021Mauritania,0,0,0,0,0,0,0,0,0,0,7,0,0,7,7
16030,Mauritania,2021,2021Mauritania,0,0,0,0,0,0,0,0,0,0,9,0,0,9,9
16031,Mauritania,2021,2021Mauritania,0,0,0,5,0,0,5,0,0,0,0,0,0,0,5
16032,Mauritania,2021,2021Mauritania,0,8,0,18,0,0,26,7,8,0,19,5,0,39,65
16033,Mauritania,2021,2021Mauritania,5,0,0,19,0,0,24,0,10,5,55,0,0,70,225
16034,Mauritania,2021,2021Mauritania,194,1641,1443,3610,554,0,7442,223,1714,1309,2956,504,0,6706,14148
16035,Mauritania,2021,2021Mauritania,1001,1767,1293,3048,240,0,7349,1067,1766,1309,3076,398,0,7616,14965
16036,Mexico,2001,2001Mexico,0,0,0,0,0,0,0,0,0,0,0,0,0,0,1592
16037,Mexico,2002,2002Mexico,0,0,0,0,0,0,0,0,0,0,0,0,0,0,1668
16038,Mexico,2003,2003Mexico,0,0,0,0,0,0,0,0,0,0,0,0,0,0,1650
16039,Mexico,2004,2004Mexico,0,0,0,0,0,0,0,0,0,0,0,0,0,0,1740
16040,Mexico,2005,2005Mexico,0,0,0,0,0,0,0,0,0,0,0,0,0,0,2309
16041,Mexico,2006,2006Mexico,0,0,0,0,0,0,0,0,0,0,0,0,0,0,3296
16042,Mexico,2006,2006Mexico,0,0,0,0,0,0,0,0,0,0,0,0,5,5,5
16043,Mexico,2007,2007Mexico,0,0,0,0,0,0,0,0,0,0,0,0,0,0,5561
16044,Mexico,2007,2007Mexico,0,0,0,0,0,0,0,0,0,0,7,0,0,7,7
16045,Mexico,2008,2008Mexico,0,0,0,0,0,0,0,0,0,0,0,0,0,0,6148
16046,Mexico,2008,2008Mexico,0,0,0,0,0,0,0,0,0,0,0,0,5,5,5
16047,Mexico,2008,2008Mexico,0,0,0,0,0,0,0,0,0,0,7,0,0,7,7
16048,Mexico,2009,2009Mexico,0,0,0,0,0,0,0,0,0,0,0,0,0,0,6394
16049,Mexico,2009,2009Mexico,0,0,0,0,0,0,0,0,0,0,7,0,0,7,7
16050,Mexico,2009,2009Mexico,0,0,5,11,0,0,16,0,5,5,6,0,0,16,32
16051,Mexico,2010,2010Mexico,0,0,0,0,0,0,0,0,0,0,0,0,0,0,6765
16052,Mexico,2010,2010Mexico,0,0,0,0,0,0,0,0,0,0,0,0,6,6,6
16053,Mexico,2010,2010Mexico,0,0,0,0,0,0,0,0,0,0,7,0,0,7,7
16054,Mexico,2010,2010Mexico,0,0,5,13,0,0,18,0,0,8,5,0,0,13,31
16055,Mexico,2011,2011Mexico,0,0,0,0,0,0,0,0,0,0,0,0,0,0,1847
16056,Mexico,2011,2011Mexico,0,0,0,0,0,0,0,0,0,0,0,0,6,6,6
16057,Mexico,2011,2011Mexico,0,0,0,0,0,0,0,0,0,0,8,0,0,8,8
16058,Mexico,2011,2011Mexico,0,0,5,12,0,0,17,5,0,6,8,0,0,19,36
16059,Mexico,2011,2011Mexico,57,110,99,625,6,0,897,48,122,93,471,0,0,734,5574
16060,Mexico,2012,2012Mexico,0,0,0,0,0,0,0,0,0,0,0,0,0,0,2380
16061,Mexico,2012,2012Mexico,0,0,0,0,0,0,0,0,0,0,8,0,0,8,8
16062,Mexico,2012,2012Mexico,0,0,0,0,0,8,8,0,0,0,0,0,0,0,8
16063,Mexico,2012,2012Mexico,0,0,0,5,0,0,5,0,0,0,0,0,0,0,5
16064,Mexico,2012,2012Mexico,0,0,5,13,0,0,18,5,0,8,11,0,0,24,42
16065,Mexico,2012,2012Mexico,23,49,26,213,0,0,311,22,36,33,166,0,0,257,5995
16066,Mexico,2013,2013Mexico,0,0,0,0,0,0,0,0,0,0,0,0,0,0,2828
16067,Mexico,2013,2013Mexico,0,0,0,0,0,0,0,0,0,0,0,0,10,10,10
16068,Mexico,2013,2013Mexico,0,0,0,0,0,0,0,0,0,0,8,0,0,8,8
16069,Mexico,2013,2013Mexico,0,0,0,5,0,0,5,0,0,0,0,0,0,0,10
16070,Mexico,2013,2013Mexico,0,6,0,5,0,0,11,0,5,5,7,0,0,17,28
16071,Mexico,2013,2013Mexico,6,20,17,96,0,0,139,5,20,23,101,0,0,149,6512
16072,Mexico,2014,2014Mexico,0,0,0,0,0,0,0,0,0,0,0,0,0,0,3852
16073,Mexico,2014,2014Mexico,0,0,0,0,0,0,0,0,0,6,0,0,0,6,6
16074,Mexico,2014,2014Mexico,0,0,0,0,0,5,5,0,0,0,0,0,6,6,11
16075,Mexico,2014,2014Mexico,0,0,0,5,0,0,5,0,0,0,0,0,0,0,10
16076,Mexico,2014,2014Mexico,0,0,5,0,0,0,5,0,0,0,0,0,0,0,5
16077,Mexico,2014,2014Mexico,0,0,7,5,0,0,12,0,0,8,6,0,0,14,26
16078,Mexico,2014,2014Mexico,5,5,5,40,0,0,55,0,5,5,28,0,0,38,6762
16079,Mexico,2015,2015Mexico,0,0,0,0,0,0,0,0,0,0,0,0,0,0,11273
16080,Mexico,2015,2015Mexico,0,0,0,0,0,0,0,0,0,0,5,0,0,5,5
16081,Mexico,2015,2015Mexico,0,0,0,0,0,0,0,0,0,6,0,0,0,6,6
16082,Mexico,2015,2015Mexico,0,0,0,0,0,6,6,0,0,0,0,0,10,10,16
16083,Mexico,2015,2015Mexico,0,0,0,5,0,0,5,0,0,0,0,0,0,0,15
16084,Mexico,2015,2015Mexico,0,0,0,8,0,0,8,0,0,5,7,0,0,12,20
16085,Mexico,2015,2015Mexico,0,0,5,0,0,0,5,0,0,0,0,0,0,0,5
16086,Mexico,2016,2016Mexico,0,0,0,0,0,0,0,0,0,0,0,0,0,0,6205
16087,Mexico,2016,2016Mexico,0,0,0,0,0,0,0,0,0,0,0,0,5,5,5
16088,Mexico,2016,2016Mexico,0,0,0,0,0,0,0,0,0,0,0,0,6,6,6
16089,Mexico,2016,2016Mexico,0,0,0,0,0,0,0,0,0,0,5,0,0,5,5
16090,Mexico,2016,2016Mexico,0,0,0,0,0,0,0,0,0,6,0,0,0,6,6
16091,Mexico,2016,2016Mexico,0,0,0,0,0,8,8,0,0,0,0,0,13,13,21
16092,Mexico,2016,2016Mexico,0,0,0,5,0,0,5,0,0,0,0,0,0,0,15
16093,Mexico,2016,2016Mexico,0,0,0,6,0,0,6,0,0,5,5,0,0,10,16
16094,Mexico,2016,2016Mexico,0,0,5,9,0,0,14,0,0,0,27,0,0,27,4102
16095,Mexico,2016,2016Mexico,0,0,6,0,0,0,6,0,0,0,0,0,0,0,6
16096,Mexico,2017,2017Mexico,0,0,0,0,0,0,0,0,0,0,0,0,0,0,11611
16097,Mexico,2017,2017Mexico,0,0,0,0,0,0,0,0,0,0,5,0,0,5,5
16098,Mexico,2017,2017Mexico,0,0,0,0,0,0,0,0,0,6,0,0,0,6,6
16099,Mexico,2017,2017Mexico,0,0,0,0,0,6,6,0,0,0,0,0,0,0,6
16100,Mexico,2017,2017Mexico,0,0,0,0,0,10,10,0,0,0,0,0,13,13,23
16101,Mexico,2017,2017Mexico,0,0,0,5,0,0,5,0,0,0,0,0,0,0,15
16102,Mexico,2017,2017Mexico,0,0,0,5,0,0,5,0,0,0,8,0,0,8,13
16103,Mexico,2018,2018Mexico,0,0,0,0,0,0,0,0,0,0,0,0,0,0,9357
16104,Mexico,2018,2018Mexico,0,0,0,0,0,0,0,0,0,0,5,0,0,5,5
16105,Mexico,2018,2018Mexico,0,0,0,0,0,10,10,0,0,0,0,0,14,14,24
16106,Mexico,2018,2018Mexico,0,0,0,5,0,0,5,0,0,0,0,0,0,0,5
16107,Mexico,2018,2018Mexico,0,0,0,8,0,0,8,0,5,0,9,0,0,14,22
16108,Mexico,2018,2018Mexico,0,5,0,37,0,0,42,0,7,6,30,0,0,43,3457
16109,Mexico,2019,2019Mexico,0,0,0,0,0,0,0,0,0,0,0,0,0,0,14555
16110,Mexico,2019,2019Mexico,0,0,0,0,0,0,0,0,0,0,5,0,0,5,5
16111,Mexico,2019,2019Mexico,0,0,0,0,0,12,12,0,0,0,0,0,15,15,27
16112,Mexico,2019,2019Mexico,0,0,0,5,0,0,5,0,0,0,0,0,0,0,10
16113,Mexico,2019,2019Mexico,0,0,0,9,0,0,9,0,5,0,10,0,0,15,24
16114,Mexico,2020,2020Mexico,0,0,0,0,0,0,0,0,0,0,0,0,0,0,12183
16115,Mexico,2020,2020Mexico,0,0,0,0,0,0,0,0,0,0,5,0,0,5,5
16116,Mexico,2020,2020Mexico,0,0,0,5,0,0,5,0,0,0,0,0,0,0,5
16117,Mexico,2020,2020Mexico,0,0,0,7,0,0,7,0,0,5,11,0,0,16,23
16118,Mexico,2020,2020Mexico,0,0,0,9,0,0,9,0,0,0,0,0,0,0,9
16119,Mexico,2020,2020Mexico,29,49,46,237,0,33,394,30,50,27,233,0,41,381,3173
16120,Mexico,2021,2021Mexico,0,0,0,0,0,0,0,0,0,0,0,0,0,0,12751
16121,Mexico,2021,2021Mexico,0,0,0,0,0,0,0,0,0,0,5,0,0,5,5
16122,Mexico,2021,2021Mexico,0,0,0,0,0,0,0,0,0,5,0,0,0,5,5
16123,Mexico,2021,2021Mexico,0,0,0,6,0,0,6,0,0,6,12,0,0,18,24
16124,Mexico,2021,2021Mexico,0,0,0,9,0,0,9,0,0,0,0,0,0,0,9
16125,Mexico,2021,2021Mexico,83,161,102,738,7,33,1124,81,141,92,759,5,41,1119,3609
16126,Morocco,2001,2001Morocco,0,0,0,0,0,0,0,0,0,0,0,0,0,0,227
16127,Morocco,2001,2001Morocco,0,0,0,0,0,5,5,0,0,0,0,0,10,10,15
16128,Morocco,2001,2001Morocco,0,0,0,0,0,14,14,0,0,0,0,0,10,10,24
16129,Morocco,2001,2001Morocco,0,0,0,0,0,23,23,0,0,0,0,0,68,68,91
16130,Morocco,2002,2002Morocco,0,0,0,0,0,0,0,0,0,0,0,0,0,0,1155
16131,Morocco,2002,2002Morocco,0,0,0,0,0,10,10,0,0,0,0,0,6,6,25
16132,Morocco,2002,2002Morocco,0,0,0,0,0,21,21,0,0,0,0,0,65,65,86
16133,Morocco,2003,2003Morocco,0,0,0,0,0,0,0,0,0,0,0,0,0,0,1192
16134,Morocco,2003,2003Morocco,0,0,0,0,0,6,6,0,0,0,0,0,5,5,20
16135,Morocco,2003,2003Morocco,0,0,0,0,0,21,21,0,0,0,0,0,58,58,79
16136,Morocco,2004,2004Morocco,0,0,0,0,0,0,0,0,0,0,0,0,0,0,1278
16137,Morocco,2004,2004Morocco,0,0,0,0,0,0,0,0,0,0,5,0,0,5,5
16138,Morocco,2004,2004Morocco,0,0,0,0,0,0,0,7,0,0,0,0,0,7,7
16139,Morocco,2004,2004Morocco,0,0,0,5,0,6,11,0,0,0,5,0,7,12,23
16140,Morocco,2005,2005Morocco,0,0,0,0,0,0,0,0,0,0,0,0,0,0,2794
16141,Morocco,2005,2005Morocco,0,0,0,0,0,0,0,0,7,0,0,0,0,7,7
16142,Morocco,2005,2005Morocco,0,0,0,0,0,23,23,0,0,0,0,0,62,62,85
16143,Morocco,2005,2005Morocco,0,0,5,5,0,7,17,0,0,0,5,0,6,11,28
16144,Morocco,2006,2006Morocco,0,0,0,0,0,0,0,0,0,0,0,0,0,0,4563
16145,Morocco,2006,2006Morocco,0,0,0,0,0,0,0,0,0,0,0,0,5,5,5
16146,Morocco,2006,2006Morocco,0,0,0,0,0,0,0,0,0,0,0,0,8,8,8
16147,Morocco,2006,2006Morocco,0,0,0,0,0,0,0,0,7,0,0,0,0,7,7
16148,Morocco,2006,2006Morocco,0,0,0,0,0,13,13,0,0,0,0,0,10,10,23
16149,Morocco,2006,2006Morocco,0,0,0,0,0,27,27,0,0,0,0,0,66,66,93
16150,Morocco,2007,2007Morocco,0,0,0,0,0,0,0,0,0,0,0,0,0,0,3884
16151,Morocco,2007,2007Morocco,0,0,0,0,0,0,0,0,0,0,0,0,9,9,9
16152,Morocco,2007,2007Morocco,0,0,0,0,0,0,0,0,0,0,5,0,0,5,5
16153,Morocco,2007,2007Morocco,0,0,0,0,0,30,30,0,0,0,0,0,71,71,101
16154,Morocco,2007,2007Morocco,0,0,0,5,0,5,10,0,0,0,0,0,9,9,19
16155,Morocco,2007,2007Morocco,0,0,0,6,0,0,6,7,0,0,0,0,0,7,13
16156,Morocco,2007,2007Morocco,0,0,5,0,0,0,5,0,0,0,0,0,0,0,5
16157,Morocco,2008,2008Morocco,0,0,0,0,0,0,0,0,0,0,0,0,0,0,3365
16158,Morocco,2008,2008Morocco,0,0,0,0,0,0,0,0,0,0,0,0,9,9,9
16159,Morocco,2008,2008Morocco,0,0,0,0,0,35,35,0,0,0,0,0,74,74,109
16160,Morocco,2008,2008Morocco,0,0,0,5,0,0,5,0,0,0,0,0,0,0,5
16161,Morocco,2008,2008Morocco,0,0,0,5,0,0,5,0,0,0,5,0,0,5,10
16162,Morocco,2008,2008Morocco,0,0,0,9,0,0,9,0,0,0,5,0,8,13,22
16163,Morocco,2009,2009Morocco,0,0,0,0,0,0,0,0,0,0,0,0,0,0,683
16164,Morocco,2009,2009Morocco,0,0,0,0,0,0,0,0,0,0,5,0,0,5,5
16165,Morocco,2009,2009Morocco,0,0,0,0,0,5,5,0,0,0,0,0,9,9,14
16166,Morocco,2009,2009Morocco,0,0,0,5,0,0,5,0,0,0,0,0,0,0,5
16167,Morocco,2009,2009Morocco,0,0,0,7,0,0,7,0,0,0,5,0,0,5,12
16168,Morocco,2009,2009Morocco,0,0,0,7,0,6,13,0,5,0,0,0,10,15,28
16169,Morocco,2009,2009Morocco,15,26,29,308,24,0,402,11,33,27,1030,27,0,1128,1530
16170,Morocco,2010,2010Morocco,0,0,0,0,0,0,0,0,0,0,0,0,0,0,585
16171,Morocco,2010,2010Morocco,0,0,0,0,0,0,0,0,0,0,5,0,0,5,5
16172,Morocco,2010,2010Morocco,0,0,0,0,0,0,0,0,0,5,0,0,0,5,5
16173,Morocco,2010,2010Morocco,0,0,0,0,0,0,0,0,6,0,0,0,0,6,6
16174,Morocco,2010,2010Morocco,0,0,0,0,0,0,0,5,0,0,0,0,0,5,5
16175,Morocco,2010,2010Morocco,0,0,0,0,0,6,6,0,0,0,0,0,10,10,16
16176,Morocco,2010,2010Morocco,0,0,0,0,0,36,36,0,0,0,0,0,84,84,120
16177,Morocco,2010,2010Morocco,0,0,0,5,0,0,5,0,0,0,0,0,0,0,5
16178,Morocco,2010,2010Morocco,0,0,0,7,0,5,12,0,0,5,5,0,7,17,29
16179,Morocco,2010,2010Morocco,15,35,29,304,28,0,411,12,29,28,987,33,0,1089,1500
16180,Morocco,2011,2011Morocco,0,0,0,0,0,0,0,0,0,0,0,0,0,0,481
16181,Morocco,2011,2011Morocco,0,0,0,0,0,0,0,0,0,0,5,0,0,5,5
16182,Morocco,2011,2011Morocco,0,0,0,0,0,0,0,0,5,0,0,0,0,5,5
16183,Morocco,2011,2011Morocco,0,0,0,0,0,7,7,0,0,0,0,0,10,10,17
16184,Morocco,2011,2011Morocco,0,0,0,0,0,38,38,0,0,0,0,0,94,94,132
16185,Morocco,2011,2011Morocco,0,0,0,5,0,0,5,0,0,0,0,0,0,0,10
16186,Morocco,2011,2011Morocco,0,0,0,6,0,0,6,0,6,0,0,0,0,6,12
16187,Morocco,2011,2011Morocco,0,0,0,7,0,0,7,0,0,0,0,0,0,0,7
16188,Morocco,2011,2011Morocco,0,5,0,13,0,0,18,0,0,0,16,0,0,16,174
16189,Morocco,2011,2011Morocco,0,6,0,8,0,0,14,0,0,0,5,0,10,15,29
16190,Morocco,2011,2011Morocco,10,25,26,299,34,0,394,7,28,23,945,36,0,1039,1433
16191,Morocco,2012,2012Morocco,0,0,0,0,0,0,0,0,0,0,0,0,0,0,537
16192,Morocco,2012,2012Morocco,0,0,0,0,0,0,0,0,0,0,5,0,0,5,5
16193,Morocco,2012,2012Morocco,0,0,0,0,0,6,6,0,0,0,0,0,12,12,18
16194,Morocco,2012,2012Morocco,0,0,0,0,0,48,48,0,0,0,0,0,116,116,164
16195,Morocco,2012,2012Morocco,0,0,0,5,0,0,5,0,0,0,0,0,0,0,5
16196,Morocco,2012,2012Morocco,0,0,0,6,0,0,6,0,0,0,0,0,0,0,6
16197,Morocco,2012,2012Morocco,0,0,0,6,0,0,6,0,0,0,7,0,0,7,169
16198,Morocco,2012,2012Morocco,0,0,0,6,0,8,14,0,0,0,5,0,8,13,27
16199,Morocco,2012,2012Morocco,0,0,0,9,0,0,9,0,0,0,0,0,0,0,9
16200,Morocco,2012,2012Morocco,9,28,31,317,48,0,433,10,33,22,909,47,0,1021,1454
16201,Morocco,2013,2013Morocco,0,0,0,0,0,0,0,0,0,0,0,0,0,0,682
16202,Morocco,2013,2013Morocco,0,0,0,0,0,0,0,0,0,0,5,0,0,5,5
16203,Morocco,2013,2013Morocco,0,0,0,0,0,5,5,0,0,0,0,0,16,16,27
16204,Morocco,2013,2013Morocco,0,0,0,0,0,55,55,0,0,0,0,0,142,142,197
16205,Morocco,2013,2013Morocco,0,0,0,5,0,0,5,0,0,0,0,0,0,0,5
16206,Morocco,2013,2013Morocco,0,0,0,6,0,0,6,0,0,0,0,0,0,0,12
16207,Morocco,2013,2013Morocco,0,0,0,6,0,0,6,0,0,5,0,0,0,5,11
16208,Morocco,2013,2013Morocco,0,0,0,11,0,0,11,0,0,0,12,0,0,12,173
16209,Morocco,2013,2013Morocco,0,5,0,8,0,5,18,0,0,0,5,0,11,16,34
16210,Morocco,2013,2013Morocco,0,8,11,50,5,0,74,5,8,5,47,5,0,70,144
16211,Morocco,2014,2014Morocco,0,0,0,0,0,0,0,0,0,0,0,0,0,0,900
16212,Morocco,2014,2014Morocco,0,0,0,0,0,0,0,0,0,0,0,0,6,6,6
16213,Morocco,2014,2014Morocco,0,0,0,0,0,0,0,0,0,0,5,0,0,5,5
16214,Morocco,2014,2014Morocco,0,0,0,0,0,65,65,0,0,0,0,0,160,160,225
16215,Morocco,2014,2014Morocco,0,0,0,7,0,9,16,0,0,0,6,0,11,17,33
16216,Morocco,2014,2014Morocco,0,0,0,9,0,0,9,0,0,0,9,0,0,9,168
16217,Morocco,2014,2014Morocco,0,0,7,0,0,0,7,0,0,0,0,0,0,0,7
16218,Morocco,2014,2014Morocco,5,0,0,15,0,0,20,0,0,5,0,0,0,5,25
16219,Morocco,2014,2014Morocco,5,7,6,52,7,0,77,9,8,8,47,5,0,77,154
16220,Morocco,2015,2015Morocco,0,0,0,0,0,0,0,0,0,0,0,0,0,0,1188
16221,Morocco,2015,2015Morocco,0,0,0,0,0,0,0,0,0,0,5,0,0,5,5
16222,Morocco,2015,2015Morocco,0,0,0,0,0,22,22,0,0,0,0,0,39,39,61
16223,Morocco,2015,2015Morocco,0,0,0,0,0,74,74,0,0,0,0,0,180,180,254
16224,Morocco,2015,2015Morocco,0,0,0,5,0,0,5,0,0,0,5,0,0,5,10
16225,Morocco,2015,2015Morocco,0,0,0,5,0,5,10,0,0,7,0,0,0,7,38
16226,Morocco,2015,2015Morocco,0,0,0,6,0,0,6,0,0,0,0,0,0,0,6
16227,Morocco,2015,2015Morocco,0,0,5,0,0,0,5,0,0,0,0,0,0,0,5
16228,Morocco,2015,2015Morocco,0,7,0,15,0,0,22,0,0,10,0,0,0,10,32
16229,Morocco,2015,2015Morocco,7,7,0,63,5,0,82,5,8,6,54,6,0,79,161
16230,Morocco,2016,2016Morocco,0,0,0,0,0,0,0,0,0,0,0,0,0,0,1254
16231,Morocco,2016,2016Morocco,0,0,0,0,0,0,0,0,0,0,8,0,0,8,8
16232,Morocco,2016,2016Morocco,0,0,0,0,0,21,21,0,0,0,0,0,49,49,70
16233,Morocco,2016,2016Morocco,0,0,0,0,0,98,98,0,0,0,0,0,254,254,352
16234,Morocco,2016,2016Morocco,0,0,0,6,0,0,6,0,0,0,0,0,0,0,6
16235,Morocco,2016,2016Morocco,0,0,0,8,0,0,8,0,0,0,0,0,0,0,8
16236,Morocco,2016,2016Morocco,0,0,0,8,0,0,8,0,0,0,9,0,0,9,158
16237,Morocco,2016,2016Morocco,0,0,0,15,0,10,25,0,0,0,9,0,14,23,48
16238,Morocco,2016,2016Morocco,5,0,5,16,0,0,26,0,0,5,0,0,0,5,31
16239,Morocco,2016,2016Morocco,7,0,0,0,0,0,7,0,0,0,0,0,0,0,7
16240,Morocco,2016,2016Morocco,15,14,8,128,7,0,172,12,14,8,85,7,0,126,298
16241,Morocco,2017,2017Morocco,0,0,0,0,0,0,0,0,0,0,0,0,0,0,1916
16242,Morocco,2017,2017Morocco,0,0,0,0,0,135,135,0,0,0,0,0,338,338,473
16243,Morocco,2017,2017Morocco,0,0,0,5,0,0,5,0,0,0,0,0,0,0,10
16244,Morocco,2017,2017Morocco,0,0,0,6,0,0,6,0,0,0,0,0,0,0,6
16245,Morocco,2017,2017Morocco,0,0,0,8,0,0,8,0,0,0,0,0,0,0,8
16246,Morocco,2017,2017Morocco,0,6,0,18,0,12,36,0,0,7,8,0,11,26,62
16247,Morocco,2017,2017Morocco,6,0,7,8,0,0,21,0,5,5,0,0,0,10,31
16248,Morocco,2017,2017Morocco,7,0,0,0,0,0,7,0,0,0,0,0,0,0,7
16249,Morocco,2017,2017Morocco,36,29,13,248,7,0,333,43,23,22,145,10,0,243,576
16250,Morocco,2018,2018Morocco,0,0,0,0,0,0,0,0,0,0,0,0,0,0,2253
16251,Morocco,2018,2018Morocco,0,0,0,0,0,196,196,0,0,0,0,0,436,436,632
16252,Morocco,2018,2018Morocco,0,0,0,5,0,0,5,0,0,0,0,0,0,0,10
16253,Morocco,2018,2018Morocco,0,0,0,6,0,0,6,0,0,0,0,0,0,0,6
16254,Morocco,2018,2018Morocco,0,0,0,16,0,0,16,5,0,0,13,0,0,18,153
16255,Morocco,2018,2018Morocco,0,7,0,0,0,0,7,0,0,0,0,0,0,0,7
16256,Morocco,2018,2018Morocco,5,0,0,17,0,15,37,5,0,0,12,0,13,30,67
16257,Morocco,2018,2018Morocco,5,0,5,18,0,0,28,0,0,0,5,0,0,5,33
16258,Morocco,2018,2018Morocco,47,35,15,297,9,0,403,49,41,24,184,11,0,309,712
16259,Morocco,2019,2019Morocco,0,0,0,0,0,0,0,0,0,0,0,0,0,0,2948
16260,Morocco,2019,2019Morocco,0,0,0,0,0,0,0,0,5,0,0,0,0,5,5
16261,Morocco,2019,2019Morocco,0,0,0,0,0,251,251,0,0,0,0,0,543,543,794
16262,Morocco,2019,2019Morocco,0,0,0,5,0,0,5,0,0,0,0,0,0,0,10
16263,Morocco,2019,2019Morocco,0,0,0,5,0,0,5,0,0,0,5,0,0,5,10
16264,Morocco,2019,2019Morocco,0,7,0,0,0,0,7,0,0,0,0,0,0,0,7
16265,Morocco,2019,2019Morocco,5,0,0,18,0,0,23,0,0,5,10,0,0,15,68
16266,Morocco,2019,2019Morocco,57,38,21,324,10,0,450,62,50,28,197,13,0,350,800
16267,Morocco,2020,2020Morocco,0,0,0,0,0,0,0,0,0,0,0,0,0,0,3367
16268,Morocco,2020,2020Morocco,0,0,0,0,0,0,0,0,0,0,5,0,0,5,5
16269,Morocco,2020,2020Morocco,0,0,0,0,0,0,0,0,5,0,0,0,0,5,5
16270,Morocco,2020,2020Morocco,0,0,0,0,0,5,5,0,0,0,0,0,0,0,5
16271,Morocco,2020,2020Morocco,0,0,0,0,0,40,40,0,0,0,0,0,102,102,142
16272,Morocco,2020,2020Morocco,0,0,0,5,0,0,5,0,0,0,0,0,0,0,10
16273,Morocco,2020,2020Morocco,0,0,0,5,0,0,5,0,0,0,7,0,0,7,12
16274,Morocco,2020,2020Morocco,0,7,0,0,0,0,7,0,0,0,0,0,0,0,7
16275,Morocco,2020,2020Morocco,0,8,0,16,5,0,29,0,0,5,12,0,0,17,79
16276,Morocco,2020,2020Morocco,44,57,26,323,10,0,460,65,67,28,200,15,0,375,835
16277,Morocco,2021,2021Morocco,0,0,0,0,0,0,0,0,0,0,0,0,0,0,4223
16278,Morocco,2021,2021Morocco,0,0,0,0,0,0,0,0,0,0,5,0,0,5,10
16279,Morocco,2021,2021Morocco,0,0,0,0,0,0,0,0,5,0,0,0,0,5,5
16280,Morocco,2021,2021Morocco,0,0,0,5,0,0,5,0,0,0,0,0,0,0,20
16281,Morocco,2021,2021Morocco,0,0,0,5,0,0,5,0,0,0,9,0,0,9,14
16282,Morocco,2021,2021Morocco,0,5,0,19,0,0,24,5,0,0,7,0,0,12,155
16283,Morocco,2021,2021Morocco,0,7,0,0,0,0,7,0,0,0,0,0,0,0,7
16284,Morocco,2021,2021Morocco,0,9,0,19,5,0,33,0,0,5,12,0,0,17,85
16285,Morocco,2021,2021Morocco,44,67,26,330,11,0,478,56,86,25,202,19,0,388,866
16286,Myanmar,2001,2001Myanmar,0,0,0,0,0,0,0,0,0,0,0,0,0,0,7189
16287,Myanmar,2001,2001Myanmar,0,0,0,0,0,0,0,0,0,0,0,0,5,5,10
16288,Myanmar,2001,2001Myanmar,0,0,0,0,0,9,9,0,0,0,0,0,56,56,65
16289,Myanmar,2001,2001Myanmar,0,0,0,0,0,37,37,0,0,0,0,0,80,80,117
16290,Myanmar,2001,2001Myanmar,0,0,0,8,0,0,8,0,6,0,8,0,0,14,22
16291,Myanmar,2001,2001Myanmar,0,7,0,12,0,0,19,0,5,0,26,0,0,31,5151
16292,Myanmar,2001,2001Myanmar,26,43,37,213,0,0,319,32,44,37,434,10,0,557,876
16293,Myanmar,2001,2001Myanmar,2020,2443,2090,4523,248,0,11324,2052,2381,2046,4061,242,0,10782,22106
16294,Myanmar,2001,2001Myanmar,7472,10132,8684,25270,1808,0,53366,7818,10734,9202,27321,1872,0,56947,110313
16295,Myanmar,2002,2002Myanmar,0,0,0,0,0,0,0,0,0,0,0,0,0,0,7791
16296,Myanmar,2002,2002Myanmar,0,0,0,0,0,0,0,0,0,0,0,0,5,5,5
16297,Myanmar,2002,2002Myanmar,0,0,0,0,0,13,13,0,0,0,0,0,61,61,74
16298,Myanmar,2002,2002Myanmar,0,0,0,0,0,23,23,0,0,0,0,0,105,105,128
16299,Myanmar,2002,2002Myanmar,5,6,5,23,0,2041,2080,9,5,5,88,0,3060,3167,5247
16300,Myanmar,2002,2002Myanmar,29,57,49,256,5,0,396,37,54,46,499,11,0,647,1043
16301,Myanmar,2002,2002Myanmar,2215,2315,1977,4425,297,0,11229,2230,2247,1920,4072,269,0,10738,21967
16302,Myanmar,2002,2002Myanmar,7482,10112,8668,26219,1861,0,54342,7762,10802,9259,28158,1915,0,57896,112238
16303,Myanmar,2003,2003Myanmar,0,0,0,0,0,0,0,0,0,0,0,0,0,0,7521
16304,Myanmar,2003,2003Myanmar,0,0,0,0,0,0,0,0,0,0,5,0,0,5,5
16305,Myanmar,2003,2003Myanmar,0,0,0,0,0,16,16,0,0,0,0,0,70,70,86
16306,Myanmar,2003,2003Myanmar,0,0,0,0,0,60,60,0,0,0,0,0,76,76,136
16307,Myanmar,2003,2003Myanmar,0,6,0,0,0,0,6,0,0,5,14,0,0,19,25
16308,Myanmar,2003,2003Myanmar,25,52,45,256,5,0,383,29,59,50,408,11,0,557,940
16309,Myanmar,2003,2003Myanmar,141,172,147,625,24,0,1109,172,212,182,2466,11,0,3043,4152
16310,Myanmar,2003,2003Myanmar,1973,2084,1787,3923,225,0,9992,2120,1956,1678,3787,210,0,9751,19743
16311,Myanmar,2003,2003Myanmar,7170,10689,9161,28409,2074,0,57503,7485,11325,9707,30576,2166,0,61259,118762
16312,Myanmar,2004,2004Myanmar,0,0,0,0,0,0,0,0,0,0,0,0,0,0,8868
16313,Myanmar,2004,2004Myanmar,0,0,0,0,0,0,0,0,0,0,5,0,0,5,5
16314,Myanmar,2004,2004Myanmar,0,0,0,0,0,58,58,0,0,0,0,0,87,87,145
16315,Myanmar,2004,2004Myanmar,37,69,60,337,5,0,508,49,77,66,451,11,0,654,1162
16316,Myanmar,2004,2004Myanmar,400,450,385,1551,49,0,2835,390,486,416,5358,116,0,6766,9601
16317,Myanmar,2004,2004Myanmar,1913,2181,1870,4095,248,0,10307,2074,2069,1774,3950,228,0,10095,20402
16318,Myanmar,2004,2004Myanmar,7445,10922,9358,28815,2162,0,58702,7845,11451,9814,30769,2233,0,62112,120814
16319,Myanmar,2005,2005Myanmar,0,0,0,0,0,0,0,0,0,0,0,0,0,0,11219
16320,Myanmar,2005,2005Myanmar,0,0,0,0,0,0,0,0,0,0,5,0,0,5,5
16321,Myanmar,2005,2005Myanmar,0,0,0,0,0,0,0,0,0,0,8,0,0,8,8
16322,Myanmar,2005,2005Myanmar,0,0,0,0,0,0,0,0,0,0,9,0,0,9,18
16323,Myanmar,2005,2005Myanmar,0,0,0,0,0,19,19,0,0,0,0,0,86,86,105
16324,Myanmar,2005,2005Myanmar,0,0,0,0,0,86,86,0,0,0,0,0,154,154,240
16325,Myanmar,2005,2005Myanmar,5,0,0,7,0,0,12,0,5,0,8,0,0,13,25
16326,Myanmar,2005,2005Myanmar,47,87,75,438,5,0,652,65,101,86,551,16,0,819,1471
16327,Myanmar,2005,2005Myanmar,638,616,528,2359,65,0,4206,612,706,606,7940,138,0,10002,14208
16328,Myanmar,2005,2005Myanmar,2000,2209,1894,4303,246,0,10652,2101,2132,1829,4116,223,0,10401,21053
16329,Myanmar,2005,2005Myanmar,8447,10871,9318,26804,2224,0,57664,8973,11430,9798,26448,2186,0,58835,116499
16330,Myanmar,2006,2006Myanmar,0,0,0,0,0,0,0,0,0,0,0,0,0,0,20448
16331,Myanmar,2006,2006Myanmar,0,0,0,0,0,0,0,0,0,0,0,0,5,5,5
16332,Myanmar,2006,2006Myanmar,0,0,0,0,0,0,0,0,0,0,0,0,12,12,12
16333,Myanmar,2006,2006Myanmar,0,0,0,0,0,0,0,0,0,0,6,0,0,6,6
16334,Myanmar,2006,2006Myanmar,0,0,0,0,0,0,0,0,0,0,14,0,0,14,14
16335,Myanmar,2006,2006Myanmar,0,0,0,0,0,0,0,0,0,0,19,0,0,19,19
16336,Myanmar,2006,2006Myanmar,0,0,0,0,0,0,0,0,0,5,6,0,0,11,11
16337,Myanmar,2006,2006Myanmar,0,0,0,0,0,22,22,0,0,0,0,0,95,95,117
16338,Myanmar,2006,2006Myanmar,0,0,0,0,0,81,81,0,0,0,0,0,188,188,269
16339,Myanmar,2006,2006Myanmar,0,0,0,5,0,0,5,0,0,0,0,0,0,0,5
16340,Myanmar,2006,2006Myanmar,0,0,0,6,0,0,6,0,0,0,15,0,0,15,21
16341,Myanmar,2006,2006Myanmar,0,0,5,8,0,0,13,0,0,0,0,0,0,0,25
16342,Myanmar,2006,2006Myanmar,70,104,123,528,5,0,830,94,120,124,626,18,0,982,1812
16343,Myanmar,2006,2006Myanmar,906,714,1064,3560,101,0,6345,942,781,1332,11966,178,0,15199,21544
16344,Myanmar,2006,2006Myanmar,2289,3256,1887,5878,315,0,13625,2312,3239,1821,4965,306,0,12643,26268
16345,Myanmar,2006,2006Myanmar,9163,12045,10031,31142,2622,0,65003,9748,12530,10478,32020,2462,0,67238,132241
16346,Myanmar,2007,2007Myanmar,0,0,0,0,0,0,0,0,0,0,0,0,0,0,7304
16347,Myanmar,2007,2007Myanmar,0,0,0,0,0,0,0,0,0,0,0,0,127,127,127
16348,Myanmar,2007,2007Myanmar,0,0,0,0,0,0,0,0,0,0,5,0,0,5,5
16349,Myanmar,2007,2007Myanmar,0,0,0,0,0,0,0,0,0,0,7,0,0,7,7
16350,Myanmar,2007,2007Myanmar,0,0,0,0,0,0,0,0,0,0,8,0,0,8,8
16351,Myanmar,2007,2007Myanmar,0,0,0,0,0,0,0,0,0,0,12,0,0,12,12
16352,Myanmar,2007,2007Myanmar,0,0,0,0,0,0,0,0,0,0,23,0,0,23,23
16353,Myanmar,2007,2007Myanmar,0,0,0,0,0,5,5,0,0,0,0,0,0,0,5
16354,Myanmar,2007,2007Myanmar,0,0,0,0,0,5,5,0,0,0,8,0,5,13,18
16355,Myanmar,2007,2007Myanmar,0,0,0,0,0,134,134,0,0,0,0,0,237,237,371
16356,Myanmar,2007,2007Myanmar,0,0,0,10,0,0,10,5,0,0,15,0,0,20,30
16357,Myanmar,2007,2007Myanmar,0,0,6,0,0,0,6,0,0,0,0,0,0,0,6
16358,Myanmar,2007,2007Myanmar,81,93,134,514,8,0,830,105,103,120,629,25,0,982,1812
16359,Myanmar,2007,2007Myanmar,974,1199,1035,5254,125,0,8587,1082,1335,1496,16707,210,0,20830,29474
16360,Myanmar,2007,2007Myanmar,2371,3765,1576,6198,305,0,14215,2481,3688,1555,5306,299,0,13329,27544
16361,Myanmar,2007,2007Myanmar,8684,11275,9349,29549,2555,0,61412,9268,11670,9761,30034,2417,0,63150,124562
16362,Myanmar,2008,2008Myanmar,0,0,0,0,0,0,0,0,0,0,0,0,0,0,7648
16363,Myanmar,2008,2008Myanmar,0,0,0,0,0,0,0,0,0,0,5,0,0,5,15
16364,Myanmar,2008,2008Myanmar,0,0,0,0,0,0,0,0,0,0,7,0,0,7,7
16365,Myanmar,2008,2008Myanmar,0,0,0,0,0,0,0,0,0,0,8,0,0,8,8
16366,Myanmar,2008,2008Myanmar,0,0,0,0,0,0,0,0,0,0,17,0,0,17,17
16367,Myanmar,2008,2008Myanmar,0,0,0,0,0,0,0,0,0,9,46,0,0,55,55
16368,Myanmar,2008,2008Myanmar,0,0,0,0,0,5,5,0,0,0,0,0,7,7,12
16369,Myanmar,2008,2008Myanmar,0,0,0,0,0,30,30,0,0,0,0,0,114,114,144
16370,Myanmar,2008,2008Myanmar,0,0,0,0,0,276,276,0,0,0,0,0,470,470,746
16371,Myanmar,2008,2008Myanmar,0,0,0,5,0,0,5,0,0,0,8,0,0,8,13
16372,Myanmar,2008,2008Myanmar,0,0,0,5,0,0,5,0,0,0,9,0,6,15,20
16373,Myanmar,2008,2008Myanmar,0,0,9,10,0,0,19,0,0,9,0,0,0,9,28
16374,Myanmar,2008,2008Myanmar,0,5,0,8,0,0,13,0,0,5,39,0,0,44,57
16375,Myanmar,2008,2008Myanmar,93,104,135,536,15,0,883,93,103,139,727,22,0,1084,1967
16376,Myanmar,2008,2008Myanmar,1803,1525,1508,6707,130,0,11673,1961,1634,1988,16218,241,0,22042,33781
16377,Myanmar,2008,2008Myanmar,2682,3575,2057,6069,272,0,14655,2701,3563,2016,5129,273,0,13682,28337
16378,Myanmar,2008,2008Myanmar,7696,10185,8261,26723,2463,0,55328,8179,10504,8638,26499,2407,0,56227,111555
16379,Myanmar,2009,2009Myanmar,0,0,0,0,0,0,0,0,0,0,0,0,0,0,7313
16380,Myanmar,2009,2009Myanmar,0,0,0,0,0,0,0,0,0,0,0,0,9,9,9
16381,Myanmar,2009,2009Myanmar,0,0,0,0,0,0,0,0,0,0,5,0,0,5,15
16382,Myanmar,2009,2009Myanmar,0,0,0,0,0,0,0,0,0,0,9,0,0,9,18
16383,Myanmar,2009,2009Myanmar,0,0,0,0,0,0,0,0,0,0,11,0,0,11,11
16384,Myanmar,2009,2009Myanmar,0,0,0,0,0,0,0,0,0,16,138,0,0,154,154
16385,Myanmar,2009,2009Myanmar,0,0,0,0,0,370,370,0,0,0,0,0,823,823,1193
16386,Myanmar,2009,2009Myanmar,0,0,0,6,0,0,6,0,0,0,5,0,0,5,11
16387,Myanmar,2009,2009Myanmar,0,0,0,9,0,0,9,0,0,0,10,0,0,10,19
16388,Myanmar,2009,2009Myanmar,0,0,8,5,0,0,13,0,0,5,9,0,7,21,34
16389,Myanmar,2009,2009Myanmar,5,0,0,0,0,0,5,0,0,0,0,0,0,0,5
16390,Myanmar,2009,2009Myanmar,5,0,0,18,0,0,23,8,0,0,70,0,0,78,101
16391,Myanmar,2009,2009Myanmar,13,13,17,150,5,0,198,9,28,15,495,11,0,558,756
16392,Myanmar,2009,2009Myanmar,154,159,194,814,20,0,1341,155,162,204,1058,32,0,1611,2952
16393,Myanmar,2009,2009Myanmar,2642,3410,2300,6119,256,0,14727,2664,3534,2217,5151,264,0,13830,228557
16394,Myanmar,2009,2009Myanmar,2753,2062,2157,12374,207,0,19553,3006,2192,3088,33223,331,0,41840,61412
16395,Myanmar,2009,2009Myanmar,7143,9498,7421,25194,2516,0,51772,7476,9902,7832,24675,2450,0,52335,104107
16396,Myanmar,2010,2010Myanmar,0,0,0,0,0,0,0,0,0,0,0,0,0,0,7203
16397,Myanmar,2010,2010Myanmar,0,0,0,0,0,0,0,0,0,0,5,0,0,5,5
16398,Myanmar,2010,2010Myanmar,0,0,0,0,0,0,0,0,0,0,55,0,0,55,55
16399,Myanmar,2010,2010Myanmar,0,0,0,0,0,0,0,0,5,0,44,0,0,49,49
16400,Myanmar,2010,2010Myanmar,0,0,0,0,0,5,5,0,0,0,0,0,6,6,11
16401,Myanmar,2010,2010Myanmar,0,0,0,0,0,38,38,0,0,0,0,0,133,133,171
16402,Myanmar,2010,2010Myanmar,0,0,0,0,0,492,492,0,0,0,0,0,975,975,1467
16403,Myanmar,2010,2010Myanmar,0,0,0,5,0,0,5,0,0,0,5,0,0,5,10
16404,Myanmar,2010,2010Myanmar,0,0,9,0,0,0,9,0,0,0,0,0,0,0,9
16405,Myanmar,2010,2010Myanmar,0,6,0,6,0,0,12,0,0,5,10,0,8,23,35
16406,Myanmar,2010,2010Myanmar,5,0,0,9,0,0,14,0,0,5,16,0,0,21,35
16407,Myanmar,2010,2010Myanmar,7,0,0,23,0,0,30,8,0,0,81,0,0,89,119
16408,Myanmar,2010,2010Myanmar,12,19,19,165,5,0,220,10,33,15,507,14,0,579,799
16409,Myanmar,2010,2010Myanmar,231,317,407,1222,40,0,2217,222,293,494,1370,34,0,2413,4630
16410,Myanmar,2010,2010Myanmar,314,448,319,798,38,0,1917,321,462,306,682,38,0,1809,229226
16411,Myanmar,2010,2010Myanmar,3304,2235,1980,14912,282,0,22713,3473,2344,2673,44472,419,0,53381,76120
16412,Myanmar,2010,2010Myanmar,6493,8697,6554,23700,2452,0,47896,6597,9071,6940,22816,2398,0,47822,95718
16413,Myanmar,2011,2011Myanmar,0,0,0,0,0,0,0,0,0,0,0,0,0,0,5767
16414,Myanmar,2011,2011Myanmar,0,0,0,0,0,0,0,0,0,0,9,0,0,9,9
16415,Myanmar,2011,2011Myanmar,0,0,0,0,0,0,0,0,0,0,54,0,0,54,54
16416,Myanmar,2011,2011Myanmar,0,0,0,0,0,5,5,0,0,0,0,0,13,13,18
16417,Myanmar,2011,2011Myanmar,0,0,0,0,0,38,38,0,0,0,0,0,136,136,174
16418,Myanmar,2011,2011Myanmar,0,0,0,0,0,555,555,0,0,0,0,0,1090,1090,1645
16419,Myanmar,2011,2011Myanmar,0,0,0,5,0,0,5,0,0,6,74,0,0,80,85
16420,Myanmar,2011,2011Myanmar,0,0,0,13,0,0,13,0,0,6,15,0,0,21,34
16421,Myanmar,2011,2011Myanmar,0,0,7,6,0,0,13,0,0,5,11,0,8,24,37
16422,Myanmar,2011,2011Myanmar,0,0,9,0,0,0,9,0,0,0,0,0,0,0,9
16423,Myanmar,2011,2011Myanmar,0,7,0,28,0,0,35,0,7,0,86,0,0,93,128
16424,Myanmar,2011,2011Myanmar,8,29,18,183,7,0,245,11,29,19,499,16,0,574,819
16425,Myanmar,2011,2011Myanmar,23,15,10,79,5,0,132,22,20,18,80,5,0,145,277
16426,Myanmar,2011,2011Myanmar,281,449,352,851,39,0,1972,281,471,344,717,40,0,1853,229644
16427,Myanmar,2011,2011Myanmar,339,419,518,1815,58,0,3149,316,432,648,2021,55,0,3472,6621
16428,Myanmar,2011,2011Myanmar,3958,2486,1712,15575,342,0,24073,4122,2659,2136,47590,534,0,57041,81146
16429,Myanmar,2011,2011Myanmar,5719,8011,5987,22244,2387,0,44348,5897,8180,6373,21031,2319,0,43800,88148
16430,Myanmar,2012,2012Myanmar,0,0,0,0,0,0,0,0,0,0,0,0,0,0,5628
16431,Myanmar,2012,2012Myanmar,0,0,0,0,0,0,0,0,0,0,5,0,0,5,5
16432,Myanmar,2012,2012Myanmar,0,0,0,0,0,5,5,0,0,0,0,0,12,12,17
16433,Myanmar,2012,2012Myanmar,0,0,0,0,0,18,18,0,0,0,0,0,28,28,46
16434,Myanmar,2012,2012Myanmar,0,0,0,0,0,39,39,0,0,0,0,0,154,154,193
16435,Myanmar,2012,2012Myanmar,0,0,0,0,0,49,49,0,0,0,0,0,78,78,127
16436,Myanmar,2012,2012Myanmar,0,0,0,0,0,606,606,0,0,0,0,0,1126,1126,1732
16437,Myanmar,2012,2012Myanmar,0,0,0,6,0,0,6,0,5,0,10,0,0,15,21
16438,Myanmar,2012,2012Myanmar,0,6,5,5,0,0,16,0,0,0,7,0,0,7,23
16439,Myanmar,2012,2012Myanmar,5,0,12,5,0,0,22,10,20,165,5,0,0,200,222
16440,Myanmar,2012,2012Myanmar,5,5,0,40,0,0,50,5,5,0,96,0,0,106,156
16441,Myanmar,2012,2012Myanmar,6,0,0,13,0,0,19,0,0,6,22,0,0,28,47
16442,Myanmar,2012,2012Myanmar,7,25,22,186,9,0,249,8,33,19,484,20,0,564,813
16443,Myanmar,2012,2012Myanmar,314,478,375,903,44,0,2114,319,493,367,737,46,0,1962,230674
16444,Myanmar,2012,2012Myanmar,379,501,505,2197,79,0,3661,393,478,686,2383,70,0,4010,7671
16445,Myanmar,2012,2012Myanmar,4637,2769,1754,16084,422,0,25666,4830,3009,2220,48328,587,0,58974,84671
16446,Myanmar,2012,2012Myanmar,5191,7562,5679,21264,2353,0,42049,5347,7713,5963,19937,2308,0,41268,83317
16447,Myanmar,2013,2013Myanmar,0,0,0,0,0,0,0,0,0,0,0,0,0,0,5204
16448,Myanmar,2013,2013Myanmar,0,0,0,0,0,0,0,0,0,0,5,0,0,5,10
16449,Myanmar,2013,2013Myanmar,0,0,0,0,0,5,5,0,0,0,0,0,13,13,18
16450,Myanmar,2013,2013Myanmar,0,0,0,0,0,16,16,0,0,0,0,0,19,19,35
16451,Myanmar,2013,2013Myanmar,0,0,0,0,0,46,46,0,0,0,0,0,208,208,254
16452,Myanmar,2013,2013Myanmar,0,0,0,0,0,531,531,0,0,0,0,0,1300,1300,1831
16453,Myanmar,2013,2013Myanmar,0,0,0,5,0,0,5,0,5,0,14,0,0,19,24
16454,Myanmar,2013,2013Myanmar,0,0,0,8,0,0,8,0,0,0,0,0,0,0,283
16455,Myanmar,2013,2013Myanmar,0,0,5,7,0,6,18,0,0,0,17,0,10,27,45
16456,Myanmar,2013,2013Myanmar,0,9,0,0,0,0,9,0,0,0,5,0,0,5,14
16457,Myanmar,2013,2013Myanmar,6,5,0,44,0,0,55,6,6,0,103,5,0,120,175
16458,Myanmar,2013,2013Myanmar,6,26,24,191,10,0,257,6,31,25,487,19,0,568,825
16459,Myanmar,2013,2013Myanmar,7,7,0,19,0,0,33,6,5,5,36,0,0,52,85
16460,Myanmar,2013,2013Myanmar,20,21,7,44,0,0,92,27,22,87,553,0,0,689,781
16461,Myanmar,2013,2013Myanmar,298,505,386,964,43,0,2196,314,510,372,751,47,0,1994,231125
16462,Myanmar,2013,2013Myanmar,620,857,606,3071,108,0,5262,639,876,774,3469,102,0,5860,11122
16463,Myanmar,2013,2013Myanmar,2720,3980,3047,11614,1339,0,22700,2826,4104,3057,10844,1317,0,22148,135476
16464,Myanmar,2013,2013Myanmar,5420,3169,1996,18112,481,0,29178,5686,3488,2587,50686,638,0,63085,92287
16465,Myanmar,2014,2014Myanmar,0,0,0,0,0,0,0,0,0,0,0,0,0,0,5283
16466,Myanmar,2014,2014Myanmar,0,0,0,0,0,0,0,0,0,0,0,0,5,5,5
16467,Myanmar,2014,2014Myanmar,0,0,0,0,0,0,0,0,0,0,5,0,0,5,5
16468,Myanmar,2014,2014Myanmar,0,0,0,0,0,0,0,0,0,0,6,0,0,6,6
16469,Myanmar,2014,2014Myanmar,0,0,0,0,0,0,0,0,0,0,77,0,0,77,77
16470,Myanmar,2014,2014Myanmar,0,0,0,0,0,51,51,0,0,0,0,0,248,248,299
16471,Myanmar,2014,2014Myanmar,0,0,0,0,0,586,586,0,0,0,0,0,1303,1303,1889
16472,Myanmar,2014,2014Myanmar,0,0,5,0,0,0,5,0,0,0,16,0,0,16,21
16473,Myanmar,2014,2014Myanmar,0,5,0,10,0,7,22,5,0,0,17,0,8,30,52
16474,Myanmar,2014,2014Myanmar,0,6,0,5,0,0,11,0,0,7,5,0,0,12,23
16475,Myanmar,2014,2014Myanmar,5,7,0,47,0,0,59,5,8,0,108,0,0,121,180
16476,Myanmar,2014,2014Myanmar,6,5,0,10,0,0,21,12,0,0,11,0,0,23,44
16477,Myanmar,2014,2014Myanmar,6,7,5,26,0,0,44,5,9,6,37,0,0,57,101
16478,Myanmar,2014,2014Myanmar,6,24,22,177,11,0,240,5,22,21,459,22,0,529,769
16479,Myanmar,2014,2014Myanmar,44,45,27,90,5,0,211,44,49,50,406,0,0,549,760
16480,Myanmar,2014,2014Myanmar,277,518,376,1152,58,0,2381,295,533,375,888,63,0,2154,232462
16481,Myanmar,2014,2014Myanmar,832,1166,784,3868,148,0,6798,874,1224,878,4391,136,0,7503,14301
16482,Myanmar,2014,2014Myanmar,4052,6388,5451,19093,2035,0,37019,4221,6673,5533,18424,1892,0,36743,128863
16483,Myanmar,2014,2014Myanmar,5999,3377,2094,19032,503,0,31005,6352,3753,2662,49401,684,0,62852,93866
16484,Myanmar,2015,2015Myanmar,0,0,0,0,0,0,0,0,0,0,0,0,0,0,6893
16485,Myanmar,2015,2015Myanmar,0,0,0,0,0,0,0,0,0,0,0,0,10,10,10
16486,Myanmar,2015,2015Myanmar,0,0,0,0,0,0,0,0,0,0,6,0,0,6,6
16487,Myanmar,2015,2015Myanmar,0,0,0,0,0,50,50,0,0,0,0,0,261,261,311
16488,Myanmar,2015,2015Myanmar,0,0,0,6,0,9,15,0,0,0,38,0,0,38,53
16489,Myanmar,2015,2015Myanmar,0,0,0,8,0,0,8,0,0,6,10,0,0,16,24
16490,Myanmar,2015,2015Myanmar,0,0,5,0,0,0,5,0,0,0,14,0,0,14,19
16491,Myanmar,2015,2015Myanmar,0,5,0,0,0,0,5,0,0,0,8,0,0,8,13
16492,Myanmar,2015,2015Myanmar,5,5,0,10,0,0,20,12,0,0,11,0,0,23,43
16493,Myanmar,2015,2015Myanmar,5,8,0,61,0,0,74,8,14,0,117,0,0,139,213
16494,Myanmar,2015,2015Myanmar,5,19,13,166,9,0,212,0,16,22,434,24,0,496,708
16495,Myanmar,2015,2015Myanmar,13,15,6,39,0,0,73,10,18,8,47,0,0,83,156
16496,Myanmar,2015,2015Myanmar,39,53,28,93,5,0,218,46,44,25,353,0,0,468,686
16497,Myanmar,2015,2015Myanmar,272,514,401,1096,54,0,2337,298,519,396,789,57,0,2059,231948
16498,Myanmar,2015,2015Myanmar,919,1340,844,4317,146,0,7566,963,1417,987,4640,162,0,8169,15735
16499,Myanmar,2015,2015Myanmar,3506,4781,3948,13363,1326,0,26924,3637,4990,4024,12430,1228,0,26309,106349
16500,Myanmar,2015,2015Myanmar,6077,3166,1907,18391,487,0,30028,6452,3450,2338,45622,741,0,58603,88637
16501,Myanmar,2016,2016Myanmar,0,0,0,0,0,0,0,0,0,0,0,0,0,0,6422
16502,Myanmar,2016,2016Myanmar,0,0,0,0,0,0,0,0,0,0,0,0,9,9,9
16503,Myanmar,2016,2016Myanmar,0,0,0,0,0,0,0,0,0,0,5,0,0,5,5
16504,Myanmar,2016,2016Myanmar,0,0,0,0,0,0,0,0,0,0,10,0,0,10,10
16505,Myanmar,2016,2016Myanmar,0,0,0,0,0,49,49,0,0,0,0,0,275,275,324
16506,Myanmar,2016,2016Myanmar,0,0,0,5,0,0,5,0,5,0,0,0,0,5,10
16507,Myanmar,2016,2016Myanmar,0,0,5,0,0,0,5,0,0,0,14,0,0,14,19
16508,Myanmar,2016,2016Myanmar,0,5,0,5,0,0,10,0,0,7,6,0,0,13,23
16509,Myanmar,2016,2016Myanmar,0,5,0,5,0,0,10,8,0,0,5,0,0,13,23
16510,Myanmar,2016,2016Myanmar,5,0,0,5,0,7,17,5,0,0,13,0,9,27,44
16511,Myanmar,2016,2016Myanmar,5,16,12,154,12,0,199,0,12,20,422,24,0,478,677
16512,Myanmar,2016,2016Myanmar,8,13,6,66,0,0,93,11,15,8,122,5,0,161,254
16513,Myanmar,2016,2016Myanmar,12,14,6,37,0,0,69,12,17,11,36,5,0,81,150
16514,Myanmar,2016,2016Myanmar,56,50,35,129,5,0,275,66,55,56,435,0,0,612,887
16515,Myanmar,2016,2016Myanmar,254,446,352,1019,46,0,2117,284,446,363,726,51,0,1870,276198
16516,Myanmar,2016,2016Myanmar,1051,1392,855,4061,145,0,7504,1137,1453,987,4299,181,0,8057,15561
16517,Myanmar,2016,2016Myanmar,3514,4485,3658,12555,1239,0,25451,3695,4635,3753,11747,1156,0,24986,102633
16518,Myanmar,2016,2016Myanmar,3776,2686,1483,18031,405,0,26381,3873,2836,1990,51365,584,0,60648,87036
16519,Myanmar,2017,2017Myanmar,0,0,0,0,0,0,0,0,0,0,0,0,0,0,5863
16520,Myanmar,2017,2017Myanmar,0,0,0,0,0,0,0,0,0,0,9,0,0,9,9
16521,Myanmar,2017,2017Myanmar,0,0,0,0,0,48,48,0,0,0,0,0,268,268,316
16522,Myanmar,2017,2017Myanmar,0,0,0,5,0,0,5,0,0,0,0,0,0,0,5
16523,Myanmar,2017,2017Myanmar,0,0,0,5,0,0,5,0,0,0,5,0,0,5,10
16524,Myanmar,2017,2017Myanmar,0,0,0,5,0,0,5,0,5,0,9,0,0,14,19
16525,Myanmar,2017,2017Myanmar,0,0,0,8,0,0,8,0,0,7,6,0,0,13,21
16526,Myanmar,2017,2017Myanmar,0,0,0,9,0,9,18,0,0,0,14,0,8,22,40
16527,Myanmar,2017,2017Myanmar,0,5,0,7,0,0,12,5,5,0,7,0,0,17,29
16528,Myanmar,2017,2017Myanmar,5,5,0,7,0,0,17,8,0,0,10,0,0,18,35
16529,Myanmar,2017,2017Myanmar,5,13,18,172,18,0,226,5,10,20,544,26,0,605,831
16530,Myanmar,2017,2017Myanmar,10,12,13,76,0,0,111,11,21,16,128,5,0,181,292
16531,Myanmar,2017,2017Myanmar,16,19,6,48,0,0,89,17,23,12,44,5,0,101,190
16532,Myanmar,2017,2017Myanmar,54,49,39,121,0,0,263,60,65,33,340,5,0,503,766
16533,Myanmar,2017,2017Myanmar,1529,1628,964,4466,166,0,8753,1701,1729,1089,4630,187,0,9336,18089
16534,Myanmar,2017,2017Myanmar,2704,4372,3651,13030,1371,0,25128,2898,4469,3799,12246,1273,0,24685,99982
16535,Myanmar,2017,2017Myanmar,7287,4057,2222,19553,453,0,33572,7726,4181,3153,48710,680,0,64450,98041
16536,Myanmar,2017,2017Myanmar,72318,87151,54987,187808,14109,0,416373,74752,92318,55836,147192,12679,0,382777,932204
16537,Myanmar,2018,2018Myanmar,0,0,0,0,0,0,0,0,0,0,0,0,0,0,5130
16538,Myanmar,2018,2018Myanmar,0,0,0,0,0,0,0,0,0,0,8,0,0,8,8
16539,Myanmar,2018,2018Myanmar,0,0,0,0,0,49,49,0,0,0,0,0,272,272,321
16540,Myanmar,2018,2018Myanmar,0,0,0,5,0,0,5,0,0,0,5,0,0,5,10
16541,Myanmar,2018,2018Myanmar,0,0,0,8,0,8,16,0,0,0,11,0,9,20,36
16542,Myanmar,2018,2018Myanmar,0,0,0,9,0,0,9,5,0,0,8,0,0,13,22
16543,Myanmar,2018,2018Myanmar,0,5,0,6,0,0,11,5,7,0,6,0,0,18,29
16544,Myanmar,2018,2018Myanmar,5,0,6,18,0,0,29,0,5,5,11,5,0,26,55
16545,Myanmar,2018,2018Myanmar,5,9,17,175,21,0,227,5,11,20,558,33,0,627,854
16546,Myanmar,2018,2018Myanmar,6,9,0,0,0,0,15,0,8,0,10,0,0,18,33
16547,Myanmar,2018,2018Myanmar,17,13,14,89,0,0,133,19,19,18,134,5,0,195,328
16548,Myanmar,2018,2018Myanmar,30,29,14,73,5,0,151,36,35,22,83,5,0,181,332
16549,Myanmar,2018,2018Myanmar,42,57,32,113,5,0,249,65,70,24,300,5,0,464,713
16550,Myanmar,2018,2018Myanmar,1632,1733,996,4537,174,0,9072,1759,1884,1102,4787,209,0,9741,18813
16551,Myanmar,2018,2018Myanmar,4397,8373,7009,26463,2967,0,49209,4688,8705,7192,24990,2819,0,48394,97603
16552,Myanmar,2018,2018Myanmar,7914,4597,2455,20829,477,0,36272,8587,4742,3210,60649,767,0,77955,114227
16553,Myanmar,2018,2018Myanmar,82740,99365,61262,214253,15903,0,473523,85552,104771,61847,166840,14102,0,433112,906635
16554,Myanmar,2019,2019Myanmar,0,0,0,0,0,0,0,0,0,0,0,0,0,0,4588
16555,Myanmar,2019,2019Myanmar,0,0,0,0,0,0,0,0,0,0,5,0,0,5,5
16556,Myanmar,2019,2019Myanmar,0,0,0,0,0,0,0,0,0,0,7,0,0,7,7
16557,Myanmar,2019,2019Myanmar,0,0,0,0,0,48,48,0,0,0,0,0,281,281,329
16558,Myanmar,2019,2019Myanmar,0,0,0,5,0,0,5,0,0,0,8,0,0,8,13
16559,Myanmar,2019,2019Myanmar,0,0,0,7,0,0,7,0,0,0,10,0,0,10,34
16560,Myanmar,2019,2019Myanmar,0,0,0,9,0,0,9,0,11,0,6,0,0,17,26
16561,Myanmar,2019,2019Myanmar,0,5,0,5,0,0,10,0,5,0,8,0,0,13,23
16562,Myanmar,2019,2019Myanmar,5,0,0,11,5,0,21,0,0,5,40,0,0,45,66
16563,Myanmar,2019,2019Myanmar,5,5,0,7,0,0,17,0,8,0,9,0,0,17,34
16564,Myanmar,2019,2019Myanmar,6,13,14,175,20,0,228,5,9,21,548,40,0,623,851
16565,Myanmar,2019,2019Myanmar,31,43,36,97,0,0,207,47,60,18,258,5,0,388,595
16566,Myanmar,2019,2019Myanmar,32,34,17,74,5,0,162,32,39,24,89,5,0,189,351
16567,Myanmar,2019,2019Myanmar,109,203,166,823,37,0,1338,106,207,140,751,32,0,1236,2574
16568,Myanmar,2019,2019Myanmar,3963,7775,6743,25557,3084,0,47122,4219,8119,6884,24072,2919,0,46213,93335
16569,Myanmar,2019,2019Myanmar,8297,5206,2626,21107,465,0,37701,8763,5489,3226,63222,830,0,81530,119231
16570,Myanmar,2019,2019Myanmar,79323,87875,57549,203374,13420,0,441541,82334,91657,60385,162241,16606,0,413223,854764
16571,Myanmar,2020,2020Myanmar,0,0,0,0,0,0,0,0,0,0,0,0,0,0,3616
16572,Myanmar,2020,2020Myanmar,0,0,0,0,0,0,0,0,0,0,0,0,5,5,5
16573,Myanmar,2020,2020Myanmar,0,0,0,0,0,0,0,0,0,0,5,0,0,5,10
16574,Myanmar,2020,2020Myanmar,0,0,0,0,0,8,8,0,0,0,0,0,0,0,8
16575,Myanmar,2020,2020Myanmar,0,0,0,0,0,168,168,0,0,0,0,0,222,222,390
16576,Myanmar,2020,2020Myanmar,0,0,0,5,0,0,5,0,0,0,8,0,0,8,13
16577,Myanmar,2020,2020Myanmar,0,0,0,8,0,0,8,0,10,0,6,0,0,16,24
16578,Myanmar,2020,2020Myanmar,0,0,5,5,0,0,10,0,0,8,5,0,0,13,23
16579,Myanmar,2020,2020Myanmar,0,0,6,15,5,0,26,0,0,5,43,0,0,48,74
16580,Myanmar,2020,2020Myanmar,0,6,0,0,0,0,6,0,0,0,9,0,0,9,30
16581,Myanmar,2020,2020Myanmar,5,8,0,6,0,0,19,0,7,0,8,0,0,15,34
16582,Myanmar,2020,2020Myanmar,7,16,12,180,22,0,237,8,8,18,550,48,0,632,869
16583,Myanmar,2020,2020Myanmar,17,32,22,82,0,0,153,28,50,23,232,5,0,338,491
16584,Myanmar,2020,2020Myanmar,32,39,18,75,5,0,169,28,44,21,97,0,0,190,359
16585,Myanmar,2020,2020Myanmar,1408,1920,1091,4719,197,0,9335,1370,2123,1209,5124,237,0,10063,19398
16586,Myanmar,2020,2020Myanmar,3370,7438,6643,25652,3269,0,46372,3556,7864,6746,24204,3063,0,45433,91805
16587,Myanmar,2020,2020Myanmar,7162,6419,2698,21478,496,0,38253,7655,6659,3182,62912,917,0,81325,119578
16588,Myanmar,2020,2020Myanmar,67019,95390,56609,214409,14042,0,447469,69573,99047,61047,171825,17557,0,419049,866518
16589,Myanmar,2021,2021Myanmar,0,0,0,0,0,0,0,0,0,0,0,0,0,0,3772
16590,Myanmar,2021,2021Myanmar,0,0,0,0,0,0,0,0,0,0,5,0,0,5,5
16591,Myanmar,2021,2021Myanmar,0,0,0,0,0,0,0,0,0,0,8,0,0,8,8
16592,Myanmar,2021,2021Myanmar,0,0,0,0,0,0,0,0,0,0,9,0,0,9,9
16593,Myanmar,2021,2021Myanmar,0,0,0,0,0,65,65,0,0,0,0,0,84,84,149
16594,Myanmar,2021,2021Myanmar,0,0,0,5,0,0,5,0,0,0,5,0,0,5,10
16595,Myanmar,2021,2021Myanmar,0,0,0,5,0,0,5,0,0,0,8,0,0,8,13
16596,Myanmar,2021,2021Myanmar,0,0,5,5,0,0,10,0,0,8,5,0,0,13,23
16597,Myanmar,2021,2021Myanmar,0,0,5,5,0,0,10,0,8,5,7,0,0,20,30
16598,Myanmar,2021,2021Myanmar,0,0,5,15,5,0,25,0,0,5,41,0,0,46,71
16599,Myanmar,2021,2021Myanmar,0,6,0,0,0,0,6,0,0,0,9,0,0,9,41
16600,Myanmar,2021,2021Myanmar,5,8,0,6,0,0,19,0,7,0,9,0,0,16,35
16601,Myanmar,2021,2021Myanmar,6,19,13,182,26,0,246,9,8,18,551,50,0,636,890
16602,Myanmar,2021,2021Myanmar,18,27,25,83,0,0,153,27,38,26,236,0,0,327,480
16603,Myanmar,2021,2021Myanmar,33,37,21,83,6,0,180,25,41,26,100,5,0,197,377
16604,Myanmar,2021,2021Myanmar,1348,2109,1248,5085,232,0,10022,1369,2252,1363,5466,282,0,10732,35832
16605,Myanmar,2021,2021Myanmar,2594,7178,6695,26365,3347,0,46179,2677,7622,6890,24867,3175,0,45231,96086
16606,Myanmar,2021,2021Myanmar,5769,7898,2786,21810,490,0,38753,6266,8150,3296,63219,914,0,81845,120598
16607,Myanmar,2021,2021Myanmar,74275,99810,60660,223655,14501,0,472901,77459,103520,66043,180599,18376,0,445997,918898
16608,Nepal,2001,2001Nepal,0,0,0,0,0,0,0,0,0,0,0,0,0,0,300
16609,Nepal,2002,2002Nepal,0,0,0,0,0,0,0,0,0,0,0,0,0,0,899
16610,Nepal,2003,2003Nepal,0,0,0,0,0,0,0,0,0,0,0,0,0,0,1224
16611,Nepal,2003,2003Nepal,0,0,0,0,0,0,0,0,0,0,0,0,8,8,8
16612,Nepal,2004,2004Nepal,0,0,0,0,0,0,0,0,0,0,0,0,0,0,1414
16613,Nepal,2005,2005Nepal,0,0,0,0,0,0,0,0,0,0,0,0,0,0,1970
16614,Nepal,2005,2005Nepal,0,0,0,0,0,0,0,0,0,0,6,0,0,6,6
16615,Nepal,2005,2005Nepal,0,0,0,0,0,0,0,0,0,0,9,0,0,9,9
16616,Nepal,2005,2005Nepal,0,0,0,0,0,0,0,0,0,0,10,0,0,10,10
16617,Nepal,2005,2005Nepal,0,0,0,0,0,5,5,0,0,0,0,0,21,21,26
16618,Nepal,2005,2005Nepal,0,0,0,5,0,0,5,0,0,0,35,0,0,35,40
16619,Nepal,2006,2006Nepal,0,0,0,0,0,0,0,0,0,0,0,0,0,0,2488
16620,Nepal,2006,2006Nepal,0,0,0,0,0,0,0,0,0,0,0,0,5,5,5
16621,Nepal,2006,2006Nepal,0,0,0,0,0,0,0,0,0,0,5,0,0,5,5
16622,Nepal,2006,2006Nepal,0,0,0,0,0,0,0,0,0,0,17,0,0,17,17
16623,Nepal,2006,2006Nepal,0,0,0,0,0,6,6,0,0,0,0,0,26,26,32
16624,Nepal,2006,2006Nepal,0,0,0,0,0,10,10,0,0,0,0,0,16,16,26
16625,Nepal,2006,2006Nepal,0,0,0,5,0,0,5,0,0,0,6,0,0,6,11
16626,Nepal,2006,2006Nepal,5,0,0,10,0,0,15,0,5,5,42,0,0,52,67
16627,Nepal,2007,2007Nepal,0,0,0,0,0,0,0,0,0,0,0,0,0,0,3225
16628,Nepal,2007,2007Nepal,0,0,0,0,0,0,0,0,0,0,6,0,0,6,6
16629,Nepal,2007,2007Nepal,0,0,0,0,0,7,7,0,0,0,0,0,29,29,36
16630,Nepal,2007,2007Nepal,0,0,0,0,0,12,12,0,0,0,0,0,19,19,31
16631,Nepal,2007,2007Nepal,0,0,0,6,0,0,6,0,0,0,9,0,0,9,15
16632,Nepal,2007,2007Nepal,0,8,0,7,0,0,15,5,0,0,31,0,0,36,51
16633,Nepal,2008,2008Nepal,0,0,0,0,0,0,0,0,0,0,0,0,0,0,4049
16634,Nepal,2008,2008Nepal,0,0,0,0,0,0,0,0,0,0,5,0,0,5,10
16635,Nepal,2008,2008Nepal,0,0,0,0,0,0,0,0,0,0,8,0,0,8,16
16636,Nepal,2008,2008Nepal,0,0,0,0,0,5,5,0,0,0,6,0,0,6,11
16637,Nepal,2008,2008Nepal,0,0,0,0,0,8,8,0,0,0,0,0,34,34,42
16638,Nepal,2008,2008Nepal,0,0,0,0,0,10,10,0,0,0,0,0,14,14,24
16639,Nepal,2008,2008Nepal,0,0,8,0,0,0,8,0,0,0,30,0,0,30,38
16640,Nepal,2009,2009Nepal,0,0,0,0,0,0,0,0,0,0,0,0,0,0,4670
16641,Nepal,2009,2009Nepal,0,0,0,0,0,0,0,0,0,0,5,0,0,5,15
16642,Nepal,2009,2009Nepal,0,0,0,0,0,0,0,0,0,0,6,0,0,6,6
16643,Nepal,2009,2009Nepal,0,0,0,0,0,0,0,0,0,0,7,0,0,7,7
16644,Nepal,2009,2009Nepal,0,0,0,0,0,0,0,0,0,0,18,0,0,18,18
16645,Nepal,2009,2009Nepal,0,0,0,0,0,5,5,0,0,0,5,0,0,5,10
16646,Nepal,2009,2009Nepal,0,0,0,0,0,10,10,0,0,0,0,0,15,15,25
16647,Nepal,2009,2009Nepal,0,15,9,74,0,0,98,5,10,13,219,5,0,252,350
16648,Nepal,2010,2010Nepal,0,0,0,0,0,0,0,0,0,0,0,0,0,0,5395
16649,Nepal,2010,2010Nepal,0,0,0,0,0,0,0,0,0,0,0,0,8,8,8
16650,Nepal,2010,2010Nepal,0,0,0,0,0,0,0,0,0,0,5,0,0,5,10
16651,Nepal,2010,2010Nepal,0,0,0,0,0,0,0,0,0,0,7,0,0,7,19
16652,Nepal,2010,2010Nepal,0,0,0,0,0,0,0,0,0,0,11,0,0,11,11
16653,Nepal,2010,2010Nepal,0,0,0,0,0,0,0,0,5,0,12,0,0,17,17
16654,Nepal,2010,2010Nepal,0,0,0,0,0,9,9,0,0,0,0,0,10,10,19
16655,Nepal,2010,2010Nepal,0,0,0,0,0,11,11,0,0,0,0,0,44,44,55
16656,Nepal,2010,2010Nepal,0,13,12,76,0,0,101,5,11,13,214,5,0,248,349
16657,Nepal,2011,2011Nepal,0,0,0,0,0,0,0,0,0,0,0,0,0,0,5386
16658,Nepal,2011,2011Nepal,0,0,0,0,0,0,0,0,0,0,0,0,8,8,8
16659,Nepal,2011,2011Nepal,0,0,0,0,0,0,0,0,0,0,5,0,0,5,15
16660,Nepal,2011,2011Nepal,0,0,0,0,0,0,0,0,0,0,7,0,0,7,7
16661,Nepal,2011,2011Nepal,0,0,0,0,0,0,0,0,0,0,10,0,0,10,15
16662,Nepal,2011,2011Nepal,0,0,0,0,0,8,8,0,0,0,0,0,9,9,17
16663,Nepal,2011,2011Nepal,0,0,0,0,0,13,13,0,0,0,0,0,49,49,62
16664,Nepal,2011,2011Nepal,0,0,0,5,0,0,5,0,0,0,13,0,0,13,18
16665,Nepal,2011,2011Nepal,0,8,0,77,7,0,92,0,8,10,155,0,0,173,986
16666,Nepal,2011,2011Nepal,0,10,7,79,0,0,96,0,14,12,204,5,0,235,331
16667,Nepal,2012,2012Nepal,0,0,0,0,0,0,0,0,0,0,0,0,0,0,5989
16668,Nepal,2012,2012Nepal,0,0,0,0,0,0,0,0,0,0,0,0,8,8,8
16669,Nepal,2012,2012Nepal,0,0,0,0,0,0,0,0,0,0,5,0,0,5,15
16670,Nepal,2012,2012Nepal,0,0,0,0,0,0,0,0,0,0,7,0,0,7,7
16671,Nepal,2012,2012Nepal,0,0,0,0,0,6,6,0,0,0,0,0,7,7,13
16672,Nepal,2012,2012Nepal,0,0,0,0,0,16,16,0,0,0,0,0,61,61,77
16673,Nepal,2012,2012Nepal,0,0,0,5,0,0,5,0,0,0,10,0,0,10,15
16674,Nepal,2012,2012Nepal,0,0,0,8,0,0,8,0,0,0,30,0,0,30,1128
16675,Nepal,2012,2012Nepal,0,11,11,91,0,0,113,5,11,9,205,6,0,236,349
16676,Nepal,2013,2013Nepal,0,0,0,0,0,0,0,0,0,0,0,0,0,0,6672
16677,Nepal,2013,2013Nepal,0,0,0,0,0,0,0,0,0,0,0,0,9,9,9
16678,Nepal,2013,2013Nepal,0,0,0,0,0,0,0,0,0,0,5,0,0,5,25
16679,Nepal,2013,2013Nepal,0,0,0,0,0,5,5,0,0,0,0,0,7,7,12
16680,Nepal,2013,2013Nepal,0,0,0,0,0,23,23,0,0,0,0,0,77,77,100
16681,Nepal,2013,2013Nepal,0,0,0,5,0,0,5,0,0,0,8,0,0,8,13
16682,Nepal,2013,2013Nepal,0,5,0,6,0,0,11,0,0,8,36,0,0,44,55
16683,Nepal,2013,2013Nepal,0,5,5,34,0,0,44,0,7,6,21,0,0,34,1212
16684,Nepal,2014,2014Nepal,0,0,0,0,0,0,0,0,0,0,0,0,0,0,7122
16685,Nepal,2014,2014Nepal,0,0,0,0,0,0,0,0,0,0,5,0,0,5,10
16686,Nepal,2014,2014Nepal,0,0,0,0,0,26,26,0,0,0,0,0,82,82,108
16687,Nepal,2014,2014Nepal,0,0,0,5,0,0,5,0,0,0,7,0,0,7,12
16688,Nepal,2014,2014Nepal,0,0,0,6,0,0,6,0,0,0,5,0,5,10,16
16689,Nepal,2014,2014Nepal,0,0,0,11,0,0,11,0,0,0,18,0,0,18,1223
16690,Nepal,2014,2014Nepal,0,5,0,6,0,0,11,0,0,6,34,0,0,40,51
16691,Nepal,2015,2015Nepal,0,0,0,0,0,0,0,0,0,0,0,0,0,0,8820
16692,Nepal,2015,2015Nepal,0,0,0,0,0,0,0,0,0,0,5,0,0,5,25
16693,Nepal,2015,2015Nepal,0,0,0,0,0,5,5,0,0,0,0,0,8,8,13
16694,Nepal,2015,2015Nepal,0,0,0,0,0,31,31,0,0,0,0,0,88,88,119
16695,Nepal,2015,2015Nepal,0,0,0,5,0,0,5,0,0,0,6,0,0,6,11
16696,Nepal,2015,2015Nepal,0,0,0,5,0,0,5,0,0,0,13,0,0,13,18
16697,Nepal,2015,2015Nepal,0,0,0,6,0,0,6,0,0,5,34,0,0,39,45
16698,Nepal,2016,2016Nepal,0,0,0,0,0,0,0,0,0,0,0,0,0,0,7562
16699,Nepal,2016,2016Nepal,0,0,0,0,0,0,0,0,0,0,5,0,0,5,20
16700,Nepal,2016,2016Nepal,0,0,0,0,0,5,5,0,0,0,0,0,8,8,13
16701,Nepal,2016,2016Nepal,0,0,0,0,0,38,38,0,0,0,0,0,90,90,128
16702,Nepal,2016,2016Nepal,0,0,0,5,0,0,5,0,0,0,7,0,0,7,12
16703,Nepal,2016,2016Nepal,0,0,0,5,0,0,5,0,0,8,0,0,8,16,21
16704,Nepal,2016,2016Nepal,0,0,0,6,0,0,6,0,0,0,36,0,0,36,42
16705,Nepal,2016,2016Nepal,0,0,7,14,12,0,33,0,0,9,64,0,0,73,566
16706,Nepal,2017,2017Nepal,0,0,0,0,0,0,0,0,0,0,0,0,0,0,8186
16707,Nepal,2017,2017Nepal,0,0,0,0,0,0,0,0,0,0,5,0,0,5,20
16708,Nepal,2017,2017Nepal,0,0,0,0,0,42,42,0,0,0,0,0,87,87,129
16709,Nepal,2017,2017Nepal,0,0,0,5,0,0,5,0,0,0,6,0,0,6,11
16710,Nepal,2017,2017Nepal,0,0,0,5,0,9,14,0,0,5,0,0,0,5,19
16711,Nepal,2017,2017Nepal,0,0,0,12,0,0,12,0,0,0,38,0,0,38,50
16712,Nepal,2018,2018Nepal,0,0,0,0,0,0,0,0,0,0,0,0,0,0,7733
16713,Nepal,2018,2018Nepal,0,0,0,0,0,0,0,0,0,0,5,0,0,5,5
16714,Nepal,2018,2018Nepal,0,0,0,0,0,0,0,0,0,0,10,0,0,10,10
16715,Nepal,2018,2018Nepal,0,0,0,0,0,5,5,0,0,0,9,0,5,14,19
16716,Nepal,2018,2018Nepal,0,0,0,0,0,49,49,0,0,0,0,0,92,92,141
16717,Nepal,2018,2018Nepal,0,0,0,5,0,0,5,0,0,0,0,0,0,0,5
16718,Nepal,2018,2018Nepal,0,0,0,5,0,0,5,0,0,0,5,0,0,5,10
16719,Nepal,2018,2018Nepal,0,0,0,17,0,0,17,0,0,5,34,0,0,39,56
16720,Nepal,2018,2018Nepal,5,9,5,44,0,0,63,7,0,10,50,0,0,67,611
16721,Nepal,2019,2019Nepal,0,0,0,0,0,0,0,0,0,0,0,0,0,0,7780
16722,Nepal,2019,2019Nepal,0,0,0,0,0,0,0,0,0,0,6,0,0,6,6
16723,Nepal,2019,2019Nepal,0,0,0,0,0,0,0,0,0,0,11,0,0,11,11
16724,Nepal,2019,2019Nepal,0,0,0,0,0,59,59,0,0,0,0,0,91,91,150
16725,Nepal,2019,2019Nepal,0,0,0,5,0,0,5,0,0,0,5,0,0,5,20
16726,Nepal,2019,2019Nepal,0,0,0,6,0,0,6,0,0,0,0,0,0,0,6
16727,Nepal,2019,2019Nepal,0,0,5,18,0,0,23,0,5,0,33,0,0,38,61
16728,Nepal,2020,2020Nepal,0,0,0,0,0,0,0,0,0,0,0,0,0,0,7312
16729,Nepal,2020,2020Nepal,0,0,0,0,0,0,0,0,0,0,0,0,5,5,5
16730,Nepal,2020,2020Nepal,0,0,0,0,0,0,0,0,0,0,5,0,0,5,10
16731,Nepal,2020,2020Nepal,0,0,0,0,0,0,0,0,0,0,11,0,0,11,11
16732,Nepal,2020,2020Nepal,0,0,0,0,0,0,0,0,6,0,0,0,0,6,6
16733,Nepal,2020,2020Nepal,0,0,0,0,0,5,5,0,0,0,0,0,6,6,11
16734,Nepal,2020,2020Nepal,0,0,0,0,0,6,6,0,0,0,0,0,0,0,6
16735,Nepal,2020,2020Nepal,0,0,0,0,0,10,10,0,0,0,15,0,0,15,25
16736,Nepal,2020,2020Nepal,0,0,0,6,0,0,6,0,0,0,5,0,0,5,11
16737,Nepal,2020,2020Nepal,0,0,0,9,0,0,9,0,0,0,0,0,0,0,26
16738,Nepal,2020,2020Nepal,6,0,0,18,0,0,24,0,0,5,31,0,0,36,60
16739,Nepal,2021,2021Nepal,0,0,0,0,0,0,0,0,0,0,0,0,0,0,6902
16740,Nepal,2021,2021Nepal,0,0,0,0,0,0,0,0,0,0,5,0,0,5,10
16741,Nepal,2021,2021Nepal,0,0,0,0,0,0,0,0,0,0,11,0,0,11,11
16742,Nepal,2021,2021Nepal,0,0,0,0,0,0,0,0,0,8,0,0,0,8,8
16743,Nepal,2021,2021Nepal,0,0,0,5,0,0,5,0,5,0,0,0,0,5,10
16744,Nepal,2021,2021Nepal,0,0,0,9,0,0,9,0,0,0,0,0,0,0,9
16745,Nepal,2021,2021Nepal,0,0,0,10,0,0,10,0,0,0,0,0,0,0,18
16746,Nepal,2021,2021Nepal,5,0,0,19,0,0,24,0,5,0,32,0,0,37,61
16747,Nicaragua,2001,2001Nicaragua,0,0,0,0,0,0,0,0,0,0,0,0,0,0,3453
16748,Nicaragua,2001,2001Nicaragua,0,0,0,0,0,49,49,0,0,0,0,0,51,51,100
16749,Nicaragua,2001,2001Nicaragua,0,0,0,5,0,0,5,0,0,0,0,0,0,0,5
16750,Nicaragua,2001,2001Nicaragua,0,0,0,11,0,0,11,0,0,0,16,0,0,16,27
16751,Nicaragua,2001,2001Nicaragua,0,5,0,24,5,0,34,5,0,5,35,0,0,45,79
16752,Nicaragua,2001,2001Nicaragua,0,8,7,59,5,0,79,0,10,9,67,9,0,95,174
16753,Nicaragua,2001,2001Nicaragua,6,27,24,194,14,0,265,0,24,22,175,17,0,238,503
16754,Nicaragua,2001,2001Nicaragua,8,5,0,13,0,0,26,6,0,5,14,5,0,30,56
16755,Nicaragua,2002,2002Nicaragua,0,0,0,0,0,0,0,0,0,0,0,0,0,0,489
16756,Nicaragua,2002,2002Nicaragua,0,0,0,5,0,0,5,0,0,0,0,0,0,0,5
16757,Nicaragua,2002,2002Nicaragua,0,0,0,10,0,0,10,0,0,0,10,0,0,10,20
16758,Nicaragua,2002,2002Nicaragua,0,0,0,242,25,0,267,0,0,0,209,25,0,234,501
16759,Nicaragua,2002,2002Nicaragua,0,0,15,22,0,0,37,0,10,5,21,0,0,36,95
16760,Nicaragua,2002,2002Nicaragua,0,5,0,24,5,0,34,5,0,5,34,0,0,44,78
16761,Nicaragua,2002,2002Nicaragua,0,6,5,65,5,0,81,0,9,0,71,9,0,89,170
16762,Nicaragua,2002,2002Nicaragua,0,8,6,162,6,0,182,0,8,6,274,5,0,293,2635
16763,Nicaragua,2002,2002Nicaragua,8,5,0,13,0,0,26,6,0,5,14,5,0,30,56
16764,Nicaragua,2003,2003Nicaragua,0,0,0,0,0,0,0,0,0,0,0,0,0,0,2931
16765,Nicaragua,2003,2003Nicaragua,0,0,0,0,0,107,107,0,0,0,0,0,123,123,230
16766,Nicaragua,2003,2003Nicaragua,0,0,0,5,0,0,5,0,0,0,0,0,0,0,5
16767,Nicaragua,2003,2003Nicaragua,0,0,0,7,0,0,7,0,0,0,12,0,0,12,19
16768,Nicaragua,2003,2003Nicaragua,0,0,0,230,25,0,255,0,0,0,201,25,0,226,481
16769,Nicaragua,2003,2003Nicaragua,0,5,0,24,5,0,34,5,0,5,34,0,0,44,78
16770,Nicaragua,2003,2003Nicaragua,0,6,5,64,0,0,75,0,9,0,73,8,0,90,170
16771,Nicaragua,2003,2003Nicaragua,5,9,8,10,0,0,32,5,11,10,7,5,0,38,70
16772,Nicaragua,2004,2004Nicaragua,0,0,0,0,0,0,0,0,0,0,0,0,0,0,826
16773,Nicaragua,2004,2004Nicaragua,0,0,0,5,0,0,5,0,0,0,0,0,0,0,5
16774,Nicaragua,2004,2004Nicaragua,0,0,0,6,0,0,6,0,0,0,0,0,0,0,6
16775,Nicaragua,2004,2004Nicaragua,0,0,0,7,0,0,7,0,0,0,9,0,0,9,170
16776,Nicaragua,2004,2004Nicaragua,0,0,0,9,0,0,9,0,0,0,10,0,0,10,19
16777,Nicaragua,2004,2004Nicaragua,0,0,0,107,0,0,107,0,0,0,122,0,0,122,229
16778,Nicaragua,2004,2004Nicaragua,0,0,0,222,25,0,247,0,0,0,197,24,0,221,468
16779,Nicaragua,2004,2004Nicaragua,0,0,5,5,0,0,10,0,0,0,5,16,0,21,31
16780,Nicaragua,2004,2004Nicaragua,5,8,8,9,0,0,30,5,11,10,7,5,0,38,68
16781,Nicaragua,2005,2005Nicaragua,0,0,0,0,0,0,0,0,0,0,0,0,0,0,821
16782,Nicaragua,2005,2005Nicaragua,0,0,0,0,0,0,0,0,0,0,6,0,0,6,6
16783,Nicaragua,2005,2005Nicaragua,0,0,0,5,0,0,5,0,0,0,0,0,0,0,5
16784,Nicaragua,2005,2005Nicaragua,0,0,0,9,0,0,9,0,0,0,10,0,0,10,19
16785,Nicaragua,2005,2005Nicaragua,0,0,0,15,0,0,15,0,0,0,24,7,0,31,46
16786,Nicaragua,2005,2005Nicaragua,0,0,0,51,18,0,69,0,0,0,94,7,0,101,170
16787,Nicaragua,2005,2005Nicaragua,0,0,0,162,20,0,182,0,0,0,104,17,0,121,303
16788,Nicaragua,2005,2005Nicaragua,0,0,5,11,0,0,16,0,0,7,6,0,0,13,29
16789,Nicaragua,2005,2005Nicaragua,0,9,7,7,5,0,28,0,12,11,8,5,0,36,64
16790,Nicaragua,2006,2006Nicaragua,0,0,0,0,0,0,0,0,0,0,0,0,0,0,1234
16791,Nicaragua,2006,2006Nicaragua,0,0,0,0,0,0,0,0,0,0,6,0,0,6,6
16792,Nicaragua,2006,2006Nicaragua,0,0,0,5,0,0,5,0,0,0,0,0,0,0,5
16793,Nicaragua,2006,2006Nicaragua,0,0,0,9,0,0,9,0,0,0,10,0,0,10,19
16794,Nicaragua,2006,2006Nicaragua,0,0,0,9,0,0,9,0,0,0,20,5,0,25,34
16795,Nicaragua,2006,2006Nicaragua,0,0,0,51,18,0,69,0,0,0,94,7,0,101,170
16796,Nicaragua,2006,2006Nicaragua,0,0,0,153,20,0,173,0,0,0,105,17,0,122,295
16797,Nicaragua,2006,2006Nicaragua,0,0,5,7,5,0,17,0,0,11,11,5,0,27,44
16798,Nicaragua,2006,2006Nicaragua,0,0,9,5,0,0,14,0,0,0,6,0,0,6,20
16799,Nicaragua,2007,2007Nicaragua,0,0,0,0,0,0,0,0,0,0,0,0,0,0,711
16800,Nicaragua,2007,2007Nicaragua,0,0,0,0,0,0,0,0,0,0,6,0,0,6,6
16801,Nicaragua,2007,2007Nicaragua,0,0,0,5,0,0,5,0,0,0,0,0,0,0,5
16802,Nicaragua,2007,2007Nicaragua,0,0,0,5,0,0,5,0,0,0,5,0,0,5,10
16803,Nicaragua,2007,2007Nicaragua,0,0,0,7,5,0,12,0,0,5,9,0,0,14,26
16804,Nicaragua,2007,2007Nicaragua,0,0,0,9,0,0,9,0,0,0,20,5,0,25,34
16805,Nicaragua,2007,2007Nicaragua,0,0,0,51,18,0,69,0,0,0,94,7,0,101,170
16806,Nicaragua,2007,2007Nicaragua,0,0,0,153,20,0,173,0,0,0,104,17,0,121,294
16807,Nicaragua,2007,2007Nicaragua,0,0,13,5,0,0,18,0,0,0,6,0,0,6,24
16808,Nicaragua,2007,2007Nicaragua,12,27,27,191,6,0,263,17,36,36,250,17,0,356,619
16809,Nicaragua,2008,2008Nicaragua,0,0,0,0,0,0,0,0,0,0,0,0,0,0,558
16810,Nicaragua,2008,2008Nicaragua,0,0,0,5,0,0,5,0,0,0,0,0,0,0,5
16811,Nicaragua,2008,2008Nicaragua,0,0,0,5,0,0,5,0,0,0,6,0,0,6,11
16812,Nicaragua,2008,2008Nicaragua,0,0,0,5,0,0,5,0,0,0,8,0,0,8,13
16813,Nicaragua,2008,2008Nicaragua,0,0,0,7,0,0,7,0,0,0,22,0,0,22,29
16814,Nicaragua,2008,2008Nicaragua,0,0,0,45,7,0,52,0,0,0,46,6,0,52,104
16815,Nicaragua,2008,2008Nicaragua,0,0,0,51,18,0,69,0,0,0,94,7,0,101,170
16816,Nicaragua,2008,2008Nicaragua,0,0,13,5,0,0,18,0,0,0,6,0,0,6,24
16817,Nicaragua,2008,2008Nicaragua,12,27,27,191,6,0,263,17,36,36,250,17,0,356,619
16818,Nicaragua,2009,2009Nicaragua,0,0,0,0,0,0,0,0,0,0,0,0,0,0,499
16819,Nicaragua,2009,2009Nicaragua,0,0,0,0,0,0,0,0,0,0,5,0,0,5,5
16820,Nicaragua,2009,2009Nicaragua,0,0,0,0,0,0,0,0,0,7,0,0,0,7,7
16821,Nicaragua,2009,2009Nicaragua,0,0,0,5,0,0,5,0,0,0,0,0,0,0,5
16822,Nicaragua,2009,2009Nicaragua,0,0,0,6,0,0,6,0,0,0,6,0,0,6,12
16823,Nicaragua,2009,2009Nicaragua,0,0,0,6,0,0,6,0,0,0,21,0,0,21,27
16824,Nicaragua,2009,2009Nicaragua,0,0,0,45,7,0,52,0,0,0,46,6,0,52,104
16825,Nicaragua,2009,2009Nicaragua,0,0,0,51,18,0,69,0,0,0,94,7,0,101,170
16826,Nicaragua,2009,2009Nicaragua,0,0,13,5,0,0,18,0,0,0,6,0,0,6,24
16827,Nicaragua,2009,2009Nicaragua,12,27,27,191,6,0,263,17,36,36,251,17,0,357,620
16828,Nicaragua,2010,2010Nicaragua,0,0,0,0,0,0,0,0,0,0,0,0,0,0,479
16829,Nicaragua,2010,2010Nicaragua,0,0,0,0,0,0,0,0,0,5,0,0,0,5,5
16830,Nicaragua,2010,2010Nicaragua,0,0,0,5,0,0,5,0,0,0,0,0,0,0,5
16831,Nicaragua,2010,2010Nicaragua,0,0,0,5,0,0,5,0,0,0,8,0,0,8,13
16832,Nicaragua,2010,2010Nicaragua,0,0,0,6,0,0,6,0,0,0,21,0,0,21,27
16833,Nicaragua,2010,2010Nicaragua,0,0,0,45,7,0,52,0,0,0,46,6,0,52,104
16834,Nicaragua,2010,2010Nicaragua,0,0,0,52,18,0,70,0,0,0,95,7,0,102,172
16835,Nicaragua,2010,2010Nicaragua,0,0,13,5,0,0,18,0,0,0,6,0,0,6,24
16836,Nicaragua,2010,2010Nicaragua,12,27,27,186,6,0,258,17,36,36,243,7,0,339,597
16837,Nicaragua,2011,2011Nicaragua,0,0,0,0,0,0,0,0,0,0,0,0,0,0,395
16838,Nicaragua,2011,2011Nicaragua,0,0,0,5,0,0,5,0,0,0,0,0,0,0,5
16839,Nicaragua,2011,2011Nicaragua,0,0,0,5,0,0,5,0,0,0,9,0,0,9,14
16840,Nicaragua,2011,2011Nicaragua,0,0,0,7,0,0,7,0,0,0,0,0,0,0,7
16841,Nicaragua,2011,2011Nicaragua,0,0,0,7,0,0,7,0,0,0,14,5,0,19,26
16842,Nicaragua,2011,2011Nicaragua,0,0,0,10,0,0,10,0,0,0,14,0,0,14,119
16843,Nicaragua,2011,2011Nicaragua,0,0,0,45,7,0,52,0,0,0,46,6,0,52,104
16844,Nicaragua,2011,2011Nicaragua,0,0,0,52,18,0,70,0,0,0,95,7,0,102,172
16845,Nicaragua,2011,2011Nicaragua,0,0,13,5,0,0,18,0,0,0,6,0,0,6,24
16846,Nicaragua,2011,2011Nicaragua,12,27,27,186,6,0,258,17,36,36,244,7,0,340,598
16847,Nicaragua,2012,2012Nicaragua,0,0,0,0,0,0,0,0,0,0,0,0,0,0,439
16848,Nicaragua,2012,2012Nicaragua,0,0,0,0,0,0,0,0,0,5,0,0,0,5,5
16849,Nicaragua,2012,2012Nicaragua,0,0,0,5,0,0,5,0,0,0,0,0,0,0,5
16850,Nicaragua,2012,2012Nicaragua,0,0,0,6,0,0,6,0,0,0,8,0,0,8,14
16851,Nicaragua,2012,2012Nicaragua,0,0,0,7,0,0,7,0,0,0,13,5,0,18,25
16852,Nicaragua,2012,2012Nicaragua,0,0,0,45,7,0,52,0,0,0,46,6,0,52,104
16853,Nicaragua,2012,2012Nicaragua,0,0,0,53,18,0,71,0,0,0,95,7,0,102,173
16854,Nicaragua,2012,2012Nicaragua,0,0,5,5,0,0,10,0,0,0,5,0,0,5,138
16855,Nicaragua,2012,2012Nicaragua,0,0,5,8,0,0,13,0,0,5,6,0,0,11,24
16856,Nicaragua,2012,2012Nicaragua,12,27,27,187,6,0,259,17,36,36,244,7,0,340,599
16857,Nicaragua,2013,2013Nicaragua,0,0,0,0,0,0,0,0,0,0,0,0,0,0,452
16858,Nicaragua,2013,2013Nicaragua,0,0,0,5,0,0,5,0,0,0,0,0,0,0,5
16859,Nicaragua,2013,2013Nicaragua,0,0,0,5,0,0,5,0,0,0,9,0,0,9,14
16860,Nicaragua,2013,2013Nicaragua,0,0,0,7,0,0,7,0,0,0,13,5,0,18,25
16861,Nicaragua,2013,2013Nicaragua,0,0,0,8,0,0,8,0,6,0,5,0,0,11,132
16862,Nicaragua,2013,2013Nicaragua,0,0,0,45,7,0,52,0,0,0,46,6,0,52,104
16863,Nicaragua,2013,2013Nicaragua,0,0,0,53,18,0,71,0,0,0,95,7,0,102,173
16864,Nicaragua,2013,2013Nicaragua,0,0,5,8,0,0,13,0,0,5,6,0,0,11,24
16865,Nicaragua,2013,2013Nicaragua,12,27,27,188,6,0,260,17,36,37,244,7,0,341,601
16866,Nicaragua,2014,2014Nicaragua,0,0,0,0,0,0,0,0,0,0,0,0,0,0,1217
16867,Nicaragua,2014,2014Nicaragua,0,0,0,0,0,0,0,0,0,0,7,0,0,7,141
16868,Nicaragua,2014,2014Nicaragua,0,0,0,0,0,0,0,0,0,0,9,0,0,9,9
16869,Nicaragua,2014,2014Nicaragua,0,0,0,5,0,0,5,0,0,0,0,0,0,0,5
16870,Nicaragua,2014,2014Nicaragua,0,0,0,5,0,0,5,0,0,0,9,0,0,9,14
16871,Nicaragua,2014,2014Nicaragua,0,0,0,7,0,0,7,0,0,0,0,0,0,0,7
16872,Nicaragua,2014,2014Nicaragua,0,0,0,7,0,0,7,0,0,0,7,0,0,7,14
16873,Nicaragua,2014,2014Nicaragua,0,0,0,53,18,0,71,0,0,0,95,7,0,102,173
16874,Nicaragua,2015,2015Nicaragua,0,0,0,0,0,0,0,0,0,0,0,0,0,0,1158
16875,Nicaragua,2015,2015Nicaragua,0,0,0,0,0,0,0,0,0,0,9,0,0,9,9
16876,Nicaragua,2015,2015Nicaragua,0,0,0,5,0,0,5,0,0,0,0,0,0,0,5
16877,Nicaragua,2015,2015Nicaragua,0,0,0,6,0,0,6,0,0,0,5,0,0,5,11
16878,Nicaragua,2015,2015Nicaragua,0,0,0,7,0,0,7,0,0,0,7,0,0,7,14
16879,Nicaragua,2015,2015Nicaragua,0,0,0,44,6,0,50,0,0,0,44,5,0,49,99
16880,Nicaragua,2015,2015Nicaragua,0,0,0,53,18,0,71,0,0,0,95,7,0,102,173
16881,Nicaragua,2016,2016Nicaragua,0,0,0,0,0,0,0,0,0,0,0,0,0,0,650
16882,Nicaragua,2016,2016Nicaragua,0,0,0,0,0,183,183,0,0,0,0,0,275,275,458
16883,Nicaragua,2016,2016Nicaragua,0,0,0,7,0,0,7,0,0,0,7,0,0,7,14
16884,Nicaragua,2016,2016Nicaragua,0,0,0,8,0,0,8,0,0,0,0,0,0,0,8
16885,Nicaragua,2016,2016Nicaragua,0,0,0,44,6,0,50,0,0,0,45,5,0,50,100
16886,Nicaragua,2016,2016Nicaragua,0,0,0,53,18,0,71,0,0,0,95,7,0,102,173
16887,Nicaragua,2016,2016Nicaragua,0,0,6,0,0,0,6,0,0,0,0,0,0,0,6
16888,Nicaragua,2017,2017Nicaragua,0,0,0,0,0,0,0,0,0,0,0,0,0,0,707
16889,Nicaragua,2017,2017Nicaragua,0,0,0,0,0,50,50,0,0,0,0,0,50,50,100
16890,Nicaragua,2017,2017Nicaragua,0,0,0,0,0,184,184,0,0,0,0,0,277,277,461
16891,Nicaragua,2017,2017Nicaragua,0,0,0,0,6,0,6,0,0,0,0,0,0,0,6
16892,Nicaragua,2017,2017Nicaragua,0,0,0,7,0,0,7,0,0,0,7,0,0,7,14
16893,Nicaragua,2017,2017Nicaragua,0,0,0,53,18,0,71,0,0,0,95,7,0,102,173
16894,Nicaragua,2017,2017Nicaragua,0,0,6,0,0,0,6,0,0,0,0,0,0,0,6
16895,Nicaragua,2018,2018Nicaragua,0,0,0,0,0,0,0,0,0,0,0,0,0,0,1554
16896,Nicaragua,2018,2018Nicaragua,0,0,0,0,0,0,0,0,0,0,0,0,8,8,8
16897,Nicaragua,2018,2018Nicaragua,0,0,0,0,0,0,0,0,0,0,6,0,0,6,83
16898,Nicaragua,2018,2018Nicaragua,0,0,0,0,0,0,0,0,0,0,7,0,0,7,7
16899,Nicaragua,2018,2018Nicaragua,0,0,0,5,0,0,5,0,0,0,0,0,0,0,5
16900,Nicaragua,2018,2018Nicaragua,0,0,0,7,0,0,7,0,0,0,7,0,0,7,14
16901,Nicaragua,2019,2019Nicaragua,0,0,0,0,0,0,0,0,0,0,0,0,0,0,4303
16902,Nicaragua,2019,2019Nicaragua,0,0,0,0,0,0,0,0,0,0,0,0,14,14,14
16903,Nicaragua,2019,2019Nicaragua,0,0,0,0,0,0,0,0,0,0,9,0,0,9,9
16904,Nicaragua,2019,2019Nicaragua,0,0,0,0,0,17,17,0,0,0,0,0,14,14,31
16905,Nicaragua,2019,2019Nicaragua,0,0,0,5,0,0,5,0,0,0,0,0,0,0,5
16906,Nicaragua,2019,2019Nicaragua,0,0,0,6,0,0,6,0,0,0,0,0,0,0,6
16907,Nicaragua,2019,2019Nicaragua,0,0,0,8,0,0,8,0,0,0,0,0,0,0,8
16908,Nicaragua,2020,2020Nicaragua,0,0,0,0,0,0,0,0,0,0,0,0,0,0,8290
16909,Nicaragua,2020,2020Nicaragua,0,0,0,0,0,0,0,0,0,0,9,0,0,9,27
16910,Nicaragua,2020,2020Nicaragua,0,0,0,0,0,9,9,0,0,0,0,0,7,7,16
16911,Nicaragua,2020,2020Nicaragua,0,0,0,0,9,0,9,0,0,0,0,0,0,0,9
16912,Nicaragua,2020,2020Nicaragua,0,0,0,5,0,0,5,0,0,0,0,0,0,0,5
16913,Nicaragua,2020,2020Nicaragua,0,0,0,6,0,0,6,0,0,0,5,0,0,5,11
16914,Nicaragua,2020,2020Nicaragua,0,0,0,37,0,38,75,0,0,0,39,0,40,79,338
16915,Nicaragua,2020,2020Nicaragua,0,0,5,0,0,0,5,0,0,0,0,0,0,0,5
16916,Nicaragua,2021,2021Nicaragua,0,0,0,0,0,0,0,0,0,0,0,0,0,0,4563
16917,Nicaragua,2021,2021Nicaragua,0,0,0,0,0,0,0,0,0,0,9,0,0,9,9
16918,Nicaragua,2021,2021Nicaragua,0,0,0,0,0,0,0,5,0,0,6,0,0,11,11
16919,Nicaragua,2021,2021Nicaragua,0,0,0,0,0,5,5,0,0,0,0,5,0,5,10
16920,Nicaragua,2021,2021Nicaragua,0,0,0,5,0,0,5,0,0,0,0,0,0,0,10
16921,Nicaragua,2021,2021Nicaragua,0,0,0,8,0,0,8,0,0,0,14,0,0,14,22
16922,Nicaragua,2021,2021Nicaragua,0,0,0,9,0,0,9,0,0,0,7,0,0,7,16
16923,Nicaragua,2021,2021Nicaragua,0,8,0,23,5,0,36,0,0,0,29,5,0,34,70
16924,Nicaragua,2021,2021Nicaragua,13,19,16,159,0,38,245,21,21,7,176,0,40,265,684
16925,Nicaragua,2021,2021Nicaragua,15,75,64,1841,265,0,2260,9,55,75,1429,199,0,1767,4027
16926,Nicaragua,2021,2021Nicaragua,48,74,36,436,5,0,599,53,82,52,823,10,0,1020,1619
16927,Niger,2001,2001Niger,0,0,0,0,0,0,0,0,0,0,0,0,0,0,468
16928,Niger,2001,2001Niger,0,0,0,0,0,0,0,0,0,0,0,0,10,10,10
16929,Niger,2002,2002Niger,0,0,0,0,0,0,0,0,0,0,0,0,0,0,820
16930,Niger,2002,2002Niger,0,0,0,0,0,0,0,0,0,0,0,0,9,9,9
16931,Niger,2003,2003Niger,0,0,0,0,0,0,0,0,0,0,0,0,0,0,708
16932,Niger,2003,2003Niger,0,0,0,0,0,0,0,0,0,0,0,0,8,8,8
16933,Niger,2004,2004Niger,0,0,0,0,0,0,0,0,0,0,0,0,0,0,676
16934,Niger,2005,2005Niger,0,0,0,0,0,0,0,0,0,0,0,0,0,0,609
16935,Niger,2005,2005Niger,0,0,0,0,0,11,11,0,0,0,0,0,17,17,28
16936,Niger,2005,2005Niger,0,5,0,0,0,0,5,0,0,0,0,0,0,0,5
16937,Niger,2006,2006Niger,0,0,0,0,0,0,0,0,0,0,0,0,0,0,753
16938,Niger,2006,2006Niger,0,0,0,0,0,0,0,0,0,0,0,0,7,7,7
16939,Niger,2006,2006Niger,0,0,0,0,0,5,5,0,0,0,0,0,7,7,12
16940,Niger,2006,2006Niger,0,0,0,0,0,12,12,0,0,0,0,0,19,19,31
16941,Niger,2007,2007Niger,0,0,0,0,0,0,0,0,0,0,0,0,0,0,762
16942,Niger,2007,2007Niger,0,0,0,0,0,0,0,8,0,0,0,0,0,8,8
16943,Niger,2007,2007Niger,0,0,0,0,0,6,6,0,0,0,0,0,6,6,12
16944,Niger,2007,2007Niger,0,0,0,0,0,13,13,0,0,0,0,0,22,22,35
16945,Niger,2008,2008Niger,0,0,0,0,0,0,0,0,0,0,0,0,0,0,712
16946,Niger,2008,2008Niger,0,0,0,0,0,0,0,0,0,0,5,0,0,5,5
16947,Niger,2008,2008Niger,0,0,0,0,0,10,10,0,0,0,0,0,12,12,22
16948,Niger,2008,2008Niger,0,0,0,0,0,15,15,0,0,0,0,0,22,22,37
16949,Niger,2008,2008Niger,0,5,0,0,0,0,5,8,0,0,0,0,0,8,13
16950,Niger,2009,2009Niger,0,0,0,0,0,0,0,0,0,0,0,0,0,0,574
16951,Niger,2009,2009Niger,0,0,0,0,0,0,0,0,0,0,5,0,0,5,5
16952,Niger,2009,2009Niger,0,0,0,0,0,17,17,0,0,0,0,0,8,8,31
16953,Niger,2009,2009Niger,0,5,0,0,0,0,5,5,0,0,0,0,0,5,10
16954,Niger,2009,2009Niger,6,9,5,27,0,0,47,5,6,7,127,0,0,145,192
16955,Niger,2010,2010Niger,0,0,0,0,0,0,0,0,0,0,0,0,0,0,504
16956,Niger,2010,2010Niger,0,0,0,0,0,0,0,0,0,0,5,0,0,5,5
16957,Niger,2010,2010Niger,0,0,0,0,0,5,5,0,0,0,0,0,10,10,15
16958,Niger,2010,2010Niger,0,0,0,0,0,14,14,0,0,0,0,0,31,31,45
16959,Niger,2010,2010Niger,0,0,0,5,0,0,5,0,0,0,0,0,0,0,5
16960,Niger,2010,2010Niger,0,5,0,0,0,0,5,0,0,5,0,0,0,5,10
16961,Niger,2010,2010Niger,6,11,8,27,0,0,52,5,5,6,142,0,0,158,210
16962,Niger,2011,2011Niger,0,0,0,0,0,0,0,0,0,0,0,0,0,0,419
16963,Niger,2011,2011Niger,0,0,0,0,0,0,0,0,0,0,5,0,0,5,5
16964,Niger,2011,2011Niger,0,0,0,0,0,15,15,0,0,0,0,0,33,33,48
16965,Niger,2011,2011Niger,0,0,0,0,0,28,28,0,0,0,0,0,26,26,54
16966,Niger,2011,2011Niger,0,0,0,14,0,0,14,0,0,5,6,0,0,11,71
16967,Niger,2011,2011Niger,0,5,0,0,0,0,5,0,0,5,0,0,0,5,10
16968,Niger,2011,2011Niger,5,12,5,28,0,0,50,0,8,5,135,0,0,148,198
16969,Niger,2012,2012Niger,0,0,0,0,0,0,0,0,0,0,0,0,0,0,428
16970,Niger,2012,2012Niger,0,0,0,0,0,0,0,0,0,0,5,0,0,5,5
16971,Niger,2012,2012Niger,0,0,0,0,0,5,5,0,0,0,0,0,5,5,10
16972,Niger,2012,2012Niger,0,0,0,0,0,16,16,0,0,0,0,0,34,34,50
16973,Niger,2012,2012Niger,0,0,0,0,0,26,26,0,0,0,0,0,24,24,50
16974,Niger,2012,2012Niger,0,0,0,6,0,0,6,0,0,0,7,0,0,7,69
16975,Niger,2012,2012Niger,5,12,6,29,0,0,52,0,8,5,147,0,0,160,212
16976,Niger,2013,2013Niger,0,0,0,0,0,0,0,0,0,0,0,0,0,0,440
16977,Niger,2013,2013Niger,0,0,0,0,0,0,0,0,0,0,5,0,0,5,5
16978,Niger,2013,2013Niger,0,0,0,0,0,0,0,0,0,5,0,0,0,5,5
16979,Niger,2013,2013Niger,0,0,0,0,0,17,17,0,0,0,0,0,35,35,52
16980,Niger,2013,2013Niger,0,0,0,0,0,21,21,0,0,0,0,0,19,19,45
16981,Niger,2013,2013Niger,0,0,0,8,0,0,8,0,0,0,28,0,0,28,36
16982,Niger,2013,2013Niger,0,0,5,0,0,0,5,0,5,0,0,0,0,5,10
16983,Niger,2013,2013Niger,0,5,0,5,0,0,10,0,0,0,0,0,0,0,81
16984,Niger,2014,2014Niger,0,0,0,0,0,0,0,0,0,0,0,0,0,0,527
16985,Niger,2014,2014Niger,0,0,0,0,0,0,0,0,0,0,0,0,5,5,5
16986,Niger,2014,2014Niger,0,0,0,0,0,0,0,0,0,0,5,0,0,5,5
16987,Niger,2014,2014Niger,0,0,0,0,0,0,0,0,0,5,0,0,0,5,5
16988,Niger,2014,2014Niger,0,0,0,0,0,17,17,0,0,0,0,0,34,34,51
16989,Niger,2014,2014Niger,0,0,5,0,0,0,5,0,5,0,0,0,0,5,10
16990,Niger,2014,2014Niger,0,0,5,7,0,0,12,0,0,0,29,0,0,29,41
16991,Niger,2014,2014Niger,0,5,0,0,0,0,5,0,0,0,5,0,0,5,84
16992,Niger,2015,2015Niger,0,0,0,0,0,0,0,0,0,0,0,0,0,0,772
16993,Niger,2015,2015Niger,0,0,0,0,0,0,0,0,0,0,5,0,0,5,10
16994,Niger,2015,2015Niger,0,0,0,0,0,0,0,0,0,5,0,0,0,5,5
16995,Niger,2015,2015Niger,0,0,0,0,0,10,10,0,0,0,0,0,0,0,10
16996,Niger,2015,2015Niger,0,0,0,0,0,18,18,0,0,0,0,0,34,34,52
16997,Niger,2015,2015Niger,0,0,0,0,0,33,33,0,0,0,0,0,50,50,83
16998,Niger,2015,2015Niger,0,0,0,5,0,0,5,0,0,0,0,0,0,0,5
16999,Niger,2015,2015Niger,0,0,6,7,0,0,13,0,5,0,27,0,0,32,45
17000,Niger,2015,2015Niger,30,45,34,86,19,0,214,33,55,23,69,7,0,187,401
17001,Niger,2016,2016Niger,0,0,0,0,0,0,0,0,0,0,0,0,0,0,522
17002,Niger,2016,2016Niger,0,0,0,0,0,0,0,0,0,0,5,0,0,5,5
17003,Niger,2016,2016Niger,0,0,0,0,0,17,17,0,0,0,0,0,36,36,53
17004,Niger,2016,2016Niger,0,0,0,0,0,33,33,0,0,0,0,0,58,58,91
17005,Niger,2016,2016Niger,0,0,0,5,0,0,5,0,0,0,0,0,0,0,5
17006,Niger,2016,2016Niger,0,0,0,6,0,0,6,0,0,0,0,0,0,0,54
17007,Niger,2016,2016Niger,0,0,5,0,0,0,5,0,0,0,5,0,0,5,10
17008,Niger,2016,2016Niger,0,0,6,6,0,0,12,0,0,0,31,0,0,31,43
17009,Niger,2016,2016Niger,40,47,34,94,19,0,234,46,56,24,80,7,0,213,447
17010,Niger,2017,2017Niger,0,0,0,0,0,0,0,0,0,0,0,0,0,0,739
17011,Niger,2017,2017Niger,0,0,0,0,0,0,0,0,0,0,5,0,0,5,5
17012,Niger,2017,2017Niger,0,0,0,0,0,19,19,0,0,0,0,0,45,45,64
17013,Niger,2017,2017Niger,0,0,0,5,0,0,5,0,0,0,0,0,0,0,5
17014,Niger,2017,2017Niger,0,0,5,0,0,0,5,0,0,0,6,0,0,6,11
17015,Niger,2017,2017Niger,0,0,5,7,0,0,12,5,0,0,27,0,0,32,44
17016,Niger,2017,2017Niger,39,49,48,95,19,0,250,44,78,29,85,9,0,245,495
17017,Niger,2018,2018Niger,0,0,0,0,0,0,0,0,0,0,0,0,0,0,882
17018,Niger,2018,2018Niger,0,0,0,0,0,31,31,0,0,0,0,0,58,58,89
17019,Niger,2018,2018Niger,0,0,0,5,0,0,5,0,0,0,0,0,0,0,5
17020,Niger,2018,2018Niger,0,0,0,6,0,0,6,0,0,0,0,0,0,0,6
17021,Niger,2018,2018Niger,0,0,0,6,0,0,6,0,0,0,6,0,0,6,12
17022,Niger,2018,2018Niger,0,0,5,13,0,0,18,7,0,0,30,0,0,37,55
17023,Niger,2018,2018Niger,56,80,47,135,21,0,339,56,90,44,101,12,0,303,642
17024,Niger,2018,2018Niger,155,137,55,200,7,0,554,132,132,38,161,7,0,470,1024
17025,Niger,2019,2019Niger,0,0,0,0,0,0,0,0,0,0,0,0,0,0,1237
17026,Niger,2019,2019Niger,0,0,0,0,0,0,0,0,0,0,8,0,0,8,8
17027,Niger,2019,2019Niger,0,0,0,0,0,36,36,0,0,0,0,0,79,79,115
17028,Niger,2019,2019Niger,0,0,0,5,0,0,5,0,0,0,0,0,0,0,5
17029,Niger,2019,2019Niger,0,0,0,6,0,0,6,0,0,0,0,0,0,0,6
17030,Niger,2019,2019Niger,0,5,0,0,0,0,5,0,0,0,0,0,0,0,5
17031,Niger,2019,2019Niger,0,6,0,14,0,0,20,7,0,0,29,0,0,36,56
17032,Niger,2019,2019Niger,47,83,44,116,17,0,307,64,78,56,88,14,0,300,607
17033,Niger,2019,2019Niger,155,137,55,200,7,0,554,132,132,38,161,7,0,470,1024
17034,Niger,2020,2020Niger,0,0,0,0,0,0,0,0,0,0,0,0,0,0,1001
17035,Niger,2020,2020Niger,0,0,0,0,0,0,0,0,0,0,7,0,0,7,7
17036,Niger,2020,2020Niger,0,0,0,0,0,52,52,0,0,0,0,0,74,74,126
17037,Niger,2020,2020Niger,0,0,0,5,0,0,5,0,0,0,0,0,0,0,5
17038,Niger,2020,2020Niger,0,0,0,6,0,0,6,0,0,0,0,0,0,0,6
17039,Niger,2020,2020Niger,0,5,0,15,0,0,20,6,0,0,31,0,0,37,57
17040,Niger,2020,2020Niger,0,6,0,0,0,0,6,0,0,0,0,0,0,0,6
17041,Niger,2020,2020Niger,51,93,55,136,18,0,353,59,106,61,108,20,0,354,707
17042,Niger,2020,2020Niger,2239,2560,1362,2958,271,0,9390,2073,2335,978,1998,164,0,7548,16938
17043,Niger,2021,2021Niger,0,0,0,0,0,0,0,0,0,0,0,0,0,0,1205
17044,Niger,2021,2021Niger,0,0,0,0,0,0,0,0,0,0,5,0,0,5,5
17045,Niger,2021,2021Niger,0,0,0,0,0,0,0,0,0,0,8,0,0,8,8
17046,Niger,2021,2021Niger,0,0,0,0,0,0,0,0,0,0,9,0,0,9,9
17047,Niger,2021,2021Niger,0,0,0,5,0,0,5,0,0,0,0,0,0,0,5
17048,Niger,2021,2021Niger,0,0,0,12,0,0,12,0,0,0,8,0,0,8,66
17049,Niger,2021,2021Niger,0,5,0,0,0,0,5,0,5,0,0,0,0,5,10
17050,Niger,2021,2021Niger,0,8,0,15,0,0,23,0,7,0,30,0,0,37,60
17051,Niger,2021,2021Niger,51,106,66,167,20,0,410,71,114,68,155,21,0,429,839
17052,Niger,2021,2021Niger,148,286,105,278,15,0,832,133,241,77,143,13,0,607,1439
17053,Niger,2021,2021Niger,2411,2720,1412,3308,299,0,10150,2258,2428,997,2237,185,0,8105,18255
17054,Nigeria,2001,2001Nigeria,0,0,0,0,0,0,0,0,0,0,0,0,0,0,5596
17055,Nigeria,2001,2001Nigeria,0,0,0,0,0,0,0,0,0,0,0,0,5,5,5
17056,Nigeria,2001,2001Nigeria,0,0,0,0,0,0,0,0,0,0,5,0,0,5,5
17057,Nigeria,2001,2001Nigeria,0,0,0,0,0,0,0,0,0,0,8,0,0,8,16
17058,Nigeria,2001,2001Nigeria,0,0,0,0,0,10,10,0,0,0,0,0,13,13,23
17059,Nigeria,2001,2001Nigeria,0,0,0,0,0,49,49,0,0,0,0,0,114,114,163
17060,Nigeria,2001,2001Nigeria,0,0,0,5,0,0,5,0,0,0,0,0,0,0,5
17061,Nigeria,2001,2001Nigeria,0,0,0,8,0,0,8,0,0,0,10,0,0,10,18
17062,Nigeria,2001,2001Nigeria,0,0,0,9,0,0,9,0,0,0,0,0,0,0,9
17063,Nigeria,2001,2001Nigeria,0,8,0,0,0,0,8,0,0,0,0,0,0,0,8
17064,Nigeria,2001,2001Nigeria,28,10,8,34,0,0,80,12,23,19,95,0,0,149,229
17065,Nigeria,2002,2002Nigeria,0,0,0,0,0,0,0,0,0,0,0,0,0,0,24011
17066,Nigeria,2002,2002Nigeria,0,0,0,0,0,0,0,0,0,0,0,0,5,5,19
17067,Nigeria,2002,2002Nigeria,0,0,0,0,0,0,0,0,0,0,5,0,0,5,41
17068,Nigeria,2002,2002Nigeria,0,0,0,0,0,0,0,0,0,0,6,0,0,6,6
17069,Nigeria,2002,2002Nigeria,0,0,0,0,0,0,0,0,0,0,8,0,0,8,8
17070,Nigeria,2002,2002Nigeria,0,0,0,0,0,0,0,0,0,5,5,0,0,10,10
17071,Nigeria,2002,2002Nigeria,0,0,0,0,0,0,0,0,7,0,0,0,0,7,7
17072,Nigeria,2002,2002Nigeria,0,0,0,0,0,56,56,0,0,0,0,0,125,125,181
17073,Nigeria,2002,2002Nigeria,0,0,0,8,0,0,8,0,0,0,10,0,0,10,18
17074,Nigeria,2002,2002Nigeria,0,8,0,0,0,0,8,0,0,0,0,0,0,0,8
17075,Nigeria,2002,2002Nigeria,30,11,10,37,0,0,88,19,24,21,98,0,0,162,250
17076,Nigeria,2003,2003Nigeria,0,0,0,0,0,0,0,0,0,0,0,0,0,0,6804
17077,Nigeria,2003,2003Nigeria,0,0,0,0,0,0,0,0,0,0,5,0,0,5,10
17078,Nigeria,2003,2003Nigeria,0,0,0,0,0,0,0,0,0,0,6,0,0,6,6
17079,Nigeria,2003,2003Nigeria,0,0,0,0,0,0,0,0,0,0,8,0,0,8,8
17080,Nigeria,2003,2003Nigeria,0,0,0,0,0,0,0,0,0,5,5,0,0,10,10
17081,Nigeria,2003,2003Nigeria,0,0,0,0,0,0,0,0,5,0,0,0,0,5,20
17082,Nigeria,2003,2003Nigeria,0,0,0,0,0,0,0,0,7,0,0,0,0,7,7
17083,Nigeria,2003,2003Nigeria,0,0,0,0,0,0,0,5,0,0,0,0,0,5,5
17084,Nigeria,2003,2003Nigeria,0,0,0,0,0,5,5,0,0,0,0,0,0,0,22
17085,Nigeria,2003,2003Nigeria,0,0,0,0,0,63,63,0,0,0,0,0,132,132,195
17086,Nigeria,2003,2003Nigeria,0,0,0,8,0,0,8,0,0,0,10,0,0,10,18
17087,Nigeria,2003,2003Nigeria,0,7,7,19,0,0,33,7,7,0,29,0,0,43,76
17088,Nigeria,2003,2003Nigeria,0,8,0,0,0,0,8,0,0,0,0,0,0,0,8
17089,Nigeria,2003,2003Nigeria,32,9,7,34,0,0,82,21,23,19,97,0,0,160,242
17090,Nigeria,2003,2003Nigeria,965,2170,1860,3734,160,0,8889,1067,2050,1757,2915,305,0,8094,16983
17091,Nigeria,2004,2004Nigeria,0,0,0,0,0,0,0,0,0,0,0,0,0,0,6719
17092,Nigeria,2004,2004Nigeria,0,0,0,0,0,0,0,0,0,0,5,0,0,5,10
17093,Nigeria,2004,2004Nigeria,0,0,0,0,0,0,0,0,0,0,8,0,0,8,8
17094,Nigeria,2004,2004Nigeria,0,0,0,0,0,0,0,0,0,5,0,0,0,5,10
17095,Nigeria,2004,2004Nigeria,0,0,0,0,0,0,0,0,0,6,0,0,0,6,6
17096,Nigeria,2004,2004Nigeria,0,0,0,5,0,0,5,0,0,0,8,0,0,8,13
17097,Nigeria,2004,2004Nigeria,0,0,0,5,0,0,5,0,0,0,10,0,0,10,15
17098,Nigeria,2004,2004Nigeria,0,0,0,7,0,0,7,0,0,0,0,0,0,0,7
17099,Nigeria,2004,2004Nigeria,0,0,0,7,0,0,7,5,0,0,15,0,0,20,27
17100,Nigeria,2004,2004Nigeria,0,0,0,8,0,0,8,0,0,0,10,0,0,10,18
17101,Nigeria,2004,2004Nigeria,0,7,7,19,0,0,33,7,7,0,29,0,0,43,76
17102,Nigeria,2004,2004Nigeria,7,0,0,0,0,0,7,5,0,0,19,0,0,24,31
17103,Nigeria,2004,2004Nigeria,9,0,0,0,0,0,9,0,0,0,9,0,0,9,18
17104,Nigeria,2004,2004Nigeria,35,8,6,33,0,0,82,21,22,18,95,0,0,156,238
17105,Nigeria,2004,2004Nigeria,1042,2105,1804,3742,153,0,8846,1156,1956,1677,2773,278,0,7840,16686
17106,Nigeria,2005,2005Nigeria,0,0,0,0,0,0,0,0,0,0,0,0,0,0,11577
17107,Nigeria,2005,2005Nigeria,0,0,0,0,0,0,0,0,0,0,5,0,0,5,20
17108,Nigeria,2005,2005Nigeria,0,0,0,0,0,0,0,0,0,0,7,0,0,7,7
17109,Nigeria,2005,2005Nigeria,0,0,0,0,0,0,0,0,0,0,8,0,0,8,8
17110,Nigeria,2005,2005Nigeria,0,0,0,0,0,128,128,0,0,0,0,0,238,238,366
17111,Nigeria,2005,2005Nigeria,0,0,0,5,0,0,5,0,0,0,5,0,0,5,10
17112,Nigeria,2005,2005Nigeria,0,0,0,5,0,0,5,0,0,0,8,0,0,8,13
17113,Nigeria,2005,2005Nigeria,0,0,0,8,0,0,8,0,0,0,0,0,0,0,8
17114,Nigeria,2005,2005Nigeria,0,0,0,9,0,0,9,0,0,0,9,0,0,9,18
17115,Nigeria,2005,2005Nigeria,0,7,7,19,0,0,33,7,7,0,29,0,0,43,76
17116,Nigeria,2005,2005Nigeria,5,0,0,8,0,5,18,7,0,0,9,0,0,16,34
17117,Nigeria,2005,2005Nigeria,7,0,0,0,0,0,7,5,0,0,19,0,0,24,31
17118,Nigeria,2005,2005Nigeria,37,8,6,33,0,0,84,23,22,18,97,0,0,160,244
17119,Nigeria,2005,2005Nigeria,602,1215,1042,2161,88,0,5108,678,1147,984,1626,163,0,4598,9711
17120,Nigeria,2006,2006Nigeria,0,0,0,0,0,0,0,0,0,0,0,0,0,0,9345
17121,Nigeria,2006,2006Nigeria,0,0,0,0,0,0,0,0,0,0,0,0,5,5,10
17122,Nigeria,2006,2006Nigeria,0,0,0,0,0,0,0,0,0,0,5,0,0,5,15
17123,Nigeria,2006,2006Nigeria,0,0,0,0,0,0,0,0,0,0,7,0,0,7,7
17124,Nigeria,2006,2006Nigeria,0,0,0,0,0,0,0,0,0,0,8,0,0,8,8
17125,Nigeria,2006,2006Nigeria,0,0,0,0,0,5,5,0,0,0,0,0,21,21,26
17126,Nigeria,2006,2006Nigeria,0,0,0,0,0,19,19,0,0,0,0,0,17,17,36
17127,Nigeria,2006,2006Nigeria,0,0,0,0,0,187,187,0,0,0,0,0,284,284,471
17128,Nigeria,2006,2006Nigeria,0,0,0,5,0,0,5,0,0,0,5,0,0,5,10
17129,Nigeria,2006,2006Nigeria,0,0,0,5,0,0,5,0,0,0,9,0,0,9,14
17130,Nigeria,2006,2006Nigeria,0,0,0,6,0,0,6,0,0,0,7,0,0,7,13
17131,Nigeria,2006,2006Nigeria,0,0,0,8,0,0,8,0,0,0,0,0,0,0,8
17132,Nigeria,2006,2006Nigeria,0,5,9,19,0,0,33,5,0,9,29,0,0,43,76
17133,Nigeria,2006,2006Nigeria,8,0,0,0,0,0,8,5,0,0,22,0,0,27,35
17134,Nigeria,2006,2006Nigeria,10,14,14,60,0,0,98,14,19,19,65,0,0,117,215
17135,Nigeria,2006,2006Nigeria,256,386,231,673,29,0,1575,307,369,214,432,56,0,1378,2953
17136,Nigeria,2007,2007Nigeria,0,0,0,0,0,0,0,0,0,0,0,0,0,0,10021
17137,Nigeria,2007,2007Nigeria,0,0,0,0,0,0,0,0,0,0,0,0,5,5,5
17138,Nigeria,2007,2007Nigeria,0,0,0,0,0,0,0,0,0,0,0,0,7,7,7
17139,Nigeria,2007,2007Nigeria,0,0,0,0,0,0,0,0,0,0,5,0,0,5,35
17140,Nigeria,2007,2007Nigeria,0,0,0,0,0,0,0,0,0,0,7,0,0,7,14
17141,Nigeria,2007,2007Nigeria,0,0,0,0,0,0,0,0,0,0,12,0,0,12,12
17142,Nigeria,2007,2007Nigeria,0,0,0,0,0,0,0,9,0,0,0,0,0,9,9
17143,Nigeria,2007,2007Nigeria,0,0,0,0,0,223,223,0,0,0,0,0,309,309,532
17144,Nigeria,2007,2007Nigeria,0,0,0,5,0,0,5,0,0,0,0,0,0,0,5
17145,Nigeria,2007,2007Nigeria,0,0,0,5,0,0,5,0,0,0,5,0,0,5,10
17146,Nigeria,2007,2007Nigeria,0,0,0,5,0,0,5,0,0,5,17,0,0,22,27
17147,Nigeria,2007,2007Nigeria,0,0,0,5,0,0,5,5,0,0,5,0,0,10,15
17148,Nigeria,2007,2007Nigeria,0,0,0,8,0,0,8,0,0,0,0,0,0,0,8
17149,Nigeria,2007,2007Nigeria,0,5,9,19,0,0,33,5,0,9,29,0,0,43,76
17150,Nigeria,2007,2007Nigeria,7,0,0,8,0,5,20,7,0,0,8,0,5,20,40
17151,Nigeria,2007,2007Nigeria,8,0,0,0,0,0,8,5,0,0,27,0,0,32,40
17152,Nigeria,2007,2007Nigeria,11,11,8,45,0,0,75,11,5,18,61,0,0,95,170
17153,Nigeria,2007,2007Nigeria,190,314,299,691,36,0,1530,221,354,242,464,61,0,1342,2872
17154,Nigeria,2008,2008Nigeria,0,0,0,0,0,0,0,0,0,0,0,0,0,0,10301
17155,Nigeria,2008,2008Nigeria,0,0,0,0,0,0,0,0,0,0,0,0,10,10,10
17156,Nigeria,2008,2008Nigeria,0,0,0,0,0,0,0,0,0,0,5,0,0,5,40
17157,Nigeria,2008,2008Nigeria,0,0,0,0,0,0,0,0,0,0,7,0,0,7,7
17158,Nigeria,2008,2008Nigeria,0,0,0,0,0,0,0,0,0,0,8,0,0,8,16
17159,Nigeria,2008,2008Nigeria,0,0,0,0,0,0,0,0,0,0,13,0,0,13,13
17160,Nigeria,2008,2008Nigeria,0,0,0,0,0,265,265,0,0,0,0,0,341,341,606
17161,Nigeria,2008,2008Nigeria,0,0,0,5,0,0,5,0,0,0,0,0,0,0,5
17162,Nigeria,2008,2008Nigeria,0,0,0,5,0,0,5,0,0,0,5,0,0,5,10
17163,Nigeria,2008,2008Nigeria,0,0,0,5,0,0,5,0,0,5,17,0,0,22,27
17164,Nigeria,2008,2008Nigeria,0,0,0,7,0,0,7,6,0,0,6,0,0,12,19
17165,Nigeria,2008,2008Nigeria,0,5,9,19,0,0,33,5,0,9,29,0,0,43,76
17166,Nigeria,2008,2008Nigeria,0,6,0,0,0,0,6,0,0,0,0,0,0,0,6
17167,Nigeria,2008,2008Nigeria,6,0,0,11,0,5,22,6,5,0,17,0,5,33,55
17168,Nigeria,2008,2008Nigeria,7,5,5,34,0,0,51,6,8,6,36,0,0,56,107
17169,Nigeria,2008,2008Nigeria,178,326,299,691,36,0,1530,207,368,242,464,61,0,1342,2872
17170,Nigeria,2009,2009Nigeria,0,0,0,0,0,0,0,0,0,0,0,0,0,0,9713
17171,Nigeria,2009,2009Nigeria,0,0,0,0,0,0,0,0,0,0,5,0,0,5,25
17172,Nigeria,2009,2009Nigeria,0,0,0,0,0,0,0,0,0,0,7,0,0,7,7
17173,Nigeria,2009,2009Nigeria,0,0,0,0,0,0,0,0,0,0,8,0,0,8,24
17174,Nigeria,2009,2009Nigeria,0,0,0,0,0,0,0,0,0,0,11,0,0,11,11
17175,Nigeria,2009,2009Nigeria,0,0,0,0,0,0,0,0,0,0,14,0,0,14,14
17176,Nigeria,2009,2009Nigeria,0,0,0,0,0,5,5,0,0,0,0,0,8,8,13
17177,Nigeria,2009,2009Nigeria,0,0,0,5,0,0,5,0,0,0,5,0,0,5,10
17178,Nigeria,2009,2009Nigeria,0,0,0,5,0,0,5,0,0,5,18,0,0,23,28
17179,Nigeria,2009,2009Nigeria,0,0,0,6,0,0,6,0,5,0,7,0,0,12,18
17180,Nigeria,2009,2009Nigeria,0,5,9,19,0,0,33,5,0,9,29,0,0,43,76
17181,Nigeria,2009,2009Nigeria,0,8,0,0,0,0,8,0,0,0,0,0,0,0,8
17182,Nigeria,2009,2009Nigeria,5,0,0,0,0,0,5,0,0,0,0,0,0,0,5
17183,Nigeria,2009,2009Nigeria,8,0,0,12,0,6,26,9,0,0,21,0,5,35,61
17184,Nigeria,2009,2009Nigeria,12,5,0,24,0,0,41,0,6,6,30,0,0,42,83
17185,Nigeria,2009,2009Nigeria,59,81,72,491,7,0,710,48,96,56,1707,23,0,1930,2640
17186,Nigeria,2009,2009Nigeria,116,275,331,767,41,0,1530,133,331,289,520,70,0,1343,2873
17187,Nigeria,2010,2010Nigeria,0,0,0,0,0,0,0,0,0,0,0,0,0,0,9029
17188,Nigeria,2010,2010Nigeria,0,0,0,0,0,0,0,0,0,0,0,0,5,5,5
17189,Nigeria,2010,2010Nigeria,0,0,0,0,0,0,0,0,0,0,5,0,0,5,15
17190,Nigeria,2010,2010Nigeria,0,0,0,0,0,0,0,0,0,0,7,0,0,7,7
17191,Nigeria,2010,2010Nigeria,0,0,0,0,0,0,0,0,0,0,8,0,0,8,8
17192,Nigeria,2010,2010Nigeria,0,0,0,0,0,0,0,0,0,0,9,0,0,9,14
17193,Nigeria,2010,2010Nigeria,0,0,0,0,0,0,0,0,0,0,12,0,0,12,12
17194,Nigeria,2010,2010Nigeria,0,0,0,0,0,0,0,0,0,0,15,0,0,15,15
17195,Nigeria,2010,2010Nigeria,0,0,0,0,0,0,0,0,0,5,0,0,0,5,10
17196,Nigeria,2010,2010Nigeria,0,0,0,0,0,0,0,0,5,0,0,0,0,5,5
17197,Nigeria,2010,2010Nigeria,0,0,0,0,0,17,17,0,0,0,0,0,20,20,37
17198,Nigeria,2010,2010Nigeria,0,0,0,0,0,348,348,0,0,0,0,0,378,378,726
17199,Nigeria,2010,2010Nigeria,0,0,0,5,0,0,5,0,0,0,0,0,0,0,5
17200,Nigeria,2010,2010Nigeria,0,0,0,5,0,0,5,0,0,0,5,0,0,5,10
17201,Nigeria,2010,2010Nigeria,0,0,0,5,0,0,5,0,0,0,16,0,0,16,21
17202,Nigeria,2010,2010Nigeria,0,0,0,5,0,0,5,0,0,0,24,0,0,24,29
17203,Nigeria,2010,2010Nigeria,0,0,0,6,0,0,6,0,5,0,7,0,0,12,18
17204,Nigeria,2010,2010Nigeria,0,5,9,19,0,0,33,5,0,9,29,0,0,43,76
17205,Nigeria,2010,2010Nigeria,5,6,0,12,0,6,29,6,6,0,18,0,7,37,66
17206,Nigeria,2010,2010Nigeria,10,0,0,19,0,0,29,0,0,7,27,0,0,34,63
17207,Nigeria,2010,2010Nigeria,50,95,66,525,7,0,743,38,103,59,1636,22,0,1858,2601
17208,Nigeria,2010,2010Nigeria,55,281,332,818,44,0,1530,70,346,282,569,76,0,1343,2873
17209,Nigeria,2011,2011Nigeria,0,0,0,0,0,0,0,0,0,0,0,0,0,0,6365
17210,Nigeria,2011,2011Nigeria,0,0,0,0,0,0,0,0,0,0,5,0,0,5,20
17211,Nigeria,2011,2011Nigeria,0,0,0,0,0,0,0,0,0,0,7,0,0,7,7
17212,Nigeria,2011,2011Nigeria,0,0,0,0,0,0,0,0,0,0,12,0,0,12,29
17213,Nigeria,2011,2011Nigeria,0,0,0,0,0,0,0,0,0,0,14,0,0,14,14
17214,Nigeria,2011,2011Nigeria,0,0,0,0,0,8,8,0,0,0,0,0,9,9,17
17215,Nigeria,2011,2011Nigeria,0,0,0,0,0,397,397,0,0,0,0,0,397,397,794
17216,Nigeria,2011,2011Nigeria,0,0,0,5,0,0,5,0,0,0,0,0,0,0,5
17217,Nigeria,2011,2011Nigeria,0,0,0,5,0,0,5,0,0,0,5,0,0,5,10
17218,Nigeria,2011,2011Nigeria,0,0,0,5,0,0,5,0,0,0,10,0,0,10,15
17219,Nigeria,2011,2011Nigeria,0,0,0,5,0,0,5,0,0,0,18,0,0,18,23
17220,Nigeria,2011,2011Nigeria,0,0,0,5,0,0,5,0,0,0,28,0,0,28,33
17221,Nigeria,2011,2011Nigeria,0,0,0,6,0,0,6,0,5,0,7,0,0,12,18
17222,Nigeria,2011,2011Nigeria,0,5,0,0,0,0,5,0,0,0,5,0,0,5,10
17223,Nigeria,2011,2011Nigeria,0,5,9,19,0,0,33,5,0,9,29,0,0,43,76
17224,Nigeria,2011,2011Nigeria,0,7,0,0,0,0,7,0,0,0,23,0,0,23,50
17225,Nigeria,2011,2011Nigeria,5,10,0,17,0,7,39,7,10,0,19,0,8,44,83
17226,Nigeria,2011,2011Nigeria,6,0,0,0,0,0,6,0,0,0,0,0,0,0,6
17227,Nigeria,2011,2011Nigeria,11,0,0,20,0,0,31,0,0,9,27,0,0,36,67
17228,Nigeria,2011,2011Nigeria,55,106,65,560,11,0,797,41,106,64,1637,22,0,1870,2667
17229,Nigeria,2011,2011Nigeria,81,122,73,566,26,0,868,76,109,40,391,0,0,616,3608
17230,Nigeria,2011,2011Nigeria,81,333,346,907,45,0,1712,108,402,309,620,72,0,1511,3223
17231,Nigeria,2012,2012Nigeria,0,0,0,0,0,0,0,0,0,0,0,0,0,0,6670
17232,Nigeria,2012,2012Nigeria,0,0,0,0,0,0,0,0,0,0,0,0,5,5,5
17233,Nigeria,2012,2012Nigeria,0,0,0,0,0,0,0,0,0,0,5,0,0,5,20
17234,Nigeria,2012,2012Nigeria,0,0,0,0,0,0,0,0,0,0,7,0,0,7,7
17235,Nigeria,2012,2012Nigeria,0,0,0,0,0,0,0,0,0,0,13,0,0,13,13
17236,Nigeria,2012,2012Nigeria,0,0,0,0,0,0,0,0,0,5,0,0,0,5,5
17237,Nigeria,2012,2012Nigeria,0,0,0,0,0,5,5,0,0,0,0,0,13,13,18
17238,Nigeria,2012,2012Nigeria,0,0,0,0,0,7,7,0,0,0,0,0,12,12,19
17239,Nigeria,2012,2012Nigeria,0,0,0,0,0,471,471,0,0,0,0,0,418,418,889
17240,Nigeria,2012,2012Nigeria,0,0,0,5,0,0,5,0,0,0,5,0,0,5,10
17241,Nigeria,2012,2012Nigeria,0,0,0,5,0,0,5,0,0,0,13,0,0,13,18
17242,Nigeria,2012,2012Nigeria,0,0,0,5,0,0,5,0,0,0,20,0,0,20,25
17243,Nigeria,2012,2012Nigeria,0,0,0,5,0,0,5,0,0,0,32,0,0,32,37
17244,Nigeria,2012,2012Nigeria,0,0,0,6,0,0,6,0,0,0,0,0,0,0,6
17245,Nigeria,2012,2012Nigeria,0,0,0,6,0,0,6,0,5,0,8,0,0,13,19
17246,Nigeria,2012,2012Nigeria,0,5,0,0,0,0,5,0,0,0,0,0,0,0,5
17247,Nigeria,2012,2012Nigeria,0,7,0,12,0,0,19,5,5,0,14,0,0,24,43
17248,Nigeria,2012,2012Nigeria,0,9,0,0,0,0,9,0,0,0,20,0,0,20,52
17249,Nigeria,2012,2012Nigeria,5,11,0,21,0,7,44,5,10,0,24,0,9,48,92
17250,Nigeria,2012,2012Nigeria,7,0,0,0,0,0,7,0,5,0,6,0,0,11,18
17251,Nigeria,2012,2012Nigeria,32,26,16,203,5,0,282,31,29,13,166,0,0,239,3990
17252,Nigeria,2012,2012Nigeria,81,333,346,907,45,0,1712,108,402,309,620,72,0,1511,3223
17253,Nigeria,2012,2012Nigeria,86,136,67,627,9,0,925,54,119,64,1643,28,0,1908,2833
17254,Nigeria,2013,2013Nigeria,0,0,0,0,0,0,0,0,0,0,0,0,0,0,16122
17255,Nigeria,2013,2013Nigeria,0,0,0,0,0,0,0,0,0,0,5,0,0,5,20
17256,Nigeria,2013,2013Nigeria,0,0,0,0,0,0,0,0,0,0,7,0,0,7,7
17257,Nigeria,2013,2013Nigeria,0,0,0,0,0,0,0,0,0,0,8,0,0,8,8
17258,Nigeria,2013,2013Nigeria,0,0,0,0,0,0,0,0,0,0,9,0,0,9,9
17259,Nigeria,2013,2013Nigeria,0,0,0,0,0,0,0,0,0,0,11,0,0,11,11
17260,Nigeria,2013,2013Nigeria,0,0,0,0,0,0,0,0,0,5,0,0,0,5,5
17261,Nigeria,2013,2013Nigeria,0,0,0,0,0,0,0,5,0,0,0,0,0,5,5
17262,Nigeria,2013,2013Nigeria,0,0,0,0,0,7,7,0,0,0,0,0,11,11,23
17263,Nigeria,2013,2013Nigeria,0,0,0,0,0,543,543,0,0,0,0,0,445,445,988
17264,Nigeria,2013,2013Nigeria,0,0,0,5,0,0,5,0,0,0,5,0,0,5,10
17265,Nigeria,2013,2013Nigeria,0,0,0,5,0,0,5,0,0,0,13,0,0,13,18
17266,Nigeria,2013,2013Nigeria,0,0,0,5,0,0,5,0,0,0,20,0,0,20,25
17267,Nigeria,2013,2013Nigeria,0,0,0,5,0,0,5,0,0,0,23,0,0,23,28
17268,Nigeria,2013,2013Nigeria,0,0,0,5,0,0,5,0,0,0,50,0,0,50,55
17269,Nigeria,2013,2013Nigeria,0,0,0,7,0,0,7,0,0,0,0,0,0,0,7
17270,Nigeria,2013,2013Nigeria,0,6,0,5,0,0,11,0,0,0,32,7,0,39,50
17271,Nigeria,2013,2013Nigeria,0,17,0,26,0,8,51,5,13,0,35,0,9,62,113
17272,Nigeria,2013,2013Nigeria,5,26,37,181,5,0,254,5,21,24,173,0,0,223,477
17273,Nigeria,2013,2013Nigeria,8,0,0,0,0,0,8,0,5,0,6,0,0,11,19
17274,Nigeria,2013,2013Nigeria,8,20,19,96,0,0,143,10,21,19,92,0,0,142,4441
17275,Nigeria,2013,2013Nigeria,36,48,19,260,5,0,368,19,38,11,284,0,0,352,720
17276,Nigeria,2013,2013Nigeria,81,118,120,6,0,0,325,74,100,49,5,0,0,228,553
17277,Nigeria,2013,2013Nigeria,191,170,113,352,55,0,881,196,186,118,306,62,0,868,7459
17278,Nigeria,2014,2014Nigeria,0,0,0,0,0,0,0,0,0,0,0,0,0,0,40917
17279,Nigeria,2014,2014Nigeria,0,0,0,0,0,0,0,0,0,0,0,0,5,5,5
17280,Nigeria,2014,2014Nigeria,0,0,0,0,0,0,0,0,0,0,0,0,17,17,17
17281,Nigeria,2014,2014Nigeria,0,0,0,0,0,0,0,0,0,0,5,0,0,5,35
17282,Nigeria,2014,2014Nigeria,0,0,0,0,0,0,0,0,0,0,7,0,0,7,7
17283,Nigeria,2014,2014Nigeria,0,0,0,0,0,0,0,0,0,0,8,0,0,8,8
17284,Nigeria,2014,2014Nigeria,0,0,0,0,0,0,0,0,0,0,10,0,0,10,10
17285,Nigeria,2014,2014Nigeria,0,0,0,0,0,0,0,0,0,0,12,0,0,12,12
17286,Nigeria,2014,2014Nigeria,0,0,0,0,0,0,0,0,9,0,0,0,0,9,9
17287,Nigeria,2014,2014Nigeria,0,0,0,0,0,0,0,5,0,0,0,0,0,5,5
17288,Nigeria,2014,2014Nigeria,0,0,0,0,0,631,631,0,0,0,0,0,471,471,1102
17289,Nigeria,2014,2014Nigeria,0,0,0,5,0,0,5,0,0,0,5,0,0,5,10
17290,Nigeria,2014,2014Nigeria,0,0,0,5,0,0,5,0,0,0,13,0,0,13,18
17291,Nigeria,2014,2014Nigeria,0,0,0,6,0,0,6,0,0,0,0,0,0,0,6
17292,Nigeria,2014,2014Nigeria,0,0,0,8,0,0,8,0,0,0,0,0,0,0,8
17293,Nigeria,2014,2014Nigeria,0,7,5,26,5,0,43,0,0,7,34,5,0,46,89
17294,Nigeria,2014,2014Nigeria,0,8,0,0,0,0,8,0,5,0,6,0,0,11,19
17295,Nigeria,2014,2014Nigeria,0,8,0,7,0,0,15,0,0,0,32,8,0,40,55
17296,Nigeria,2014,2014Nigeria,5,0,0,0,0,0,5,0,0,0,0,0,0,0,5
17297,Nigeria,2014,2014Nigeria,5,20,0,33,0,8,66,5,17,0,45,0,9,76,142
17298,Nigeria,2014,2014Nigeria,9,0,0,0,0,0,9,0,0,0,0,0,0,0,9
17299,Nigeria,2014,2014Nigeria,18,28,15,116,0,0,177,11,28,12,104,0,0,155,4683
17300,Nigeria,2014,2014Nigeria,51,67,23,305,5,0,451,22,42,14,333,5,0,416,867
17301,Nigeria,2014,2014Nigeria,221,280,171,453,39,0,1164,225,296,154,353,39,0,1067,39968
17302,Nigeria,2014,2014Nigeria,308,394,143,570,20,0,1435,300,343,111,356,35,0,1145,2930
17303,Nigeria,2015,2015Nigeria,0,0,0,0,0,0,0,0,0,0,0,0,0,0,18908
17304,Nigeria,2015,2015Nigeria,0,0,0,0,0,0,0,0,0,0,0,0,5,5,5
17305,Nigeria,2015,2015Nigeria,0,0,0,0,0,0,0,0,0,0,0,0,6,6,6
17306,Nigeria,2015,2015Nigeria,0,0,0,0,0,0,0,0,0,0,5,0,0,5,20
17307,Nigeria,2015,2015Nigeria,0,0,0,0,0,0,0,0,0,0,6,0,0,6,6
17308,Nigeria,2015,2015Nigeria,0,0,0,0,0,0,0,0,0,0,7,0,0,7,7
17309,Nigeria,2015,2015Nigeria,0,0,0,0,0,0,0,0,0,0,8,0,0,8,16
17310,Nigeria,2015,2015Nigeria,0,0,0,0,0,0,0,0,0,0,10,0,0,10,10
17311,Nigeria,2015,2015Nigeria,0,0,0,0,0,0,0,0,0,0,11,0,0,11,11
17312,Nigeria,2015,2015Nigeria,0,0,0,0,0,0,0,0,0,9,0,0,0,9,9
17313,Nigeria,2015,2015Nigeria,0,0,0,0,0,13,13,0,0,0,0,0,24,24,37
17314,Nigeria,2015,2015Nigeria,0,0,0,0,0,746,746,0,0,0,0,0,504,504,1250
17315,Nigeria,2015,2015Nigeria,0,0,0,0,0,37713,37713,0,0,0,0,0,30608,30608,68321
17316,Nigeria,2015,2015Nigeria,0,0,0,5,0,0,5,0,0,0,5,0,0,5,10
17317,Nigeria,2015,2015Nigeria,0,0,0,5,0,0,5,0,0,9,11,0,0,20,25
17318,Nigeria,2015,2015Nigeria,0,0,0,8,0,0,8,0,0,0,0,0,0,0,16
17319,Nigeria,2015,2015Nigeria,0,0,0,14,0,0,14,0,5,0,81,0,0,86,100
17320,Nigeria,2015,2015Nigeria,0,0,8,7,0,0,15,0,0,0,24,5,0,29,44
17321,Nigeria,2015,2015Nigeria,0,5,0,0,0,0,5,0,0,0,8,0,0,8,13
17322,Nigeria,2015,2015Nigeria,0,8,0,0,0,0,8,0,5,0,6,0,0,11,19
17323,Nigeria,2015,2015Nigeria,0,19,33,174,5,0,231,0,19,25,163,0,0,207,438
17324,Nigeria,2015,2015Nigeria,5,0,0,0,0,0,5,0,0,0,0,0,0,0,5
17325,Nigeria,2015,2015Nigeria,8,0,0,0,0,0,8,0,0,0,0,0,0,0,8
17326,Nigeria,2015,2015Nigeria,10,21,0,46,0,0,77,9,24,0,53,0,0,86,179
17327,Nigeria,2015,2015Nigeria,45,82,28,335,6,0,496,26,53,10,391,5,0,485,981
17328,Nigeria,2015,2015Nigeria,441,835,362,1200,51,0,2889,434,808,355,1078,125,0,2800,5689
17329,Nigeria,2015,2015Nigeria,4359,5834,2997,9161,898,0,23249,4445,5961,2935,6259,785,0,20385,71840
17330,Nigeria,2016,2016Nigeria,0,0,0,0,0,0,0,0,0,0,0,0,0,0,19508
17331,Nigeria,2016,2016Nigeria,0,0,0,0,0,0,0,0,0,0,0,0,5,5,5
17332,Nigeria,2016,2016Nigeria,0,0,0,0,0,0,0,0,0,0,5,0,0,5,10
17333,Nigeria,2016,2016Nigeria,0,0,0,0,0,0,0,0,0,0,6,0,0,6,12
17334,Nigeria,2016,2016Nigeria,0,0,0,0,0,0,0,0,0,0,7,0,0,7,28
17335,Nigeria,2016,2016Nigeria,0,0,0,0,0,0,0,0,0,0,9,0,0,9,9
17336,Nigeria,2016,2016Nigeria,0,0,0,0,0,0,0,0,0,0,10,0,0,10,10
17337,Nigeria,2016,2016Nigeria,0,0,0,0,0,0,0,0,0,0,13,0,0,13,13
17338,Nigeria,2016,2016Nigeria,0,0,0,0,0,0,0,0,0,6,5,0,0,11,11
17339,Nigeria,2016,2016Nigeria,0,0,0,0,0,5,5,0,0,0,0,0,5,5,10
17340,Nigeria,2016,2016Nigeria,0,0,0,0,0,15,15,0,0,0,0,0,28,28,43
17341,Nigeria,2016,2016Nigeria,0,0,0,0,0,1047,1047,0,0,0,0,0,606,606,1653
17342,Nigeria,2016,2016Nigeria,0,0,0,5,0,0,5,0,0,0,5,0,0,5,10
17343,Nigeria,2016,2016Nigeria,0,0,0,8,0,0,8,0,0,0,0,0,0,0,8
17344,Nigeria,2016,2016Nigeria,0,0,0,17,0,0,17,0,5,0,92,0,0,97,114
17345,Nigeria,2016,2016Nigeria,0,0,5,9,0,0,14,0,0,0,27,0,0,27,41
17346,Nigeria,2016,2016Nigeria,0,5,0,0,0,0,5,5,0,0,6,0,0,11,16
17347,Nigeria,2016,2016Nigeria,0,8,0,0,0,0,8,0,0,0,0,0,0,0,8
17348,Nigeria,2016,2016Nigeria,0,8,16,140,0,0,164,5,7,13,147,0,0,172,4068
17349,Nigeria,2016,2016Nigeria,0,16,23,178,5,0,222,0,14,22,165,0,0,201,423
17350,Nigeria,2016,2016Nigeria,5,0,0,5,0,0,10,0,0,0,0,0,0,0,10
17351,Nigeria,2016,2016Nigeria,9,16,5,42,0,11,83,7,23,0,53,0,9,92,175
17352,Nigeria,2016,2016Nigeria,58,114,27,387,5,0,591,33,70,14,408,5,0,530,1121
17353,Nigeria,2016,2016Nigeria,789,1110,478,1596,68,0,4041,750,997,444,1392,153,0,3736,7777
17354,Nigeria,2016,2016Nigeria,6898,8080,4608,11682,1256,0,32524,6866,8063,4833,8223,1454,0,29439,88706
17355,Nigeria,2016,2016Nigeria,10730,13964,4992,21416,1421,0,52523,11928,15148,5491,17649,2762,0,52978,105501
17356,Nigeria,2017,2017Nigeria,0,0,0,0,0,0,0,0,0,0,0,0,0,0,28597
17357,Nigeria,2017,2017Nigeria,0,0,0,0,0,0,0,0,0,0,0,0,5,5,5
17358,Nigeria,2017,2017Nigeria,0,0,0,0,0,0,0,0,0,0,5,0,0,5,144
17359,Nigeria,2017,2017Nigeria,0,0,0,0,0,0,0,0,0,0,6,0,0,6,6
17360,Nigeria,2017,2017Nigeria,0,0,0,0,0,0,0,0,0,0,7,0,0,7,14
17361,Nigeria,2017,2017Nigeria,0,0,0,0,0,0,0,0,0,0,8,0,0,8,8
17362,Nigeria,2017,2017Nigeria,0,0,0,0,0,0,0,0,0,0,10,0,0,10,10
17363,Nigeria,2017,2017Nigeria,0,0,0,0,0,0,0,0,0,0,13,0,0,13,13
17364,Nigeria,2017,2017Nigeria,0,0,0,0,0,0,0,0,0,9,0,0,0,9,9
17365,Nigeria,2017,2017Nigeria,0,0,0,0,0,7,7,0,0,0,0,0,12,12,19
17366,Nigeria,2017,2017Nigeria,0,0,0,0,0,1396,1396,0,0,0,0,0,705,705,2101
17367,Nigeria,2017,2017Nigeria,0,0,0,5,0,0,5,0,0,0,5,0,0,5,10
17368,Nigeria,2017,2017Nigeria,0,0,0,5,0,0,5,0,0,0,18,0,0,18,23
17369,Nigeria,2017,2017Nigeria,0,0,0,5,0,0,5,0,5,0,0,0,0,5,10
17370,Nigeria,2017,2017Nigeria,0,0,0,6,0,0,6,5,0,0,6,0,0,11,17
17371,Nigeria,2017,2017Nigeria,0,0,8,7,0,0,15,0,0,0,27,0,0,27,42
17372,Nigeria,2017,2017Nigeria,0,5,0,0,0,0,5,0,0,0,0,0,0,0,5
17373,Nigeria,2017,2017Nigeria,0,5,0,0,0,0,5,5,0,0,7,0,0,12,17
17374,Nigeria,2017,2017Nigeria,0,9,0,0,0,0,9,0,0,0,0,0,0,0,9
17375,Nigeria,2017,2017Nigeria,0,12,21,185,6,0,224,0,8,18,171,0,0,197,421
17376,Nigeria,2017,2017Nigeria,5,0,0,6,0,0,11,0,0,0,0,0,0,0,11
17377,Nigeria,2017,2017Nigeria,8,17,7,46,0,10,88,8,22,5,50,0,12,97,185
17378,Nigeria,2017,2017Nigeria,507,350,71,1498,10,0,2436,452,271,56,748,8,0,1535,3971
17379,Nigeria,2017,2017Nigeria,902,1105,1017,1677,79,0,4780,888,1064,913,1725,171,0,4761,9541
17380,Nigeria,2017,2017Nigeria,6390,8562,4041,13112,1569,0,33674,6505,8425,3914,8464,1355,0,28663,85319
17381,Nigeria,2017,2017Nigeria,10870,15852,5952,24499,1184,0,58357,10295,13549,5709,18725,1835,0,50113,108470
17382,Nigeria,2018,2018Nigeria,0,0,0,0,0,0,0,0,0,0,0,0,0,0,29229
17383,Nigeria,2018,2018Nigeria,0,0,0,0,0,0,0,0,0,0,5,0,0,5,41
17384,Nigeria,2018,2018Nigeria,0,0,0,0,0,0,0,0,0,0,6,0,0,6,6
17385,Nigeria,2018,2018Nigeria,0,0,0,0,0,0,0,0,0,0,7,0,0,7,14
17386,Nigeria,2018,2018Nigeria,0,0,0,0,0,0,0,0,0,0,8,0,0,8,8
17387,Nigeria,2018,2018Nigeria,0,0,0,0,0,0,0,0,0,0,12,0,0,12,12
17388,Nigeria,2018,2018Nigeria,0,0,0,0,0,0,0,0,0,0,17,0,0,17,17
17389,Nigeria,2018,2018Nigeria,0,0,0,0,0,0,0,0,0,9,0,0,0,9,9
17390,Nigeria,2018,2018Nigeria,0,0,0,0,0,1738,1738,0,0,0,0,0,787,787,2525
17391,Nigeria,2018,2018Nigeria,0,0,0,5,0,0,5,0,0,0,0,0,0,0,5
17392,Nigeria,2018,2018Nigeria,0,0,0,5,0,0,5,0,0,5,0,0,0,5,10
17393,Nigeria,2018,2018Nigeria,0,0,0,6,0,0,6,7,0,0,5,0,0,12,18
17394,Nigeria,2018,2018Nigeria,0,0,0,7,0,0,7,0,0,5,0,0,0,5,12
17395,Nigeria,2018,2018Nigeria,0,0,5,0,0,0,5,0,0,0,0,0,0,0,5
17396,Nigeria,2018,2018Nigeria,0,0,8,8,0,0,16,0,0,0,25,0,0,25,41
17397,Nigeria,2018,2018Nigeria,0,5,0,0,0,0,5,0,0,0,0,0,0,0,5
17398,Nigeria,2018,2018Nigeria,0,5,0,0,0,0,5,0,0,0,6,0,0,6,11
17399,Nigeria,2018,2018Nigeria,0,11,17,106,5,0,139,0,11,17,88,0,0,116,255
17400,Nigeria,2018,2018Nigeria,5,0,0,0,0,0,5,0,0,0,5,0,0,5,10
17401,Nigeria,2018,2018Nigeria,5,0,0,5,0,0,10,0,0,0,0,0,0,0,10
17402,Nigeria,2018,2018Nigeria,16,18,9,54,0,14,111,9,23,5,48,0,12,97,208
17403,Nigeria,2018,2018Nigeria,18,73,42,259,0,0,392,23,73,54,278,0,0,428,5483
17404,Nigeria,2018,2018Nigeria,943,622,104,2390,11,0,4070,777,551,82,941,14,0,2365,6435
17405,Nigeria,2018,2018Nigeria,1056,1550,780,2250,86,0,5722,1057,1454,864,2007,206,0,5588,11310
17406,Nigeria,2018,2018Nigeria,8400,17131,7534,26452,1801,0,61318,8374,16879,7221,22373,2703,0,57550,118868
17407,Nigeria,2018,2018Nigeria,11313,14460,6541,21442,2513,0,56269,11839,13863,6577,11808,1931,0,46018,102287
17408,Nigeria,2019,2019Nigeria,0,0,0,0,0,0,0,0,0,0,0,0,0,0,39830
17409,Nigeria,2019,2019Nigeria,0,0,0,0,0,0,0,0,0,0,5,0,0,5,20
17410,Nigeria,2019,2019Nigeria,0,0,0,0,0,0,0,0,0,0,6,0,0,6,6
17411,Nigeria,2019,2019Nigeria,0,0,0,0,0,0,0,0,0,0,7,0,0,7,14
17412,Nigeria,2019,2019Nigeria,0,0,0,0,0,0,0,0,0,0,8,0,0,8,8
17413,Nigeria,2019,2019Nigeria,0,0,0,0,0,0,0,0,0,0,12,0,0,12,12
17414,Nigeria,2019,2019Nigeria,0,0,0,0,0,0,0,0,0,0,22,0,0,22,22
17415,Nigeria,2019,2019Nigeria,0,0,0,0,0,0,0,0,0,9,0,0,0,9,9
17416,Nigeria,2019,2019Nigeria,0,0,0,0,0,6,6,0,0,0,0,0,0,0,6
17417,Nigeria,2019,2019Nigeria,0,0,0,0,0,2237,2237,0,0,0,0,0,979,979,3216
17418,Nigeria,2019,2019Nigeria,0,0,0,7,0,0,7,0,8,0,6,0,0,14,21
17419,Nigeria,2019,2019Nigeria,0,0,5,0,0,0,5,0,0,0,0,0,0,0,5
17420,Nigeria,2019,2019Nigeria,0,0,8,8,0,0,16,0,0,0,25,0,0,25,41
17421,Nigeria,2019,2019Nigeria,0,5,0,0,0,0,5,0,0,0,0,0,0,0,5
17422,Nigeria,2019,2019Nigeria,0,5,0,0,0,0,5,0,0,0,6,0,0,6,11
17423,Nigeria,2019,2019Nigeria,0,5,0,7,0,0,12,0,0,5,0,0,0,5,17
17424,Nigeria,2019,2019Nigeria,5,11,16,122,5,0,159,0,12,15,107,0,0,134,293
17425,Nigeria,2019,2019Nigeria,21,23,11,68,0,0,123,15,27,6,50,0,0,98,246
17426,Nigeria,2019,2019Nigeria,1119,844,144,2803,15,0,4925,930,778,124,1052,19,0,2903,7828
17427,Nigeria,2019,2019Nigeria,1404,1482,955,2596,117,0,6554,1380,1609,818,2115,244,0,6166,12720
17428,Nigeria,2019,2019Nigeria,9254,18203,8339,25733,2247,0,63776,8248,16224,7433,22938,2002,0,56845,120621
17429,Nigeria,2019,2019Nigeria,10366,15956,7279,23148,2432,0,59181,10557,15769,7108,15517,2495,0,51446,110627
17430,Nigeria,2020,2020Nigeria,0,0,0,0,0,0,0,0,0,0,0,0,0,0,30473
17431,Nigeria,2020,2020Nigeria,0,0,0,0,0,0,0,0,0,0,0,0,5,5,5
17432,Nigeria,2020,2020Nigeria,0,0,0,0,0,0,0,0,0,0,0,0,6,6,6
17433,Nigeria,2020,2020Nigeria,0,0,0,0,0,0,0,0,0,0,0,0,9,9,9
17434,Nigeria,2020,2020Nigeria,0,0,0,0,0,0,0,0,0,0,5,0,0,5,15
17435,Nigeria,2020,2020Nigeria,0,0,0,0,0,0,0,0,0,0,6,0,0,6,6
17436,Nigeria,2020,2020Nigeria,0,0,0,0,0,0,0,0,0,0,7,0,0,7,7
17437,Nigeria,2020,2020Nigeria,0,0,0,0,0,0,0,0,0,0,8,0,0,8,8
17438,Nigeria,2020,2020Nigeria,0,0,0,0,0,0,0,0,0,0,9,0,0,9,18
17439,Nigeria,2020,2020Nigeria,0,0,0,0,0,0,0,0,0,0,11,0,0,11,11
17440,Nigeria,2020,2020Nigeria,0,0,0,0,0,0,0,0,0,0,12,0,0,12,12
17441,Nigeria,2020,2020Nigeria,0,0,0,0,0,0,0,0,0,0,22,0,0,22,22
17442,Nigeria,2020,2020Nigeria,0,0,0,0,0,0,0,5,0,0,0,0,0,5,5
17443,Nigeria,2020,2020Nigeria,0,0,0,0,0,5,5,0,0,0,0,0,7,7,12
17444,Nigeria,2020,2020Nigeria,0,0,0,0,0,15,15,0,0,0,0,0,37,37,52
17445,Nigeria,2020,2020Nigeria,0,0,0,0,0,26,26,0,0,0,0,0,29,29,55
17446,Nigeria,2020,2020Nigeria,0,0,0,5,0,0,5,0,0,0,0,0,0,0,5
17447,Nigeria,2020,2020Nigeria,0,0,0,5,0,0,5,0,0,0,7,0,0,7,12
17448,Nigeria,2020,2020Nigeria,0,0,0,6,0,0,6,0,0,0,31,0,0,31,37
17449,Nigeria,2020,2020Nigeria,0,0,0,9,0,0,9,0,9,0,6,0,0,15,24
17450,Nigeria,2020,2020Nigeria,0,0,5,0,0,0,5,0,0,0,0,0,0,0,5
17451,Nigeria,2020,2020Nigeria,0,0,7,5,0,0,12,0,0,0,0,0,0,0,12
17452,Nigeria,2020,2020Nigeria,0,0,7,10,0,0,17,0,0,0,25,0,0,25,42
17453,Nigeria,2020,2020Nigeria,0,7,0,9,0,0,16,0,0,6,0,0,0,6,22
17454,Nigeria,2020,2020Nigeria,5,0,0,0,0,0,5,0,0,0,6,0,0,6,11
17455,Nigeria,2020,2020Nigeria,5,12,15,149,5,0,186,5,12,13,123,0,0,153,339
17456,Nigeria,2020,2020Nigeria,26,26,9,81,0,0,142,17,28,6,59,0,0,110,278
17457,Nigeria,2020,2020Nigeria,81,222,97,665,0,69,1134,70,235,101,451,0,44,901,8082
17458,Nigeria,2020,2020Nigeria,1076,1095,216,3071,16,0,5474,943,1042,166,1155,19,0,3325,8813
17459,Nigeria,2020,2020Nigeria,1736,1974,1203,3307,157,0,8377,1671,2027,1030,2678,343,0,7749,16126
17460,Nigeria,2020,2020Nigeria,10186,16909,8536,24688,2704,0,63023,10384,16738,8310,16226,2741,0,54399,117422
17461,Nigeria,2020,2020Nigeria,12875,27727,11323,35953,2911,0,90789,12240,26012,10347,29064,2562,0,80225,171014
17462,Nigeria,2021,2021Nigeria,0,0,0,0,0,0,0,0,0,0,0,0,0,0,35110
17463,Nigeria,2021,2021Nigeria,0,0,0,0,0,0,0,0,0,0,0,0,5,5,5
17464,Nigeria,2021,2021Nigeria,0,0,0,0,0,0,0,0,0,0,0,0,7,7,7
17465,Nigeria,2021,2021Nigeria,0,0,0,0,0,0,0,0,0,0,0,0,8,8,8
17466,Nigeria,2021,2021Nigeria,0,0,0,0,0,0,0,0,0,0,5,0,0,5,20
17467,Nigeria,2021,2021Nigeria,0,0,0,0,0,0,0,0,0,0,6,0,0,6,18
17468,Nigeria,2021,2021Nigeria,0,0,0,0,0,0,0,0,0,0,7,0,0,7,7
17469,Nigeria,2021,2021Nigeria,0,0,0,0,0,0,0,0,0,0,8,0,0,8,8
17470,Nigeria,2021,2021Nigeria,0,0,0,0,0,0,0,0,0,0,9,0,0,9,18
17471,Nigeria,2021,2021Nigeria,0,0,0,0,0,0,0,0,0,0,11,0,0,11,11
17472,Nigeria,2021,2021Nigeria,0,0,0,0,0,0,0,0,0,0,12,0,0,12,12
17473,Nigeria,2021,2021Nigeria,0,0,0,0,0,0,0,0,0,0,22,0,0,22,22
17474,Nigeria,2021,2021Nigeria,0,0,0,0,0,0,0,0,5,0,0,0,0,5,10
17475,Nigeria,2021,2021Nigeria,0,0,0,0,0,0,0,5,0,0,0,0,0,5,5
17476,Nigeria,2021,2021Nigeria,0,0,0,5,0,0,5,0,0,0,5,0,0,5,10
17477,Nigeria,2021,2021Nigeria,0,0,0,7,0,0,7,0,0,0,33,0,0,33,40
17478,Nigeria,2021,2021Nigeria,0,0,0,8,0,0,8,6,5,0,6,0,0,17,25
17479,Nigeria,2021,2021Nigeria,0,0,0,11,0,0,11,0,5,0,29,0,0,34,45
17480,Nigeria,2021,2021Nigeria,0,0,6,11,0,0,17,0,0,0,20,5,0,25,42
17481,Nigeria,2021,2021Nigeria,0,0,7,5,0,0,12,0,0,0,0,0,0,0,12
17482,Nigeria,2021,2021Nigeria,5,21,22,165,7,0,220,5,22,15,129,5,0,176,396
17483,Nigeria,2021,2021Nigeria,6,0,0,0,0,0,6,0,7,0,0,0,0,7,13
17484,Nigeria,2021,2021Nigeria,9,0,0,11,0,0,20,0,0,5,0,0,0,5,25
17485,Nigeria,2021,2021Nigeria,22,26,13,81,0,0,142,21,27,9,60,0,0,117,282
17486,Nigeria,2021,2021Nigeria,181,518,259,1700,15,69,2742,177,556,240,1191,11,44,2219,10172
17487,Nigeria,2021,2021Nigeria,1074,1396,314,3369,19,0,6172,913,1330,266,1317,25,0,3851,10023
17488,Nigeria,2021,2021Nigeria,1850,2347,1498,4085,186,0,9966,1706,2476,1294,3446,433,0,9355,19321
17489,Nigeria,2021,2021Nigeria,9386,17550,9289,26040,2780,0,65045,9465,17504,8890,17249,2775,0,55883,120928
17490,Nigeria,2021,2021Nigeria,12667,30982,13717,39584,3327,0,100277,12116,28674,12348,30789,2861,0,86788,187065
17491,North Macedonia,2001,2001North Macedonia,0,0,0,0,0,0,0,0,0,0,0,0,0,0,718
17492,North Macedonia,2001,2001North Macedonia,0,0,0,0,0,24,24,0,0,0,0,0,36,36,60
17493,North Macedonia,2001,2001North Macedonia,0,0,0,0,0,39,39,0,0,0,0,0,41,41,80
17494,North Macedonia,2001,2001North Macedonia,0,0,0,6,0,0,6,0,0,0,0,0,0,0,6
17495,North Macedonia,2001,2001North Macedonia,0,0,5,14,0,0,19,5,8,6,14,0,0,33,52
17496,North Macedonia,2001,2001North Macedonia,476,945,810,3300,418,0,5949,535,995,853,2189,292,0,4864,11276
17497,North Macedonia,2002,2002North Macedonia,0,0,0,0,0,0,0,0,0,0,0,0,0,0,4300
17498,North Macedonia,2002,2002North Macedonia,0,0,0,0,0,10,10,0,0,0,0,0,22,22,84
17499,North Macedonia,2002,2002North Macedonia,0,0,0,0,0,26,26,0,0,0,0,0,37,37,63
17500,North Macedonia,2002,2002North Macedonia,0,0,0,9,0,0,9,0,6,6,15,5,0,32,41
17501,North Macedonia,2002,2002North Macedonia,237,307,263,924,77,0,1808,261,351,300,720,74,0,1706,3614
17502,North Macedonia,2003,2003North Macedonia,0,0,0,0,0,0,0,0,0,0,0,0,0,0,4380
17503,North Macedonia,2003,2003North Macedonia,0,0,0,0,0,11,11,0,0,0,0,0,24,24,114
17504,North Macedonia,2003,2003North Macedonia,0,0,0,0,0,35,35,0,0,0,0,0,49,49,84
17505,North Macedonia,2003,2003North Macedonia,95,122,104,350,30,0,701,102,140,120,260,70,0,692,1403
17506,North Macedonia,2004,2004North Macedonia,0,0,0,0,0,0,0,0,0,0,0,0,0,0,4191
17507,North Macedonia,2004,2004North Macedonia,0,0,0,0,0,5,5,0,0,0,0,0,0,0,5
17508,North Macedonia,2004,2004North Macedonia,0,7,7,31,5,10,60,5,11,10,23,0,22,71,131
17509,North Macedonia,2004,2004North Macedonia,55,70,60,200,20,0,405,55,73,62,130,39,5,364,779
17510,North Macedonia,2005,2005North Macedonia,0,0,0,0,0,0,0,0,0,0,0,0,0,0,7671
17511,North Macedonia,2005,2005North Macedonia,0,0,0,0,0,5,5,0,0,0,0,0,0,0,5
17512,North Macedonia,2005,2005North Macedonia,0,0,0,0,0,71,71,0,0,0,0,0,82,82,153
17513,North Macedonia,2005,2005North Macedonia,5,66,56,187,6,0,320,5,62,54,144,44,0,309,629
17514,North Macedonia,2005,2005North Macedonia,6,10,8,34,5,8,71,5,13,11,27,0,18,74,145
17515,North Macedonia,2006,2006North Macedonia,0,0,0,0,0,0,0,0,0,0,0,0,0,0,7168
17516,North Macedonia,2006,2006North Macedonia,0,0,0,0,0,0,0,0,0,0,0,0,6,6,6
17517,North Macedonia,2006,2006North Macedonia,0,0,0,0,0,14,14,0,0,0,0,0,22,22,36
17518,North Macedonia,2006,2006North Macedonia,0,0,0,0,0,75,75,0,0,0,0,0,78,78,153
17519,North Macedonia,2006,2006North Macedonia,0,0,0,0,0,82,82,0,0,0,0,0,94,94,176
17520,North Macedonia,2006,2006North Macedonia,5,32,32,114,9,0,192,7,38,39,108,14,0,206,398
17521,North Macedonia,2007,2007North Macedonia,0,0,0,0,0,0,0,0,0,0,0,0,0,0,7289
17522,North Macedonia,2007,2007North Macedonia,0,0,0,0,0,0,0,0,0,0,5,0,0,5,5
17523,North Macedonia,2007,2007North Macedonia,0,0,0,0,0,10,10,0,0,0,0,0,11,11,21
17524,North Macedonia,2007,2007North Macedonia,0,0,0,0,0,91,91,0,0,0,0,0,107,107,198
17525,North Macedonia,2007,2007North Macedonia,5,11,11,41,5,8,81,7,12,11,32,0,18,80,161
17526,North Macedonia,2007,2007North Macedonia,5,32,32,114,9,0,192,7,38,39,108,14,0,206,398
17527,North Macedonia,2008,2008North Macedonia,0,0,0,0,0,0,0,0,0,0,0,0,0,0,7132
17528,North Macedonia,2008,2008North Macedonia,0,0,0,0,0,0,0,0,0,0,0,0,10,10,10
17529,North Macedonia,2008,2008North Macedonia,0,0,0,0,0,0,0,0,0,0,5,0,0,5,5
17530,North Macedonia,2008,2008North Macedonia,0,0,0,0,0,96,96,0,0,0,0,0,110,110,206
17531,North Macedonia,2008,2008North Macedonia,5,16,9,40,5,9,84,6,13,9,30,0,18,76,160
17532,North Macedonia,2009,2009North Macedonia,0,0,0,0,0,0,0,0,0,0,0,0,0,0,1659
17533,North Macedonia,2009,2009North Macedonia,0,0,0,0,0,0,0,0,0,0,0,0,11,11,11
17534,North Macedonia,2009,2009North Macedonia,0,0,0,0,0,0,0,0,0,0,6,0,0,6,6
17535,North Macedonia,2009,2009North Macedonia,0,0,0,0,0,0,0,5,0,0,0,0,0,5,5
17536,North Macedonia,2009,2009North Macedonia,5,17,9,36,6,10,83,6,11,11,29,0,19,76,159
17537,North Macedonia,2009,2009North Macedonia,39,147,297,1954,68,0,2505,32,185,300,2994,65,0,3576,6081
17538,North Macedonia,2010,2010North Macedonia,0,0,0,0,0,0,0,0,0,0,0,0,0,0,1364
17539,North Macedonia,2010,2010North Macedonia,0,0,0,0,0,0,0,0,0,0,6,0,0,6,6
17540,North Macedonia,2010,2010North Macedonia,0,0,0,0,0,0,0,5,0,0,0,0,0,5,5
17541,North Macedonia,2010,2010North Macedonia,0,0,0,0,0,7,7,0,0,0,0,0,15,15,22
17542,North Macedonia,2010,2010North Macedonia,0,0,0,0,0,120,120,0,0,0,0,0,140,140,260
17543,North Macedonia,2010,2010North Macedonia,0,0,9,14,0,0,23,0,0,7,7,0,0,14,37
17544,North Macedonia,2010,2010North Macedonia,5,17,8,36,5,8,79,7,8,13,27,0,17,72,151
17545,North Macedonia,2010,2010North Macedonia,31,137,262,2001,77,0,2508,37,158,270,2996,66,0,3527,6035
17546,North Macedonia,2011,2011North Macedonia,0,0,0,0,0,0,0,0,0,0,0,0,0,0,1058
17547,North Macedonia,2011,2011North Macedonia,0,0,0,0,0,0,0,0,0,0,6,0,0,6,6
17548,North Macedonia,2011,2011North Macedonia,0,0,0,0,0,0,0,5,0,0,0,0,0,5,5
17549,North Macedonia,2011,2011North Macedonia,0,0,0,0,0,15,15,0,0,0,0,0,18,18,33
17550,North Macedonia,2011,2011North Macedonia,0,0,0,0,0,128,128,0,0,0,0,0,145,145,273
17551,North Macedonia,2011,2011North Macedonia,0,0,0,6,0,0,6,0,0,0,14,0,0,14,117
17552,North Macedonia,2011,2011North Macedonia,0,5,7,14,0,0,26,0,0,5,20,0,0,25,51
17553,North Macedonia,2011,2011North Macedonia,5,16,10,39,5,8,83,8,10,11,25,0,15,69,152
17554,North Macedonia,2011,2011North Macedonia,22,111,232,2004,93,0,2462,31,140,234,3042,73,0,3520,5982
17555,North Macedonia,2012,2012North Macedonia,0,0,0,0,0,0,0,0,0,0,0,0,0,0,791
17556,North Macedonia,2012,2012North Macedonia,0,0,0,0,0,0,0,0,0,0,6,0,0,6,6
17557,North Macedonia,2012,2012North Macedonia,0,0,0,0,0,0,0,5,0,0,0,0,0,5,5
17558,North Macedonia,2012,2012North Macedonia,0,0,0,0,0,20,20,0,0,0,0,0,25,25,45
17559,North Macedonia,2012,2012North Macedonia,0,0,0,0,0,144,144,0,0,0,0,0,156,156,300
17560,North Macedonia,2012,2012North Macedonia,0,0,0,9,0,0,9,0,0,0,8,0,0,8,97
17561,North Macedonia,2012,2012North Macedonia,6,14,12,46,0,8,86,8,15,11,28,0,15,77,163
17562,North Macedonia,2012,2012North Macedonia,34,118,227,2108,112,0,2599,30,142,223,3068,113,0,3576,6175
17563,North Macedonia,2013,2013North Macedonia,0,0,0,0,0,0,0,0,0,0,0,0,0,0,796
17564,North Macedonia,2013,2013North Macedonia,0,0,0,0,0,0,0,0,0,0,5,0,0,5,5
17565,North Macedonia,2013,2013North Macedonia,0,0,0,0,0,0,0,0,0,0,6,0,0,6,6
17566,North Macedonia,2013,2013North Macedonia,0,0,0,0,0,0,0,5,0,0,0,0,0,5,5
17567,North Macedonia,2013,2013North Macedonia,0,0,0,0,0,151,151,0,0,0,0,0,165,165,316
17568,North Macedonia,2013,2013North Macedonia,5,10,13,45,0,8,81,5,13,10,29,0,15,72,153
17569,North Macedonia,2013,2013North Macedonia,5,19,42,89,9,0,164,9,20,41,93,14,0,177,341
17570,North Macedonia,2014,2014North Macedonia,0,0,0,0,0,0,0,0,0,0,0,0,0,0,837
17571,North Macedonia,2014,2014North Macedonia,0,0,0,0,0,0,0,0,5,0,0,0,0,5,5
17572,North Macedonia,2014,2014North Macedonia,0,0,0,0,0,154,154,0,0,0,0,0,162,162,316
17573,North Macedonia,2014,2014North Macedonia,0,0,0,0,6,0,6,0,0,0,0,0,0,0,6
17574,North Macedonia,2014,2014North Macedonia,0,0,0,7,0,0,7,0,0,0,5,5,0,10,17
17575,North Macedonia,2014,2014North Macedonia,10,11,18,52,0,9,100,8,17,11,30,0,15,81,181
17576,North Macedonia,2014,2014North Macedonia,10,18,42,118,10,0,198,12,23,39,102,16,0,192,390
17577,North Macedonia,2015,2015North Macedonia,0,0,0,0,0,0,0,0,0,0,0,0,0,0,682
17578,North Macedonia,2015,2015North Macedonia,0,0,0,0,0,0,0,0,0,0,6,0,0,6,6
17579,North Macedonia,2015,2015North Macedonia,0,0,0,0,0,0,0,0,0,0,9,0,0,9,9
17580,North Macedonia,2015,2015North Macedonia,0,0,0,0,0,0,0,0,5,0,0,0,0,5,5
17581,North Macedonia,2015,2015North Macedonia,0,0,0,0,0,46,46,0,0,0,0,0,55,55,101
17582,North Macedonia,2015,2015North Macedonia,0,0,0,0,0,157,157,0,0,0,0,0,166,166,323
17583,North Macedonia,2015,2015North Macedonia,5,6,5,24,0,47,87,7,7,7,44,0,32,97,184
17584,North Macedonia,2015,2015North Macedonia,12,22,27,154,12,0,227,10,27,41,134,20,0,232,459
17585,North Macedonia,2016,2016North Macedonia,0,0,0,0,0,0,0,0,0,0,0,0,0,0,537
17586,North Macedonia,2016,2016North Macedonia,0,0,0,0,0,0,0,0,0,0,6,0,0,6,6
17587,North Macedonia,2016,2016North Macedonia,0,0,0,0,0,0,0,0,0,0,9,0,0,9,9
17588,North Macedonia,2016,2016North Macedonia,0,0,0,0,0,0,0,0,0,5,0,0,0,5,48
17589,North Macedonia,2016,2016North Macedonia,0,0,0,0,0,0,0,0,5,0,0,0,0,5,5
17590,North Macedonia,2016,2016North Macedonia,0,0,0,0,0,50,50,0,0,0,0,0,63,63,113
17591,North Macedonia,2016,2016North Macedonia,0,0,0,0,0,162,162,0,0,0,0,0,173,173,335
17592,North Macedonia,2016,2016North Macedonia,6,17,21,45,0,6,95,9,13,14,33,5,10,84,179
17593,North Macedonia,2016,2016North Macedonia,12,22,27,189,15,0,265,11,29,28,146,19,0,233,498
17594,North Macedonia,2017,2017North Macedonia,0,0,0,0,0,0,0,0,0,0,0,0,0,0,492
17595,North Macedonia,2017,2017North Macedonia,0,0,0,0,0,0,0,0,0,0,9,0,0,9,9
17596,North Macedonia,2017,2017North Macedonia,0,0,0,0,0,0,0,0,5,0,0,0,0,5,5
17597,North Macedonia,2017,2017North Macedonia,0,0,0,0,0,166,166,0,0,0,0,0,174,174,340
17598,North Macedonia,2017,2017North Macedonia,0,0,0,5,0,0,5,0,0,0,9,0,0,9,14
17599,North Macedonia,2017,2017North Macedonia,10,17,20,47,5,7,106,8,12,14,41,0,7,82,188
17600,North Macedonia,2017,2017North Macedonia,19,34,30,218,15,0,316,16,38,36,173,26,0,289,605
17601,North Macedonia,2018,2018North Macedonia,0,0,0,0,0,0,0,0,0,0,0,0,0,0,512
17602,North Macedonia,2018,2018North Macedonia,0,0,0,0,0,0,0,0,0,0,9,0,0,9,9
17603,North Macedonia,2018,2018North Macedonia,0,0,0,0,0,0,0,0,5,0,0,0,0,5,5
17604,North Macedonia,2018,2018North Macedonia,0,0,0,0,0,173,173,0,0,0,0,0,178,178,351
17605,North Macedonia,2018,2018North Macedonia,7,15,19,44,5,8,98,8,10,10,41,0,8,77,175
17606,North Macedonia,2018,2018North Macedonia,17,39,29,251,18,0,354,17,46,36,188,28,0,315,669
17607,North Macedonia,2019,2019North Macedonia,0,0,0,0,0,0,0,0,0,0,0,0,0,0,503
17608,North Macedonia,2019,2019North Macedonia,0,0,0,0,0,0,0,0,0,0,9,0,0,9,9
17609,North Macedonia,2019,2019North Macedonia,0,0,0,0,0,0,0,0,5,0,0,0,0,5,5
17610,North Macedonia,2019,2019North Macedonia,0,0,0,0,0,191,191,0,0,0,0,0,192,192,383
17611,North Macedonia,2019,2019North Macedonia,7,13,16,42,5,0,83,6,10,5,40,0,0,61,162
17612,North Macedonia,2019,2019North Macedonia,16,41,41,259,21,0,378,19,52,34,206,33,0,344,722
17613,North Macedonia,2020,2020North Macedonia,0,0,0,0,0,0,0,0,0,0,0,0,0,0,626
17614,North Macedonia,2020,2020North Macedonia,0,0,0,0,0,0,0,0,0,0,9,0,0,9,9
17615,North Macedonia,2020,2020North Macedonia,0,0,0,0,0,54,54,0,0,0,0,0,74,74,128
17616,North Macedonia,2020,2020North Macedonia,5,12,15,44,5,0,81,6,8,8,37,0,0,59,158
17617,North Macedonia,2020,2020North Macedonia,12,32,31,244,22,0,341,10,53,38,175,38,0,314,655
17618,North Macedonia,2021,2021North Macedonia,0,0,0,0,0,0,0,0,0,0,0,0,0,0,1065
17619,North Macedonia,2021,2021North Macedonia,0,0,0,0,0,0,0,0,0,0,9,0,0,9,9
17620,North Macedonia,2021,2021North Macedonia,0,0,0,6,0,0,6,0,0,0,0,0,0,0,6
17621,North Macedonia,2021,2021North Macedonia,5,14,9,45,5,0,78,6,7,9,31,5,0,58,155
17622,North Macedonia,2021,2021North Macedonia,6,26,38,222,26,0,318,8,43,41,159,38,0,289,607
17623,Pakistan,2001,2001Pakistan,0,0,0,0,0,0,0,0,0,0,0,0,0,0,11859
17624,Pakistan,2001,2001Pakistan,0,0,0,0,0,0,0,0,0,0,5,0,0,5,5
17625,Pakistan,2001,2001Pakistan,0,0,0,0,0,0,0,0,0,5,0,0,0,5,10
17626,Pakistan,2001,2001Pakistan,0,0,0,0,0,0,0,0,5,0,0,0,0,5,5
17627,Pakistan,2001,2001Pakistan,0,0,0,0,0,25,25,0,0,0,0,0,53,53,78
17628,Pakistan,2001,2001Pakistan,0,0,0,0,0,37,37,0,0,0,0,0,108,108,145
17629,Pakistan,2001,2001Pakistan,0,0,0,0,0,89,89,0,0,0,0,0,118,118,207
17630,Pakistan,2001,2001Pakistan,0,0,0,5,0,0,5,0,0,0,7,0,0,7,12
17631,Pakistan,2001,2001Pakistan,0,5,0,0,0,0,5,0,0,0,0,0,0,0,5
17632,Pakistan,2002,2002Pakistan,0,0,0,0,0,0,0,0,0,0,0,0,0,0,22723
17633,Pakistan,2002,2002Pakistan,0,0,0,0,0,0,0,0,0,0,5,0,0,5,5
17634,Pakistan,2002,2002Pakistan,0,0,0,0,0,0,0,0,0,5,0,0,0,5,10
17635,Pakistan,2002,2002Pakistan,0,0,0,0,0,41,41,0,0,0,0,0,116,116,157
17636,Pakistan,2002,2002Pakistan,0,0,0,0,0,52,52,0,0,0,0,0,67,67,193
17637,Pakistan,2002,2002Pakistan,0,0,9,15,0,0,24,6,5,0,31,0,0,42,66
17638,Pakistan,2002,2002Pakistan,0,5,0,0,0,0,5,0,0,0,0,0,0,0,5
17639,Pakistan,2002,2002Pakistan,5,0,0,0,0,0,5,0,0,0,0,0,0,0,5
17640,Pakistan,2003,2003Pakistan,0,0,0,0,0,0,0,0,0,0,0,0,0,0,23929
17641,Pakistan,2003,2003Pakistan,0,0,0,0,0,0,0,0,0,0,5,0,0,5,5
17642,Pakistan,2003,2003Pakistan,0,0,0,0,0,0,0,0,0,0,7,0,0,7,7
17643,Pakistan,2003,2003Pakistan,0,0,0,0,0,43,43,0,0,0,0,0,61,61,204
17644,Pakistan,2003,2003Pakistan,0,0,0,0,0,44,44,0,0,0,0,0,125,125,169
17645,Pakistan,2003,2003Pakistan,0,0,8,0,0,0,8,0,0,0,0,0,0,0,8
17646,Pakistan,2003,2003Pakistan,9,0,0,17,0,0,26,7,5,0,30,0,0,42,68
17647,Pakistan,2004,2004Pakistan,0,0,0,0,0,0,0,0,0,0,0,0,0,0,25574
17648,Pakistan,2004,2004Pakistan,0,0,0,0,0,0,0,0,0,0,5,0,0,5,5
17649,Pakistan,2004,2004Pakistan,0,0,0,0,0,0,0,0,0,0,14,0,0,14,14
17650,Pakistan,2004,2004Pakistan,0,0,0,0,0,0,0,0,9,0,0,0,0,9,9
17651,Pakistan,2004,2004Pakistan,0,0,0,5,0,0,5,0,0,0,8,0,0,8,13
17652,Pakistan,2004,2004Pakistan,0,0,0,6,0,0,6,0,0,0,0,0,0,0,6
17653,Pakistan,2004,2004Pakistan,0,0,0,9,0,0,9,0,0,0,0,0,0,0,9
17654,Pakistan,2004,2004Pakistan,0,0,6,5,0,0,11,0,5,0,27,0,0,32,43
17655,Pakistan,2004,2004Pakistan,0,9,0,0,0,0,9,0,0,0,0,0,0,0,9
17656,Pakistan,2004,2004Pakistan,5,0,0,5,0,0,10,0,0,5,27,0,0,32,42
17657,Pakistan,2004,2004Pakistan,5,7,6,22,0,36,76,5,10,9,31,0,55,110,186
17658,Pakistan,2004,2004Pakistan,9,0,0,8,0,0,17,0,0,8,8,0,0,16,33
17659,Pakistan,2005,2005Pakistan,0,0,0,0,0,0,0,0,0,0,0,0,0,0,29232
17660,Pakistan,2005,2005Pakistan,0,0,0,0,0,0,0,0,0,0,5,0,0,5,5
17661,Pakistan,2005,2005Pakistan,0,0,0,0,0,0,0,0,0,7,0,0,0,7,7
17662,Pakistan,2005,2005Pakistan,0,0,0,0,0,0,0,0,5,0,0,0,0,5,5
17663,Pakistan,2005,2005Pakistan,0,0,0,0,0,0,0,0,5,0,7,0,0,12,12
17664,Pakistan,2005,2005Pakistan,0,0,0,0,0,9,9,0,0,0,0,0,0,0,9
17665,Pakistan,2005,2005Pakistan,0,0,0,0,0,54,54,0,0,0,0,0,182,182,236
17666,Pakistan,2005,2005Pakistan,0,0,0,8,0,0,8,0,0,0,14,0,0,14,22
17667,Pakistan,2005,2005Pakistan,0,0,0,8,0,0,8,0,0,0,29,0,0,29,37
17668,Pakistan,2005,2005Pakistan,0,0,0,9,0,0,9,0,0,0,0,0,0,0,9
17669,Pakistan,2005,2005Pakistan,5,5,5,18,0,29,62,5,8,7,25,0,49,94,156
17670,Pakistan,2005,2005Pakistan,5,6,5,19,0,0,35,6,9,8,27,0,0,50,85
17671,Pakistan,2005,2005Pakistan,9,0,0,17,0,0,26,5,6,6,48,0,0,65,91
17672,Pakistan,2006,2006Pakistan,0,0,0,0,0,0,0,0,0,0,0,0,0,0,24676
17673,Pakistan,2006,2006Pakistan,0,0,0,0,0,0,0,0,0,0,0,0,5,5,5
17674,Pakistan,2006,2006Pakistan,0,0,0,0,0,0,0,0,0,0,0,0,7,7,7
17675,Pakistan,2006,2006Pakistan,0,0,0,0,0,0,0,0,0,0,5,0,0,5,10
17676,Pakistan,2006,2006Pakistan,0,0,0,0,0,0,0,0,0,0,6,0,0,6,6
17677,Pakistan,2006,2006Pakistan,0,0,0,0,0,9,9,0,0,0,0,0,0,0,9
17678,Pakistan,2006,2006Pakistan,0,0,0,0,0,30,30,0,0,0,0,0,42,42,72
17679,Pakistan,2006,2006Pakistan,0,0,0,0,0,62,62,0,0,0,0,0,98,98,160
17680,Pakistan,2006,2006Pakistan,0,0,0,0,0,67,67,0,0,0,0,0,205,205,272
17681,Pakistan,2006,2006Pakistan,0,0,0,6,0,0,6,0,0,0,12,0,0,12,18
17682,Pakistan,2006,2006Pakistan,0,0,0,8,0,0,8,0,0,0,0,0,0,0,8
17683,Pakistan,2006,2006Pakistan,0,0,7,0,0,0,7,0,0,0,30,0,0,30,37
17684,Pakistan,2006,2006Pakistan,0,8,0,12,0,0,20,6,11,0,42,0,0,59,79
17685,Pakistan,2006,2006Pakistan,8,11,6,34,5,0,64,7,12,7,46,5,0,77,141
17686,Pakistan,2006,2006Pakistan,15,6,0,27,0,0,48,11,8,6,63,0,0,88,136
17687,Pakistan,2007,2007Pakistan,0,0,0,0,0,0,0,0,0,0,0,0,0,0,30853
17688,Pakistan,2007,2007Pakistan,0,0,0,0,0,0,0,0,0,0,5,0,0,5,5
17689,Pakistan,2007,2007Pakistan,0,0,0,0,0,0,0,0,0,0,7,0,0,7,7
17690,Pakistan,2007,2007Pakistan,0,0,0,0,0,0,0,0,0,0,15,0,0,15,15
17691,Pakistan,2007,2007Pakistan,0,0,0,0,0,0,0,0,5,0,0,0,0,5,5
17692,Pakistan,2007,2007Pakistan,0,0,0,0,0,18,18,0,0,0,0,0,37,37,55
17693,Pakistan,2007,2007Pakistan,0,0,0,0,0,76,76,0,0,0,0,0,230,230,306
17694,Pakistan,2007,2007Pakistan,0,0,0,5,0,0,5,0,0,0,10,0,0,10,15
17695,Pakistan,2007,2007Pakistan,0,0,0,7,0,0,7,0,0,0,0,0,0,0,7
17696,Pakistan,2007,2007Pakistan,0,0,7,0,0,0,7,0,0,0,29,0,0,29,36
17697,Pakistan,2007,2007Pakistan,0,6,0,0,0,0,6,0,0,0,7,0,0,7,13
17698,Pakistan,2007,2007Pakistan,0,7,0,20,0,25,52,5,0,10,20,0,46,81,133
17699,Pakistan,2007,2007Pakistan,8,0,8,22,0,0,38,6,5,8,42,0,0,61,99
17700,Pakistan,2007,2007Pakistan,12,7,0,27,0,0,46,13,8,5,65,0,0,91,137
17701,Pakistan,2007,2007Pakistan,13,15,8,38,5,0,79,6,17,9,50,0,0,82,161
17702,Pakistan,2008,2008Pakistan,0,0,0,0,0,0,0,0,0,0,0,0,0,0,31382
17703,Pakistan,2008,2008Pakistan,0,0,0,0,0,0,0,0,0,0,5,0,0,5,5
17704,Pakistan,2008,2008Pakistan,0,0,0,0,0,0,0,0,0,0,7,0,0,7,7
17705,Pakistan,2008,2008Pakistan,0,0,0,0,0,0,0,0,0,0,15,0,0,15,15
17706,Pakistan,2008,2008Pakistan,0,0,0,0,0,20,20,0,0,0,0,0,36,36,56
17707,Pakistan,2008,2008Pakistan,0,0,0,0,0,88,88,0,0,0,0,0,250,250,338
17708,Pakistan,2008,2008Pakistan,0,0,0,5,0,0,5,0,0,0,8,0,0,8,13
17709,Pakistan,2008,2008Pakistan,0,0,0,5,0,0,5,0,0,0,11,0,0,11,16
17710,Pakistan,2008,2008Pakistan,0,0,0,7,0,0,7,0,0,0,0,0,0,0,7
17711,Pakistan,2008,2008Pakistan,0,0,0,8,0,0,8,0,0,0,10,0,0,10,18
17712,Pakistan,2008,2008Pakistan,0,0,5,0,0,0,5,0,8,0,0,0,0,8,13
17713,Pakistan,2008,2008Pakistan,0,5,0,8,0,0,13,0,0,8,13,0,0,21,34
17714,Pakistan,2008,2008Pakistan,0,6,0,0,0,0,6,0,0,0,6,0,0,6,12
17715,Pakistan,2008,2008Pakistan,0,9,0,22,0,29,60,5,5,7,21,5,50,93,153
17716,Pakistan,2008,2008Pakistan,14,11,0,29,0,0,54,11,14,8,59,0,0,92,146
17717,Pakistan,2008,2008Pakistan,15,16,9,42,5,0,87,7,21,11,50,0,0,89,176
17718,Pakistan,2009,2009Pakistan,0,0,0,0,0,0,0,0,0,0,0,0,0,0,27192
17719,Pakistan,2009,2009Pakistan,0,0,0,0,0,0,0,0,0,0,5,0,0,5,10
17720,Pakistan,2009,2009Pakistan,0,0,0,0,0,0,0,0,0,0,7,0,0,7,7
17721,Pakistan,2009,2009Pakistan,0,0,0,0,0,0,0,0,0,0,27,0,0,27,27
17722,Pakistan,2009,2009Pakistan,0,0,0,0,0,0,0,5,0,0,0,0,0,5,5
17723,Pakistan,2009,2009Pakistan,0,0,0,0,0,18,18,0,0,0,0,0,37,37,55
17724,Pakistan,2009,2009Pakistan,0,0,0,5,0,0,5,0,0,0,8,0,0,8,13
17725,Pakistan,2009,2009Pakistan,0,0,0,5,0,0,5,0,0,0,13,0,0,13,18
17726,Pakistan,2009,2009Pakistan,0,0,0,7,0,0,7,0,0,0,0,0,0,0,7
17727,Pakistan,2009,2009Pakistan,0,0,5,6,0,0,11,7,0,0,7,0,0,14,25
17728,Pakistan,2009,2009Pakistan,0,0,6,0,0,0,6,0,0,0,0,0,0,0,6
17729,Pakistan,2009,2009Pakistan,0,5,0,6,0,0,11,5,0,0,7,0,0,12,23
17730,Pakistan,2009,2009Pakistan,0,5,0,14,0,0,19,0,12,0,11,0,0,23,42
17731,Pakistan,2009,2009Pakistan,0,6,0,0,0,0,6,0,0,0,0,0,0,0,6
17732,Pakistan,2009,2009Pakistan,0,6,0,0,0,0,6,0,0,0,7,0,0,7,13
17733,Pakistan,2009,2009Pakistan,5,0,0,0,0,0,5,0,0,0,0,0,0,0,5
17734,Pakistan,2009,2009Pakistan,5,7,0,22,0,25,59,5,5,7,24,5,45,91,150
17735,Pakistan,2009,2009Pakistan,13,10,0,27,0,0,50,12,13,11,56,0,0,92,142
17736,Pakistan,2009,2009Pakistan,95,295,297,1666,223,0,2576,90,318,264,3784,351,0,4807,7383
17737,Pakistan,2010,2010Pakistan,0,0,0,0,0,0,0,0,0,0,0,0,0,0,25284
17738,Pakistan,2010,2010Pakistan,0,0,0,0,0,0,0,0,0,0,5,0,0,5,10
17739,Pakistan,2010,2010Pakistan,0,0,0,0,0,0,0,0,0,0,7,0,0,7,7
17740,Pakistan,2010,2010Pakistan,0,0,0,0,0,0,0,0,0,0,29,0,0,29,29
17741,Pakistan,2010,2010Pakistan,0,0,0,0,0,0,0,0,5,0,0,0,0,5,5
17742,Pakistan,2010,2010Pakistan,0,0,0,0,0,0,0,0,6,0,0,0,0,6,6
17743,Pakistan,2010,2010Pakistan,0,0,0,0,0,5,5,0,0,0,0,0,9,9,14
17744,Pakistan,2010,2010Pakistan,0,0,0,0,0,14,14,0,0,0,0,0,31,31,45
17745,Pakistan,2010,2010Pakistan,0,0,0,0,0,106,106,0,0,0,0,0,308,308,414
17746,Pakistan,2010,2010Pakistan,0,0,0,5,0,0,5,0,0,0,8,0,0,8,13
17747,Pakistan,2010,2010Pakistan,0,0,0,5,0,0,5,0,0,0,11,0,0,11,16
17748,Pakistan,2010,2010Pakistan,0,0,0,5,0,0,5,0,0,0,18,0,0,18,23
17749,Pakistan,2010,2010Pakistan,0,0,0,7,0,0,7,0,0,0,0,0,0,0,6398
17750,Pakistan,2010,2010Pakistan,0,0,0,8,0,0,8,0,0,0,0,0,0,0,8
17751,Pakistan,2010,2010Pakistan,0,0,6,0,0,0,6,5,0,0,0,0,0,5,11
17752,Pakistan,2010,2010Pakistan,0,5,0,6,0,0,11,5,0,0,8,0,0,13,24
17753,Pakistan,2010,2010Pakistan,0,5,5,17,0,0,27,0,0,7,16,0,0,23,50
17754,Pakistan,2010,2010Pakistan,0,5,7,13,0,0,25,5,7,5,18,0,0,35,60
17755,Pakistan,2010,2010Pakistan,5,0,0,0,0,0,5,0,0,0,0,0,0,0,5
17756,Pakistan,2010,2010Pakistan,5,5,0,15,0,23,48,0,0,5,22,0,39,66,114
17757,Pakistan,2010,2010Pakistan,5,7,0,10,0,0,22,7,0,0,16,0,0,23,45
17758,Pakistan,2010,2010Pakistan,9,10,5,51,5,0,80,7,10,20,47,0,0,84,164
17759,Pakistan,2010,2010Pakistan,11,16,0,35,0,0,62,15,16,8,55,0,0,94,156
17760,Pakistan,2010,2010Pakistan,72,271,273,1617,223,0,2456,80,269,256,3636,381,0,4622,7078
17761,Pakistan,2011,2011Pakistan,0,0,0,0,0,0,0,0,0,0,0,0,0,0,11565
17762,Pakistan,2011,2011Pakistan,0,0,0,0,0,0,0,0,0,0,5,0,0,5,10
17763,Pakistan,2011,2011Pakistan,0,0,0,0,0,0,0,0,0,0,7,0,0,7,14
17764,Pakistan,2011,2011Pakistan,0,0,0,0,0,0,0,0,0,0,20,0,0,20,42
17765,Pakistan,2011,2011Pakistan,0,0,0,0,0,0,0,0,0,0,29,0,0,29,29
17766,Pakistan,2011,2011Pakistan,0,0,0,0,0,0,0,0,0,5,21,0,0,26,26
17767,Pakistan,2011,2011Pakistan,0,0,0,0,0,0,0,0,5,0,0,0,0,5,10
17768,Pakistan,2011,2011Pakistan,0,0,0,0,0,5,5,0,0,0,0,0,6,6,11
17769,Pakistan,2011,2011Pakistan,0,0,0,0,0,8,8,0,0,0,0,0,28,28,41
17770,Pakistan,2011,2011Pakistan,0,0,0,0,0,118,118,0,0,0,0,0,353,353,471
17771,Pakistan,2011,2011Pakistan,0,0,0,5,0,0,5,0,0,0,7,0,0,7,12
17772,Pakistan,2011,2011Pakistan,0,0,0,5,0,0,5,0,7,0,0,0,0,7,12
17773,Pakistan,2011,2011Pakistan,0,0,0,6,0,0,6,0,0,0,17,0,0,17,23
17774,Pakistan,2011,2011Pakistan,0,0,0,7,0,0,7,0,0,0,7,0,0,7,14
17775,Pakistan,2011,2011Pakistan,0,0,0,8,0,0,8,0,0,0,0,0,0,0,8
17776,Pakistan,2011,2011Pakistan,0,0,6,0,0,0,6,0,0,0,8,0,0,8,14
17777,Pakistan,2011,2011Pakistan,0,0,9,19,0,0,28,0,6,7,25,0,0,38,66
17778,Pakistan,2011,2011Pakistan,0,5,0,0,0,0,5,0,0,0,16,0,0,16,21
17779,Pakistan,2011,2011Pakistan,0,5,0,6,0,0,11,5,0,0,7,0,0,12,23
17780,Pakistan,2011,2011Pakistan,0,5,5,6,0,0,16,0,8,5,0,0,0,13,2972
17781,Pakistan,2011,2011Pakistan,0,7,0,9,0,0,16,6,0,0,7,0,0,13,29
17782,Pakistan,2011,2011Pakistan,5,5,0,14,0,23,47,0,6,0,21,0,42,69,116
17783,Pakistan,2011,2011Pakistan,5,7,0,11,0,0,23,5,5,0,15,0,0,25,48
17784,Pakistan,2011,2011Pakistan,6,7,5,50,0,0,68,0,12,12,36,5,0,65,133
17785,Pakistan,2011,2011Pakistan,11,16,0,34,0,0,61,13,15,5,56,0,0,89,150
17786,Pakistan,2011,2011Pakistan,15,23,11,77,0,0,126,26,34,20,99,5,0,184,310
17787,Pakistan,2011,2011Pakistan,16,53,40,280,76,0,465,9,42,44,306,62,0,463,13149
17788,Pakistan,2011,2011Pakistan,57,216,222,1523,220,0,2238,59,232,220,3485,395,0,4391,6629
17789,Pakistan,2012,2012Pakistan,0,0,0,0,0,0,0,0,0,0,0,0,0,0,13353
17790,Pakistan,2012,2012Pakistan,0,0,0,0,0,0,0,0,0,0,5,0,0,5,10
17791,Pakistan,2012,2012Pakistan,0,0,0,0,0,0,0,0,0,0,7,0,0,7,14
17792,Pakistan,2012,2012Pakistan,0,0,0,0,0,0,0,0,0,0,14,0,0,14,41
17793,Pakistan,2012,2012Pakistan,0,0,0,0,0,0,0,0,0,0,29,0,0,29,29
17794,Pakistan,2012,2012Pakistan,0,0,0,0,0,0,0,0,0,5,23,0,0,28,28
17795,Pakistan,2012,2012Pakistan,0,0,0,0,0,0,0,0,0,20,0,0,0,20,20
17796,Pakistan,2012,2012Pakistan,0,0,0,0,0,0,0,0,5,0,0,0,0,5,15
17797,Pakistan,2012,2012Pakistan,0,0,0,0,0,0,0,5,0,0,0,0,0,5,5
17798,Pakistan,2012,2012Pakistan,0,0,0,0,0,5,5,0,0,0,0,0,5,5,10
17799,Pakistan,2012,2012Pakistan,0,0,0,0,0,7,7,0,0,0,0,0,16,16,23
17800,Pakistan,2012,2012Pakistan,0,0,0,0,0,9,9,0,0,0,0,0,30,30,39
17801,Pakistan,2012,2012Pakistan,0,0,0,0,0,137,137,0,0,0,0,0,410,410,547
17802,Pakistan,2012,2012Pakistan,0,0,0,7,0,0,7,0,0,0,8,0,0,8,15
17803,Pakistan,2012,2012Pakistan,0,0,7,0,0,0,7,0,0,5,7,0,0,12,19
17804,Pakistan,2012,2012Pakistan,0,0,8,0,0,0,8,0,0,0,0,0,0,0,8
17805,Pakistan,2012,2012Pakistan,0,5,0,0,0,0,5,0,0,0,13,0,0,13,18
17806,Pakistan,2012,2012Pakistan,0,5,5,16,0,0,26,0,0,8,18,0,0,26,52
17807,Pakistan,2012,2012Pakistan,0,7,0,10,0,24,41,0,5,0,18,0,35,58,99
17808,Pakistan,2012,2012Pakistan,0,7,11,5,0,0,23,8,0,27,5,0,0,40,63
17809,Pakistan,2012,2012Pakistan,0,8,5,7,0,0,20,5,0,0,7,0,0,12,32
17810,Pakistan,2012,2012Pakistan,0,22,0,0,0,0,22,0,13,0,0,0,0,13,16147
17811,Pakistan,2012,2012Pakistan,5,7,8,29,0,0,49,6,11,8,30,0,0,55,104
17812,Pakistan,2012,2012Pakistan,8,8,6,23,0,0,45,9,6,5,31,0,0,51,96
17813,Pakistan,2012,2012Pakistan,10,15,8,77,0,0,110,24,19,22,94,5,0,164,274
17814,Pakistan,2012,2012Pakistan,14,16,5,41,0,0,76,13,15,6,59,0,0,93,169
17815,Pakistan,2012,2012Pakistan,15,19,20,150,49,0,253,13,23,12,167,32,0,247,11605
17816,Pakistan,2012,2012Pakistan,51,225,241,1552,239,0,2308,65,201,235,3667,467,0,4635,6943
17817,Pakistan,2013,2013Pakistan,0,0,0,0,0,0,0,0,0,0,0,0,0,0,15657
17818,Pakistan,2013,2013Pakistan,0,0,0,0,0,0,0,0,0,0,0,0,5,5,18
17819,Pakistan,2013,2013Pakistan,0,0,0,0,0,0,0,0,0,0,5,0,0,5,10
17820,Pakistan,2013,2013Pakistan,0,0,0,0,0,0,0,0,0,0,29,0,0,29,29
17821,Pakistan,2013,2013Pakistan,0,0,0,0,0,0,0,0,0,0,38,5,0,43,43
17822,Pakistan,2013,2013Pakistan,0,0,0,0,0,0,0,0,5,0,0,0,0,5,5
17823,Pakistan,2013,2013Pakistan,0,0,0,0,0,0,0,0,8,0,0,0,0,8,8
17824,Pakistan,2013,2013Pakistan,0,0,0,0,0,0,0,5,0,0,0,0,0,5,5
17825,Pakistan,2013,2013Pakistan,0,0,0,0,0,5,5,0,0,0,0,0,5,5,10
17826,Pakistan,2013,2013Pakistan,0,0,0,0,0,11,11,0,0,0,0,0,46,46,77
17827,Pakistan,2013,2013Pakistan,0,0,0,0,0,150,150,0,0,0,0,0,533,533,683
17828,Pakistan,2013,2013Pakistan,0,0,0,5,0,0,5,0,0,5,0,0,0,5,10
17829,Pakistan,2013,2013Pakistan,0,0,0,5,0,0,5,5,0,0,8,0,0,13,18
17830,Pakistan,2013,2013Pakistan,0,0,0,6,0,0,6,0,0,0,0,0,0,0,6
17831,Pakistan,2013,2013Pakistan,0,0,0,7,0,0,7,0,0,5,14,0,0,19,26
17832,Pakistan,2013,2013Pakistan,0,0,0,9,0,0,9,0,0,0,0,0,0,0,9
17833,Pakistan,2013,2013Pakistan,0,0,0,9,0,0,9,0,0,5,5,0,0,10,19
17834,Pakistan,2013,2013Pakistan,0,0,0,11,0,0,11,5,0,0,18,0,0,23,34
17835,Pakistan,2013,2013Pakistan,0,0,0,16,0,0,16,0,6,0,38,0,0,44,60
17836,Pakistan,2013,2013Pakistan,0,0,5,11,0,0,16,0,0,11,93,0,0,104,120
17837,Pakistan,2013,2013Pakistan,0,0,5,12,0,0,17,0,13,0,10,0,0,23,40
17838,Pakistan,2013,2013Pakistan,0,5,8,39,5,0,57,0,8,11,62,5,0,86,143
17839,Pakistan,2013,2013Pakistan,0,6,0,5,0,0,11,0,0,5,8,0,0,13,24
17840,Pakistan,2013,2013Pakistan,0,6,0,8,0,27,41,0,5,0,15,0,38,58,99
17841,Pakistan,2013,2013Pakistan,0,8,7,7,0,0,22,0,0,12,0,0,0,12,16825
17842,Pakistan,2013,2013Pakistan,5,0,0,0,0,0,5,0,0,0,0,0,0,0,5
17843,Pakistan,2013,2013Pakistan,5,14,9,38,0,0,66,5,14,14,44,0,0,77,143
17844,Pakistan,2013,2013Pakistan,9,10,6,45,0,0,70,14,12,7,49,0,0,82,152
17845,Pakistan,2013,2013Pakistan,11,14,7,43,5,0,80,10,21,9,64,6,0,110,190
17846,Pakistan,2013,2013Pakistan,12,20,5,49,0,0,86,13,15,7,59,0,0,94,180
17847,Pakistan,2013,2013Pakistan,27,67,50,278,57,0,479,15,62,45,260,52,0,434,10641
17848,Pakistan,2013,2013Pakistan,94,160,107,733,161,0,1255,82,177,116,1621,136,0,2132,3387
17849,Pakistan,2014,2014Pakistan,0,0,0,0,0,0,0,0,0,0,0,0,0,0,19752
17850,Pakistan,2014,2014Pakistan,0,0,0,0,0,0,0,0,0,0,5,0,0,5,15
17851,Pakistan,2014,2014Pakistan,0,0,0,0,0,0,0,0,0,0,8,0,0,8,8
17852,Pakistan,2014,2014Pakistan,0,0,0,0,0,0,0,0,0,0,16,0,0,16,16
17853,Pakistan,2014,2014Pakistan,0,0,0,0,0,0,0,0,0,0,25,0,0,25,25
17854,Pakistan,2014,2014Pakistan,0,0,0,0,0,0,0,0,5,0,0,0,0,5,5
17855,Pakistan,2014,2014Pakistan,0,0,0,0,0,0,0,0,6,0,0,0,0,6,6
17856,Pakistan,2014,2014Pakistan,0,0,0,0,0,0,0,0,7,0,0,0,0,7,7
17857,Pakistan,2014,2014Pakistan,0,0,0,0,0,0,0,5,0,0,0,0,0,5,10
17858,Pakistan,2014,2014Pakistan,0,0,0,0,0,6,6,0,0,0,0,0,12,12,18
17859,Pakistan,2014,2014Pakistan,0,0,0,0,0,6,6,0,0,0,0,0,31,31,37
17860,Pakistan,2014,2014Pakistan,0,0,0,0,0,168,168,0,0,0,0,0,668,668,836
17861,Pakistan,2014,2014Pakistan,0,0,0,5,0,0,5,0,0,0,8,0,0,8,13
17862,Pakistan,2014,2014Pakistan,0,0,0,5,0,0,5,0,0,5,0,0,0,5,10
17863,Pakistan,2014,2014Pakistan,0,0,0,6,0,0,6,0,0,0,0,0,0,0,12
17864,Pakistan,2014,2014Pakistan,0,0,0,6,0,0,6,0,0,0,39,5,0,44,50
17865,Pakistan,2014,2014Pakistan,0,0,0,10,0,0,10,0,0,0,58,0,0,58,68
17866,Pakistan,2014,2014Pakistan,0,0,0,12,0,0,12,7,0,0,19,0,0,26,38
17867,Pakistan,2014,2014Pakistan,0,0,8,0,0,0,8,0,0,0,9,0,0,9,17
17868,Pakistan,2014,2014Pakistan,0,5,0,0,0,0,5,0,0,0,0,0,0,0,5
17869,Pakistan,2014,2014Pakistan,0,5,10,5,0,0,20,0,5,8,5,0,0,18,38
17870,Pakistan,2014,2014Pakistan,0,7,0,9,0,24,40,0,5,0,21,0,38,64,104
17871,Pakistan,2014,2014Pakistan,0,13,0,5,0,0,18,0,5,0,20,0,0,25,43
17872,Pakistan,2014,2014Pakistan,5,0,8,20,0,0,33,0,5,18,170,0,0,193,226
17873,Pakistan,2014,2014Pakistan,11,0,0,6,0,0,17,0,0,0,11,0,0,11,28
17874,Pakistan,2014,2014Pakistan,14,17,5,70,0,0,106,19,18,15,77,0,0,129,235
17875,Pakistan,2014,2014Pakistan,17,16,12,69,5,0,119,14,24,10,95,0,0,143,262
17876,Pakistan,2014,2014Pakistan,20,34,22,105,5,0,186,22,35,21,103,5,0,186,372
17877,Pakistan,2014,2014Pakistan,23,32,18,90,6,0,169,16,39,21,109,8,0,193,362
17878,Pakistan,2014,2014Pakistan,31,53,26,231,69,0,410,32,59,43,258,52,0,444,8613
17879,Pakistan,2014,2014Pakistan,103,208,133,859,196,0,1499,104,229,136,2200,163,0,2832,4331
17880,Pakistan,2014,2014Pakistan,19638,25396,22380,72673,2821,0,142908,19661,28078,19713,64262,5607,0,137321,300385
17881,Pakistan,2015,2015Pakistan,0,0,0,0,0,0,0,0,0,0,0,0,0,0,31512
17882,Pakistan,2015,2015Pakistan,0,0,0,0,0,0,0,0,0,0,0,0,9,9,9
17883,Pakistan,2015,2015Pakistan,0,0,0,0,0,0,0,0,0,0,5,0,0,5,10
17884,Pakistan,2015,2015Pakistan,0,0,0,0,0,0,0,0,0,0,6,0,0,6,6
17885,Pakistan,2015,2015Pakistan,0,0,0,0,0,0,0,0,0,0,13,0,0,13,13
17886,Pakistan,2015,2015Pakistan,0,0,0,0,0,0,0,0,0,0,34,0,0,34,34
17887,Pakistan,2015,2015Pakistan,0,0,0,0,0,0,0,0,0,6,23,0,0,29,29
17888,Pakistan,2015,2015Pakistan,0,0,0,0,0,0,0,5,0,0,0,0,0,5,5
17889,Pakistan,2015,2015Pakistan,0,0,0,0,0,45,45,0,0,0,0,0,143,143,188
17890,Pakistan,2015,2015Pakistan,0,0,0,0,0,189,189,0,0,0,0,0,772,772,961
17891,Pakistan,2015,2015Pakistan,0,0,0,5,0,0,5,0,0,0,14,0,5,19,24
17892,Pakistan,2015,2015Pakistan,0,0,0,5,0,0,5,0,0,5,0,0,0,5,10
17893,Pakistan,2015,2015Pakistan,0,0,0,6,0,0,6,0,0,0,0,0,0,0,12
17894,Pakistan,2015,2015Pakistan,0,0,0,7,0,0,7,0,0,0,21,5,0,26,33
17895,Pakistan,2015,2015Pakistan,0,0,5,0,0,0,5,0,0,0,8,0,0,8,13
17896,Pakistan,2015,2015Pakistan,0,0,8,0,0,0,8,0,0,5,5,0,0,10,18
17897,Pakistan,2015,2015Pakistan,0,5,0,0,0,0,5,0,0,0,0,0,0,0,5
17898,Pakistan,2015,2015Pakistan,0,5,5,13,0,9,32,0,7,0,20,0,8,35,112
17899,Pakistan,2015,2015Pakistan,0,7,0,17,0,0,24,0,10,5,94,0,0,109,133
17900,Pakistan,2015,2015Pakistan,0,7,0,28,0,0,35,12,9,0,79,0,0,100,135
17901,Pakistan,2015,2015Pakistan,5,0,5,23,0,0,33,0,0,9,19,5,0,33,66
17902,Pakistan,2015,2015Pakistan,5,7,5,51,5,0,73,5,7,11,66,5,0,94,167
17903,Pakistan,2015,2015Pakistan,5,15,0,15,0,0,35,0,7,0,27,0,0,34,69
17904,Pakistan,2015,2015Pakistan,5,17,0,7,0,0,29,0,0,5,7,0,0,12,41
17905,Pakistan,2015,2015Pakistan,6,0,15,49,0,0,70,10,11,13,240,0,0,274,344
17906,Pakistan,2015,2015Pakistan,8,0,0,0,0,0,8,0,0,0,0,0,0,0,8
17907,Pakistan,2015,2015Pakistan,8,0,0,5,0,0,13,0,8,0,0,0,0,8,21
17908,Pakistan,2015,2015Pakistan,15,18,5,66,5,0,109,18,16,14,69,5,0,122,237
17909,Pakistan,2015,2015Pakistan,16,19,13,67,5,0,120,7,24,11,94,5,0,141,261
17910,Pakistan,2015,2015Pakistan,32,64,25,171,11,0,303,40,56,26,198,8,0,328,631
17911,Pakistan,2015,2015Pakistan,37,57,25,141,12,0,272,24,52,24,169,13,0,282,554
17912,Pakistan,2015,2015Pakistan,86,165,124,941,205,0,1521,78,213,135,2568,187,0,3181,4702
17913,Pakistan,2015,2015Pakistan,24244,20074,26249,44062,5285,0,119914,20691,20546,27756,41366,6765,0,117124,257523
17914,Pakistan,2016,2016Pakistan,0,0,0,0,0,0,0,0,0,0,0,0,0,0,29817
17915,Pakistan,2016,2016Pakistan,0,0,0,0,0,0,0,0,0,0,0,0,10,10,10
17916,Pakistan,2016,2016Pakistan,0,0,0,0,0,0,0,0,0,0,5,0,0,5,15
17917,Pakistan,2016,2016Pakistan,0,0,0,0,0,0,0,0,0,0,7,0,0,7,7
17918,Pakistan,2016,2016Pakistan,0,0,0,0,0,0,0,0,0,0,10,0,0,10,10
17919,Pakistan,2016,2016Pakistan,0,0,0,0,0,0,0,0,0,5,0,0,0,5,5
17920,Pakistan,2016,2016Pakistan,0,0,0,0,0,0,0,0,0,7,0,0,0,7,7
17921,Pakistan,2016,2016Pakistan,0,0,0,0,0,0,0,0,5,0,0,0,0,5,5
17922,Pakistan,2016,2016Pakistan,0,0,0,0,0,42,42,0,0,0,0,0,180,180,222
17923,Pakistan,2016,2016Pakistan,0,0,0,0,0,219,219,0,0,0,0,0,918,918,1137
17924,Pakistan,2016,2016Pakistan,0,0,0,5,0,0,5,0,0,0,5,0,0,5,10
17925,Pakistan,2016,2016Pakistan,0,0,0,5,0,0,5,0,0,0,28,0,0,28,33
17926,Pakistan,2016,2016Pakistan,0,0,0,5,0,0,5,0,0,5,0,0,0,5,10
17927,Pakistan,2016,2016Pakistan,0,0,0,8,0,0,8,0,0,5,18,0,0,23,31
17928,Pakistan,2016,2016Pakistan,0,0,5,5,0,0,10,0,5,0,7,0,0,12,22
17929,Pakistan,2016,2016Pakistan,0,0,9,15,0,26,50,0,0,8,23,0,42,73,123
17930,Pakistan,2016,2016Pakistan,0,5,0,0,0,0,5,0,0,0,0,0,0,0,5
17931,Pakistan,2016,2016Pakistan,0,5,0,0,0,0,5,0,7,0,0,0,0,7,12
17932,Pakistan,2016,2016Pakistan,0,5,0,12,0,0,17,0,7,0,18,0,0,25,42
17933,Pakistan,2016,2016Pakistan,0,7,0,0,0,0,7,0,7,0,0,0,0,7,14
17934,Pakistan,2016,2016Pakistan,0,9,0,8,0,0,17,0,0,0,9,0,0,9,26
17935,Pakistan,2016,2016Pakistan,0,9,0,24,0,0,33,0,11,8,184,0,0,203,236
17936,Pakistan,2016,2016Pakistan,0,10,12,43,0,0,65,10,13,10,232,5,0,270,335
17937,Pakistan,2016,2016Pakistan,0,14,5,44,5,0,68,5,8,7,80,0,0,100,168
17938,Pakistan,2016,2016Pakistan,0,15,5,16,0,0,36,0,12,0,27,0,0,39,75
17939,Pakistan,2016,2016Pakistan,6,14,0,6,0,0,26,0,6,6,12,0,0,24,50
17940,Pakistan,2016,2016Pakistan,6,89,56,292,35,0,478,10,81,80,243,48,0,462,4564
17941,Pakistan,2016,2016Pakistan,8,0,0,0,0,0,8,0,0,0,0,0,0,0,8
17942,Pakistan,2016,2016Pakistan,10,7,11,35,0,0,63,14,8,5,40,5,0,72,135
17943,Pakistan,2016,2016Pakistan,12,9,0,43,0,0,64,14,16,6,101,0,0,137,201
17944,Pakistan,2016,2016Pakistan,13,20,10,74,0,0,117,10,20,11,99,0,0,140,257
17945,Pakistan,2016,2016Pakistan,21,36,28,135,8,0,228,21,40,18,162,10,0,251,479
17946,Pakistan,2016,2016Pakistan,63,23,17,99,5,0,207,59,13,13,320,5,0,410,617
17947,Pakistan,2016,2016Pakistan,84,189,121,998,244,0,1636,76,204,148,2888,217,0,3533,5169
17948,Pakistan,2016,2016Pakistan,113,149,85,490,30,0,867,100,169,100,563,26,0,958,1825
17949,Pakistan,2016,2016Pakistan,5512,11424,2019,6930,510,0,26395,5756,13021,4339,9217,1009,0,33342,59737
17950,Pakistan,2017,2017Pakistan,0,0,0,0,0,0,0,0,0,0,0,0,0,0,39232
17951,Pakistan,2017,2017Pakistan,0,0,0,0,0,0,0,0,0,0,0,0,9,9,9
17952,Pakistan,2017,2017Pakistan,0,0,0,0,0,0,0,0,0,0,5,0,0,5,15
17953,Pakistan,2017,2017Pakistan,0,0,0,0,0,0,0,0,0,0,8,0,0,8,8
17954,Pakistan,2017,2017Pakistan,0,0,0,0,0,0,0,0,0,0,9,0,0,9,9
17955,Pakistan,2017,2017Pakistan,0,0,0,0,0,0,0,0,0,0,25,0,0,25,25
17956,Pakistan,2017,2017Pakistan,0,0,0,0,0,0,0,0,5,0,0,0,0,5,10
17957,Pakistan,2017,2017Pakistan,0,0,0,0,0,244,244,0,0,0,0,0,1155,1155,1399
17958,Pakistan,2017,2017Pakistan,0,0,0,5,0,0,5,0,0,5,0,0,0,5,10
17959,Pakistan,2017,2017Pakistan,0,0,0,5,0,0,5,0,5,0,0,0,0,5,10
17960,Pakistan,2017,2017Pakistan,0,0,0,5,0,0,5,0,5,0,30,0,0,35,40
17961,Pakistan,2017,2017Pakistan,0,0,0,5,0,0,5,5,0,0,14,0,0,19,260
17962,Pakistan,2017,2017Pakistan,0,0,0,7,0,0,7,0,0,0,9,0,0,9,16
17963,Pakistan,2017,2017Pakistan,0,0,0,8,0,0,8,0,0,5,19,0,0,24,32
17964,Pakistan,2017,2017Pakistan,0,0,0,8,0,0,8,0,0,8,10,0,0,18,26
17965,Pakistan,2017,2017Pakistan,0,0,0,9,0,0,9,0,0,0,9,0,0,9,18
17966,Pakistan,2017,2017Pakistan,0,0,5,0,0,0,5,0,0,0,5,0,0,5,10
17967,Pakistan,2017,2017Pakistan,0,5,0,0,0,0,5,0,0,0,0,0,0,0,5
17968,Pakistan,2017,2017Pakistan,0,5,0,0,0,0,5,0,0,7,0,0,0,7,12
17969,Pakistan,2017,2017Pakistan,0,6,5,16,0,52,79,0,0,12,32,0,27,71,150
17970,Pakistan,2017,2017Pakistan,0,13,0,22,0,0,35,0,7,10,25,0,0,42,77
17971,Pakistan,2017,2017Pakistan,0,15,5,18,0,0,38,0,14,0,34,0,0,48,86
17972,Pakistan,2017,2017Pakistan,5,5,15,49,0,0,74,15,19,6,258,0,0,298,372
17973,Pakistan,2017,2017Pakistan,5,8,5,43,5,0,66,0,9,7,85,5,0,106,172
17974,Pakistan,2017,2017Pakistan,5,13,9,6,0,0,33,0,0,15,8,0,0,23,56
17975,Pakistan,2017,2017Pakistan,10,17,10,67,0,0,104,8,16,10,90,0,0,124,228
17976,Pakistan,2017,2017Pakistan,13,14,5,50,0,0,82,10,22,7,103,0,0,142,224
17977,Pakistan,2017,2017Pakistan,14,9,7,43,0,0,73,25,15,5,50,5,0,100,173
17978,Pakistan,2017,2017Pakistan,25,40,22,165,10,0,262,32,41,22,235,8,0,338,600
17979,Pakistan,2017,2017Pakistan,51,84,55,309,16,0,515,50,84,50,376,15,0,575,1090
17980,Pakistan,2017,2017Pakistan,119,164,93,568,35,0,979,111,179,120,654,32,0,1096,2075
17981,Pakistan,2017,2017Pakistan,153,284,153,1280,284,0,2154,125,277,246,3512,258,0,4418,6572
17982,Pakistan,2017,2017Pakistan,6445,15077,2693,7606,610,0,32431,6738,17355,6227,11844,1298,0,43462,75893
17983,Pakistan,2018,2018Pakistan,0,0,0,0,0,0,0,0,0,0,0,0,0,0,39378
17984,Pakistan,2018,2018Pakistan,0,0,0,0,0,0,0,0,0,0,0,0,8,8,8
17985,Pakistan,2018,2018Pakistan,0,0,0,0,0,0,0,0,0,0,5,0,0,5,33
17986,Pakistan,2018,2018Pakistan,0,0,0,0,0,0,0,0,0,0,7,0,0,7,7
17987,Pakistan,2018,2018Pakistan,0,0,0,0,0,0,0,0,0,0,9,0,0,9,18
17988,Pakistan,2018,2018Pakistan,0,0,0,0,0,0,0,0,5,0,0,0,0,5,10
17989,Pakistan,2018,2018Pakistan,0,0,0,0,0,271,271,0,0,0,0,0,1368,1368,1639
17990,Pakistan,2018,2018Pakistan,0,0,0,5,0,0,5,0,0,0,0,0,0,0,5
17991,Pakistan,2018,2018Pakistan,0,0,0,5,0,0,5,0,5,0,0,0,0,5,10
17992,Pakistan,2018,2018Pakistan,0,0,0,5,0,0,5,0,6,0,0,0,0,6,11
17993,Pakistan,2018,2018Pakistan,0,0,0,7,0,0,7,0,0,8,0,0,0,8,15
17994,Pakistan,2018,2018Pakistan,0,0,0,8,0,0,8,0,0,5,19,0,0,24,32
17995,Pakistan,2018,2018Pakistan,0,0,0,17,0,0,17,0,0,0,9,0,0,9,26
17996,Pakistan,2018,2018Pakistan,0,5,0,0,0,0,5,0,0,0,0,0,0,0,5
17997,Pakistan,2018,2018Pakistan,0,5,0,0,0,0,5,0,7,0,0,0,0,7,12
17998,Pakistan,2018,2018Pakistan,0,6,0,0,0,0,6,0,0,5,31,0,0,36,42
17999,Pakistan,2018,2018Pakistan,0,8,6,18,0,42,74,5,5,7,46,0,69,132,206
18000,Pakistan,2018,2018Pakistan,0,13,0,23,0,0,36,0,8,5,42,0,0,55,91
18001,Pakistan,2018,2018Pakistan,0,16,10,43,0,0,69,0,23,5,243,0,0,271,340
18002,Pakistan,2018,2018Pakistan,0,17,14,0,0,0,31,0,0,5,15,0,0,20,51
18003,Pakistan,2018,2018Pakistan,0,21,5,22,0,0,48,0,10,5,39,0,0,54,102
18004,Pakistan,2018,2018Pakistan,5,0,0,0,0,0,5,0,0,0,0,0,0,0,5
18005,Pakistan,2018,2018Pakistan,5,8,5,49,0,0,67,5,11,5,92,5,0,118,185
18006,Pakistan,2018,2018Pakistan,7,18,9,65,0,0,99,6,13,11,84,5,0,119,218
18007,Pakistan,2018,2018Pakistan,11,18,7,41,0,0,77,20,19,9,95,0,0,143,220
18008,Pakistan,2018,2018Pakistan,12,12,5,44,5,0,78,31,23,0,49,5,0,108,186
18009,Pakistan,2018,2018Pakistan,25,32,9,134,12,0,212,32,45,35,226,8,0,346,558
18010,Pakistan,2018,2018Pakistan,48,174,148,621,101,0,1092,50,181,143,645,90,0,1109,5607
18011,Pakistan,2018,2018Pakistan,78,116,97,467,22,0,780,79,120,85,547,27,0,858,1638
18012,Pakistan,2018,2018Pakistan,105,151,89,535,30,0,910,98,177,115,614,28,0,1032,1942
18013,Pakistan,2018,2018Pakistan,195,309,198,1415,314,0,2431,164,304,258,4017,280,0,5023,7454
18014,Pakistan,2018,2018Pakistan,7521,8360,4890,15951,1584,0,38306,6787,8589,4322,12194,1996,0,33888,72194
18015,Pakistan,2019,2019Pakistan,0,0,0,0,0,0,0,0,0,0,0,0,0,0,47297
18016,Pakistan,2019,2019Pakistan,0,0,0,0,0,0,0,0,0,0,0,0,8,8,8
18017,Pakistan,2019,2019Pakistan,0,0,0,0,0,0,0,0,0,0,5,0,0,5,10
18018,Pakistan,2019,2019Pakistan,0,0,0,0,0,0,0,0,0,0,6,0,0,6,6
18019,Pakistan,2019,2019Pakistan,0,0,0,0,0,0,0,0,0,0,7,0,0,7,7
18020,Pakistan,2019,2019Pakistan,0,0,0,0,0,0,0,0,0,0,9,0,0,9,9
18021,Pakistan,2019,2019Pakistan,0,0,0,0,0,0,0,0,0,0,40,0,0,40,40
18022,Pakistan,2019,2019Pakistan,0,0,0,0,0,0,0,0,0,0,42,0,0,42,42
18023,Pakistan,2019,2019Pakistan,0,0,0,0,0,0,0,0,5,0,0,0,0,5,10
18024,Pakistan,2019,2019Pakistan,0,0,0,0,0,0,0,0,7,0,0,0,0,7,7
18025,Pakistan,2019,2019Pakistan,0,0,0,0,0,311,311,0,0,0,0,0,1541,1541,1852
18026,Pakistan,2019,2019Pakistan,0,0,0,5,0,0,5,0,0,0,5,0,0,5,20
18027,Pakistan,2019,2019Pakistan,0,0,0,5,0,0,5,0,6,0,0,0,0,6,11
18028,Pakistan,2019,2019Pakistan,0,0,0,5,5,0,10,0,5,0,6,0,0,11,21
18029,Pakistan,2019,2019Pakistan,0,0,0,6,0,0,6,0,0,0,0,0,0,0,6
18030,Pakistan,2019,2019Pakistan,0,0,0,7,0,0,7,0,0,12,7,0,0,19,26
18031,Pakistan,2019,2019Pakistan,0,0,0,8,0,0,8,0,0,8,0,0,0,8,16
18032,Pakistan,2019,2019Pakistan,0,0,5,7,0,0,12,0,0,5,21,0,0,26,38
18033,Pakistan,2019,2019Pakistan,0,5,0,0,0,0,5,0,0,0,0,0,0,0,5
18034,Pakistan,2019,2019Pakistan,0,5,0,0,0,0,5,0,5,0,0,0,0,5,10
18035,Pakistan,2019,2019Pakistan,0,5,0,5,0,0,10,0,8,0,24,0,0,32,42
18036,Pakistan,2019,2019Pakistan,0,6,7,25,0,0,38,0,10,5,35,0,0,50,88
18037,Pakistan,2019,2019Pakistan,0,9,0,16,0,0,25,0,5,5,18,0,0,28,53
18038,Pakistan,2019,2019Pakistan,0,15,9,38,0,0,62,6,24,0,224,0,0,254,316
18039,Pakistan,2019,2019Pakistan,5,0,0,0,0,0,5,0,0,0,0,0,0,0,5
18040,Pakistan,2019,2019Pakistan,5,12,6,53,0,0,76,6,11,6,71,6,0,100,176
18041,Pakistan,2019,2019Pakistan,6,5,9,23,0,0,43,5,14,12,58,0,0,89,241
18042,Pakistan,2019,2019Pakistan,7,16,18,76,5,0,122,6,13,7,144,5,0,175,297
18043,Pakistan,2019,2019Pakistan,10,18,8,41,0,0,77,18,22,8,95,0,0,143,220
18044,Pakistan,2019,2019Pakistan,13,14,10,46,5,0,88,21,28,5,59,6,0,119,207
18045,Pakistan,2019,2019Pakistan,20,49,40,180,13,0,302,42,70,42,332,12,0,498,800
18046,Pakistan,2019,2019Pakistan,75,128,85,450,26,0,764,82,151,111,536,23,0,903,1667
18047,Pakistan,2019,2019Pakistan,140,225,169,814,41,0,1389,155,236,197,1011,45,0,1644,3033
18048,Pakistan,2019,2019Pakistan,206,343,226,1548,332,0,2655,190,340,279,4373,288,0,5470,8125
18049,Pakistan,2019,2019Pakistan,7521,8360,4890,15951,1584,0,38306,6787,8589,4322,12191,1996,0,33885,72191
18050,Pakistan,2020,2020Pakistan,0,0,0,0,0,0,0,0,0,0,0,0,0,0,38273
18051,Pakistan,2020,2020Pakistan,0,0,0,0,0,0,0,0,0,0,0,0,7,7,7
18052,Pakistan,2020,2020Pakistan,0,0,0,0,0,0,0,0,0,0,5,0,0,5,15
18053,Pakistan,2020,2020Pakistan,0,0,0,0,0,0,0,0,0,0,7,0,0,7,7
18054,Pakistan,2020,2020Pakistan,0,0,0,0,0,0,0,0,0,0,10,0,0,10,10
18055,Pakistan,2020,2020Pakistan,0,0,0,0,0,0,0,0,0,0,29,0,0,29,29
18056,Pakistan,2020,2020Pakistan,0,0,0,0,0,0,0,0,0,0,32,0,0,32,32
18057,Pakistan,2020,2020Pakistan,0,0,0,0,0,0,0,0,0,0,36,0,0,36,36
18058,Pakistan,2020,2020Pakistan,0,0,0,0,0,0,0,0,0,5,0,0,0,5,5
18059,Pakistan,2020,2020Pakistan,0,0,0,0,0,0,0,0,0,9,0,0,0,9,9
18060,Pakistan,2020,2020Pakistan,0,0,0,0,0,0,0,0,5,0,0,0,0,5,5
18061,Pakistan,2020,2020Pakistan,0,0,0,0,0,40,40,0,0,0,0,0,66,66,106
18062,Pakistan,2020,2020Pakistan,0,0,0,0,0,53,53,0,0,0,0,0,59,59,112
18063,Pakistan,2020,2020Pakistan,0,0,0,0,0,77,77,0,0,0,0,0,223,223,300
18064,Pakistan,2020,2020Pakistan,0,0,0,5,0,0,5,0,0,0,5,0,0,5,10
18065,Pakistan,2020,2020Pakistan,0,0,0,5,0,0,5,0,0,6,0,0,0,6,11
18066,Pakistan,2020,2020Pakistan,0,0,0,6,0,0,6,0,0,0,0,0,0,0,6
18067,Pakistan,2020,2020Pakistan,0,0,0,7,0,0,7,0,0,0,9,0,0,9,16
18068,Pakistan,2020,2020Pakistan,0,0,0,8,0,0,8,0,0,0,9,0,0,9,17
18069,Pakistan,2020,2020Pakistan,0,0,5,0,0,0,5,0,0,0,0,0,0,0,5
18070,Pakistan,2020,2020Pakistan,0,0,5,7,0,0,12,0,0,5,22,0,0,27,39
18071,Pakistan,2020,2020Pakistan,0,0,5,26,0,0,31,0,0,13,16,0,0,29,60
18072,Pakistan,2020,2020Pakistan,0,0,6,0,0,0,6,0,0,0,0,0,0,0,6
18073,Pakistan,2020,2020Pakistan,0,5,0,0,0,0,5,0,5,0,0,0,0,5,10
18074,Pakistan,2020,2020Pakistan,0,5,0,5,0,0,10,0,8,0,19,0,0,27,37
18075,Pakistan,2020,2020Pakistan,0,5,0,11,0,0,16,0,6,0,10,0,0,16,32
18076,Pakistan,2020,2020Pakistan,0,5,12,26,0,0,43,0,12,6,41,0,0,59,102
18077,Pakistan,2020,2020Pakistan,0,8,0,5,0,0,13,0,0,0,8,0,0,8,21
18078,Pakistan,2020,2020Pakistan,0,9,0,16,0,0,25,0,5,5,18,0,0,28,53
18079,Pakistan,2020,2020Pakistan,0,13,7,35,0,0,55,5,10,5,209,0,0,229,284
18080,Pakistan,2020,2020Pakistan,5,0,0,0,0,0,5,0,0,0,0,0,0,0,5
18081,Pakistan,2020,2020Pakistan,5,6,8,27,0,0,46,7,14,17,58,0,0,96,273
18082,Pakistan,2020,2020Pakistan,5,10,8,55,0,0,78,6,11,9,71,9,0,106,184
18083,Pakistan,2020,2020Pakistan,8,20,16,93,5,0,142,10,18,7,183,5,0,223,365
18084,Pakistan,2020,2020Pakistan,9,19,11,47,0,0,86,18,21,16,94,0,0,149,235
18085,Pakistan,2020,2020Pakistan,10,27,5,48,6,0,96,18,26,5,62,7,0,118,214
18086,Pakistan,2020,2020Pakistan,22,58,34,171,10,0,295,45,56,39,332,9,0,481,776
18087,Pakistan,2020,2020Pakistan,26,49,30,131,26,65,327,30,50,20,365,34,16,515,6085
18088,Pakistan,2020,2020Pakistan,58,132,85,447,27,0,749,83,141,115,549,25,0,913,1662
18089,Pakistan,2020,2020Pakistan,127,232,178,866,43,0,1446,136,261,202,1068,53,0,1720,3166
18090,Pakistan,2020,2020Pakistan,216,368,246,1633,344,0,2807,198,369,292,4492,312,0,5663,8475
18091,Pakistan,2020,2020Pakistan,7516,8360,4891,15951,1584,0,38302,6787,8586,4320,12194,1996,0,33883,72185
18092,Pakistan,2021,2021Pakistan,0,0,0,0,0,0,0,0,0,0,0,0,0,0,41738
18093,Pakistan,2021,2021Pakistan,0,0,0,0,0,0,0,0,0,0,0,0,8,8,8
18094,Pakistan,2021,2021Pakistan,0,0,0,0,0,0,0,0,0,0,0,0,10,10,10
18095,Pakistan,2021,2021Pakistan,0,0,0,0,0,0,0,0,0,0,5,0,0,5,10
18096,Pakistan,2021,2021Pakistan,0,0,0,0,0,0,0,0,0,0,5,0,5,10,10
18097,Pakistan,2021,2021Pakistan,0,0,0,0,0,0,0,0,0,0,11,0,0,11,11
18098,Pakistan,2021,2021Pakistan,0,0,0,0,0,0,0,0,0,0,27,0,0,27,27
18099,Pakistan,2021,2021Pakistan,0,0,0,0,0,0,0,0,0,0,29,0,0,29,58
18100,Pakistan,2021,2021Pakistan,0,0,0,0,0,0,0,0,0,5,0,0,0,5,5
18101,Pakistan,2021,2021Pakistan,0,0,0,0,0,0,0,0,0,9,0,0,0,9,9
18102,Pakistan,2021,2021Pakistan,0,0,0,0,0,0,0,0,5,0,0,0,0,5,10
18103,Pakistan,2021,2021Pakistan,0,0,0,0,0,0,0,5,0,0,0,0,0,5,5
18104,Pakistan,2021,2021Pakistan,0,0,0,5,0,0,5,0,0,0,5,0,0,5,10
18105,Pakistan,2021,2021Pakistan,0,0,0,5,0,0,5,0,0,6,0,0,0,6,11
18106,Pakistan,2021,2021Pakistan,0,0,0,6,0,0,6,0,0,0,0,0,0,0,6
18107,Pakistan,2021,2021Pakistan,0,0,0,6,0,0,6,0,0,0,6,0,0,6,12
18108,Pakistan,2021,2021Pakistan,0,0,0,7,0,0,7,0,0,0,9,0,0,9,16
18109,Pakistan,2021,2021Pakistan,0,0,0,7,0,0,7,0,5,0,13,0,0,18,25
18110,Pakistan,2021,2021Pakistan,0,0,0,7,0,0,7,0,7,0,14,0,0,21,28
18111,Pakistan,2021,2021Pakistan,0,0,0,9,0,0,9,0,0,0,0,0,0,0,9
18112,Pakistan,2021,2021Pakistan,0,0,5,0,0,0,5,0,0,0,0,0,0,0,10
18113,Pakistan,2021,2021Pakistan,0,0,5,7,0,0,12,0,0,5,22,0,0,27,39
18114,Pakistan,2021,2021Pakistan,0,0,5,25,0,0,30,0,0,6,24,0,0,30,60
18115,Pakistan,2021,2021Pakistan,0,0,7,18,0,0,25,0,5,0,15,0,0,20,45
18116,Pakistan,2021,2021Pakistan,0,5,0,0,0,0,5,0,0,0,0,0,0,0,5
18117,Pakistan,2021,2021Pakistan,0,5,0,11,0,0,16,0,0,6,10,0,0,16,32
18118,Pakistan,2021,2021Pakistan,0,5,11,25,0,0,41,0,13,6,43,0,0,62,103
18119,Pakistan,2021,2021Pakistan,0,6,0,0,0,0,6,0,0,0,5,0,0,5,11
18120,Pakistan,2021,2021Pakistan,0,10,9,27,5,0,51,0,9,12,27,0,0,48,99
18121,Pakistan,2021,2021Pakistan,0,13,10,50,5,0,78,5,11,10,73,9,0,108,186
18122,Pakistan,2021,2021Pakistan,5,0,0,0,0,0,5,0,0,0,0,0,0,0,5
18123,Pakistan,2021,2021Pakistan,5,6,8,35,0,0,54,5,14,24,63,0,0,106,296
18124,Pakistan,2021,2021Pakistan,5,11,8,35,0,0,59,5,10,5,202,0,0,222,281
18125,Pakistan,2021,2021Pakistan,6,18,10,44,0,0,78,15,25,15,94,0,0,149,227
18126,Pakistan,2021,2021Pakistan,8,25,16,103,5,0,157,12,16,13,187,6,0,234,391
18127,Pakistan,2021,2021Pakistan,10,25,11,48,5,0,99,20,28,6,63,5,0,122,221
18128,Pakistan,2021,2021Pakistan,19,47,39,156,11,0,272,33,54,36,301,13,0,437,709
18129,Pakistan,2021,2021Pakistan,47,131,86,424,28,0,716,61,126,113,538,24,0,862,1578
18130,Pakistan,2021,2021Pakistan,66,140,100,490,73,65,934,87,158,96,990,76,16,1423,7171
18131,Pakistan,2021,2021Pakistan,133,250,190,989,51,0,1613,150,293,223,1294,59,0,2019,3632
18132,Pakistan,2021,2021Pakistan,216,394,269,1746,335,0,2960,210,387,333,4566,332,0,5828,8788
18133,Pakistan,2021,2021Pakistan,7005,7773,4568,14677,1483,0,35506,6323,7955,4049,11181,1897,0,31405,66911
18134,Palestinian,2001,2001Palestinian,0,0,0,0,0,0,0,0,0,0,0,0,0,0,339121
18135,Palestinian,2001,2001Palestinian,0,0,0,0,0,0,0,0,0,0,5,0,0,5,10
18136,Palestinian,2001,2001Palestinian,0,0,0,0,0,0,0,0,0,0,6,0,0,6,36
18137,Palestinian,2001,2001Palestinian,0,0,0,0,0,0,0,0,0,0,8,0,0,8,16
18138,Palestinian,2001,2001Palestinian,0,0,0,0,0,0,0,0,0,0,12,0,0,12,12
18139,Palestinian,2001,2001Palestinian,0,0,0,0,0,0,0,0,5,0,7,0,0,12,12
18140,Palestinian,2001,2001Palestinian,0,0,0,0,0,0,0,7,0,0,0,0,0,7,7
18141,Palestinian,2001,2001Palestinian,0,0,0,0,0,5,5,0,0,0,0,0,10,10,15
18142,Palestinian,2001,2001Palestinian,0,0,0,0,0,10,10,0,0,0,0,0,17,17,27
18143,Palestinian,2001,2001Palestinian,0,0,0,0,0,24,24,0,0,0,0,0,54,54,78
18144,Palestinian,2001,2001Palestinian,0,0,0,9,0,0,9,0,0,5,10,0,0,15,24
18145,Palestinian,2001,2001Palestinian,0,0,0,10,0,0,10,0,0,0,9,0,0,9,19
18146,Palestinian,2001,2001Palestinian,0,0,0,12,0,0,12,0,0,5,15,0,0,20,32
18147,Palestinian,2001,2001Palestinian,0,5,0,9,0,0,14,0,7,0,8,0,0,15,29
18148,Palestinian,2001,2001Palestinian,0,5,5,7,0,0,17,0,5,0,14,5,0,24,41
18149,Palestinian,2001,2001Palestinian,0,7,0,0,0,0,7,0,0,0,0,0,0,0,7
18150,Palestinian,2001,2001Palestinian,0,7,0,23,5,0,35,0,5,0,84,10,0,99,134
18151,Palestinian,2001,2001Palestinian,0,8,7,33,0,0,48,5,6,5,50,9,0,75,123
18152,Palestinian,2001,2001Palestinian,10,73,62,239,21,0,405,5,64,55,288,14,0,426,831
18153,Palestinian,2001,2001Palestinian,50,81,69,300,90,0,590,50,65,55,100,120,0,390,8584
18154,Palestinian,2002,2002Palestinian,0,0,0,0,0,0,0,0,0,0,0,0,0,0,347464
18155,Palestinian,2002,2002Palestinian,0,0,0,0,0,0,0,0,0,0,5,0,0,5,10
18156,Palestinian,2002,2002Palestinian,0,0,0,0,0,0,0,0,0,0,6,0,0,6,12
18157,Palestinian,2002,2002Palestinian,0,0,0,0,0,0,0,0,0,0,8,0,0,8,16
18158,Palestinian,2002,2002Palestinian,0,0,0,0,0,0,0,0,0,0,15,0,0,15,15
18159,Palestinian,2002,2002Palestinian,0,0,0,0,0,5,5,0,0,0,0,0,11,11,16
18160,Palestinian,2002,2002Palestinian,0,0,0,0,0,24,24,0,0,0,0,0,55,55,79
18161,Palestinian,2002,2002Palestinian,0,0,0,0,0,35,35,0,0,0,0,0,1114,1114,1149
18162,Palestinian,2002,2002Palestinian,0,0,0,0,0,30100,30100,0,0,0,0,0,39900,39900,70195
18163,Palestinian,2002,2002Palestinian,0,0,0,5,0,0,5,0,0,5,16,0,0,21,26
18164,Palestinian,2002,2002Palestinian,0,0,0,6,0,0,6,0,0,0,0,0,0,0,6
18165,Palestinian,2002,2002Palestinian,0,0,0,6,0,0,6,0,0,0,8,0,0,8,14
18166,Palestinian,2002,2002Palestinian,0,0,0,7,0,0,7,0,0,0,0,0,0,0,30
18167,Palestinian,2002,2002Palestinian,0,0,0,9,0,0,9,0,0,0,15,0,0,15,24
18168,Palestinian,2002,2002Palestinian,0,0,0,10,0,0,10,0,0,0,9,0,0,9,19
18169,Palestinian,2002,2002Palestinian,0,5,0,9,0,0,14,0,5,0,10,0,0,15,29
18170,Palestinian,2002,2002Palestinian,0,6,7,55,0,0,68,0,7,7,56,11,0,81,149
18171,Palestinian,2002,2002Palestinian,0,7,0,0,0,0,7,0,0,0,0,0,0,0,7
18172,Palestinian,2002,2002Palestinian,11,88,76,261,15,0,451,7,91,78,273,11,0,460,911
18173,Palestinian,2002,2002Palestinian,55,81,69,300,90,0,595,65,65,55,100,120,0,405,8604
18174,Palestinian,2003,2003Palestinian,0,0,0,0,0,0,0,0,0,0,0,0,0,0,326226
18175,Palestinian,2003,2003Palestinian,0,0,0,0,0,0,0,0,0,0,5,0,0,5,5
18176,Palestinian,2003,2003Palestinian,0,0,0,0,0,0,0,0,0,0,9,0,0,9,18
18177,Palestinian,2003,2003Palestinian,0,0,0,0,0,0,0,0,0,0,11,0,0,11,11
18178,Palestinian,2003,2003Palestinian,0,0,0,0,0,0,0,0,0,0,14,0,0,14,14
18179,Palestinian,2003,2003Palestinian,0,0,0,0,0,0,0,0,5,0,0,0,0,5,5
18180,Palestinian,2003,2003Palestinian,0,0,0,0,0,5,5,0,0,0,0,0,15,15,20
18181,Palestinian,2003,2003Palestinian,0,0,0,0,0,24,24,0,0,0,0,0,52,52,76
18182,Palestinian,2003,2003Palestinian,0,0,0,5,0,0,5,0,0,0,9,0,0,9,14
18183,Palestinian,2003,2003Palestinian,0,0,0,5,0,0,5,0,0,0,13,0,0,13,18
18184,Palestinian,2003,2003Palestinian,0,0,0,6,0,0,6,0,0,0,0,0,0,0,6
18185,Palestinian,2003,2003Palestinian,0,0,0,9,0,0,9,0,0,0,15,0,0,15,24
18186,Palestinian,2003,2003Palestinian,0,0,0,10,0,0,10,0,0,0,9,0,0,9,19
18187,Palestinian,2003,2003Palestinian,0,0,0,14,0,0,14,0,5,0,10,0,0,15,29
18188,Palestinian,2003,2003Palestinian,0,6,0,0,0,0,6,0,0,0,6,0,0,6,12
18189,Palestinian,2003,2003Palestinian,0,7,0,0,0,0,7,0,0,0,0,0,0,0,7
18190,Palestinian,2003,2003Palestinian,0,9,9,0,0,0,18,0,0,0,9,0,0,9,32
18191,Palestinian,2003,2003Palestinian,11,88,76,261,15,0,451,7,91,78,272,11,0,459,910
18192,Palestinian,2003,2003Palestinian,26,18,10,146,0,0,200,25,19,11,144,11,0,210,410
18193,Palestinian,2003,2003Palestinian,908,1756,1538,6198,799,0,11199,937,1858,1583,6338,791,0,11507,22706
18194,Palestinian,2004,2004Palestinian,0,0,0,0,0,0,0,0,0,0,0,0,0,0,76613
18195,Palestinian,2004,2004Palestinian,0,0,0,0,0,0,0,0,0,0,5,0,0,5,10
18196,Palestinian,2004,2004Palestinian,0,0,0,0,0,0,0,0,0,0,8,0,0,8,8
18197,Palestinian,2004,2004Palestinian,0,0,0,0,0,0,0,0,0,0,11,0,0,11,11
18198,Palestinian,2004,2004Palestinian,0,0,0,0,0,0,0,0,0,0,12,0,0,12,33
18199,Palestinian,2004,2004Palestinian,0,0,0,0,0,0,0,0,0,0,15,0,0,15,15
18200,Palestinian,2004,2004Palestinian,0,0,0,0,0,0,0,0,0,8,0,0,0,8,8
18201,Palestinian,2004,2004Palestinian,0,0,0,0,0,0,0,0,5,0,0,0,0,5,5
18202,Palestinian,2004,2004Palestinian,0,0,0,0,0,5,5,0,0,0,0,0,15,15,20
18203,Palestinian,2004,2004Palestinian,0,0,0,0,0,79202,79202,0,0,0,0,0,160805,160805,240007
18204,Palestinian,2004,2004Palestinian,0,0,0,5,0,0,5,0,0,0,0,0,0,0,5
18205,Palestinian,2004,2004Palestinian,0,0,0,5,0,0,5,0,0,0,5,0,0,5,10
18206,Palestinian,2004,2004Palestinian,0,0,0,5,0,0,5,0,0,0,10,0,0,10,15
18207,Palestinian,2004,2004Palestinian,0,0,0,6,0,0,6,0,0,0,0,0,0,0,6
18208,Palestinian,2004,2004Palestinian,0,0,0,6,0,0,6,0,0,0,9,0,0,9,15
18209,Palestinian,2004,2004Palestinian,0,0,0,7,0,0,7,0,0,0,7,0,0,7,14
18210,Palestinian,2004,2004Palestinian,0,0,0,9,0,0,9,0,0,0,15,0,0,15,24
18211,Palestinian,2004,2004Palestinian,0,0,0,12,0,0,12,0,6,0,24,0,0,30,42
18212,Palestinian,2004,2004Palestinian,0,5,0,0,0,0,5,0,0,0,0,0,0,0,5
18213,Palestinian,2004,2004Palestinian,0,6,0,0,0,0,6,0,0,0,6,0,0,6,12
18214,Palestinian,2004,2004Palestinian,0,7,0,0,0,0,7,0,0,0,0,0,0,0,7
18215,Palestinian,2004,2004Palestinian,8,0,0,0,0,0,8,0,0,0,0,0,0,0,8
18216,Palestinian,2004,2004Palestinian,11,88,76,261,15,0,451,7,91,78,272,11,0,459,910
18217,Palestinian,2004,2004Palestinian,15,48,48,24,0,0,135,45,99,85,76,0,0,305,440
18218,Palestinian,2004,2004Palestinian,509,677,581,2009,153,0,3929,531,780,669,2865,99,0,4944,8873
18219,Palestinian,2004,2004Palestinian,849,1763,1543,6235,809,0,11199,870,1863,1587,6388,804,0,11512,22711
18220,Palestinian,2005,2005Palestinian,0,0,0,0,0,0,0,0,0,0,0,0,0,0,254989
18221,Palestinian,2005,2005Palestinian,0,0,0,0,0,0,0,0,0,0,5,0,0,5,15
18222,Palestinian,2005,2005Palestinian,0,0,0,0,0,0,0,0,0,0,7,0,0,7,7
18223,Palestinian,2005,2005Palestinian,0,0,0,0,0,0,0,0,0,0,8,0,0,8,8
18224,Palestinian,2005,2005Palestinian,0,0,0,0,0,0,0,0,0,0,8,5,0,13,34
18225,Palestinian,2005,2005Palestinian,0,0,0,0,0,0,0,0,0,0,9,0,0,9,9
18226,Palestinian,2005,2005Palestinian,0,0,0,0,0,0,0,0,0,0,15,0,0,15,15
18227,Palestinian,2005,2005Palestinian,0,0,0,0,0,0,0,0,0,7,0,0,0,7,7
18228,Palestinian,2005,2005Palestinian,0,0,0,0,0,0,0,0,5,0,0,0,0,5,5
18229,Palestinian,2005,2005Palestinian,0,0,0,0,0,5,5,0,0,0,0,0,16,16,21
18230,Palestinian,2005,2005Palestinian,0,0,0,0,0,17,17,0,0,0,0,0,43,43,60
18231,Palestinian,2005,2005Palestinian,0,0,0,0,0,24,24,0,0,0,0,0,57,57,81
18232,Palestinian,2005,2005Palestinian,0,0,0,5,0,0,5,0,0,0,0,0,0,0,5
18233,Palestinian,2005,2005Palestinian,0,0,0,5,0,0,5,0,0,0,5,0,0,5,10
18234,Palestinian,2005,2005Palestinian,0,0,0,5,0,0,5,0,0,0,10,0,0,10,15
18235,Palestinian,2005,2005Palestinian,0,0,0,6,0,0,6,0,0,0,0,0,0,0,6
18236,Palestinian,2005,2005Palestinian,0,0,0,7,0,0,7,0,0,6,12,0,0,18,25
18237,Palestinian,2005,2005Palestinian,0,0,6,0,0,0,6,0,0,7,0,0,0,7,13
18238,Palestinian,2005,2005Palestinian,0,5,0,0,0,0,5,0,0,0,0,0,0,0,5
18239,Palestinian,2005,2005Palestinian,0,5,0,0,0,0,5,0,0,0,10,0,0,10,15
18240,Palestinian,2005,2005Palestinian,0,7,0,0,0,0,7,0,0,0,0,0,0,0,7
18241,Palestinian,2005,2005Palestinian,0,8,7,43,6,0,64,0,7,6,163,15,0,191,70255
18242,Palestinian,2005,2005Palestinian,8,0,0,0,0,0,8,0,0,0,0,0,0,0,8
18243,Palestinian,2005,2005Palestinian,15,48,47,25,0,0,135,45,98,85,77,0,0,305,440
18244,Palestinian,2005,2005Palestinian,40,43,37,298,20,0,438,35,65,55,282,35,0,472,910
18245,Palestinian,2005,2005Palestinian,597,1797,1534,6402,864,0,11194,633,1851,1578,6563,879,0,11504,22698
18246,Palestinian,2006,2006Palestinian,0,0,0,0,0,0,0,0,0,0,0,0,0,0,246077
18247,Palestinian,2006,2006Palestinian,0,0,0,0,0,0,0,0,0,0,5,0,0,5,49
18248,Palestinian,2006,2006Palestinian,0,0,0,0,0,0,0,0,0,0,6,0,0,6,6
18249,Palestinian,2006,2006Palestinian,0,0,0,0,0,0,0,0,0,0,9,0,0,9,18
18250,Palestinian,2006,2006Palestinian,0,0,0,0,0,0,0,0,0,0,12,0,0,12,12
18251,Palestinian,2006,2006Palestinian,0,0,0,0,0,0,0,0,0,0,17,0,0,17,17
18252,Palestinian,2006,2006Palestinian,0,0,0,0,0,0,0,0,0,5,7,0,0,12,12
18253,Palestinian,2006,2006Palestinian,0,0,0,0,0,0,0,0,5,0,0,0,0,5,5
18254,Palestinian,2006,2006Palestinian,0,0,0,0,0,5,5,0,0,0,0,0,11,11,16
18255,Palestinian,2006,2006Palestinian,0,0,0,0,0,8,8,0,0,0,0,0,18,18,26
18256,Palestinian,2006,2006Palestinian,0,0,0,0,0,12,12,0,0,0,0,0,28,28,40
18257,Palestinian,2006,2006Palestinian,0,0,0,0,0,27,27,0,0,0,0,0,59,59,86
18258,Palestinian,2006,2006Palestinian,0,0,0,0,0,33,33,0,0,0,0,0,75,75,108
18259,Palestinian,2006,2006Palestinian,0,0,0,5,0,0,5,0,0,0,5,0,0,5,10
18260,Palestinian,2006,2006Palestinian,0,0,0,5,0,0,5,0,0,0,9,0,0,9,14
18261,Palestinian,2006,2006Palestinian,0,0,0,6,0,0,6,0,0,0,0,0,0,0,6
18262,Palestinian,2006,2006Palestinian,0,0,5,0,0,0,5,0,0,0,7,0,0,7,12
18263,Palestinian,2006,2006Palestinian,0,0,5,6,0,0,11,5,5,7,33,0,0,50,61
18264,Palestinian,2006,2006Palestinian,0,6,0,8,0,0,14,0,0,0,8,0,0,8,22
18265,Palestinian,2006,2006Palestinian,9,0,0,0,0,0,9,0,0,0,0,0,0,0,9
18266,Palestinian,2006,2006Palestinian,11,69,139,670,50,0,939,20,75,161,594,94,0,944,1883
18267,Palestinian,2006,2006Palestinian,15,45,50,25,0,0,135,45,92,91,77,0,0,305,440
18268,Palestinian,2006,2006Palestinian,279,1093,1074,4321,610,0,7377,282,1157,1102,4431,651,0,7623,15000
18269,Palestinian,2006,2006Palestinian,6303,8006,4957,12988,844,0,33098,7001,5059,10002,14462,576,0,37100,70198
18270,Palestinian,2007,2007Palestinian,0,0,0,0,0,0,0,0,0,0,0,0,0,0,251902
18271,Palestinian,2007,2007Palestinian,0,0,0,0,0,0,0,0,0,0,0,0,5,5,5
18272,Palestinian,2007,2007Palestinian,0,0,0,0,0,0,0,0,0,0,5,0,0,5,20
18273,Palestinian,2007,2007Palestinian,0,0,0,0,0,0,0,0,0,0,6,0,0,6,12
18274,Palestinian,2007,2007Palestinian,0,0,0,0,0,0,0,0,0,0,7,0,0,7,7
18275,Palestinian,2007,2007Palestinian,0,0,0,0,0,0,0,0,0,0,8,0,0,8,8
18276,Palestinian,2007,2007Palestinian,0,0,0,0,0,0,0,0,0,0,9,0,0,9,18
18277,Palestinian,2007,2007Palestinian,0,0,0,0,0,0,0,0,0,0,12,0,0,12,12
18278,Palestinian,2007,2007Palestinian,0,0,0,0,0,0,0,0,0,0,20,0,0,20,20
18279,Palestinian,2007,2007Palestinian,0,0,0,0,0,0,0,0,5,0,0,0,0,5,5
18280,Palestinian,2007,2007Palestinian,0,0,0,0,0,9,9,0,0,0,0,0,19,19,28
18281,Palestinian,2007,2007Palestinian,0,0,0,0,0,15,15,0,0,0,0,0,29,29,44
18282,Palestinian,2007,2007Palestinian,0,0,0,0,0,28,28,0,0,0,0,0,69,69,97
18283,Palestinian,2007,2007Palestinian,0,0,0,5,0,0,5,0,0,0,10,0,0,10,15
18284,Palestinian,2007,2007Palestinian,0,0,0,6,0,0,6,0,0,5,7,0,0,12,18
18285,Palestinian,2007,2007Palestinian,0,0,0,8,0,0,8,0,5,0,13,0,0,18,26
18286,Palestinian,2007,2007Palestinian,0,5,0,5,0,0,10,0,9,0,11,0,0,20,30
18287,Palestinian,2007,2007Palestinian,0,5,0,13,0,0,18,5,0,6,18,0,0,29,47
18288,Palestinian,2007,2007Palestinian,0,7,0,13,0,0,20,0,8,0,19,0,0,27,47
18289,Palestinian,2007,2007Palestinian,0,8,7,25,5,0,45,0,6,5,59,11,0,81,126
18290,Palestinian,2007,2007Palestinian,8,15,12,55,0,0,90,12,21,26,78,0,0,137,227
18291,Palestinian,2007,2007Palestinian,14,82,155,712,51,0,1014,14,71,154,605,95,0,939,1953
18292,Palestinian,2007,2007Palestinian,15,50,45,25,0,0,135,45,87,94,79,0,0,305,440
18293,Palestinian,2007,2007Palestinian,68,102,53,232,18,0,473,57,84,61,281,18,0,501,974
18294,Palestinian,2007,2007Palestinian,381,741,622,1653,4122,0,7519,396,749,681,4904,688,0,7418,14937
18295,Palestinian,2007,2007Palestinian,6301,8008,4959,12994,845,0,33107,7000,5058,10003,14466,579,0,37106,70213
18296,Palestinian,2008,2008Palestinian,0,0,0,0,0,0,0,0,0,0,0,0,0,0,252117
18297,Palestinian,2008,2008Palestinian,0,0,0,0,0,0,0,0,0,0,5,0,0,5,20
18298,Palestinian,2008,2008Palestinian,0,0,0,0,0,0,0,0,0,0,6,0,0,6,6
18299,Palestinian,2008,2008Palestinian,0,0,0,0,0,0,0,0,0,0,9,0,0,9,18
18300,Palestinian,2008,2008Palestinian,0,0,0,0,0,0,0,0,0,0,10,0,0,10,10
18301,Palestinian,2008,2008Palestinian,0,0,0,0,0,0,0,0,0,0,20,0,0,20,20
18302,Palestinian,2008,2008Palestinian,0,0,0,0,0,16,16,0,0,0,0,0,23,23,39
18303,Palestinian,2008,2008Palestinian,0,0,0,0,0,17,17,0,0,0,0,0,23,23,40
18304,Palestinian,2008,2008Palestinian,0,0,0,0,0,29,29,0,0,0,0,0,80,80,109
18305,Palestinian,2008,2008Palestinian,0,0,0,5,0,0,5,0,0,0,0,0,0,0,31
18306,Palestinian,2008,2008Palestinian,0,0,0,5,0,0,5,0,0,0,11,0,0,11,16
18307,Palestinian,2008,2008Palestinian,0,0,0,6,0,0,6,0,0,5,7,0,0,12,18
18308,Palestinian,2008,2008Palestinian,0,0,0,7,0,0,7,0,5,0,14,0,0,19,26
18309,Palestinian,2008,2008Palestinian,0,0,0,8,0,0,8,8,0,0,7,0,0,15,23
18310,Palestinian,2008,2008Palestinian,0,0,0,9,0,0,9,0,0,0,0,0,0,0,9
18311,Palestinian,2008,2008Palestinian,0,0,5,0,0,0,5,0,7,0,0,0,0,7,12
18312,Palestinian,2008,2008Palestinian,0,0,5,5,0,0,10,0,0,5,10,0,0,15,25
18313,Palestinian,2008,2008Palestinian,0,8,7,25,5,0,45,0,6,5,60,11,0,82,127
18314,Palestinian,2008,2008Palestinian,5,7,15,16,0,0,43,0,13,7,21,0,0,41,84
18315,Palestinian,2008,2008Palestinian,6,8,5,40,0,0,59,9,13,16,44,0,0,82,141
18316,Palestinian,2008,2008Palestinian,7,23,29,143,12,0,214,0,18,40,205,40,0,303,517
18317,Palestinian,2008,2008Palestinian,8,0,0,0,0,0,8,0,0,0,0,0,0,0,8
18318,Palestinian,2008,2008Palestinian,10,5,6,28,0,0,49,6,5,6,39,0,0,56,105
18319,Palestinian,2008,2008Palestinian,37,114,164,987,101,0,1403,62,117,168,910,182,0,1439,2842
18320,Palestinian,2008,2008Palestinian,77,107,53,285,26,0,548,81,92,85,338,21,0,617,1165
18321,Palestinian,2008,2008Palestinian,504,801,835,3327,503,0,5970,508,764,835,3711,514,0,6332,12302
18322,Palestinian,2008,2008Palestinian,6300,8006,4955,12987,844,0,33092,7000,5054,10000,14452,576,0,37082,70174
18323,Palestinian,2009,2009Palestinian,0,0,0,0,0,0,0,0,0,0,0,0,0,0,7479
18324,Palestinian,2009,2009Palestinian,0,0,0,0,0,0,0,0,0,0,5,0,0,5,15
18325,Palestinian,2009,2009Palestinian,0,0,0,0,0,0,0,0,0,0,6,0,0,6,12
18326,Palestinian,2009,2009Palestinian,0,0,0,0,0,0,0,0,0,0,9,0,0,9,9
18327,Palestinian,2009,2009Palestinian,0,0,0,0,0,0,0,0,0,0,11,0,0,11,11
18328,Palestinian,2009,2009Palestinian,0,0,0,0,0,0,0,0,0,0,18,0,0,18,18
18329,Palestinian,2009,2009Palestinian,0,0,0,0,0,0,0,5,0,0,0,0,0,5,5
18330,Palestinian,2009,2009Palestinian,0,0,0,0,0,14,14,0,0,0,0,0,21,21,35
18331,Palestinian,2009,2009Palestinian,0,0,0,0,0,21,21,0,0,0,0,0,31,31,52
18332,Palestinian,2009,2009Palestinian,0,0,0,5,0,0,5,0,0,0,10,0,0,10,15
18333,Palestinian,2009,2009Palestinian,0,0,0,5,0,0,5,0,0,0,11,0,0,11,16
18334,Palestinian,2009,2009Palestinian,0,0,0,6,0,0,6,0,0,5,7,0,0,12,18
18335,Palestinian,2009,2009Palestinian,0,0,0,7,0,0,7,0,9,0,9,0,0,18,25
18336,Palestinian,2009,2009Palestinian,0,0,0,10,0,0,10,0,0,0,0,0,0,0,34
18337,Palestinian,2009,2009Palestinian,0,0,5,0,0,0,5,0,0,0,13,0,0,13,18
18338,Palestinian,2009,2009Palestinian,0,0,5,5,0,0,10,0,5,0,14,0,0,19,29
18339,Palestinian,2009,2009Palestinian,0,8,0,0,0,0,8,0,0,0,8,0,0,8,16
18340,Palestinian,2009,2009Palestinian,0,8,7,26,5,0,46,0,6,5,53,11,0,75,121
18341,Palestinian,2009,2009Palestinian,0,9,0,20,0,0,29,5,5,6,32,0,0,48,77
18342,Palestinian,2009,2009Palestinian,9,0,16,18,0,0,43,0,13,7,19,0,0,39,82
18343,Palestinian,2009,2009Palestinian,11,23,39,161,18,0,252,5,14,42,230,37,0,328,580
18344,Palestinian,2009,2009Palestinian,13,11,10,29,5,0,68,9,7,5,62,5,0,88,156
18345,Palestinian,2009,2009Palestinian,36,50,38,148,9,0,281,41,52,44,203,10,0,350,631
18346,Palestinian,2009,2009Palestinian,81,186,205,1217,147,0,1836,100,176,229,1189,247,0,1941,3777
18347,Palestinian,2009,2009Palestinian,437,751,779,3337,507,0,5811,456,711,771,3649,532,0,6119,11930
18348,Palestinian,2009,2009Palestinian,6301,8002,4952,12959,841,0,33055,7000,5051,10002,14355,561,0,36969,70024
18349,Palestinian,2010,2010Palestinian,0,0,0,0,0,0,0,0,0,0,0,0,0,0,7952
18350,Palestinian,2010,2010Palestinian,0,0,0,0,0,0,0,0,0,0,5,0,0,5,15
18351,Palestinian,2010,2010Palestinian,0,0,0,0,0,0,0,0,0,0,6,0,0,6,6
18352,Palestinian,2010,2010Palestinian,0,0,0,0,0,0,0,0,0,0,9,0,0,9,9
18353,Palestinian,2010,2010Palestinian,0,0,0,0,0,0,0,0,0,0,10,0,0,10,10
18354,Palestinian,2010,2010Palestinian,0,0,0,0,0,0,0,0,0,0,14,0,0,14,14
18355,Palestinian,2010,2010Palestinian,0,0,0,0,0,0,0,0,0,0,18,0,0,18,18
18356,Palestinian,2010,2010Palestinian,0,0,0,0,0,0,0,0,0,5,0,0,0,5,5
18357,Palestinian,2010,2010Palestinian,0,0,0,0,0,0,0,0,5,0,0,0,0,5,5
18358,Palestinian,2010,2010Palestinian,0,0,0,0,0,0,0,5,0,0,0,0,0,5,5
18359,Palestinian,2010,2010Palestinian,0,0,0,0,0,5,5,0,0,0,0,0,17,17,22
18360,Palestinian,2010,2010Palestinian,0,0,0,0,0,47,47,0,0,0,0,0,75,75,122
18361,Palestinian,2010,2010Palestinian,0,0,0,0,0,53,53,0,0,0,0,0,141,141,194
18362,Palestinian,2010,2010Palestinian,0,0,0,5,0,0,5,0,0,0,0,0,0,0,5
18363,Palestinian,2010,2010Palestinian,0,0,0,5,0,0,5,0,0,0,11,0,0,11,16
18364,Palestinian,2010,2010Palestinian,0,0,0,6,0,0,6,0,0,5,7,0,0,12,18
18365,Palestinian,2010,2010Palestinian,0,0,0,7,0,0,7,0,9,0,9,0,0,18,25
18366,Palestinian,2010,2010Palestinian,0,0,0,13,0,0,13,0,0,0,0,0,0,0,37
18367,Palestinian,2010,2010Palestinian,0,0,5,0,0,0,5,0,0,0,5,0,0,5,10
18368,Palestinian,2010,2010Palestinian,0,0,5,0,0,0,5,0,0,6,0,0,0,6,11
18369,Palestinian,2010,2010Palestinian,0,0,5,0,0,0,5,0,6,0,0,0,0,6,11
18370,Palestinian,2010,2010Palestinian,0,0,5,5,0,0,10,0,0,5,15,0,0,20,30
18371,Palestinian,2010,2010Palestinian,0,0,5,18,0,0,23,0,7,11,23,0,0,41,64
18372,Palestinian,2010,2010Palestinian,0,0,8,0,0,0,8,0,0,0,0,0,0,0,8
18373,Palestinian,2010,2010Palestinian,0,0,10,38,5,0,53,0,0,5,47,7,0,59,117
18374,Palestinian,2010,2010Palestinian,0,5,5,11,0,12,33,0,6,7,25,0,17,55,88
18375,Palestinian,2010,2010Palestinian,0,6,0,7,5,0,18,5,5,0,5,0,0,15,33
18376,Palestinian,2010,2010Palestinian,5,0,0,0,0,0,5,0,0,0,0,0,0,0,5
18377,Palestinian,2010,2010Palestinian,5,5,0,19,0,0,29,0,7,6,36,0,0,49,78
18378,Palestinian,2010,2010Palestinian,13,16,13,33,5,0,80,8,10,5,87,5,0,115,195
18379,Palestinian,2010,2010Palestinian,17,35,41,177,44,0,314,25,51,58,156,17,0,307,621
18380,Palestinian,2010,2010Palestinian,70,183,148,826,97,0,1324,77,186,156,814,182,0,1415,2739
18381,Palestinian,2010,2010Palestinian,347,700,708,3026,489,0,5270,387,648,726,3261,506,0,5528,10798
18382,Palestinian,2010,2010Palestinian,6301,8001,4952,12961,841,0,33056,7000,5051,10001,14357,561,0,36970,70026
18383,Palestinian,2011,2011Palestinian,0,0,0,0,0,0,0,0,0,0,0,0,0,0,3520
18384,Palestinian,2011,2011Palestinian,0,0,0,0,0,0,0,0,0,0,5,0,0,5,20
18385,Palestinian,2011,2011Palestinian,0,0,0,0,0,0,0,0,0,0,6,0,0,6,12
18386,Palestinian,2011,2011Palestinian,0,0,0,0,0,0,0,0,0,0,7,0,0,7,14
18387,Palestinian,2011,2011Palestinian,0,0,0,0,0,0,0,0,0,0,8,0,0,8,35
18388,Palestinian,2011,2011Palestinian,0,0,0,0,0,0,0,0,0,0,9,0,0,9,18
18389,Palestinian,2011,2011Palestinian,0,0,0,0,0,0,0,0,0,0,20,0,0,20,20
18390,Palestinian,2011,2011Palestinian,0,0,0,0,0,0,0,0,5,0,0,0,0,5,5
18391,Palestinian,2011,2011Palestinian,0,0,0,0,0,0,0,5,0,0,0,0,0,5,5
18392,Palestinian,2011,2011Palestinian,0,0,0,0,0,23,23,0,0,0,0,0,53,53,76
18393,Palestinian,2011,2011Palestinian,0,0,0,0,0,57,57,0,0,0,0,0,161,161,218
18394,Palestinian,2011,2011Palestinian,0,0,0,5,0,0,5,0,0,0,0,0,0,0,5
18395,Palestinian,2011,2011Palestinian,0,0,0,6,0,0,6,0,0,5,7,0,0,12,18
18396,Palestinian,2011,2011Palestinian,0,0,0,7,0,0,7,0,0,0,0,0,0,0,7
18397,Palestinian,2011,2011Palestinian,0,0,0,7,0,0,7,0,9,0,9,0,0,18,25
18398,Palestinian,2011,2011Palestinian,0,0,0,10,0,0,10,0,0,5,18,0,0,23,33
18399,Palestinian,2011,2011Palestinian,0,0,5,0,0,0,5,0,0,0,0,0,0,0,5
18400,Palestinian,2011,2011Palestinian,0,0,5,0,0,0,5,0,0,5,0,0,0,5,10
18401,Palestinian,2011,2011Palestinian,0,0,6,5,0,0,11,0,0,8,18,0,0,26,37
18402,Palestinian,2011,2011Palestinian,0,0,8,0,0,0,8,0,0,0,0,0,0,0,8
18403,Palestinian,2011,2011Palestinian,0,0,10,15,0,0,25,0,8,0,8,0,0,16,41
18404,Palestinian,2011,2011Palestinian,0,0,10,40,5,0,55,0,0,5,50,7,0,62,117
18405,Palestinian,2011,2011Palestinian,0,5,0,0,0,0,5,0,0,0,5,0,0,5,10
18406,Palestinian,2011,2011Palestinian,0,5,0,0,0,0,5,0,0,0,7,0,0,7,4017
18407,Palestinian,2011,2011Palestinian,0,7,7,12,0,12,38,0,7,5,36,0,14,62,100
18408,Palestinian,2011,2011Palestinian,0,7,12,16,0,0,35,8,5,6,36,0,0,55,90
18409,Palestinian,2011,2011Palestinian,0,8,0,17,0,0,25,0,7,6,36,0,0,49,74
18410,Palestinian,2011,2011Palestinian,7,7,5,31,0,0,50,5,7,5,68,0,0,85,636
18411,Palestinian,2011,2011Palestinian,14,25,30,121,7,0,197,11,14,21,168,19,0,233,430
18412,Palestinian,2011,2011Palestinian,16,21,11,40,5,0,93,12,11,9,116,6,0,154,247
18413,Palestinian,2011,2011Palestinian,69,178,147,817,101,0,1312,72,185,149,811,181,0,1398,2710
18414,Palestinian,2011,2011Palestinian,395,725,746,3243,531,0,5640,421,715,764,3481,528,0,5909,11549
18415,Palestinian,2011,2011Palestinian,6301,8001,4961,12958,841,0,33062,7000,5051,10000,14355,561,0,36967,70029
18416,Palestinian,2012,2012Palestinian,0,0,0,0,0,0,0,0,0,0,0,0,0,0,3773
18417,Palestinian,2012,2012Palestinian,0,0,0,0,0,0,0,0,0,0,5,0,0,5,25
18418,Palestinian,2012,2012Palestinian,0,0,0,0,0,0,0,0,0,0,6,0,0,6,6
18419,Palestinian,2012,2012Palestinian,0,0,0,0,0,0,0,0,0,0,7,0,0,7,14
18420,Palestinian,2012,2012Palestinian,0,0,0,0,0,0,0,0,0,0,9,0,0,9,9
18421,Palestinian,2012,2012Palestinian,0,0,0,0,0,0,0,0,0,0,10,0,0,10,30
18422,Palestinian,2012,2012Palestinian,0,0,0,0,0,0,0,0,0,0,20,0,0,20,20
18423,Palestinian,2012,2012Palestinian,0,0,0,0,0,0,0,0,0,8,0,0,0,8,8
18424,Palestinian,2012,2012Palestinian,0,0,0,0,0,0,0,0,5,0,0,0,0,5,5
18425,Palestinian,2012,2012Palestinian,0,0,0,0,0,8,8,0,0,0,0,0,27,27,35
18426,Palestinian,2012,2012Palestinian,0,0,0,0,0,38,38,0,0,0,0,0,92,92,130
18427,Palestinian,2012,2012Palestinian,0,0,0,0,0,66,66,0,0,0,0,0,186,186,252
18428,Palestinian,2012,2012Palestinian,0,0,0,5,0,0,5,0,0,0,0,0,0,0,5
18429,Palestinian,2012,2012Palestinian,0,0,0,6,0,0,6,0,0,5,9,0,0,14,20
18430,Palestinian,2012,2012Palestinian,0,0,0,6,0,0,6,0,9,0,7,0,0,16,22
18431,Palestinian,2012,2012Palestinian,0,0,0,8,0,0,8,0,0,0,18,5,0,23,31
18432,Palestinian,2012,2012Palestinian,0,0,0,8,0,0,8,0,6,0,12,0,0,18,674
18433,Palestinian,2012,2012Palestinian,0,0,5,0,0,0,5,0,0,0,0,0,0,0,5
18434,Palestinian,2012,2012Palestinian,0,0,5,5,0,0,10,0,7,0,20,0,0,27,37
18435,Palestinian,2012,2012Palestinian,0,0,8,0,0,0,8,0,0,0,0,0,0,0,8
18436,Palestinian,2012,2012Palestinian,0,0,10,40,5,0,55,0,0,5,50,7,0,62,117
18437,Palestinian,2012,2012Palestinian,0,5,0,0,0,0,5,0,0,0,0,0,0,0,5
18438,Palestinian,2012,2012Palestinian,0,5,0,0,0,0,5,0,0,0,10,0,0,10,4020
18439,Palestinian,2012,2012Palestinian,0,5,0,0,0,0,5,0,5,0,10,0,0,15,20
18440,Palestinian,2012,2012Palestinian,0,6,8,13,0,14,41,0,5,0,24,5,34,68,109
18441,Palestinian,2012,2012Palestinian,0,7,0,21,0,0,28,0,6,5,9,0,0,20,48
18442,Palestinian,2012,2012Palestinian,0,8,0,0,0,0,8,0,0,0,5,0,0,5,13
18443,Palestinian,2012,2012Palestinian,0,15,18,23,0,0,56,0,18,29,43,0,0,90,146
18444,Palestinian,2012,2012Palestinian,5,6,0,10,0,0,21,0,0,9,30,0,0,39,60
18445,Palestinian,2012,2012Palestinian,10,25,32,108,6,0,181,6,23,15,157,19,0,220,401
18446,Palestinian,2012,2012Palestinian,12,16,8,36,5,0,77,12,11,8,120,7,0,158,235
18447,Palestinian,2012,2012Palestinian,75,229,338,655,90,0,1387,78,248,357,694,154,0,1531,3138
18448,Palestinian,2012,2012Palestinian,375,774,856,3073,492,0,5570,413,761,887,3330,506,0,5897,11467
18449,Palestinian,2012,2012Palestinian,6303,8002,4953,12961,841,0,33060,7000,5052,10002,14354,560,0,36968,70028
18450,Palestinian,2013,2013Palestinian,0,0,0,0,0,0,0,0,0,0,0,0,0,0,3766
18451,Palestinian,2013,2013Palestinian,0,0,0,0,0,0,0,0,0,0,0,0,5,5,30
18452,Palestinian,2013,2013Palestinian,0,0,0,0,0,0,0,0,0,0,5,0,0,5,50
18453,Palestinian,2013,2013Palestinian,0,0,0,0,0,0,0,0,0,0,6,0,0,6,6
18454,Palestinian,2013,2013Palestinian,0,0,0,0,0,0,0,0,0,0,9,0,0,9,18
18455,Palestinian,2013,2013Palestinian,0,0,0,0,0,0,0,0,0,0,12,0,0,12,4017
18456,Palestinian,2013,2013Palestinian,0,0,0,0,0,0,0,0,0,0,24,0,0,24,24
18457,Palestinian,2013,2013Palestinian,0,0,0,0,0,0,0,0,8,0,0,0,0,8,8
18458,Palestinian,2013,2013Palestinian,0,0,0,0,0,11,11,0,0,0,0,0,13,13,24
18459,Palestinian,2013,2013Palestinian,0,0,0,0,0,19,19,0,0,0,0,0,46,46,125
18460,Palestinian,2013,2013Palestinian,0,0,0,0,0,90,90,0,0,0,0,0,224,224,314
18461,Palestinian,2013,2013Palestinian,0,0,0,5,0,0,5,0,0,0,0,0,0,0,10
18462,Palestinian,2013,2013Palestinian,0,0,0,6,0,0,6,0,0,5,9,0,0,14,20
18463,Palestinian,2013,2013Palestinian,0,0,0,6,0,0,6,0,9,0,7,0,0,16,22
18464,Palestinian,2013,2013Palestinian,0,0,0,11,0,0,11,0,5,0,22,0,0,27,38
18465,Palestinian,2013,2013Palestinian,0,0,5,0,0,0,5,0,0,0,0,0,0,0,5
18466,Palestinian,2013,2013Palestinian,0,0,9,16,0,0,25,0,9,0,43,5,0,57,82
18467,Palestinian,2013,2013Palestinian,0,0,20,52,17,0,89,0,5,8,92,18,0,123,212
18468,Palestinian,2013,2013Palestinian,0,5,0,0,0,0,5,0,0,0,0,0,0,0,5
18469,Palestinian,2013,2013Palestinian,0,5,0,0,0,0,5,0,5,0,18,0,0,23,37
18470,Palestinian,2013,2013Palestinian,0,5,0,5,0,0,10,0,0,0,6,0,0,6,16
18471,Palestinian,2013,2013Palestinian,0,5,0,17,0,0,22,0,0,6,7,0,0,13,35
18472,Palestinian,2013,2013Palestinian,0,8,0,11,0,0,19,0,0,7,14,0,0,21,682
18473,Palestinian,2013,2013Palestinian,5,0,0,6,0,0,11,0,5,0,16,0,0,21,32
18474,Palestinian,2013,2013Palestinian,6,12,0,10,0,0,28,0,9,0,31,0,0,40,68
18475,Palestinian,2013,2013Palestinian,6,12,5,20,0,0,43,5,11,5,56,0,0,77,120
18476,Palestinian,2013,2013Palestinian,8,30,32,128,5,0,203,6,25,17,177,20,0,245,448
18477,Palestinian,2013,2013Palestinian,9,14,8,34,0,0,65,12,19,11,129,5,0,176,241
18478,Palestinian,2013,2013Palestinian,17,6,15,32,0,0,70,6,11,27,45,0,0,89,159
18479,Palestinian,2013,2013Palestinian,22,40,59,144,17,0,282,23,34,53,187,9,0,306,588
18480,Palestinian,2013,2013Palestinian,139,363,263,1333,151,0,2249,149,371,298,1523,225,0,2566,4815
18481,Palestinian,2013,2013Palestinian,398,489,599,2852,529,0,4867,512,604,568,2896,545,0,5125,9992
18482,Palestinian,2013,2013Palestinian,6305,8000,4960,12955,840,0,33060,7000,5050,10006,14350,560,0,36966,70026
18483,Palestinian,2014,2014Palestinian,0,0,0,0,0,0,0,0,0,0,0,0,0,0,4240
18484,Palestinian,2014,2014Palestinian,0,0,0,0,0,0,0,0,0,0,5,0,0,5,45
18485,Palestinian,2014,2014Palestinian,0,0,0,0,0,0,0,0,0,0,6,0,0,6,6
18486,Palestinian,2014,2014Palestinian,0,0,0,0,0,0,0,0,0,0,9,0,0,9,9
18487,Palestinian,2014,2014Palestinian,0,0,0,0,0,0,0,0,0,0,11,0,0,11,4016
18488,Palestinian,2014,2014Palestinian,0,0,0,0,0,0,0,0,0,0,34,0,0,34,34
18489,Palestinian,2014,2014Palestinian,0,0,0,0,0,0,0,0,0,8,0,0,0,8,8
18490,Palestinian,2014,2014Palestinian,0,0,0,0,0,7,7,0,0,0,0,0,25,25,32
18491,Palestinian,2014,2014Palestinian,0,0,0,0,0,9,9,0,0,0,0,0,9,9,18
18492,Palestinian,2014,2014Palestinian,0,0,0,0,0,122,122,0,0,0,0,0,292,292,414
18493,Palestinian,2014,2014Palestinian,0,0,0,5,0,0,5,0,0,0,0,0,0,0,5
18494,Palestinian,2014,2014Palestinian,0,0,0,6,0,0,6,0,0,0,0,0,0,0,6
18495,Palestinian,2014,2014Palestinian,0,0,0,6,0,0,6,0,9,0,0,0,0,9,15
18496,Palestinian,2014,2014Palestinian,0,0,0,6,0,0,6,0,9,0,7,0,0,16,22
18497,Palestinian,2014,2014Palestinian,0,0,0,7,0,0,7,0,0,0,20,0,0,20,27
18498,Palestinian,2014,2014Palestinian,0,0,0,8,0,0,8,0,0,0,0,0,0,0,8
18499,Palestinian,2014,2014Palestinian,0,0,0,8,0,0,8,0,0,0,22,5,0,27,35
18500,Palestinian,2014,2014Palestinian,0,0,0,8,0,0,8,0,5,0,17,0,0,22,30
18501,Palestinian,2014,2014Palestinian,0,0,0,14,0,0,14,0,6,0,17,5,0,28,42
18502,Palestinian,2014,2014Palestinian,0,0,5,0,0,0,5,0,0,0,0,0,0,0,5
18503,Palestinian,2014,2014Palestinian,0,0,6,5,0,0,11,0,0,0,5,0,0,5,16
18504,Palestinian,2014,2014Palestinian,0,0,6,6,5,0,17,0,0,9,23,0,0,32,634
18505,Palestinian,2014,2014Palestinian,0,0,7,11,0,0,18,0,0,0,5,0,0,5,23
18506,Palestinian,2014,2014Palestinian,0,5,0,0,0,0,5,0,0,0,0,0,0,0,5
18507,Palestinian,2014,2014Palestinian,0,6,0,0,0,0,6,0,0,0,5,0,0,5,11
18508,Palestinian,2014,2014Palestinian,0,12,5,25,0,0,42,6,7,0,259,0,0,272,314
18509,Palestinian,2014,2014Palestinian,5,0,0,0,0,0,5,0,0,0,0,0,0,0,5
18510,Palestinian,2014,2014Palestinian,5,7,0,7,0,0,19,0,9,0,15,0,0,24,43
18511,Palestinian,2014,2014Palestinian,5,10,5,12,0,0,32,0,8,5,28,0,0,41,73
18512,Palestinian,2014,2014Palestinian,5,34,34,132,6,0,211,7,25,17,179,24,0,252,463
18513,Palestinian,2014,2014Palestinian,6,21,13,48,5,0,93,17,26,6,103,5,0,157,250
18514,Palestinian,2014,2014Palestinian,8,21,9,42,0,0,80,13,27,15,146,6,0,207,287
18515,Palestinian,2014,2014Palestinian,11,25,27,61,5,0,129,27,23,21,88,0,0,159,288
18516,Palestinian,2014,2014Palestinian,18,16,15,53,0,0,102,13,17,8,124,5,0,167,269
18517,Palestinian,2014,2014Palestinian,36,57,55,234,22,0,404,39,56,54,268,28,0,445,849
18518,Palestinian,2014,2014Palestinian,143,388,295,1475,171,0,2472,161,424,318,1761,255,0,2919,5391
18519,Palestinian,2014,2014Palestinian,314,495,473,2775,521,0,4578,345,558,445,2787,533,0,4668,9246
18520,Palestinian,2014,2014Palestinian,6300,8006,4961,12955,839,0,33061,6999,5051,10003,14350,559,0,36962,70023
18521,Palestinian,2015,2015Palestinian,0,0,0,0,0,0,0,0,0,0,0,0,0,0,5256
18522,Palestinian,2015,2015Palestinian,0,0,0,0,0,0,0,0,0,0,5,0,0,5,35
18523,Palestinian,2015,2015Palestinian,0,0,0,0,0,0,0,0,0,0,6,0,0,6,6
18524,Palestinian,2015,2015Palestinian,0,0,0,0,0,0,0,0,0,0,7,0,0,7,7
18525,Palestinian,2015,2015Palestinian,0,0,0,0,0,0,0,0,0,0,9,0,0,9,9
18526,Palestinian,2015,2015Palestinian,0,0,0,0,0,0,0,0,0,0,11,0,0,11,4016
18527,Palestinian,2015,2015Palestinian,0,0,0,0,0,0,0,0,0,0,33,0,0,33,33
18528,Palestinian,2015,2015Palestinian,0,0,0,0,0,0,0,0,0,5,0,0,0,5,5
18529,Palestinian,2015,2015Palestinian,0,0,0,0,0,6,6,0,0,0,0,0,32,32,38
18530,Palestinian,2015,2015Palestinian,0,0,0,0,0,18,18,0,0,0,0,0,72,72,90
18531,Palestinian,2015,2015Palestinian,0,0,0,0,0,181,181,0,0,0,0,0,384,384,565
18532,Palestinian,2015,2015Palestinian,0,0,0,5,0,0,5,0,0,0,0,0,0,0,15
18533,Palestinian,2015,2015Palestinian,0,0,0,6,0,0,6,0,0,0,0,0,0,0,6
18534,Palestinian,2015,2015Palestinian,0,0,0,6,0,0,6,0,9,0,0,0,0,9,15
18535,Palestinian,2015,2015Palestinian,0,0,0,7,0,0,7,0,0,0,0,0,0,0,7
18536,Palestinian,2015,2015Palestinian,0,0,0,7,0,0,7,0,0,0,28,0,0,28,35
18537,Palestinian,2015,2015Palestinian,0,0,0,13,0,0,13,0,5,0,18,5,0,28,41
18538,Palestinian,2015,2015Palestinian,0,0,0,17,0,0,17,0,0,0,13,5,0,18,35
18539,Palestinian,2015,2015Palestinian,0,0,6,7,0,0,13,0,0,5,10,0,0,15,28
18540,Palestinian,2015,2015Palestinian,0,0,6,7,0,0,13,0,0,11,5,0,0,16,29
18541,Palestinian,2015,2015Palestinian,0,5,0,0,0,0,5,0,0,0,0,0,0,0,10
18542,Palestinian,2015,2015Palestinian,0,5,0,19,0,0,24,5,0,5,50,5,0,65,89
18543,Palestinian,2015,2015Palestinian,0,17,5,50,0,0,72,0,31,5,276,0,0,312,384
18544,Palestinian,2015,2015Palestinian,0,35,40,144,6,0,225,6,26,14,186,25,0,257,482
18545,Palestinian,2015,2015Palestinian,5,6,5,8,0,0,24,0,6,5,24,0,0,35,59
18546,Palestinian,2015,2015Palestinian,6,14,0,14,0,0,34,5,8,0,32,0,0,45,79
18547,Palestinian,2015,2015Palestinian,10,20,10,46,5,0,91,10,25,13,159,9,0,216,307
18548,Palestinian,2015,2015Palestinian,12,39,28,80,5,0,164,21,40,24,112,5,0,202,366
18549,Palestinian,2015,2015Palestinian,19,27,19,83,9,0,157,21,29,18,173,11,0,252,409
18550,Palestinian,2015,2015Palestinian,26,73,37,264,32,0,432,22,65,51,307,29,0,474,906
18551,Palestinian,2015,2015Palestinian,110,385,253,1475,182,0,2405,107,418,399,1787,264,0,2975,5380
18552,Palestinian,2015,2015Palestinian,210,526,453,2820,582,0,4591,248,575,429,2816,591,0,4659,9250
18553,Palestinian,2015,2015Palestinian,6300,8005,4956,12962,839,0,33062,6999,5050,10001,14350,559,0,36959,70021
18554,Palestinian,2016,2016Palestinian,0,0,0,0,0,0,0,0,0,0,0,0,0,0,5582
18555,Palestinian,2016,2016Palestinian,0,0,0,0,0,0,0,0,0,0,5,0,0,5,25
18556,Palestinian,2016,2016Palestinian,0,0,0,0,0,0,0,0,0,0,6,0,0,6,12
18557,Palestinian,2016,2016Palestinian,0,0,0,0,0,0,0,0,0,0,7,0,0,7,7
18558,Palestinian,2016,2016Palestinian,0,0,0,0,0,0,0,0,0,0,8,0,0,8,8
18559,Palestinian,2016,2016Palestinian,0,0,0,0,0,0,0,0,0,0,10,0,0,10,4015
18560,Palestinian,2016,2016Palestinian,0,0,0,0,0,0,0,0,0,0,45,0,0,45,45
18561,Palestinian,2016,2016Palestinian,0,0,0,0,0,0,0,0,0,5,0,0,0,5,5
18562,Palestinian,2016,2016Palestinian,0,0,0,0,0,0,0,0,5,0,10,0,0,15,15
18563,Palestinian,2016,2016Palestinian,0,0,0,0,0,5,5,0,0,0,0,0,0,0,5
18564,Palestinian,2016,2016Palestinian,0,0,0,0,0,6,6,0,0,0,0,0,31,31,37
18565,Palestinian,2016,2016Palestinian,0,0,0,0,0,18,18,0,0,0,0,0,20,20,38
18566,Palestinian,2016,2016Palestinian,0,0,0,0,0,23,23,0,0,0,0,0,94,94,117
18567,Palestinian,2016,2016Palestinian,0,0,0,0,0,253,253,0,0,0,0,0,452,452,705
18568,Palestinian,2016,2016Palestinian,0,0,0,5,0,0,5,0,0,0,0,0,0,0,10
18569,Palestinian,2016,2016Palestinian,0,0,0,5,0,0,5,0,0,0,5,0,0,5,20
18570,Palestinian,2016,2016Palestinian,0,0,0,5,0,0,5,0,0,12,0,0,0,12,17
18571,Palestinian,2016,2016Palestinian,0,0,0,6,0,0,6,0,0,0,0,0,0,0,6
18572,Palestinian,2016,2016Palestinian,0,0,0,6,0,0,6,7,0,0,16,5,0,28,34
18573,Palestinian,2016,2016Palestinian,0,0,0,10,5,0,15,0,5,0,26,5,0,36,51
18574,Palestinian,2016,2016Palestinian,0,0,0,24,0,0,24,0,0,5,34,0,0,39,489
18575,Palestinian,2016,2016Palestinian,0,0,5,16,0,0,21,0,5,5,54,5,0,69,90
18576,Palestinian,2016,2016Palestinian,0,5,0,0,0,0,5,0,0,0,0,0,0,0,5
18577,Palestinian,2016,2016Palestinian,0,5,0,0,0,0,5,0,0,0,8,0,0,8,13
18578,Palestinian,2016,2016Palestinian,0,7,0,0,0,0,7,0,0,0,0,0,0,0,7
18579,Palestinian,2016,2016Palestinian,0,9,0,9,0,0,18,0,0,8,18,0,0,26,44
18580,Palestinian,2016,2016Palestinian,0,10,6,12,0,0,28,0,8,6,26,0,0,40,68
18581,Palestinian,2016,2016Palestinian,0,11,5,8,0,0,24,0,5,6,24,0,0,35,59
18582,Palestinian,2016,2016Palestinian,0,24,5,66,0,0,95,0,38,5,310,0,0,353,448
18583,Palestinian,2016,2016Palestinian,5,0,0,5,0,0,10,0,0,5,23,0,0,28,38
18584,Palestinian,2016,2016Palestinian,5,9,5,51,0,0,70,13,11,8,143,0,0,175,245
18585,Palestinian,2016,2016Palestinian,5,34,41,190,10,0,280,6,24,23,208,38,0,299,579
18586,Palestinian,2016,2016Palestinian,14,35,17,93,10,0,169,17,38,15,204,10,0,284,453
18587,Palestinian,2016,2016Palestinian,18,35,24,73,10,0,160,16,32,17,125,0,0,190,350
18588,Palestinian,2016,2016Palestinian,33,59,55,297,47,0,491,36,85,40,351,40,0,552,1043
18589,Palestinian,2016,2016Palestinian,74,363,331,1534,203,0,2505,71,378,374,1762,289,0,2874,5379
18590,Palestinian,2016,2016Palestinian,253,427,369,2336,494,0,3879,280,0,348,2219,498,479,3824,7703
18591,Palestinian,2016,2016Palestinian,6300,8011,4950,12956,840,0,33057,7000,5060,10000,14350,560,0,36970,70027
18592,Palestinian,2017,2017Palestinian,0,0,0,0,0,0,0,0,0,0,0,0,0,0,7609
18593,Palestinian,2017,2017Palestinian,0,0,0,0,0,0,0,0,0,0,0,9,0,9,9
18594,Palestinian,2017,2017Palestinian,0,0,0,0,0,0,0,0,0,0,5,0,0,5,20
18595,Palestinian,2017,2017Palestinian,0,0,0,0,0,0,0,0,0,0,6,0,0,6,6
18596,Palestinian,2017,2017Palestinian,0,0,0,0,0,0,0,0,0,0,7,0,0,7,7
18597,Palestinian,2017,2017Palestinian,0,0,0,0,0,0,0,0,0,0,8,0,0,8,8
18598,Palestinian,2017,2017Palestinian,0,0,0,0,0,0,0,0,0,0,9,0,0,9,4014
18599,Palestinian,2017,2017Palestinian,0,0,0,0,0,0,0,0,0,5,0,0,0,5,5
18600,Palestinian,2017,2017Palestinian,0,0,0,0,0,0,0,0,0,5,6,0,0,11,11
18601,Palestinian,2017,2017Palestinian,0,0,0,0,0,0,0,0,0,5,10,0,0,15,15
18602,Palestinian,2017,2017Palestinian,0,0,0,0,0,0,0,0,0,10,12,0,0,22,22
18603,Palestinian,2017,2017Palestinian,0,0,0,0,0,0,0,0,5,0,5,0,0,10,20
18604,Palestinian,2017,2017Palestinian,0,0,0,0,0,6,6,0,0,0,0,0,31,31,37
18605,Palestinian,2017,2017Palestinian,0,0,0,0,0,18,18,0,0,0,0,0,20,20,38
18606,Palestinian,2017,2017Palestinian,0,0,0,0,0,302,302,0,0,0,0,0,511,511,813
18607,Palestinian,2017,2017Palestinian,0,0,0,5,0,0,5,0,0,0,0,0,0,0,5
18608,Palestinian,2017,2017Palestinian,0,0,0,5,0,0,5,0,0,0,5,0,0,5,10
18609,Palestinian,2017,2017Palestinian,0,0,0,5,0,0,5,0,0,0,43,0,0,43,48
18610,Palestinian,2017,2017Palestinian,0,0,0,6,0,0,6,0,0,0,0,0,0,0,6
18611,Palestinian,2017,2017Palestinian,0,0,0,10,0,0,10,0,0,0,14,5,0,19,29
18612,Palestinian,2017,2017Palestinian,0,0,5,0,0,0,5,0,0,0,0,0,0,0,5
18613,Palestinian,2017,2017Palestinian,0,0,5,0,0,0,5,0,0,0,8,0,0,8,13
18614,Palestinian,2017,2017Palestinian,0,0,5,18,0,0,23,0,5,6,55,5,0,71,94
18615,Palestinian,2017,2017Palestinian,0,0,5,19,0,0,24,0,6,0,24,5,0,35,59
18616,Palestinian,2017,2017Palestinian,0,0,9,0,0,0,9,0,0,0,0,0,0,0,9
18617,Palestinian,2017,2017Palestinian,0,5,0,0,0,0,5,0,0,0,0,0,0,0,5
18618,Palestinian,2017,2017Palestinian,0,5,0,6,0,0,11,0,5,0,26,0,0,31,42
18619,Palestinian,2017,2017Palestinian,0,5,0,15,0,0,20,0,5,0,41,5,0,51,71
18620,Palestinian,2017,2017Palestinian,0,10,5,14,0,0,29,5,5,6,30,0,0,46,75
18621,Palestinian,2017,2017Palestinian,5,0,0,8,0,0,13,5,0,8,19,5,0,37,490
18622,Palestinian,2017,2017Palestinian,5,5,0,6,0,0,16,0,0,8,11,5,0,24,40
18623,Palestinian,2017,2017Palestinian,5,29,45,201,14,0,294,8,26,29,219,49,0,331,625
18624,Palestinian,2017,2017Palestinian,8,20,10,37,5,0,80,9,18,8,115,6,0,156,236
18625,Palestinian,2017,2017Palestinian,12,43,17,77,17,0,166,21,36,17,143,5,0,222,388
18626,Palestinian,2017,2017Palestinian,16,29,18,81,10,0,154,12,32,19,182,14,0,259,413
18627,Palestinian,2017,2017Palestinian,40,49,54,352,49,0,544,21,82,68,375,57,0,603,1147
18628,Palestinian,2017,2017Palestinian,49,333,319,1567,220,0,2488,45,350,347,1777,296,0,2815,5303
18629,Palestinian,2017,2017Palestinian,213,446,378,2386,539,0,3962,212,511,371,2255,554,0,3903,7865
18630,Palestinian,2017,2017Palestinian,6300,8000,4955,12958,840,0,33053,7000,5055,10000,14350,560,0,36965,70018
18631,Palestinian,2018,2018Palestinian,0,0,0,0,0,0,0,0,0,0,0,0,0,0,8720
18632,Palestinian,2018,2018Palestinian,0,0,0,0,0,0,0,0,0,0,5,0,0,5,15
18633,Palestinian,2018,2018Palestinian,0,0,0,0,0,0,0,0,0,0,6,0,0,6,6
18634,Palestinian,2018,2018Palestinian,0,0,0,0,0,0,0,0,0,0,7,0,0,7,14
18635,Palestinian,2018,2018Palestinian,0,0,0,0,0,0,0,0,0,0,8,0,0,8,4013
18636,Palestinian,2018,2018Palestinian,0,0,0,0,0,0,0,0,0,0,9,0,0,9,18
18637,Palestinian,2018,2018Palestinian,0,0,0,0,0,0,0,0,0,5,0,0,0,5,5
18638,Palestinian,2018,2018Palestinian,0,0,0,0,0,0,0,0,0,10,11,0,0,21,21
18639,Palestinian,2018,2018Palestinian,0,0,0,0,0,0,0,5,0,0,0,0,0,5,5
18640,Palestinian,2018,2018Palestinian,0,0,0,0,0,349,349,0,0,0,0,0,591,591,940
18641,Palestinian,2018,2018Palestinian,0,0,0,0,5,0,5,0,0,0,14,0,0,14,19
18642,Palestinian,2018,2018Palestinian,0,0,0,5,0,0,5,0,0,0,0,0,0,0,10
18643,Palestinian,2018,2018Palestinian,0,0,0,5,0,0,5,0,0,0,5,0,0,5,10
18644,Palestinian,2018,2018Palestinian,0,0,0,5,0,0,5,0,0,0,7,0,0,7,24
18645,Palestinian,2018,2018Palestinian,0,0,0,5,0,0,5,0,0,0,11,0,0,11,16
18646,Palestinian,2018,2018Palestinian,0,0,0,5,0,0,5,0,0,0,50,0,0,50,55
18647,Palestinian,2018,2018Palestinian,0,0,0,7,0,0,7,0,7,0,5,0,0,12,70021
18648,Palestinian,2018,2018Palestinian,0,0,0,10,0,0,10,0,7,0,20,0,0,27,37
18649,Palestinian,2018,2018Palestinian,0,0,5,11,0,0,16,0,7,0,30,0,0,37,53
18650,Palestinian,2018,2018Palestinian,0,0,5,16,0,0,21,0,5,5,42,5,0,57,78
18651,Palestinian,2018,2018Palestinian,0,0,6,0,0,0,6,0,0,0,8,0,0,8,14
18652,Palestinian,2018,2018Palestinian,0,6,0,15,0,0,21,0,0,6,51,6,0,63,84
18653,Palestinian,2018,2018Palestinian,0,8,0,0,0,0,8,0,0,0,6,0,0,6,14
18654,Palestinian,2018,2018Palestinian,0,10,5,15,0,0,30,5,6,5,27,0,0,43,73
18655,Palestinian,2018,2018Palestinian,5,22,10,78,12,0,127,8,12,29,108,6,0,163,1120
18656,Palestinian,2018,2018Palestinian,5,23,44,200,17,0,289,5,31,21,226,47,0,330,619
18657,Palestinian,2018,2018Palestinian,8,0,0,7,0,0,15,0,5,0,9,0,0,14,29
18658,Palestinian,2018,2018Palestinian,8,44,19,73,13,0,157,23,36,11,130,10,0,210,367
18659,Palestinian,2018,2018Palestinian,9,15,5,39,5,0,73,7,14,9,116,7,0,153,226
18660,Palestinian,2018,2018Palestinian,12,33,15,72,11,0,143,11,27,17,164,15,0,234,377
18661,Palestinian,2018,2018Palestinian,30,305,287,1344,186,0,2152,20,316,312,1522,233,0,2403,4555
18662,Palestinian,2018,2018Palestinian,48,46,61,381,46,0,582,29,106,66,377,66,0,644,1226
18663,Palestinian,2018,2018Palestinian,216,458,371,2406,570,0,4021,215,482,388,2248,590,0,3923,7944
18664,Palestinian,2019,2019Palestinian,0,0,0,0,0,0,0,0,0,0,0,0,0,0,12833
18665,Palestinian,2019,2019Palestinian,0,0,0,0,0,0,0,0,0,0,0,0,10,10,10
18666,Palestinian,2019,2019Palestinian,0,0,0,0,0,0,0,0,0,0,5,0,0,5,10
18667,Palestinian,2019,2019Palestinian,0,0,0,0,0,0,0,0,0,0,6,0,0,6,6
18668,Palestinian,2019,2019Palestinian,0,0,0,0,0,0,0,0,0,0,7,0,0,7,21
18669,Palestinian,2019,2019Palestinian,0,0,0,0,0,0,0,0,0,0,8,0,0,8,8
18670,Palestinian,2019,2019Palestinian,0,0,0,0,0,0,0,0,0,5,0,0,0,5,10
18671,Palestinian,2019,2019Palestinian,0,0,0,0,0,0,0,0,0,10,11,0,0,21,21
18672,Palestinian,2019,2019Palestinian,0,0,0,0,0,429,429,0,0,0,0,0,680,680,1109
18673,Palestinian,2019,2019Palestinian,0,0,0,0,5,0,5,0,0,0,16,0,0,16,21
18674,Palestinian,2019,2019Palestinian,0,0,0,5,0,0,5,0,0,0,6,0,0,6,11
18675,Palestinian,2019,2019Palestinian,0,0,0,5,0,0,5,0,0,0,8,0,0,8,13
18676,Palestinian,2019,2019Palestinian,0,0,0,5,0,0,5,0,0,0,9,0,0,9,14
18677,Palestinian,2019,2019Palestinian,0,0,0,5,0,0,5,0,0,0,13,0,0,13,18
18678,Palestinian,2019,2019Palestinian,0,0,0,5,0,0,5,0,0,0,49,0,0,49,54
18679,Palestinian,2019,2019Palestinian,0,0,0,5,0,0,5,0,0,5,5,0,0,10,15
18680,Palestinian,2019,2019Palestinian,0,0,0,7,0,0,7,0,0,0,9,0,0,9,16
18681,Palestinian,2019,2019Palestinian,0,0,0,7,0,34995,35002,0,8,0,6,0,34994,35008,70010
18682,Palestinian,2019,2019Palestinian,0,0,6,22,0,0,28,5,7,8,63,6,0,89,117
18683,Palestinian,2019,2019Palestinian,0,8,0,12,0,0,20,0,6,0,32,0,0,38,58
18684,Palestinian,2019,2019Palestinian,0,9,6,10,5,0,30,0,9,6,27,0,0,42,72
18685,Palestinian,2019,2019Palestinian,0,30,39,199,20,0,288,5,20,33,228,51,0,337,625
18686,Palestinian,2019,2019Palestinian,5,0,0,10,0,0,15,0,0,0,20,0,0,20,35
18687,Palestinian,2019,2019Palestinian,5,5,0,16,5,0,31,0,5,6,134,7,0,152,183
18688,Palestinian,2019,2019Palestinian,5,5,5,12,0,0,27,0,5,5,18,5,0,33,60
18689,Palestinian,2019,2019Palestinian,7,26,13,57,13,0,116,8,20,13,141,12,0,194,310
18690,Palestinian,2019,2019Palestinian,8,12,8,33,5,0,66,6,12,7,77,5,0,107,173
18691,Palestinian,2019,2019Palestinian,8,39,14,66,8,0,135,16,23,15,124,8,0,186,321
18692,Palestinian,2019,2019Palestinian,12,14,8,38,6,0,78,8,13,10,112,5,0,148,226
18693,Palestinian,2019,2019Palestinian,16,132,120,610,86,0,964,14,150,132,652,103,0,1051,2015
18694,Palestinian,2019,2019Palestinian,215,443,337,2392,589,0,3976,191,467,390,2236,598,0,3882,7858
18695,Palestinian,2020,2020Palestinian,0,0,0,0,0,0,0,0,0,0,0,0,0,0,13485
18696,Palestinian,2020,2020Palestinian,0,0,0,0,0,0,0,0,0,0,0,0,8,8,8
18697,Palestinian,2020,2020Palestinian,0,0,0,0,0,0,0,0,0,0,0,0,10,10,10
18698,Palestinian,2020,2020Palestinian,0,0,0,0,0,0,0,0,0,0,5,0,0,5,30
18699,Palestinian,2020,2020Palestinian,0,0,0,0,0,0,0,0,0,0,7,0,0,7,21
18700,Palestinian,2020,2020Palestinian,0,0,0,0,0,0,0,0,0,0,8,0,0,8,8
18701,Palestinian,2020,2020Palestinian,0,0,0,0,0,0,0,0,0,0,9,0,0,9,9
18702,Palestinian,2020,2020Palestinian,0,0,0,0,0,0,0,0,0,0,9,5,0,14,14
18703,Palestinian,2020,2020Palestinian,0,0,0,0,0,0,0,0,0,0,50,0,0,50,50
18704,Palestinian,2020,2020Palestinian,0,0,0,0,0,0,0,0,0,10,11,0,0,21,21
18705,Palestinian,2020,2020Palestinian,0,0,0,0,0,0,0,0,7,0,0,0,0,7,15
18706,Palestinian,2020,2020Palestinian,0,0,0,0,0,18,18,0,0,0,0,0,72,72,90
18707,Palestinian,2020,2020Palestinian,0,0,0,0,0,317,317,0,0,0,0,0,907,907,1224
18708,Palestinian,2020,2020Palestinian,0,0,0,5,0,0,5,0,0,0,8,0,0,8,13
18709,Palestinian,2020,2020Palestinian,0,0,0,5,0,0,5,0,0,0,9,0,0,9,14
18710,Palestinian,2020,2020Palestinian,0,0,0,5,0,0,5,0,0,0,14,0,0,14,19
18711,Palestinian,2020,2020Palestinian,0,0,0,5,0,0,5,0,5,0,8,0,0,13,18
18712,Palestinian,2020,2020Palestinian,0,0,0,5,0,0,5,5,0,0,5,0,0,10,15
18713,Palestinian,2020,2020Palestinian,0,0,0,7,0,35000,35007,0,8,0,7,0,35000,35015,70022
18714,Palestinian,2020,2020Palestinian,0,0,0,15,0,0,15,0,9,0,11,0,0,20,35
18715,Palestinian,2020,2020Palestinian,0,0,5,0,0,0,5,0,0,0,0,0,0,0,5
18716,Palestinian,2020,2020Palestinian,0,0,7,10,0,0,17,0,0,5,15,0,0,20,37
18717,Palestinian,2020,2020Palestinian,0,0,7,22,5,0,34,0,12,14,71,7,0,104,138
18718,Palestinian,2020,2020Palestinian,0,5,5,7,5,0,22,0,7,5,24,0,0,36,58
18719,Palestinian,2020,2020Palestinian,0,5,5,11,0,0,21,0,5,0,29,0,0,34,55
18720,Palestinian,2020,2020Palestinian,0,6,0,11,5,0,22,0,0,7,48,5,0,60,82
18721,Palestinian,2020,2020Palestinian,0,17,49,199,24,0,289,5,28,25,232,51,0,341,630
18722,Palestinian,2020,2020Palestinian,5,23,12,49,13,0,102,5,20,11,139,13,0,188,290
18723,Palestinian,2020,2020Palestinian,6,6,6,16,0,0,34,0,6,6,23,5,0,40,74
18724,Palestinian,2020,2020Palestinian,7,13,8,37,5,0,70,7,10,8,84,6,0,115,185
18725,Palestinian,2020,2020Palestinian,10,32,13,54,5,0,114,8,23,11,102,11,0,155,269
18726,Palestinian,2020,2020Palestinian,10,70,74,403,63,0,620,10,83,89,398,82,0,662,1282
18727,Palestinian,2020,2020Palestinian,11,11,11,36,5,0,74,7,16,11,103,5,0,142,216
18728,Palestinian,2020,2020Palestinian,24,34,0,82,0,26,166,0,41,0,86,0,64,191,1777
18729,Palestinian,2020,2020Palestinian,56,114,109,450,37,0,766,59,117,114,970,40,0,1300,2066
18730,Palestinian,2020,2020Palestinian,169,450,330,2404,632,0,3985,168,474,377,2250,614,0,3883,7868
18731,Palestinian,2021,2021Palestinian,0,0,0,0,0,0,0,0,0,0,0,0,0,0,18405
18732,Palestinian,2021,2021Palestinian,0,0,0,0,0,0,0,0,0,0,0,0,10,10,10
18733,Palestinian,2021,2021Palestinian,0,0,0,0,0,0,0,0,0,0,5,0,0,5,30
18734,Palestinian,2021,2021Palestinian,0,0,0,0,0,0,0,0,0,0,6,0,0,6,6
18735,Palestinian,2021,2021Palestinian,0,0,0,0,0,0,0,0,0,0,7,0,0,7,21
18736,Palestinian,2021,2021Palestinian,0,0,0,0,0,0,0,0,0,0,9,0,0,9,9
18737,Palestinian,2021,2021Palestinian,0,0,0,0,0,0,0,0,0,0,11,0,0,11,11
18738,Palestinian,2021,2021Palestinian,0,0,0,0,0,0,0,0,0,10,11,0,0,21,21
18739,Palestinian,2021,2021Palestinian,0,0,0,5,0,0,5,0,0,0,6,5,0,11,16
18740,Palestinian,2021,2021Palestinian,0,0,0,5,0,0,5,0,0,0,10,0,0,10,15
18741,Palestinian,2021,2021Palestinian,0,0,0,5,0,0,5,0,0,0,16,0,0,16,21
18742,Palestinian,2021,2021Palestinian,0,0,0,5,0,0,5,0,0,0,54,0,0,54,59
18743,Palestinian,2021,2021Palestinian,0,0,0,5,0,0,5,0,5,0,8,0,0,13,18
18744,Palestinian,2021,2021Palestinian,0,0,0,5,0,0,5,6,0,0,5,0,0,11,16
18745,Palestinian,2021,2021Palestinian,0,0,0,5,0,35001,35006,0,0,9,5,0,35001,35015,70021
18746,Palestinian,2021,2021Palestinian,0,0,0,8,0,0,8,0,0,0,7,0,0,7,15
18747,Palestinian,2021,2021Palestinian,0,0,5,13,0,0,18,0,0,5,16,0,0,21,39
18748,Palestinian,2021,2021Palestinian,0,0,7,21,5,0,33,0,13,10,67,7,0,97,130
18749,Palestinian,2021,2021Palestinian,0,0,8,0,0,0,8,0,0,0,0,0,0,0,8
18750,Palestinian,2021,2021Palestinian,0,5,0,0,0,0,5,0,0,0,0,0,0,0,5
18751,Palestinian,2021,2021Palestinian,0,6,0,0,0,0,6,0,0,0,0,0,0,0,6
18752,Palestinian,2021,2021Palestinian,0,6,0,5,5,0,16,0,0,5,13,0,0,18,34
18753,Palestinian,2021,2021Palestinian,0,7,5,8,0,0,20,0,0,7,22,0,0,29,49
18754,Palestinian,2021,2021Palestinian,0,9,0,6,5,0,20,0,7,5,20,0,0,32,52
18755,Palestinian,2021,2021Palestinian,0,9,0,11,5,0,25,0,0,7,51,6,0,64,89
18756,Palestinian,2021,2021Palestinian,0,13,45,176,31,0,265,0,17,27,206,61,0,311,576
18757,Palestinian,2021,2021Palestinian,5,5,6,18,0,0,34,5,5,0,29,5,0,44,78
18758,Palestinian,2021,2021Palestinian,5,12,12,47,12,0,88,5,18,12,129,13,0,177,265
18759,Palestinian,2021,2021Palestinian,5,22,15,46,0,0,88,5,17,13,80,5,0,120,208
18760,Palestinian,2021,2021Palestinian,5,38,48,120,31,0,242,10,58,49,170,31,0,318,560
18761,Palestinian,2021,2021Palestinian,6,0,0,0,0,0,6,0,6,0,0,0,0,6,12
18762,Palestinian,2021,2021Palestinian,7,0,6,12,0,0,25,0,8,0,25,0,0,33,58
18763,Palestinian,2021,2021Palestinian,7,13,8,37,5,0,70,7,10,8,84,6,0,115,185
18764,Palestinian,2021,2021Palestinian,13,14,15,41,7,0,90,5,20,13,112,9,0,159,249
18765,Palestinian,2021,2021Palestinian,50,82,24,217,14,26,413,39,102,18,345,8,64,576,2374
18766,Palestinian,2021,2021Palestinian,60,100,113,436,40,0,749,65,112,129,920,41,0,1267,2025
18767,Palestinian,2021,2021Palestinian,141,454,336,2407,644,0,3982,171,459,375,2246,652,0,3903,7885
18768,Peru,2001,2001Peru,0,0,0,0,0,0,0,0,0,0,0,0,0,0,5457
18769,Peru,2001,2001Peru,0,0,0,0,0,0,0,0,0,0,6,0,0,6,6
18770,Peru,2001,2001Peru,0,0,0,0,0,13,13,0,0,0,0,0,12,12,25
18771,Peru,2001,2001Peru,0,0,0,0,0,18,18,0,0,0,0,0,26,26,44
18772,Peru,2001,2001Peru,0,0,0,0,0,148,148,0,0,0,0,0,179,179,327
18773,Peru,2001,2001Peru,0,0,0,5,0,0,5,0,0,0,0,0,0,0,5
18774,Peru,2001,2001Peru,0,0,0,6,0,0,6,0,0,0,0,0,0,0,6
18775,Peru,2001,2001Peru,0,0,0,8,0,0,8,0,8,0,0,0,0,8,16
18776,Peru,2001,2001Peru,0,0,0,9,0,0,9,0,0,6,8,0,0,14,23
18777,Peru,2001,2001Peru,0,5,0,13,0,0,18,0,0,0,20,0,0,20,38
18778,Peru,2001,2001Peru,7,7,6,38,0,0,58,6,6,6,18,0,0,36,233
18779,Peru,2001,2001Peru,10,12,10,58,5,0,95,9,14,12,92,0,0,127,320
18780,Peru,2002,2002Peru,0,0,0,0,0,0,0,0,0,0,0,0,0,0,5203
18781,Peru,2002,2002Peru,0,0,0,0,0,0,0,0,0,0,5,0,0,5,238
18782,Peru,2002,2002Peru,0,0,0,0,0,0,0,0,0,0,6,0,0,6,6
18783,Peru,2002,2002Peru,0,0,0,0,0,8,8,0,0,0,0,0,15,15,35
18784,Peru,2002,2002Peru,0,0,0,0,0,134,134,0,0,0,0,0,176,176,310
18785,Peru,2002,2002Peru,0,0,0,5,0,0,5,0,0,0,0,0,0,0,5
18786,Peru,2002,2002Peru,0,0,0,8,0,0,8,0,0,0,0,0,0,0,8
18787,Peru,2002,2002Peru,0,0,0,8,0,0,8,0,8,0,0,0,0,8,16
18788,Peru,2002,2002Peru,0,0,0,9,0,0,9,0,0,6,6,0,0,12,21
18789,Peru,2002,2002Peru,0,0,0,17,0,0,17,0,0,0,17,0,0,17,34
18790,Peru,2002,2002Peru,0,5,5,35,0,0,45,0,0,8,25,0,0,33,236
18791,Peru,2002,2002Peru,10,12,10,58,5,0,95,9,14,12,93,0,0,128,319
18792,Peru,2003,2003Peru,0,0,0,0,0,0,0,0,0,0,0,0,0,0,5207
18793,Peru,2003,2003Peru,0,0,0,0,0,0,0,0,0,0,6,0,0,6,6
18794,Peru,2003,2003Peru,0,0,0,0,0,5,5,0,0,0,0,0,12,12,31
18795,Peru,2003,2003Peru,0,0,0,0,0,119,119,0,0,0,0,0,151,151,270
18796,Peru,2003,2003Peru,0,0,0,5,0,0,5,0,0,0,0,0,0,0,5
18797,Peru,2003,2003Peru,0,0,0,8,0,0,8,0,8,0,0,0,0,8,16
18798,Peru,2003,2003Peru,0,0,0,9,0,0,9,0,0,6,6,0,0,12,21
18799,Peru,2003,2003Peru,0,5,0,5,0,0,10,0,0,0,12,0,0,12,22
18800,Peru,2004,2004Peru,0,0,0,0,0,0,0,0,0,0,0,0,0,0,3547
18801,Peru,2004,2004Peru,0,0,0,0,0,9,9,0,5,0,5,0,11,21,30
18802,Peru,2004,2004Peru,0,0,0,5,0,0,5,0,0,0,0,0,0,0,5
18803,Peru,2004,2004Peru,0,0,0,6,0,0,6,0,0,0,0,0,0,0,6
18804,Peru,2004,2004Peru,0,0,0,9,0,0,9,0,0,0,11,0,0,11,20
18805,Peru,2004,2004Peru,0,0,0,9,0,0,9,0,0,6,6,0,0,12,21
18806,Peru,2004,2004Peru,0,5,0,5,0,0,10,0,0,0,7,0,0,7,17
18807,Peru,2004,2004Peru,0,6,0,12,0,0,18,0,0,5,16,0,0,21,39
18808,Peru,2004,2004Peru,0,10,8,48,6,0,72,0,19,17,113,0,0,149,221
18809,Peru,2004,2004Peru,6,21,18,146,5,0,196,7,34,29,170,7,0,247,443
18810,Peru,2004,2004Peru,9,25,21,138,6,0,199,23,25,22,142,7,0,219,418
18811,Peru,2005,2005Peru,0,0,0,0,0,0,0,0,0,0,0,0,0,0,3381
18812,Peru,2005,2005Peru,0,0,0,0,0,8,8,0,0,0,6,0,12,18,26
18813,Peru,2005,2005Peru,0,0,0,0,0,114,114,0,0,0,0,0,154,154,268
18814,Peru,2005,2005Peru,0,0,0,5,0,0,5,0,0,0,0,0,0,0,5
18815,Peru,2005,2005Peru,0,0,0,7,0,0,7,0,0,0,7,0,0,7,14
18816,Peru,2005,2005Peru,0,0,0,8,0,0,8,0,0,0,8,5,0,13,21
18817,Peru,2005,2005Peru,0,0,0,8,0,0,8,0,0,0,11,0,0,11,19
18818,Peru,2005,2005Peru,0,0,0,9,0,0,9,0,0,0,0,0,0,0,9
18819,Peru,2005,2005Peru,0,10,8,49,6,0,73,0,19,16,113,0,0,148,221
18820,Peru,2005,2005Peru,5,14,13,154,5,0,191,6,15,15,209,6,0,251,442
18821,Peru,2005,2005Peru,5,26,22,161,8,0,222,11,29,25,156,14,0,235,457
18822,Peru,2006,2006Peru,0,0,0,0,0,0,0,0,0,0,0,0,0,0,5440
18823,Peru,2006,2006Peru,0,0,0,0,0,7,7,0,0,0,0,0,15,15,22
18824,Peru,2006,2006Peru,0,0,0,0,0,16,16,0,0,0,0,0,22,22,38
18825,Peru,2006,2006Peru,0,0,0,0,0,111,111,0,0,0,0,0,155,155,266
18826,Peru,2006,2006Peru,0,0,0,7,0,0,7,0,0,0,0,0,0,0,7
18827,Peru,2006,2006Peru,0,0,0,7,0,0,7,0,0,0,7,0,0,7,14
18828,Peru,2006,2006Peru,0,0,0,8,0,0,8,0,0,0,8,5,0,13,21
18829,Peru,2006,2006Peru,0,0,0,8,0,0,8,0,0,0,11,0,0,11,19
18830,Peru,2006,2006Peru,0,0,0,9,0,0,9,0,0,0,0,0,0,0,9
18831,Peru,2006,2006Peru,0,11,8,49,6,0,74,0,21,15,114,0,0,150,224
18832,Peru,2006,2006Peru,5,20,28,167,13,0,233,5,36,22,166,8,0,237,470
18833,Peru,2006,2006Peru,6,17,18,102,5,0,148,7,14,20,121,7,0,169,447
18834,Peru,2007,2007Peru,0,0,0,0,0,0,0,0,0,0,0,0,0,0,5818
18835,Peru,2007,2007Peru,0,0,0,0,0,0,0,0,0,0,8,0,0,8,8
18836,Peru,2007,2007Peru,0,0,0,0,0,5,5,0,0,0,0,0,0,0,5
18837,Peru,2007,2007Peru,0,0,0,0,0,112,112,0,0,0,0,0,157,157,269
18838,Peru,2007,2007Peru,0,0,0,7,0,0,7,0,0,0,0,0,0,0,7
18839,Peru,2007,2007Peru,0,0,0,7,0,0,7,0,0,0,5,0,8,13,20
18840,Peru,2007,2007Peru,0,0,0,7,0,0,7,0,0,0,7,0,0,7,14
18841,Peru,2007,2007Peru,0,0,0,8,0,0,8,0,0,0,8,5,0,13,21
18842,Peru,2007,2007Peru,0,0,0,9,0,0,9,0,0,0,0,0,0,0,9
18843,Peru,2007,2007Peru,0,0,5,13,0,0,18,0,0,5,17,0,0,22,40
18844,Peru,2007,2007Peru,0,5,5,27,0,0,37,7,0,0,26,0,0,33,70
18845,Peru,2007,2007Peru,0,11,7,51,6,0,75,0,21,14,117,0,0,152,227
18846,Peru,2007,2007Peru,0,18,34,177,5,0,234,5,12,19,238,7,0,281,515
18847,Peru,2007,2007Peru,5,10,10,73,0,0,98,6,13,13,93,7,0,132,230
18848,Peru,2007,2007Peru,6,20,32,170,13,0,241,6,36,25,169,8,0,244,485
18849,Peru,2008,2008Peru,0,0,0,0,0,0,0,0,0,0,0,0,0,0,6113
18850,Peru,2008,2008Peru,0,0,0,0,0,0,0,0,0,0,8,0,0,8,8
18851,Peru,2008,2008Peru,0,0,0,0,0,5,5,0,0,0,0,0,0,0,5
18852,Peru,2008,2008Peru,0,0,0,0,0,6,6,0,0,0,5,0,7,12,18
18853,Peru,2008,2008Peru,0,0,0,0,0,110,110,0,0,0,0,0,153,153,263
18854,Peru,2008,2008Peru,0,0,0,6,0,0,6,0,0,0,0,0,0,0,6
18855,Peru,2008,2008Peru,0,0,0,7,0,0,7,0,0,0,7,0,0,7,14
18856,Peru,2008,2008Peru,0,0,0,8,0,0,8,0,0,0,8,5,0,13,21
18857,Peru,2008,2008Peru,0,0,0,9,0,0,9,0,0,0,0,0,0,0,9
18858,Peru,2008,2008Peru,0,0,5,13,0,0,18,0,0,5,17,0,0,22,40
18859,Peru,2008,2008Peru,0,0,9,41,0,0,50,7,0,0,30,0,0,37,87
18860,Peru,2008,2008Peru,0,18,34,177,5,0,234,5,12,19,238,7,0,281,515
18861,Peru,2008,2008Peru,5,10,10,73,0,0,98,6,13,13,93,7,0,132,230
18862,Peru,2009,2009Peru,0,0,0,0,0,0,0,0,0,0,0,0,0,0,5097
18863,Peru,2009,2009Peru,0,0,0,0,0,0,0,0,0,0,9,0,0,9,9
18864,Peru,2009,2009Peru,0,0,0,0,0,5,5,0,0,0,0,0,0,0,5
18865,Peru,2009,2009Peru,0,0,0,5,0,0,5,0,0,0,5,0,5,10,15
18866,Peru,2009,2009Peru,0,0,0,6,0,0,6,0,0,0,0,0,0,0,6
18867,Peru,2009,2009Peru,0,0,0,7,0,0,7,0,0,0,7,0,0,7,14
18868,Peru,2009,2009Peru,0,0,0,8,0,0,8,0,0,0,0,0,0,0,8
18869,Peru,2009,2009Peru,0,0,0,8,0,0,8,0,0,0,8,5,0,13,21
18870,Peru,2009,2009Peru,0,0,5,13,0,0,18,0,0,5,17,0,0,22,40
18871,Peru,2009,2009Peru,0,0,8,43,0,0,51,0,0,8,31,0,0,39,90
18872,Peru,2009,2009Peru,0,0,38,187,5,0,230,0,6,20,253,7,0,286,516
18873,Peru,2009,2009Peru,0,5,10,85,13,0,113,0,5,6,84,13,0,108,221
18874,Peru,2009,2009Peru,5,9,10,74,0,0,98,6,13,13,94,6,0,132,230
18875,Peru,2010,2010Peru,0,0,0,0,0,0,0,0,0,0,0,0,0,0,4396
18876,Peru,2010,2010Peru,0,0,0,0,0,0,0,0,0,0,10,0,0,10,10
18877,Peru,2010,2010Peru,0,0,0,0,0,5,5,0,0,0,0,0,0,0,5
18878,Peru,2010,2010Peru,0,0,0,0,0,5,5,0,0,0,0,0,7,7,12
18879,Peru,2010,2010Peru,0,0,0,0,0,112,112,0,0,0,0,0,156,156,268
18880,Peru,2010,2010Peru,0,0,0,7,0,0,7,0,0,0,0,0,0,0,7
18881,Peru,2010,2010Peru,0,0,0,7,0,0,7,0,0,0,7,0,0,7,14
18882,Peru,2010,2010Peru,0,0,0,8,0,0,8,0,0,0,0,0,0,0,8
18883,Peru,2010,2010Peru,0,0,0,8,0,0,8,0,0,0,8,5,0,13,21
18884,Peru,2010,2010Peru,0,0,0,17,0,0,17,0,0,5,23,0,0,28,45
18885,Peru,2010,2010Peru,0,0,7,46,0,0,53,0,0,9,30,5,0,44,97
18886,Peru,2010,2010Peru,0,0,15,90,0,0,105,0,6,25,254,6,0,291,515
18887,Peru,2010,2010Peru,0,5,6,79,12,0,102,0,5,5,82,14,0,106,208
18888,Peru,2010,2010Peru,5,9,10,73,0,0,97,6,13,13,94,5,0,131,228
18889,Peru,2011,2011Peru,0,0,0,0,0,0,0,0,0,0,0,0,0,0,1411
18890,Peru,2011,2011Peru,0,0,0,0,0,5,5,0,0,0,0,0,0,0,5
18891,Peru,2011,2011Peru,0,0,0,0,0,5,5,0,0,0,0,0,7,7,12
18892,Peru,2011,2011Peru,0,0,0,0,0,116,116,0,0,0,0,0,161,161,277
18893,Peru,2011,2011Peru,0,0,0,5,0,0,5,0,0,0,0,0,0,0,14
18894,Peru,2011,2011Peru,0,0,0,7,0,0,7,0,0,0,0,0,0,0,7
18895,Peru,2011,2011Peru,0,0,0,7,0,0,7,0,0,0,7,0,0,7,14
18896,Peru,2011,2011Peru,0,0,0,8,0,0,8,0,0,0,0,0,0,0,8
18897,Peru,2011,2011Peru,0,0,0,8,0,0,8,0,0,0,8,5,0,13,21
18898,Peru,2011,2011Peru,0,0,0,17,0,0,17,0,0,5,23,0,0,28,45
18899,Peru,2011,2011Peru,0,0,6,47,0,0,53,0,0,9,30,5,0,44,97
18900,Peru,2011,2011Peru,0,0,8,25,5,0,38,0,0,9,23,0,0,32,2048
18901,Peru,2011,2011Peru,0,0,8,80,18,0,106,0,0,9,78,9,0,96,582
18902,Peru,2011,2011Peru,0,0,9,81,15,0,105,0,5,7,70,17,0,99,204
18903,Peru,2011,2011Peru,0,0,38,186,5,0,229,0,6,20,253,7,0,286,515
18904,Peru,2011,2011Peru,5,9,10,73,0,0,97,6,13,13,94,5,0,131,228
18905,Peru,2012,2012Peru,0,0,0,0,0,0,0,0,0,0,0,0,0,0,1288
18906,Peru,2012,2012Peru,0,0,0,0,0,0,0,0,0,0,7,0,0,7,7
18907,Peru,2012,2012Peru,0,0,0,0,0,0,0,0,0,0,8,0,0,8,8
18908,Peru,2012,2012Peru,0,0,0,0,0,5,5,0,0,0,0,0,0,0,5
18909,Peru,2012,2012Peru,0,0,0,0,0,5,5,0,0,0,0,0,6,6,11
18910,Peru,2012,2012Peru,0,0,0,0,0,124,124,0,0,0,0,0,164,164,288
18911,Peru,2012,2012Peru,0,0,0,5,0,0,5,0,0,0,5,0,0,5,10
18912,Peru,2012,2012Peru,0,0,0,7,0,0,7,0,0,0,0,0,0,0,7
18913,Peru,2012,2012Peru,0,0,0,8,0,0,8,0,0,10,0,5,0,15,23
18914,Peru,2012,2012Peru,0,0,0,17,0,0,17,0,0,5,9,0,0,14,1905
18915,Peru,2012,2012Peru,0,0,0,17,0,0,17,0,0,5,23,0,0,28,45
18916,Peru,2012,2012Peru,0,0,5,47,0,0,52,0,6,0,31,5,0,42,94
18917,Peru,2012,2012Peru,0,0,6,76,14,0,96,0,0,9,71,19,0,99,195
18918,Peru,2012,2012Peru,0,0,6,79,20,0,105,0,0,7,77,11,0,95,582
18919,Peru,2012,2012Peru,0,0,38,185,5,0,228,0,6,20,250,7,0,283,511
18920,Peru,2012,2012Peru,5,9,10,73,0,0,97,6,13,13,94,5,0,131,228
18921,Peru,2013,2013Peru,0,0,0,0,0,0,0,0,0,0,0,0,0,0,1134
18922,Peru,2013,2013Peru,0,0,0,0,0,0,0,0,0,0,7,0,0,7,7
18923,Peru,2013,2013Peru,0,0,0,0,0,0,0,0,0,0,8,0,0,8,8
18924,Peru,2013,2013Peru,0,0,0,0,0,5,5,0,0,0,0,0,0,0,5
18925,Peru,2013,2013Peru,0,0,0,0,0,5,5,0,0,0,0,0,5,5,10
18926,Peru,2013,2013Peru,0,0,0,0,0,124,124,0,0,0,0,0,168,168,292
18927,Peru,2013,2013Peru,0,0,0,5,0,0,5,0,0,0,5,0,0,5,10
18928,Peru,2013,2013Peru,0,0,0,7,0,0,7,0,0,0,0,0,0,0,7
18929,Peru,2013,2013Peru,0,0,0,8,0,0,8,0,0,10,0,5,0,15,23
18930,Peru,2013,2013Peru,0,0,0,17,0,0,17,0,0,5,23,0,0,28,45
18931,Peru,2013,2013Peru,0,0,5,16,5,0,26,0,0,5,8,0,0,13,1757
18932,Peru,2013,2013Peru,0,0,5,46,0,0,51,0,6,0,31,5,0,42,93
18933,Peru,2013,2013Peru,0,0,11,246,45,0,302,0,0,11,227,42,0,280,582
18934,Peru,2013,2013Peru,0,0,36,180,5,0,221,0,5,32,248,7,0,292,513
18935,Peru,2013,2013Peru,0,5,0,18,6,0,29,0,0,0,9,10,0,19,48
18936,Peru,2013,2013Peru,5,9,10,73,0,0,97,6,13,13,94,5,0,131,228
18937,Peru,2014,2014Peru,0,0,0,0,0,0,0,0,0,0,0,0,0,0,1289
18938,Peru,2014,2014Peru,0,0,0,0,0,0,0,0,0,0,0,0,5,5,5
18939,Peru,2014,2014Peru,0,0,0,0,0,0,0,0,0,0,0,0,9,9,9
18940,Peru,2014,2014Peru,0,0,0,0,0,0,0,0,0,0,8,0,0,8,8
18941,Peru,2014,2014Peru,0,0,0,0,0,125,125,0,0,0,0,0,160,160,285
18942,Peru,2014,2014Peru,0,0,0,0,5,0,5,0,0,13,0,5,0,18,23
18943,Peru,2014,2014Peru,0,0,0,5,0,0,5,0,0,0,5,0,0,5,10
18944,Peru,2014,2014Peru,0,0,0,5,0,0,5,0,0,6,34,0,0,40,45
18945,Peru,2014,2014Peru,0,0,0,6,0,0,6,0,0,0,0,0,0,0,6
18946,Peru,2014,2014Peru,0,0,0,7,0,0,7,0,0,0,0,0,0,0,7
18947,Peru,2014,2014Peru,0,0,0,7,0,0,7,0,0,5,5,0,0,10,1505
18948,Peru,2014,2014Peru,0,0,0,20,8,0,28,0,0,0,7,11,0,18,46
18949,Peru,2014,2014Peru,0,0,11,246,45,0,302,0,0,11,227,42,0,280,582
18950,Peru,2014,2014Peru,0,0,34,188,6,0,228,0,7,21,250,7,0,285,513
18951,Peru,2015,2015Peru,0,0,0,0,0,0,0,0,0,0,0,0,0,0,2002
18952,Peru,2015,2015Peru,0,0,0,0,0,0,0,0,0,0,0,0,5,5,5
18953,Peru,2015,2015Peru,0,0,0,0,0,0,0,0,0,0,8,0,0,8,8
18954,Peru,2015,2015Peru,0,0,0,0,0,5,5,0,0,0,0,0,0,0,5
18955,Peru,2015,2015Peru,0,0,0,0,0,9,9,0,0,0,0,0,0,0,9
18956,Peru,2015,2015Peru,0,0,0,0,0,129,129,0,0,0,0,0,161,161,290
18957,Peru,2015,2015Peru,0,0,0,0,5,0,5,0,0,13,0,5,0,18,23
18958,Peru,2015,2015Peru,0,0,0,7,0,0,7,0,0,0,0,0,0,0,7
18959,Peru,2015,2015Peru,0,0,0,12,0,0,12,0,0,0,33,0,0,33,45
18960,Peru,2015,2015Peru,0,0,0,19,8,0,27,0,0,0,5,10,0,15,42
18961,Peru,2015,2015Peru,0,0,5,218,49,0,272,0,0,5,218,53,0,276,548
18962,Peru,2015,2015Peru,0,0,16,32,0,0,48,0,5,9,21,5,0,40,93
18963,Peru,2015,2015Peru,0,0,32,188,6,0,226,0,5,24,252,7,0,288,514
18964,Peru,2016,2016Peru,0,0,0,0,0,0,0,0,0,0,0,0,0,0,1301
18965,Peru,2016,2016Peru,0,0,0,0,0,0,0,0,0,0,0,0,5,5,5
18966,Peru,2016,2016Peru,0,0,0,0,0,0,0,0,0,0,0,0,8,8,8
18967,Peru,2016,2016Peru,0,0,0,0,0,0,0,0,0,0,7,0,0,7,7
18968,Peru,2016,2016Peru,0,0,0,0,0,6,6,0,0,0,0,0,9,9,15
18969,Peru,2016,2016Peru,0,0,0,0,0,129,129,0,0,0,0,0,159,159,288
18970,Peru,2016,2016Peru,0,0,0,0,5,0,5,0,0,13,0,5,0,18,23
18971,Peru,2016,2016Peru,0,0,0,5,0,0,5,0,0,0,0,0,0,0,5
18972,Peru,2016,2016Peru,0,0,0,6,0,0,6,0,0,0,5,0,0,5,316
18973,Peru,2016,2016Peru,0,0,0,12,0,0,12,0,0,0,33,0,0,33,45
18974,Peru,2016,2016Peru,0,0,0,16,10,0,26,0,0,0,5,8,0,13,39
18975,Peru,2016,2016Peru,0,0,5,223,45,0,273,0,0,0,224,50,0,274,547
18976,Peru,2017,2017Peru,0,0,0,0,0,0,0,0,0,0,0,0,0,0,1573
18977,Peru,2017,2017Peru,0,0,0,0,0,0,0,0,0,0,6,0,0,6,6
18978,Peru,2017,2017Peru,0,0,0,0,0,6,6,0,0,0,0,0,9,9,15
18979,Peru,2017,2017Peru,0,0,0,0,0,8,8,0,0,0,0,0,0,0,8
18980,Peru,2017,2017Peru,0,0,0,0,0,131,131,0,0,0,0,0,167,167,298
18981,Peru,2017,2017Peru,0,0,0,0,5,0,5,0,0,13,0,5,0,18,23
18982,Peru,2017,2017Peru,0,0,0,16,10,0,26,0,0,0,5,7,0,12,38
18983,Peru,2017,2017Peru,0,0,0,46,0,0,46,0,0,5,22,7,0,34,80
18984,Peru,2017,2017Peru,0,0,0,224,50,0,274,0,0,0,222,51,0,273,547
18985,Peru,2018,2018Peru,0,0,0,0,0,0,0,0,0,0,0,0,0,0,1437
18986,Peru,2018,2018Peru,0,0,0,0,0,0,0,0,0,0,0,0,8,8,8
18987,Peru,2018,2018Peru,0,0,0,0,0,0,0,0,0,0,6,0,0,6,6
18988,Peru,2018,2018Peru,0,0,0,0,0,140,140,0,0,0,0,0,175,175,315
18989,Peru,2018,2018Peru,0,0,0,5,0,0,5,0,0,0,0,0,0,0,5
18990,Peru,2018,2018Peru,0,0,0,15,11,0,26,0,0,0,6,7,0,13,39
18991,Peru,2018,2018Peru,0,0,0,220,54,0,274,0,0,0,212,59,0,271,545
18992,Peru,2018,2018Peru,0,5,0,8,0,0,13,0,5,0,10,0,0,15,224
18993,Peru,2019,2019Peru,0,0,0,0,0,0,0,0,0,0,0,0,0,0,1844
18994,Peru,2019,2019Peru,0,0,0,0,0,0,0,0,0,0,6,0,0,6,6
18995,Peru,2019,2019Peru,0,0,0,0,0,144,144,0,0,0,0,0,182,182,326
18996,Peru,2019,2019Peru,0,0,0,5,0,0,5,0,0,0,0,0,0,0,5
18997,Peru,2019,2019Peru,0,0,0,15,10,0,25,0,0,0,9,6,0,15,40
18998,Peru,2019,2019Peru,0,0,0,211,61,0,272,0,0,0,204,68,0,272,544
18999,Peru,2020,2020Peru,0,0,0,0,0,0,0,0,0,0,0,0,0,0,1520
19000,Peru,2020,2020Peru,0,0,0,0,0,0,0,0,0,0,5,0,0,5,113
19001,Peru,2020,2020Peru,0,0,0,0,0,0,0,0,0,0,6,0,0,6,6
19002,Peru,2020,2020Peru,0,0,0,0,0,0,0,9,0,0,0,0,0,9,524
19003,Peru,2020,2020Peru,0,0,0,5,0,0,5,0,0,0,0,0,0,0,5
19004,Peru,2020,2020Peru,0,0,0,15,10,0,25,0,0,0,8,6,0,14,39
19005,Peru,2020,2020Peru,0,0,0,39,7,0,46,0,0,5,21,10,0,36,82
19006,Peru,2020,2020Peru,0,0,0,203,68,0,271,0,0,0,199,75,0,274,545
19007,Peru,2021,2021Peru,0,0,0,0,0,0,0,0,0,0,0,0,0,0,2558
19008,Peru,2021,2021Peru,0,0,0,0,0,0,0,0,0,0,7,0,0,7,7
19009,Peru,2021,2021Peru,0,0,0,5,0,0,5,0,0,0,0,0,0,0,5
19010,Peru,2021,2021Peru,0,0,0,13,8,0,21,0,0,0,5,5,0,10,31
19011,Peru,2021,2021Peru,0,0,0,38,8,0,46,0,5,0,20,11,0,36,82
19012,Peru,2021,2021Peru,0,0,0,200,73,0,273,0,0,0,192,83,0,275,548
19013,Peru,2021,2021Peru,0,7,5,42,0,0,54,0,6,5,48,0,0,59,113
19014,Peru,2021,2021Peru,5,6,5,15,0,0,31,0,8,0,8,0,0,16,144
19015,Peru,2021,2021Peru,6,5,0,0,0,0,11,13,0,0,9,0,0,22,33
19016,Philippines,2001,2001Philippines,0,0,0,0,0,0,0,0,0,0,0,0,0,0,45469
19017,Philippines,2002,2002Philippines,0,0,0,0,0,0,0,0,0,0,0,0,0,0,499
19018,Philippines,2002,2002Philippines,0,0,0,7,0,0,7,0,0,0,0,0,0,0,45107
19019,Philippines,2003,2003Philippines,0,0,0,0,0,0,0,0,0,0,0,0,0,0,402
19020,Philippines,2003,2003Philippines,0,0,0,0,0,0,0,0,0,0,7,0,0,7,7
19021,Philippines,2004,2004Philippines,0,0,0,0,0,0,0,0,0,0,0,0,0,0,423
19022,Philippines,2004,2004Philippines,0,0,0,0,0,0,0,0,0,0,5,0,0,5,5
19023,Philippines,2005,2005Philippines,0,0,0,0,0,0,0,0,0,0,0,0,0,0,459
19024,Philippines,2005,2005Philippines,0,0,0,0,0,0,0,0,0,0,5,0,0,5,5
19025,Philippines,2006,2006Philippines,0,0,0,0,0,0,0,0,0,0,0,0,0,0,883
19026,Philippines,2006,2006Philippines,0,0,0,0,0,0,0,0,0,0,5,0,0,5,5
19027,Philippines,2007,2007Philippines,0,0,0,0,0,0,0,0,0,0,0,0,0,0,1545
19028,Philippines,2007,2007Philippines,0,0,0,0,0,0,0,0,0,0,5,0,0,5,5
19029,Philippines,2008,2008Philippines,0,0,0,0,0,0,0,0,0,0,0,0,0,0,1348
19030,Philippines,2009,2009Philippines,0,0,0,0,0,0,0,0,0,0,0,0,0,0,771
19031,Philippines,2009,2009Philippines,0,5,11,115,11,0,142,0,9,14,44,7,0,74,216
19032,Philippines,2010,2010Philippines,0,0,0,0,0,0,0,0,0,0,0,0,0,0,735
19033,Philippines,2010,2010Philippines,0,6,15,111,20,0,152,0,6,13,46,11,0,76,228
19034,Philippines,2011,2011Philippines,0,0,0,0,0,0,0,0,0,0,0,0,0,0,418
19035,Philippines,2011,2011Philippines,0,0,6,21,0,0,27,0,0,0,14,0,0,14,310
19036,Philippines,2011,2011Philippines,0,8,8,103,23,0,142,0,5,14,42,14,0,75,217
19037,Philippines,2012,2012Philippines,0,0,0,0,0,0,0,0,0,0,0,0,0,0,403
19038,Philippines,2012,2012Philippines,0,0,0,11,0,0,11,0,0,0,0,0,0,0,322
19039,Philippines,2012,2012Philippines,0,0,5,0,0,0,5,0,0,0,0,0,0,0,5
19040,Philippines,2012,2012Philippines,5,8,5,129,22,0,169,0,5,16,44,15,0,80,249
19041,Philippines,2013,2013Philippines,0,0,0,0,0,0,0,0,0,0,0,0,0,0,359
19042,Philippines,2013,2013Philippines,0,0,0,5,0,0,5,0,0,0,0,0,0,0,5
19043,Philippines,2013,2013Philippines,0,0,0,9,0,0,9,0,7,0,0,0,0,7,321
19044,Philippines,2013,2013Philippines,0,0,5,0,0,0,5,0,0,0,0,0,0,0,5
19045,Philippines,2013,2013Philippines,0,8,5,7,0,0,20,0,0,8,0,0,0,8,28
19046,Philippines,2014,2014Philippines,0,0,0,0,0,0,0,0,0,0,0,0,0,0,317
19047,Philippines,2014,2014Philippines,0,0,0,5,0,0,5,0,0,0,0,0,0,0,5
19048,Philippines,2014,2014Philippines,0,0,0,6,0,0,6,0,0,0,0,0,0,0,6
19049,Philippines,2014,2014Philippines,0,0,0,9,0,0,9,0,0,0,0,0,0,0,301
19050,Philippines,2014,2014Philippines,0,8,5,9,0,0,22,0,9,0,0,0,0,9,31
19051,Philippines,2015,2015Philippines,0,0,0,0,0,0,0,0,0,0,0,0,0,0,538
19052,Philippines,2015,2015Philippines,0,0,0,0,0,0,0,0,5,0,0,0,0,5,5
19053,Philippines,2015,2015Philippines,0,0,0,5,0,0,5,0,0,0,0,0,0,0,5
19054,Philippines,2015,2015Philippines,0,0,0,6,0,0,6,0,0,0,0,0,0,0,6
19055,Philippines,2015,2015Philippines,0,6,0,13,0,0,19,0,9,0,0,0,0,9,28
19056,Philippines,2016,2016Philippines,0,0,0,0,0,0,0,0,0,0,0,0,0,0,261
19057,Philippines,2016,2016Philippines,0,0,0,0,0,0,0,0,5,0,0,0,0,5,5
19058,Philippines,2016,2016Philippines,0,0,0,5,0,0,5,0,0,0,0,0,0,0,25
19059,Philippines,2016,2016Philippines,0,0,0,7,0,0,7,0,0,0,0,0,0,0,110
19060,Philippines,2016,2016Philippines,0,0,6,12,0,0,18,0,0,7,0,0,0,7,25
19061,Philippines,2017,2017Philippines,0,0,0,0,0,0,0,0,0,0,0,0,0,0,381
19062,Philippines,2017,2017Philippines,0,0,0,0,0,0,0,0,5,0,0,0,0,5,5
19063,Philippines,2017,2017Philippines,0,0,0,5,0,0,5,0,0,0,0,0,0,0,25
19064,Philippines,2017,2017Philippines,0,0,0,6,0,0,6,0,0,0,0,0,0,0,6
19065,Philippines,2017,2017Philippines,0,0,5,13,5,0,23,0,0,5,0,0,0,5,28
19066,Philippines,2018,2018Philippines,0,0,0,0,0,0,0,0,0,0,0,0,0,0,353
19067,Philippines,2018,2018Philippines,0,0,0,0,0,0,0,0,5,0,0,0,0,5,5
19068,Philippines,2018,2018Philippines,0,0,0,0,0,5,5,0,0,0,0,0,0,0,5
19069,Philippines,2018,2018Philippines,0,0,0,7,0,0,7,0,0,0,0,0,0,0,7
19070,Philippines,2018,2018Philippines,0,0,0,10,0,0,10,5,5,0,0,0,0,10,20
19071,Philippines,2018,2018Philippines,0,0,0,12,0,0,12,0,0,0,5,0,0,5,94
19072,Philippines,2018,2018Philippines,0,5,0,0,0,0,5,0,0,0,0,0,0,0,5
19073,Philippines,2018,2018Philippines,6,0,0,15,5,0,26,0,7,0,0,0,0,7,33
19074,Philippines,2019,2019Philippines,0,0,0,0,0,0,0,0,0,0,0,0,0,0,465
19075,Philippines,2019,2019Philippines,0,0,0,0,0,0,0,0,5,0,0,0,0,5,5
19076,Philippines,2019,2019Philippines,0,0,0,0,0,5,5,0,0,0,0,0,0,0,5
19077,Philippines,2019,2019Philippines,0,0,0,5,0,0,5,0,5,0,0,0,0,5,10
19078,Philippines,2019,2019Philippines,0,0,5,0,0,0,5,0,0,0,0,0,0,0,5
19079,Philippines,2019,2019Philippines,0,5,0,9,0,0,14,5,5,0,0,0,0,10,24
19080,Philippines,2019,2019Philippines,8,0,0,20,5,0,33,0,7,0,0,0,0,7,40
19081,Philippines,2020,2020Philippines,0,0,0,0,0,0,0,0,0,0,0,0,0,0,332
19082,Philippines,2020,2020Philippines,0,0,0,0,0,0,0,0,0,0,19,0,0,19,60
19083,Philippines,2020,2020Philippines,0,0,0,6,0,0,6,0,5,0,0,0,0,5,11
19084,Philippines,2020,2020Philippines,0,0,5,10,0,0,15,0,5,0,0,0,0,5,20
19085,Philippines,2020,2020Philippines,0,0,6,0,0,0,6,0,0,0,0,0,0,0,6
19086,Philippines,2020,2020Philippines,7,0,0,19,6,0,32,0,8,0,0,0,0,8,40
19087,Philippines,2021,2021Philippines,0,0,0,0,0,0,0,0,0,0,0,0,0,0,366
19088,Philippines,2021,2021Philippines,0,0,0,5,0,0,5,0,0,0,0,0,0,0,5
19089,Philippines,2021,2021Philippines,0,0,0,7,0,0,7,0,0,5,0,0,0,5,12
19090,Philippines,2021,2021Philippines,0,0,0,8,0,0,8,0,0,0,0,0,0,0,8
19091,Philippines,2021,2021Philippines,0,0,0,18,0,0,18,0,0,0,32,0,0,32,73
19092,Philippines,2021,2021Philippines,0,0,5,10,0,0,15,0,5,0,0,0,0,5,20
19093,Philippines,2021,2021Philippines,6,0,0,15,8,0,29,0,8,0,0,0,0,8,37
19094,Poland,2001,2001Poland,0,0,0,0,0,0,0,0,0,0,0,0,0,0,2136
19095,Poland,2001,2001Poland,0,0,0,0,0,0,0,0,0,0,0,5,0,5,5
19096,Poland,2001,2001Poland,0,0,0,0,0,0,0,0,0,0,5,0,0,5,5
19097,Poland,2001,2001Poland,0,0,0,0,0,17,17,0,0,0,0,0,13,13,30
19098,Poland,2001,2001Poland,0,0,0,0,0,134,134,0,0,0,0,0,121,121,255
19099,Poland,2001,2001Poland,0,0,0,0,0,348,348,0,0,0,0,0,403,403,751
19100,Poland,2001,2001Poland,0,0,5,0,0,0,5,0,0,0,0,0,0,0,5
19101,Poland,2002,2002Poland,0,0,0,0,0,0,0,0,0,0,0,0,0,0,16435
19102,Poland,2002,2002Poland,0,0,0,0,0,0,0,0,0,0,0,5,0,5,5
19103,Poland,2002,2002Poland,0,0,0,0,0,0,0,0,0,0,5,0,0,5,5
19104,Poland,2002,2002Poland,0,0,0,0,0,15,15,0,0,0,0,0,11,11,26
19105,Poland,2002,2002Poland,0,0,0,0,0,131,131,0,0,0,0,0,111,111,242
19106,Poland,2003,2003Poland,0,0,0,0,0,0,0,0,0,0,0,0,0,0,14984
19107,Poland,2003,2003Poland,0,0,0,0,0,0,0,0,0,0,0,5,0,5,5
19108,Poland,2003,2003Poland,0,0,0,0,0,0,0,0,0,0,5,0,0,5,5
19109,Poland,2003,2003Poland,0,0,0,0,0,11,11,0,0,0,0,0,8,8,19
19110,Poland,2003,2003Poland,0,0,0,0,0,105,105,0,0,0,0,0,93,93,198
19111,Poland,2004,2004Poland,0,0,0,0,0,0,0,0,0,0,0,0,0,0,10657
19112,Poland,2004,2004Poland,0,0,0,0,0,0,0,0,0,0,0,5,0,5,5
19113,Poland,2004,2004Poland,0,0,0,0,0,0,0,0,0,0,5,0,0,5,5
19114,Poland,2004,2004Poland,0,0,0,0,0,9,9,0,0,0,0,0,7,7,16
19115,Poland,2005,2005Poland,0,0,0,0,0,0,0,0,0,0,0,0,0,0,19438
19116,Poland,2005,2005Poland,0,0,0,0,0,0,0,0,0,0,0,5,0,5,5
19117,Poland,2005,2005Poland,0,0,0,0,0,0,0,0,0,0,5,0,0,5,5
19118,Poland,2005,2005Poland,0,0,0,0,0,8,8,0,0,0,0,0,0,0,8
19119,Poland,2005,2005Poland,0,0,0,0,0,97,97,0,0,0,0,0,84,84,181
19120,Poland,2005,2005Poland,0,0,0,0,5,0,5,0,0,0,0,0,0,0,5
19121,Poland,2006,2006Poland,0,0,0,0,0,0,0,0,0,0,0,0,0,0,12867
19122,Poland,2006,2006Poland,0,0,0,0,0,0,0,0,0,0,0,5,0,5,5
19123,Poland,2006,2006Poland,0,0,0,0,0,0,0,0,0,0,5,0,0,5,5
19124,Poland,2006,2006Poland,0,0,0,0,0,9,9,0,0,0,0,0,0,0,9
19125,Poland,2006,2006Poland,0,0,0,0,0,100,100,0,0,0,0,0,90,90,190
19126,Poland,2006,2006Poland,0,0,0,0,0,186,186,0,0,0,0,0,246,246,432
19127,Poland,2007,2007Poland,0,0,0,0,0,0,0,0,0,0,0,0,0,0,2327
19128,Poland,2007,2007Poland,0,0,0,0,0,0,0,0,0,0,0,5,0,5,5
19129,Poland,2007,2007Poland,0,0,0,0,0,0,0,0,0,0,5,0,0,5,5
19130,Poland,2007,2007Poland,0,0,0,0,0,9,9,0,0,0,0,0,0,0,9
19131,Poland,2007,2007Poland,0,0,0,0,0,97,97,0,0,0,0,0,91,91,188
19132,Poland,2007,2007Poland,0,0,0,0,0,165,165,0,0,0,0,0,212,212,377
19133,Poland,2008,2008Poland,0,0,0,0,0,0,0,0,0,0,0,0,0,0,1846
19134,Poland,2008,2008Poland,0,0,0,0,0,0,0,0,0,0,0,5,0,5,5
19135,Poland,2008,2008Poland,0,0,0,0,0,0,0,0,0,0,5,0,0,5,5
19136,Poland,2008,2008Poland,0,0,0,0,0,9,9,0,0,0,0,0,0,0,9
19137,Poland,2008,2008Poland,0,0,0,0,0,95,95,0,0,0,0,0,90,90,185
19138,Poland,2008,2008Poland,0,0,0,0,0,143,143,0,0,0,0,0,192,192,335
19139,Poland,2009,2009Poland,0,0,0,0,0,0,0,0,0,0,0,0,0,0,987
19140,Poland,2009,2009Poland,0,0,0,0,0,0,0,0,0,0,0,5,0,5,5
19141,Poland,2009,2009Poland,0,0,0,0,0,0,0,0,0,0,5,0,0,5,5
19142,Poland,2009,2009Poland,0,0,0,0,0,5,5,0,0,0,0,0,5,5,10
19143,Poland,2009,2009Poland,0,0,0,0,0,132,132,0,0,0,0,0,170,170,302
19144,Poland,2009,2009Poland,12,37,46,206,56,0,357,14,41,42,212,77,0,386,743
19145,Poland,2010,2010Poland,0,0,0,0,0,0,0,0,0,0,0,0,0,0,714
19146,Poland,2010,2010Poland,0,0,0,0,0,0,0,0,0,0,0,0,7,7,7
19147,Poland,2010,2010Poland,0,0,0,0,0,0,0,0,0,0,0,5,0,5,5
19148,Poland,2010,2010Poland,0,0,0,0,0,0,0,0,0,0,5,0,0,5,5
19149,Poland,2010,2010Poland,0,0,0,0,0,117,117,0,0,0,0,0,157,157,274
19150,Poland,2010,2010Poland,12,35,45,208,61,0,361,11,48,40,210,83,0,392,753
19151,Poland,2011,2011Poland,0,0,0,0,0,0,0,0,0,0,0,0,0,0,207
19152,Poland,2011,2011Poland,0,0,0,0,0,0,0,0,0,0,0,0,9,9,9
19153,Poland,2011,2011Poland,0,0,0,0,0,0,0,0,0,0,0,5,0,5,5
19154,Poland,2011,2011Poland,0,0,0,0,0,0,0,0,0,0,5,0,0,5,5
19155,Poland,2011,2011Poland,0,0,0,0,0,85,85,0,0,0,0,0,89,89,174
19156,Poland,2011,2011Poland,0,0,0,0,0,101,101,0,0,0,0,0,143,143,244
19157,Poland,2011,2011Poland,0,0,8,9,0,0,17,0,0,0,6,0,0,6,421
19158,Poland,2011,2011Poland,8,37,46,206,64,0,361,10,49,40,197,89,0,385,746
19159,Poland,2012,2012Poland,0,0,0,0,0,0,0,0,0,0,0,0,0,0,130
19160,Poland,2012,2012Poland,0,0,0,0,0,0,0,0,0,0,0,0,9,9,9
19161,Poland,2012,2012Poland,0,0,0,0,0,0,0,0,0,0,5,0,0,5,10
19162,Poland,2012,2012Poland,0,0,0,0,0,85,85,0,0,0,0,0,88,88,173
19163,Poland,2012,2012Poland,0,0,0,0,0,93,93,0,0,0,0,0,127,127,220
19164,Poland,2012,2012Poland,0,0,0,14,0,0,14,0,0,0,10,0,0,10,359
19165,Poland,2012,2012Poland,6,37,45,205,71,0,364,9,43,40,179,102,0,373,737
19166,Poland,2013,2013Poland,0,0,0,0,0,0,0,0,0,0,0,0,0,0,65
19167,Poland,2013,2013Poland,0,0,0,0,0,0,0,0,0,0,0,0,9,9,9
19168,Poland,2013,2013Poland,0,0,0,0,0,0,0,0,0,0,5,0,0,5,10
19169,Poland,2013,2013Poland,0,0,0,0,0,27,27,0,0,0,0,0,38,38,65
19170,Poland,2013,2013Poland,0,0,0,0,0,76,76,0,0,0,0,0,84,84,160
19171,Poland,2013,2013Poland,0,0,6,16,5,0,27,0,0,0,20,5,0,25,52
19172,Poland,2013,2013Poland,0,5,5,107,93,0,210,0,7,7,261,257,0,532,742
19173,Poland,2013,2013Poland,0,7,0,0,0,0,7,0,0,0,0,0,0,0,325
19174,Poland,2014,2014Poland,0,0,0,0,0,0,0,0,0,0,0,0,0,0,158
19175,Poland,2014,2014Poland,0,0,0,0,0,0,0,0,0,0,0,0,7,7,7
19176,Poland,2014,2014Poland,0,0,0,0,0,0,0,0,0,0,5,0,0,5,10
19177,Poland,2014,2014Poland,0,0,0,0,0,72,72,0,0,0,0,0,82,82,154
19178,Poland,2014,2014Poland,0,0,0,6,0,0,6,0,0,6,0,0,0,6,259
19179,Poland,2014,2014Poland,0,5,6,96,101,0,208,0,5,5,231,269,0,510,718
19180,Poland,2015,2015Poland,0,0,0,0,0,0,0,0,0,0,0,0,0,0,224
19181,Poland,2015,2015Poland,0,0,0,0,0,0,0,0,0,0,5,0,0,5,5
19182,Poland,2015,2015Poland,0,0,0,0,0,5,5,0,0,0,0,0,0,0,5
19183,Poland,2015,2015Poland,0,0,0,0,0,64,64,0,0,0,0,0,103,103,167
19184,Poland,2015,2015Poland,0,0,0,0,0,67,67,0,0,0,0,0,77,77,144
19185,Poland,2015,2015Poland,0,0,5,16,5,0,26,0,0,0,19,5,0,24,50
19186,Poland,2015,2015Poland,0,0,9,90,102,0,201,0,7,0,214,281,0,502,703
19187,Poland,2016,2016Poland,0,0,0,0,0,0,0,0,0,0,0,0,0,0,37
19188,Poland,2016,2016Poland,0,0,0,0,0,0,0,0,0,0,0,0,5,5,5
19189,Poland,2016,2016Poland,0,0,0,0,0,0,0,0,0,0,6,0,0,6,129
19190,Poland,2016,2016Poland,0,0,0,0,0,57,57,0,0,0,0,0,97,97,154
19191,Poland,2016,2016Poland,0,0,0,0,0,66,66,0,0,0,0,0,77,77,143
19192,Poland,2016,2016Poland,0,0,7,78,109,0,194,0,0,6,174,317,0,497,691
19193,Poland,2017,2017Poland,0,0,0,0,0,0,0,0,0,0,0,0,0,0,312
19194,Poland,2017,2017Poland,0,0,0,0,0,5,5,0,0,0,0,0,0,0,5
19195,Poland,2017,2017Poland,0,0,0,0,0,65,65,0,0,0,0,0,75,75,140
19196,Poland,2017,2017Poland,0,0,5,67,113,0,185,0,0,7,157,317,0,481,666
19197,Poland,2018,2018Poland,0,0,0,0,0,0,0,0,0,0,0,0,0,0,181
19198,Poland,2018,2018Poland,0,0,0,0,0,65,65,0,0,0,0,0,74,74,139
19199,Poland,2018,2018Poland,0,0,0,10,0,0,10,0,0,0,9,0,0,9,129
19200,Poland,2018,2018Poland,0,0,5,57,118,0,180,0,0,6,125,325,0,456,636
19201,Poland,2019,2019Poland,0,0,0,0,0,0,0,0,0,0,0,0,0,0,210
19202,Poland,2019,2019Poland,0,0,0,0,0,62,62,0,0,0,0,0,70,70,132
19203,Poland,2019,2019Poland,0,0,5,42,128,0,175,0,0,5,109,330,0,444,619
19204,Poland,2020,2020Poland,0,0,0,0,0,0,0,0,0,0,0,0,0,0,215
19205,Poland,2020,2020Poland,0,0,0,0,0,26,26,0,0,0,0,0,72,72,98
19206,Poland,2020,2020Poland,0,0,5,34,133,0,172,0,0,6,92,327,0,425,597
19207,Poland,2021,2021Poland,0,0,0,0,0,0,0,0,0,0,0,0,0,0,242
19208,Poland,2021,2021Poland,0,0,0,35,134,0,169,0,5,0,69,330,0,404,573
19209,Poland,2021,2021Poland,0,0,6,0,0,0,6,0,0,0,5,0,0,5,72
19210,Rep. of Moldova,2001,2001Rep. of Moldova,0,0,0,0,0,0,0,0,0,0,0,0,0,0,3639
19211,Rep. of Moldova,2001,2001Rep. of Moldova,0,0,0,0,0,6,6,0,0,0,0,0,0,0,6
19212,Rep. of Moldova,2001,2001Rep. of Moldova,0,0,0,0,0,39,39,0,0,0,0,0,47,47,86
19213,Rep. of Moldova,2002,2002Rep. of Moldova,0,0,0,0,0,0,0,0,0,0,0,0,0,0,10016
19214,Rep. of Moldova,2002,2002Rep. of Moldova,0,0,0,0,0,0,0,0,0,0,0,0,5,5,5
19215,Rep. of Moldova,2002,2002Rep. of Moldova,0,0,0,0,0,48,48,0,0,0,0,0,52,52,100
19216,Rep. of Moldova,2003,2003Rep. of Moldova,0,0,0,0,0,0,0,0,0,0,0,0,0,0,10997
19217,Rep. of Moldova,2003,2003Rep. of Moldova,0,0,0,0,0,0,0,0,0,0,0,0,5,5,5
19218,Rep. of Moldova,2003,2003Rep. of Moldova,0,0,0,0,0,64,64,0,0,0,0,0,75,75,139
19219,Rep. of Moldova,2004,2004Rep. of Moldova,0,0,0,0,0,0,0,0,0,0,0,0,0,0,11924
19220,Rep. of Moldova,2004,2004Rep. of Moldova,0,0,0,0,0,0,0,0,0,0,0,0,7,7,7
19221,Rep. of Moldova,2004,2004Rep. of Moldova,0,0,0,5,0,0,5,0,0,0,0,0,0,0,5
19222,Rep. of Moldova,2005,2005Rep. of Moldova,0,0,0,0,0,0,0,0,0,0,0,0,0,0,11759
19223,Rep. of Moldova,2005,2005Rep. of Moldova,0,0,0,0,0,5,5,0,0,0,0,0,0,0,5
19224,Rep. of Moldova,2005,2005Rep. of Moldova,0,0,0,0,0,141,141,0,0,0,0,0,144,144,285
19225,Rep. of Moldova,2005,2005Rep. of Moldova,0,0,0,6,0,0,6,0,0,0,0,0,5,5,11
19226,Rep. of Moldova,2005,2005Rep. of Moldova,5,0,0,0,0,0,5,0,0,0,0,0,0,0,5
19227,Rep. of Moldova,2006,2006Rep. of Moldova,0,0,0,0,0,0,0,0,0,0,0,0,0,0,11313
19228,Rep. of Moldova,2006,2006Rep. of Moldova,0,0,0,0,0,0,0,0,5,0,0,0,0,5,5
19229,Rep. of Moldova,2006,2006Rep. of Moldova,0,0,0,0,0,5,5,0,0,0,0,0,6,6,11
19230,Rep. of Moldova,2006,2006Rep. of Moldova,0,0,0,0,0,6,6,0,0,0,0,0,6,6,12
19231,Rep. of Moldova,2006,2006Rep. of Moldova,0,0,0,0,0,9,9,0,0,0,0,0,0,0,9
19232,Rep. of Moldova,2006,2006Rep. of Moldova,0,0,0,0,0,168,168,0,0,0,0,0,162,162,330
19233,Rep. of Moldova,2007,2007Rep. of Moldova,0,0,0,0,0,0,0,0,0,0,0,0,0,0,4531
19234,Rep. of Moldova,2007,2007Rep. of Moldova,0,0,0,0,0,0,0,0,0,0,0,0,7,7,7
19235,Rep. of Moldova,2007,2007Rep. of Moldova,0,0,0,0,0,179,179,0,0,0,0,0,180,180,359
19236,Rep. of Moldova,2007,2007Rep. of Moldova,0,0,0,6,0,0,6,0,0,0,0,0,5,5,11
19237,Rep. of Moldova,2007,2007Rep. of Moldova,5,0,0,0,0,0,5,0,0,0,0,0,0,0,5
19238,Rep. of Moldova,2008,2008Rep. of Moldova,0,0,0,0,0,0,0,0,0,0,0,0,0,0,5163
19239,Rep. of Moldova,2008,2008Rep. of Moldova,0,0,0,0,0,0,0,0,0,0,0,0,7,7,7
19240,Rep. of Moldova,2008,2008Rep. of Moldova,0,0,0,0,0,187,187,0,0,0,0,0,182,182,369
19241,Rep. of Moldova,2008,2008Rep. of Moldova,0,0,0,7,0,0,7,0,0,0,0,0,0,0,7
19242,Rep. of Moldova,2008,2008Rep. of Moldova,5,0,0,0,0,0,5,0,0,0,0,0,0,0,5
19243,Rep. of Moldova,2009,2009Rep. of Moldova,0,0,0,0,0,0,0,0,0,0,0,0,0,0,1866
19244,Rep. of Moldova,2009,2009Rep. of Moldova,0,0,0,0,0,0,0,0,0,0,0,0,6,6,6
19245,Rep. of Moldova,2009,2009Rep. of Moldova,0,0,0,5,0,0,5,5,0,0,0,0,0,5,10
19246,Rep. of Moldova,2009,2009Rep. of Moldova,5,0,0,0,0,0,5,0,0,0,0,0,0,0,5
19247,Rep. of Moldova,2009,2009Rep. of Moldova,7,60,147,1268,669,0,2151,5,73,130,1199,483,0,1890,4041
19248,Rep. of Moldova,2010,2010Rep. of Moldova,0,0,0,0,0,0,0,0,0,0,0,0,0,0,1578
19249,Rep. of Moldova,2010,2010Rep. of Moldova,0,0,0,0,0,0,0,0,0,0,0,0,5,5,5
19250,Rep. of Moldova,2010,2010Rep. of Moldova,0,0,0,0,0,193,193,0,0,0,0,0,184,184,377
19251,Rep. of Moldova,2010,2010Rep. of Moldova,0,0,0,5,0,0,5,5,0,0,0,0,0,5,10
19252,Rep. of Moldova,2010,2010Rep. of Moldova,5,0,0,0,0,0,5,0,0,0,0,0,0,0,5
19253,Rep. of Moldova,2010,2010Rep. of Moldova,5,53,141,1333,738,0,2270,5,58,131,1232,533,0,1959,4229
19254,Rep. of Moldova,2011,2011Rep. of Moldova,0,0,0,0,0,0,0,0,0,0,0,0,0,0,1551
19255,Rep. of Moldova,2011,2011Rep. of Moldova,0,0,0,0,0,0,0,0,0,0,0,0,5,5,5
19256,Rep. of Moldova,2011,2011Rep. of Moldova,0,0,0,0,0,195,195,0,0,0,0,0,187,187,382
19257,Rep. of Moldova,2011,2011Rep. of Moldova,0,0,0,6,0,0,6,0,5,0,0,0,0,5,11
19258,Rep. of Moldova,2011,2011Rep. of Moldova,0,0,5,32,0,0,37,0,0,0,31,0,0,31,168
19259,Rep. of Moldova,2011,2011Rep. of Moldova,0,47,110,1284,770,0,2211,5,41,120,1196,566,0,1928,4139
19260,Rep. of Moldova,2011,2011Rep. of Moldova,5,0,0,0,0,0,5,0,0,0,0,0,0,0,5
19261,Rep. of Moldova,2012,2012Rep. of Moldova,0,0,0,0,0,0,0,0,0,0,0,0,0,0,1546
19262,Rep. of Moldova,2012,2012Rep. of Moldova,0,0,0,0,0,0,0,0,0,0,0,0,5,5,5
19263,Rep. of Moldova,2012,2012Rep. of Moldova,0,0,0,0,0,0,0,0,5,0,0,0,0,5,5
19264,Rep. of Moldova,2012,2012Rep. of Moldova,0,0,0,0,0,12,12,0,0,0,0,0,8,8,20
19265,Rep. of Moldova,2012,2012Rep. of Moldova,0,0,0,0,0,190,190,0,0,0,0,0,190,190,380
19266,Rep. of Moldova,2012,2012Rep. of Moldova,0,0,0,8,0,0,8,0,0,0,8,0,0,8,187
19267,Rep. of Moldova,2012,2012Rep. of Moldova,0,0,0,11,0,0,11,0,6,0,0,0,0,6,17
19268,Rep. of Moldova,2012,2012Rep. of Moldova,0,37,93,1206,805,0,2141,0,31,107,1131,578,0,1847,3988
19269,Rep. of Moldova,2013,2013Rep. of Moldova,0,0,0,0,0,0,0,0,0,0,0,0,0,0,1451
19270,Rep. of Moldova,2013,2013Rep. of Moldova,0,0,0,0,0,0,0,0,0,0,0,0,5,5,5
19271,Rep. of Moldova,2013,2013Rep. of Moldova,0,0,0,0,0,0,0,0,5,0,0,0,0,5,5
19272,Rep. of Moldova,2013,2013Rep. of Moldova,0,0,0,0,0,191,191,0,0,0,0,0,189,189,380
19273,Rep. of Moldova,2013,2013Rep. of Moldova,0,0,0,9,0,0,9,0,0,0,7,0,0,7,198
19274,Rep. of Moldova,2013,2013Rep. of Moldova,0,0,0,9,0,0,9,0,0,5,0,0,0,5,14
19275,Rep. of Moldova,2013,2013Rep. of Moldova,0,0,0,9,5,0,14,0,5,0,12,0,0,17,31
19276,Rep. of Moldova,2013,2013Rep. of Moldova,0,0,6,52,0,0,58,0,0,5,63,0,0,68,126
19277,Rep. of Moldova,2014,2014Rep. of Moldova,0,0,0,0,0,0,0,0,0,0,0,0,0,0,1626
19278,Rep. of Moldova,2014,2014Rep. of Moldova,0,0,0,0,0,179,179,0,0,0,0,0,177,177,356
19279,Rep. of Moldova,2014,2014Rep. of Moldova,0,0,0,5,0,0,5,0,0,0,0,0,0,0,195
19280,Rep. of Moldova,2014,2014Rep. of Moldova,0,0,0,8,0,0,8,0,0,5,0,0,0,5,13
19281,Rep. of Moldova,2014,2014Rep. of Moldova,0,5,0,9,5,0,19,0,5,0,16,0,0,21,40
19282,Rep. of Moldova,2015,2015Rep. of Moldova,0,0,0,0,0,0,0,0,0,0,0,0,0,0,1773
19283,Rep. of Moldova,2015,2015Rep. of Moldova,0,0,0,0,0,0,0,0,0,0,0,0,5,5,5
19284,Rep. of Moldova,2015,2015Rep. of Moldova,0,0,0,0,0,174,174,0,0,0,0,0,173,173,347
19285,Rep. of Moldova,2015,2015Rep. of Moldova,0,0,0,9,0,0,9,0,0,5,0,0,0,5,14
19286,Rep. of Moldova,2015,2015Rep. of Moldova,0,5,0,46,0,0,51,0,0,5,50,0,0,55,106
19287,Rep. of Moldova,2015,2015Rep. of Moldova,0,8,0,13,5,0,26,5,0,0,13,0,0,18,44
19288,Rep. of Moldova,2016,2016Rep. of Moldova,0,0,0,0,0,0,0,0,0,0,0,0,0,0,1805
19289,Rep. of Moldova,2016,2016Rep. of Moldova,0,0,0,0,0,0,0,0,0,0,0,0,5,5,5
19290,Rep. of Moldova,2016,2016Rep. of Moldova,0,0,0,0,0,0,0,0,0,0,0,0,6,6,6
19291,Rep. of Moldova,2016,2016Rep. of Moldova,0,0,0,0,0,172,172,0,0,0,0,0,171,171,343
19292,Rep. of Moldova,2016,2016Rep. of Moldova,0,5,0,47,0,0,52,0,0,5,48,0,0,53,105
19293,Rep. of Moldova,2016,2016Rep. of Moldova,9,0,0,20,5,0,34,5,0,0,13,0,0,18,52
19294,Rep. of Moldova,2017,2017Rep. of Moldova,0,0,0,0,0,0,0,0,0,0,0,0,0,0,1819
19295,Rep. of Moldova,2017,2017Rep. of Moldova,0,0,0,0,0,7,7,0,0,0,0,0,0,0,7
19296,Rep. of Moldova,2017,2017Rep. of Moldova,0,0,0,0,0,162,162,0,0,0,0,0,160,160,322
19297,Rep. of Moldova,2017,2017Rep. of Moldova,0,5,0,47,0,0,52,0,0,0,48,5,0,53,105
19298,Rep. of Moldova,2017,2017Rep. of Moldova,5,6,5,34,7,0,57,0,5,5,19,0,0,29,86
19299,Rep. of Moldova,2018,2018Rep. of Moldova,0,0,0,0,0,0,0,0,0,0,0,0,0,0,1783
19300,Rep. of Moldova,2018,2018Rep. of Moldova,0,0,0,0,0,160,160,0,0,0,0,0,159,159,319
19301,Rep. of Moldova,2018,2018Rep. of Moldova,0,0,0,5,0,0,5,0,0,0,0,0,0,0,126
19302,Rep. of Moldova,2018,2018Rep. of Moldova,0,0,0,8,0,0,8,0,0,0,0,0,0,0,8
19303,Rep. of Moldova,2018,2018Rep. of Moldova,0,0,5,17,0,0,22,0,0,0,33,0,0,33,55
19304,Rep. of Moldova,2018,2018Rep. of Moldova,0,13,5,42,7,0,67,0,7,6,26,0,0,39,106
19305,Rep. of Moldova,2019,2019Rep. of Moldova,0,0,0,0,0,0,0,0,0,0,0,0,0,0,1918
19306,Rep. of Moldova,2019,2019Rep. of Moldova,0,0,0,0,0,158,158,0,0,0,0,0,159,159,317
19307,Rep. of Moldova,2019,2019Rep. of Moldova,0,0,0,5,0,0,5,0,0,0,5,0,0,5,10
19308,Rep. of Moldova,2019,2019Rep. of Moldova,0,0,5,16,0,0,21,0,0,0,33,0,0,33,54
19309,Rep. of Moldova,2019,2019Rep. of Moldova,5,14,6,49,7,0,81,5,9,5,28,0,0,47,128
19310,Rep. of Moldova,2020,2020Rep. of Moldova,0,0,0,0,0,0,0,0,0,0,0,0,0,0,2006
19311,Rep. of Moldova,2020,2020Rep. of Moldova,0,0,0,0,0,0,0,0,0,0,0,0,5,5,10
19312,Rep. of Moldova,2020,2020Rep. of Moldova,0,0,0,5,0,0,5,0,0,0,5,0,0,5,10
19313,Rep. of Moldova,2020,2020Rep. of Moldova,0,0,5,16,0,0,21,0,0,0,33,0,0,33,54
19314,Rep. of Moldova,2020,2020Rep. of Moldova,0,12,10,44,7,0,73,5,10,5,33,0,0,53,126
19315,Rep. of Moldova,2021,2021Rep. of Moldova,0,0,0,0,0,0,0,0,0,0,0,0,0,0,1938
19316,Rep. of Moldova,2021,2021Rep. of Moldova,0,0,0,0,0,8,8,0,0,0,0,0,9,9,17
19317,Rep. of Moldova,2021,2021Rep. of Moldova,0,0,0,5,0,0,5,0,0,0,5,0,0,5,10
19318,Rep. of Moldova,2021,2021Rep. of Moldova,0,0,0,6,0,0,6,0,0,0,0,0,0,0,45
19319,Rep. of Moldova,2021,2021Rep. of Moldova,0,0,5,15,0,0,20,0,0,0,26,5,0,31,51
19320,Rep. of Moldova,2021,2021Rep. of Moldova,5,15,7,42,5,0,74,5,12,5,33,0,0,55,129
19321,Romania,2001,2001Romania,0,0,0,0,0,0,0,0,0,0,0,0,0,0,5452
19322,Romania,2001,2001Romania,0,0,0,0,0,0,0,0,0,0,5,0,0,5,5
19323,Romania,2001,2001Romania,0,0,0,0,0,22,22,0,0,0,0,0,41,41,63
19324,Romania,2001,2001Romania,0,0,0,0,0,119,119,0,0,0,0,0,88,88,207
19325,Romania,2001,2001Romania,0,0,0,0,0,158,158,0,0,0,0,0,161,161,319
19326,Romania,2001,2001Romania,0,0,0,0,6,0,6,0,0,0,0,0,0,0,6
19327,Romania,2002,2002Romania,0,0,0,0,0,0,0,0,0,0,0,0,0,0,8423
19328,Romania,2002,2002Romania,0,0,0,0,0,77,77,0,0,0,0,0,54,54,157
19329,Romania,2002,2002Romania,0,0,0,0,0,122,122,0,0,0,0,0,134,134,256
19330,Romania,2002,2002Romania,0,0,0,0,6,0,6,0,0,0,0,0,0,0,6
19331,Romania,2003,2003Romania,0,0,0,0,0,0,0,0,0,0,0,0,0,0,8049
19332,Romania,2003,2003Romania,0,0,0,0,0,61,61,0,0,0,0,0,46,46,130
19333,Romania,2003,2003Romania,0,0,0,0,0,93,93,0,0,0,0,0,106,106,199
19334,Romania,2003,2003Romania,0,0,0,0,6,0,6,0,0,0,0,0,0,0,6
19335,Romania,2004,2004Romania,0,0,0,0,0,0,0,0,0,0,0,0,0,0,5970
19336,Romania,2004,2004Romania,0,0,0,0,6,0,6,0,0,0,0,0,0,0,6
19337,Romania,2004,2004Romania,0,0,0,12,0,27,39,5,0,0,6,0,17,28,67
19338,Romania,2005,2005Romania,0,0,0,0,0,0,0,0,0,0,0,0,0,0,11332
19339,Romania,2005,2005Romania,0,0,0,0,0,43,43,0,0,0,0,0,52,52,95
19340,Romania,2005,2005Romania,0,0,0,0,7,0,7,0,0,0,0,0,0,0,7
19341,Romania,2005,2005Romania,0,0,0,10,0,25,35,5,0,0,5,0,16,26,61
19342,Romania,2006,2006Romania,0,0,0,0,0,0,0,0,0,0,0,0,0,0,6916
19343,Romania,2006,2006Romania,0,0,0,0,0,25,25,0,0,0,0,0,32,32,57
19344,Romania,2006,2006Romania,0,0,0,0,0,31,31,0,0,0,0,0,23,23,54
19345,Romania,2006,2006Romania,0,0,0,0,0,89,89,0,0,0,0,0,101,101,190
19346,Romania,2006,2006Romania,0,0,0,0,7,0,7,0,0,0,0,0,0,0,7
19347,Romania,2007,2007Romania,0,0,0,0,0,0,0,0,0,0,0,0,0,0,4981
19348,Romania,2007,2007Romania,0,0,0,0,0,24,24,0,0,0,0,0,33,33,57
19349,Romania,2007,2007Romania,0,0,0,0,0,87,87,0,0,0,0,0,99,99,186
19350,Romania,2007,2007Romania,0,0,0,0,7,0,7,0,0,0,0,0,0,0,7
19351,Romania,2007,2007Romania,0,0,0,5,0,0,5,0,0,0,0,0,0,0,5
19352,Romania,2007,2007Romania,0,0,0,5,0,0,5,0,0,0,8,0,0,8,13
19353,Romania,2007,2007Romania,0,0,0,8,0,20,28,0,5,0,0,0,17,22,50
19354,Romania,2008,2008Romania,0,0,0,0,0,0,0,0,0,0,0,0,0,0,4436
19355,Romania,2008,2008Romania,0,0,0,0,0,18,18,0,0,0,0,0,32,32,50
19356,Romania,2008,2008Romania,0,0,0,0,0,87,87,0,0,0,0,0,99,99,186
19357,Romania,2008,2008Romania,0,0,0,0,7,0,7,0,0,0,0,0,0,0,7
19358,Romania,2008,2008Romania,0,0,0,5,0,0,5,0,0,0,0,0,0,0,5
19359,Romania,2008,2008Romania,0,0,0,5,0,0,5,0,0,0,8,0,0,8,13
19360,Romania,2008,2008Romania,0,0,0,8,0,19,27,0,0,0,5,0,18,23,50
19361,Romania,2009,2009Romania,0,0,0,0,0,0,0,0,0,0,0,0,0,0,3567
19362,Romania,2009,2009Romania,0,0,0,0,0,15,15,0,0,0,0,0,30,30,45
19363,Romania,2009,2009Romania,0,0,0,0,7,0,7,0,0,0,0,0,0,0,7
19364,Romania,2009,2009Romania,0,0,0,5,0,0,5,0,0,0,0,0,0,0,5
19365,Romania,2009,2009Romania,0,0,0,5,0,0,5,0,0,0,8,0,0,8,13
19366,Romania,2009,2009Romania,0,0,0,5,0,15,20,0,5,0,0,0,14,19,39
19367,Romania,2009,2009Romania,6,21,19,194,119,0,359,5,18,13,194,85,0,315,674
19368,Romania,2010,2010Romania,0,0,0,0,0,0,0,0,0,0,0,0,0,0,3090
19369,Romania,2010,2010Romania,0,0,0,0,0,0,0,0,0,0,13,0,0,13,13
19370,Romania,2010,2010Romania,0,0,0,0,0,14,14,0,0,0,0,0,26,26,40
19371,Romania,2010,2010Romania,0,0,0,0,0,81,81,0,0,0,0,0,101,101,182
19372,Romania,2010,2010Romania,0,0,0,0,7,0,7,0,0,0,0,0,0,0,7
19373,Romania,2010,2010Romania,0,0,0,5,0,0,5,0,0,0,0,0,0,0,5
19374,Romania,2010,2010Romania,0,0,0,5,0,13,18,0,5,0,0,0,12,17,35
19375,Romania,2010,2010Romania,6,19,17,154,103,0,299,5,13,10,148,79,0,255,554
19376,Romania,2011,2011Romania,0,0,0,0,0,0,0,0,0,0,0,0,0,0,1774
19377,Romania,2011,2011Romania,0,0,0,0,0,0,0,0,0,0,13,0,0,13,13
19378,Romania,2011,2011Romania,0,0,0,0,0,14,14,0,0,0,0,0,26,26,40
19379,Romania,2011,2011Romania,0,0,0,0,0,78,78,0,0,0,0,0,103,103,181
19380,Romania,2011,2011Romania,0,0,0,0,7,0,7,0,0,0,0,0,0,0,7
19381,Romania,2011,2011Romania,0,0,0,5,0,0,5,0,0,0,0,0,0,0,5
19382,Romania,2011,2011Romania,0,0,0,5,0,13,18,0,5,0,0,0,9,14,32
19383,Romania,2011,2011Romania,0,0,5,14,0,0,19,0,0,5,19,0,0,24,53
19384,Romania,2011,2011Romania,0,5,0,19,0,0,24,0,6,0,18,0,0,24,800
19385,Romania,2011,2011Romania,5,12,19,138,98,0,272,0,18,6,143,78,0,245,517
19386,Romania,2012,2012Romania,0,0,0,0,0,0,0,0,0,0,0,0,0,0,1190
19387,Romania,2012,2012Romania,0,0,0,0,0,0,0,0,0,0,7,0,0,7,7
19388,Romania,2012,2012Romania,0,0,0,0,0,14,14,0,0,0,0,0,24,24,38
19389,Romania,2012,2012Romania,0,0,0,0,0,15,15,0,5,0,0,0,7,12,27
19390,Romania,2012,2012Romania,0,0,0,0,0,45,45,0,0,0,0,0,78,78,123
19391,Romania,2012,2012Romania,0,0,0,0,0,73,73,0,0,0,0,0,97,97,170
19392,Romania,2012,2012Romania,0,0,0,0,7,0,7,0,0,0,0,0,0,0,7
19393,Romania,2012,2012Romania,0,0,0,5,0,0,5,0,0,0,0,0,0,0,5
19394,Romania,2012,2012Romania,0,0,5,14,0,0,19,0,0,5,18,0,0,23,53
19395,Romania,2012,2012Romania,0,6,0,10,0,0,16,0,0,5,18,0,0,23,690
19396,Romania,2012,2012Romania,9,13,13,123,93,0,251,0,17,7,135,82,0,241,492
19397,Romania,2013,2013Romania,0,0,0,0,0,0,0,0,0,0,0,0,0,0,930
19398,Romania,2013,2013Romania,0,0,0,0,0,0,0,0,0,0,7,0,0,7,7
19399,Romania,2013,2013Romania,0,0,0,0,0,9,9,0,0,0,0,0,16,16,25
19400,Romania,2013,2013Romania,0,0,0,0,0,13,13,0,0,5,0,0,7,12,25
19401,Romania,2013,2013Romania,0,0,0,0,0,71,71,0,0,0,0,0,96,96,167
19402,Romania,2013,2013Romania,0,0,0,0,7,0,7,0,0,0,0,0,0,0,7
19403,Romania,2013,2013Romania,0,0,0,5,0,0,5,0,0,0,0,0,0,0,5
19404,Romania,2013,2013Romania,0,0,5,16,0,0,21,0,0,5,23,5,0,33,54
19405,Romania,2013,2013Romania,0,0,5,120,11,0,136,0,0,14,179,18,0,211,347
19406,Romania,2013,2013Romania,0,0,7,11,0,0,18,9,0,0,19,0,0,28,577
19407,Romania,2013,2013Romania,0,5,0,0,0,0,5,0,0,0,0,0,0,0,5
19408,Romania,2013,2013Romania,0,5,6,18,30,0,59,0,9,0,42,72,0,123,182
19409,Romania,2014,2014Romania,0,0,0,0,0,0,0,0,0,0,0,0,0,0,1028
19410,Romania,2014,2014Romania,0,0,0,0,0,0,0,0,0,0,7,0,0,7,7
19411,Romania,2014,2014Romania,0,0,0,0,0,13,13,0,0,5,0,0,7,12,25
19412,Romania,2014,2014Romania,0,0,0,0,0,67,67,0,0,0,0,0,92,92,159
19413,Romania,2014,2014Romania,0,0,0,0,7,0,7,0,0,0,0,0,0,0,7
19414,Romania,2014,2014Romania,0,0,5,16,0,0,21,0,0,5,23,5,0,33,54
19415,Romania,2014,2014Romania,0,5,5,17,28,0,55,0,8,0,34,80,0,122,177
19416,Romania,2014,2014Romania,0,8,0,0,0,0,8,0,0,0,0,0,0,0,460
19417,Romania,2015,2015Romania,0,0,0,0,0,0,0,0,0,0,0,0,0,0,961
19418,Romania,2015,2015Romania,0,0,0,0,0,0,0,0,0,0,8,0,0,8,22
19419,Romania,2015,2015Romania,0,0,0,0,0,18,18,0,0,0,0,0,23,23,41
19420,Romania,2015,2015Romania,0,0,0,0,0,65,65,0,0,0,0,0,91,91,156
19421,Romania,2015,2015Romania,0,0,0,0,7,0,7,0,0,0,0,0,0,0,7
19422,Romania,2015,2015Romania,0,0,0,21,0,0,21,0,0,0,25,5,0,30,51
19423,Romania,2015,2015Romania,0,0,5,107,12,0,124,0,0,11,168,20,0,199,323
19424,Romania,2015,2015Romania,0,0,6,18,28,0,52,0,7,0,31,80,0,118,170
19425,Romania,2016,2016Romania,0,0,0,0,0,0,0,0,0,0,0,0,0,0,568
19426,Romania,2016,2016Romania,0,0,0,0,0,0,0,0,0,0,5,0,0,5,188
19427,Romania,2016,2016Romania,0,0,0,0,0,8,8,0,5,0,0,0,7,12,20
19428,Romania,2016,2016Romania,0,0,0,0,0,14,14,0,0,0,0,0,24,24,38
19429,Romania,2016,2016Romania,0,0,0,0,0,66,66,0,0,0,0,0,91,91,157
19430,Romania,2016,2016Romania,0,0,0,0,7,0,7,0,0,0,0,0,0,0,7
19431,Romania,2016,2016Romania,0,0,0,21,0,0,21,0,0,0,25,5,0,30,51
19432,Romania,2016,2016Romania,0,0,6,20,27,0,53,0,0,7,26,80,0,113,166
19433,Romania,2017,2017Romania,0,0,0,0,0,0,0,0,0,0,0,0,0,0,818
19434,Romania,2017,2017Romania,0,0,0,0,0,7,7,0,5,0,0,0,8,13,20
19435,Romania,2017,2017Romania,0,0,0,0,0,64,64,0,0,0,0,0,87,87,151
19436,Romania,2017,2017Romania,0,0,0,0,7,0,7,0,0,0,0,0,0,0,7
19437,Romania,2017,2017Romania,0,0,0,21,0,0,21,0,0,0,25,5,0,30,51
19438,Romania,2017,2017Romania,0,0,5,20,27,0,52,0,0,9,22,80,0,111,163
19439,Romania,2018,2018Romania,0,0,0,0,0,0,0,0,0,0,0,0,0,0,561
19440,Romania,2018,2018Romania,0,0,0,0,0,8,8,0,5,0,0,0,6,11,19
19441,Romania,2018,2018Romania,0,0,0,0,0,62,62,0,0,0,0,0,84,84,146
19442,Romania,2018,2018Romania,0,0,0,0,7,0,7,0,0,0,0,0,0,0,7
19443,Romania,2018,2018Romania,0,0,0,16,5,0,21,0,0,0,24,6,0,30,51
19444,Romania,2018,2018Romania,0,0,5,0,0,0,5,0,0,0,5,0,0,5,216
19445,Romania,2018,2018Romania,0,0,5,18,27,0,50,0,0,7,22,76,0,105,155
19446,Romania,2019,2019Romania,0,0,0,0,0,0,0,0,0,0,0,0,0,0,986
19447,Romania,2019,2019Romania,0,0,0,0,0,0,0,0,5,0,0,0,0,5,19
19448,Romania,2019,2019Romania,0,0,0,0,0,61,61,0,0,0,0,0,82,82,143
19449,Romania,2019,2019Romania,0,0,0,0,7,0,7,0,0,0,0,0,0,0,7
19450,Romania,2019,2019Romania,0,0,0,16,5,0,21,0,0,0,24,6,0,30,51
19451,Romania,2019,2019Romania,0,0,5,16,27,0,48,0,0,6,19,73,0,98,146
19452,Romania,2020,2020Romania,0,0,0,0,0,0,0,0,0,0,0,0,0,0,696
19453,Romania,2020,2020Romania,0,0,0,0,0,16,16,0,0,0,0,0,20,20,36
19454,Romania,2020,2020Romania,0,0,0,0,0,33,33,0,0,0,0,0,29,29,423
19455,Romania,2020,2020Romania,0,0,0,16,5,0,21,0,0,0,24,6,0,30,51
19456,Romania,2020,2020Romania,0,0,5,12,27,0,44,0,0,6,20,67,0,93,137
19457,Romania,2021,2021Romania,0,0,0,0,0,0,0,0,0,0,0,0,0,0,748
19458,Romania,2021,2021Romania,0,0,0,0,0,0,0,0,0,0,7,0,0,7,7
19459,Romania,2021,2021Romania,0,0,0,16,5,0,21,0,0,0,24,6,0,30,51
19460,Romania,2021,2021Romania,0,0,5,13,24,0,42,0,0,5,16,66,0,87,129
19461,Romania,2021,2021Romania,0,7,0,36,0,33,76,0,5,11,34,0,29,79,482
19462,Russian Federation,2001,2001Russian Federation,0,0,0,0,0,0,0,0,0,0,0,0,0,0,35613
19463,Russian Federation,2001,2001Russian Federation,0,0,0,0,0,5,5,0,0,0,0,0,5,5,10
19464,Russian Federation,2001,2001Russian Federation,0,0,0,0,0,30,30,0,0,0,0,0,34,34,107
19465,Russian Federation,2001,2001Russian Federation,0,0,0,0,0,38,38,0,0,0,0,0,26,26,64
19466,Russian Federation,2001,2001Russian Federation,0,0,0,0,0,374,374,0,0,0,0,0,344,344,718
19467,Russian Federation,2001,2001Russian Federation,0,0,0,0,5,0,5,0,0,0,0,0,0,0,10
19468,Russian Federation,2001,2001Russian Federation,0,0,0,0,5,0,5,0,0,0,5,9,0,14,19
19469,Russian Federation,2001,2001Russian Federation,0,0,0,5,0,0,5,0,0,0,0,0,0,0,5
19470,Russian Federation,2001,2001Russian Federation,0,0,0,5,0,0,5,0,0,0,7,0,0,7,12
19471,Russian Federation,2001,2001Russian Federation,0,0,0,5,0,0,5,0,0,0,15,8,0,23,28
19472,Russian Federation,2001,2001Russian Federation,0,0,0,8,0,0,8,0,0,0,0,0,0,0,8
19473,Russian Federation,2001,2001Russian Federation,0,5,0,0,0,0,5,0,0,0,0,0,0,0,15
19474,Russian Federation,2001,2001Russian Federation,5,7,6,14,0,0,32,0,7,6,17,0,0,30,72
19475,Russian Federation,2001,2001Russian Federation,5,18,17,67,6,0,113,5,23,20,68,0,0,116,229
19476,Russian Federation,2001,2001Russian Federation,7,0,6,23,0,0,36,0,8,7,15,0,0,30,66
19477,Russian Federation,2001,2001Russian Federation,9,15,19,26,0,0,69,14,21,5,32,0,0,72,158
19478,Russian Federation,2001,2001Russian Federation,10,11,9,37,0,0,67,14,7,6,42,0,0,69,136
19479,Russian Federation,2001,2001Russian Federation,435,762,655,2068,186,0,4106,466,798,691,1707,116,0,3778,7884
19480,Russian Federation,2002,2002Russian Federation,0,0,0,0,0,0,0,0,0,0,0,0,0,0,70984
19481,Russian Federation,2002,2002Russian Federation,0,0,0,0,0,0,0,0,0,0,5,0,0,5,5
19482,Russian Federation,2002,2002Russian Federation,0,0,0,0,0,19,19,0,0,0,0,0,11,11,79
19483,Russian Federation,2002,2002Russian Federation,0,0,0,0,0,911,911,0,0,0,0,0,883,883,1794
19484,Russian Federation,2002,2002Russian Federation,0,0,0,0,0,8217,8217,0,0,0,0,0,5478,5478,13695
19485,Russian Federation,2002,2002Russian Federation,0,0,0,0,5,0,5,0,0,0,0,0,0,0,5
19486,Russian Federation,2002,2002Russian Federation,0,0,0,0,5,0,5,0,0,0,5,9,0,14,19
19487,Russian Federation,2002,2002Russian Federation,0,0,0,5,0,0,5,0,0,0,0,0,0,0,5
19488,Russian Federation,2002,2002Russian Federation,0,0,0,5,0,0,5,0,0,0,7,0,0,7,12
19489,Russian Federation,2002,2002Russian Federation,0,0,0,5,0,0,5,0,5,0,0,0,0,5,10
19490,Russian Federation,2002,2002Russian Federation,0,0,0,8,0,0,8,0,0,0,17,0,0,17,25
19491,Russian Federation,2002,2002Russian Federation,0,5,0,0,0,0,5,0,0,0,0,0,0,0,10
19492,Russian Federation,2002,2002Russian Federation,5,5,5,26,0,0,41,5,7,6,16,0,0,34,75
19493,Russian Federation,2002,2002Russian Federation,5,20,19,63,7,0,114,5,23,20,66,0,0,114,228
19494,Russian Federation,2002,2002Russian Federation,7,9,7,52,0,0,75,5,8,7,21,0,0,41,116
19495,Russian Federation,2002,2002Russian Federation,13,18,18,54,0,0,103,34,25,16,55,0,0,130,233
19496,Russian Federation,2002,2002Russian Federation,14,15,12,35,5,0,81,16,9,8,40,0,0,73,154
19497,Russian Federation,2002,2002Russian Federation,347,366,313,979,51,0,2056,407,400,350,918,45,0,2120,4176
19498,Russian Federation,2003,2003Russian Federation,0,0,0,0,0,0,0,0,0,0,0,0,0,0,74938
19499,Russian Federation,2003,2003Russian Federation,0,0,0,0,0,0,0,0,0,0,5,0,0,5,10
19500,Russian Federation,2003,2003Russian Federation,0,0,0,0,0,0,0,0,0,0,9,0,0,9,9
19501,Russian Federation,2003,2003Russian Federation,0,0,0,0,0,0,0,0,0,6,0,0,0,6,6
19502,Russian Federation,2003,2003Russian Federation,0,0,0,0,0,5,5,0,0,0,0,0,0,0,5
19503,Russian Federation,2003,2003Russian Federation,0,0,0,0,0,35,35,0,0,0,0,0,25,25,124
19504,Russian Federation,2003,2003Russian Federation,0,0,0,0,0,1342,1342,0,0,0,0,0,1271,1271,2613
19505,Russian Federation,2003,2003Russian Federation,0,0,0,0,0,8210,8210,0,0,0,0,0,5474,5474,13684
19506,Russian Federation,2003,2003Russian Federation,0,0,0,0,5,0,5,0,0,0,5,9,0,14,19
19507,Russian Federation,2003,2003Russian Federation,0,0,0,6,0,0,6,0,5,0,0,0,0,5,11
19508,Russian Federation,2003,2003Russian Federation,0,0,0,8,0,0,8,0,0,0,7,0,0,7,15
19509,Russian Federation,2003,2003Russian Federation,0,5,0,0,0,0,5,0,0,0,0,0,0,0,5
19510,Russian Federation,2003,2003Russian Federation,0,7,7,28,0,0,42,5,5,6,20,0,0,36,78
19511,Russian Federation,2003,2003Russian Federation,0,29,25,56,0,0,110,0,0,0,0,0,95,95,674
19512,Russian Federation,2003,2003Russian Federation,5,8,6,22,0,0,41,9,9,8,25,0,0,51,92
19513,Russian Federation,2003,2003Russian Federation,5,19,17,60,8,0,109,5,23,20,61,0,0,109,218
19514,Russian Federation,2003,2003Russian Federation,6,8,6,16,0,0,36,5,5,6,13,0,0,29,65
19515,Russian Federation,2003,2003Russian Federation,307,391,326,894,44,0,1962,362,416,351,715,42,0,1886,3848
19516,Russian Federation,2004,2004Russian Federation,0,0,0,0,0,0,0,0,0,0,0,0,0,0,82834
19517,Russian Federation,2004,2004Russian Federation,0,0,0,0,0,0,0,0,0,0,0,0,5,5,5
19518,Russian Federation,2004,2004Russian Federation,0,0,0,0,0,0,0,0,0,0,5,0,0,5,20
19519,Russian Federation,2004,2004Russian Federation,0,0,0,0,0,0,0,0,0,0,6,0,0,6,6
19520,Russian Federation,2004,2004Russian Federation,0,0,0,0,0,0,0,0,0,0,11,0,0,11,11
19521,Russian Federation,2004,2004Russian Federation,0,0,0,0,5,0,5,0,0,0,5,9,0,14,19
19522,Russian Federation,2004,2004Russian Federation,0,0,0,5,0,0,5,0,0,0,0,0,0,0,5
19523,Russian Federation,2004,2004Russian Federation,0,0,0,6,0,0,6,0,0,0,7,0,0,7,13
19524,Russian Federation,2004,2004Russian Federation,0,0,0,8,0,0,8,0,0,0,0,0,0,0,16
19525,Russian Federation,2004,2004Russian Federation,0,0,5,7,0,0,12,0,0,0,9,0,0,9,21
19526,Russian Federation,2004,2004Russian Federation,0,0,9,8,0,0,17,0,9,0,15,0,0,24,41
19527,Russian Federation,2004,2004Russian Federation,0,5,0,0,0,0,5,0,0,0,0,0,0,0,5
19528,Russian Federation,2004,2004Russian Federation,0,5,0,9,0,0,14,0,0,6,14,0,0,20,34
19529,Russian Federation,2004,2004Russian Federation,0,6,7,29,0,0,42,5,6,6,20,0,0,37,79
19530,Russian Federation,2004,2004Russian Federation,0,20,18,54,7,0,99,5,20,18,53,0,0,96,195
19531,Russian Federation,2004,2004Russian Federation,5,10,9,33,5,45,107,12,8,6,27,0,38,91,198
19532,Russian Federation,2004,2004Russian Federation,182,255,226,611,22,0,1296,217,271,242,494,23,0,1247,2543
19533,Russian Federation,2004,2004Russian Federation,268,770,660,2712,83,0,4493,321,739,633,2133,48,0,3874,8367
19534,Russian Federation,2004,2004Russian Federation,1020,1909,1636,3240,405,0,8210,1164,1224,1050,1325,711,0,5474,13684
19535,Russian Federation,2005,2005Russian Federation,0,0,0,0,0,0,0,0,0,0,0,0,0,0,91721
19536,Russian Federation,2005,2005Russian Federation,0,0,0,0,0,0,0,0,0,0,0,0,6,6,6
19537,Russian Federation,2005,2005Russian Federation,0,0,0,0,0,0,0,0,0,0,5,0,0,5,10
19538,Russian Federation,2005,2005Russian Federation,0,0,0,0,0,0,0,0,0,0,6,0,0,6,6
19539,Russian Federation,2005,2005Russian Federation,0,0,0,0,0,0,0,0,0,0,7,0,0,7,7
19540,Russian Federation,2005,2005Russian Federation,0,0,0,0,0,0,0,0,0,0,12,0,0,12,12
19541,Russian Federation,2005,2005Russian Federation,0,0,0,0,0,18,18,0,0,0,0,0,14,14,32
19542,Russian Federation,2005,2005Russian Federation,0,0,0,0,0,2696,2696,0,0,0,0,0,2596,2596,5292
19543,Russian Federation,2005,2005Russian Federation,0,0,0,0,5,0,5,0,0,0,5,9,0,14,19
19544,Russian Federation,2005,2005Russian Federation,0,0,0,8,0,0,8,0,0,0,0,0,0,0,16
19545,Russian Federation,2005,2005Russian Federation,0,0,7,6,0,0,13,0,0,6,9,0,0,15,28
19546,Russian Federation,2005,2005Russian Federation,0,0,8,0,0,0,8,0,0,0,0,0,0,0,14
19547,Russian Federation,2005,2005Russian Federation,0,5,0,0,0,0,5,0,0,0,0,0,0,0,10
19548,Russian Federation,2005,2005Russian Federation,0,5,0,12,0,0,17,0,0,8,17,0,0,25,42
19549,Russian Federation,2005,2005Russian Federation,0,13,11,46,8,0,78,0,13,12,52,0,0,77,155
19550,Russian Federation,2005,2005Russian Federation,5,6,5,32,0,0,48,7,7,6,22,0,0,42,90
19551,Russian Federation,2005,2005Russian Federation,13,16,14,49,5,49,146,18,13,12,43,0,34,120,266
19552,Russian Federation,2005,2005Russian Federation,134,251,215,622,24,0,1246,177,283,242,507,28,0,1237,2483
19553,Russian Federation,2005,2005Russian Federation,211,216,186,841,25,0,1479,269,215,184,662,19,0,1349,2828
19554,Russian Federation,2006,2006Russian Federation,0,0,0,0,0,0,0,0,0,0,0,0,0,0,139696
19555,Russian Federation,2006,2006Russian Federation,0,0,0,0,0,0,0,0,0,0,0,0,8,8,8
19556,Russian Federation,2006,2006Russian Federation,0,0,0,0,0,0,0,0,0,0,5,0,0,5,20
19557,Russian Federation,2006,2006Russian Federation,0,0,0,0,0,0,0,0,0,0,6,0,0,6,6
19558,Russian Federation,2006,2006Russian Federation,0,0,0,0,0,0,0,0,0,0,7,0,0,7,7
19559,Russian Federation,2006,2006Russian Federation,0,0,0,0,0,0,0,0,0,0,11,0,0,11,11
19560,Russian Federation,2006,2006Russian Federation,0,0,0,0,0,25,25,0,0,0,0,0,18,18,43
19561,Russian Federation,2006,2006Russian Federation,0,0,0,0,0,66,66,0,0,0,0,0,62,62,128
19562,Russian Federation,2006,2006Russian Federation,0,0,0,0,0,211,211,0,0,0,0,0,178,178,389
19563,Russian Federation,2006,2006Russian Federation,0,0,0,0,0,2556,2556,0,0,0,0,0,2869,2869,5425
19564,Russian Federation,2006,2006Russian Federation,0,0,0,0,0,3029,3029,0,0,0,0,0,2916,2916,5945
19565,Russian Federation,2006,2006Russian Federation,0,0,0,0,5,0,5,0,0,0,5,8,0,13,18
19566,Russian Federation,2006,2006Russian Federation,0,0,0,5,0,0,5,0,0,0,0,0,0,0,5
19567,Russian Federation,2006,2006Russian Federation,0,0,0,8,0,0,8,0,0,0,0,0,0,0,16
19568,Russian Federation,2006,2006Russian Federation,0,0,0,16,0,0,16,0,0,5,18,0,0,23,39
19569,Russian Federation,2006,2006Russian Federation,0,0,5,0,0,0,5,0,0,0,0,0,0,0,5
19570,Russian Federation,2006,2006Russian Federation,0,6,0,6,0,0,12,0,6,0,12,0,0,18,30
19571,Russian Federation,2006,2006Russian Federation,5,10,0,34,0,0,49,5,8,6,24,0,0,43,92
19572,Russian Federation,2006,2006Russian Federation,48,109,136,363,13,0,669,60,130,166,314,23,0,693,1362
19573,Russian Federation,2006,2006Russian Federation,130,0,644,1044,54,0,1872,149,0,682,975,35,0,1841,3713
19574,Russian Federation,2006,2006Russian Federation,181,217,142,712,29,0,1281,204,272,120,532,16,0,1144,2425
19575,Russian Federation,2007,2007Russian Federation,0,0,0,0,0,0,0,0,0,0,0,0,0,0,73249
19576,Russian Federation,2007,2007Russian Federation,0,0,0,0,0,0,0,0,0,0,5,0,0,5,20
19577,Russian Federation,2007,2007Russian Federation,0,0,0,0,0,0,0,0,0,0,6,0,0,6,6
19578,Russian Federation,2007,2007Russian Federation,0,0,0,0,0,0,0,0,0,0,8,0,0,8,8
19579,Russian Federation,2007,2007Russian Federation,0,0,0,0,0,0,0,0,0,0,11,0,0,11,11
19580,Russian Federation,2007,2007Russian Federation,0,0,0,0,0,81,81,0,0,0,0,0,75,75,156
19581,Russian Federation,2007,2007Russian Federation,0,0,0,0,0,147,147,0,0,0,0,0,113,113,502
19582,Russian Federation,2007,2007Russian Federation,0,0,0,0,0,2421,2421,0,0,0,0,0,2729,2729,5150
19583,Russian Federation,2007,2007Russian Federation,0,0,0,0,0,3348,3348,0,0,0,0,0,3265,3265,6613
19584,Russian Federation,2007,2007Russian Federation,0,0,0,0,5,0,5,0,0,0,5,8,0,13,18
19585,Russian Federation,2007,2007Russian Federation,0,0,0,5,0,0,5,0,0,0,0,0,0,0,10
19586,Russian Federation,2007,2007Russian Federation,0,0,0,6,0,0,6,0,0,0,0,0,0,0,6
19587,Russian Federation,2007,2007Russian Federation,0,0,0,8,0,0,8,0,0,0,0,0,0,0,16
19588,Russian Federation,2007,2007Russian Federation,0,0,0,9,0,0,9,0,0,0,10,0,0,10,19
19589,Russian Federation,2007,2007Russian Federation,0,0,0,17,0,0,17,0,0,5,18,0,0,23,40
19590,Russian Federation,2007,2007Russian Federation,0,5,0,5,0,0,10,0,0,0,9,0,0,9,19
19591,Russian Federation,2007,2007Russian Federation,0,6,0,7,0,0,13,0,6,0,10,0,0,16,29
19592,Russian Federation,2007,2007Russian Federation,0,15,0,37,0,0,52,9,10,7,24,0,0,50,102
19593,Russian Federation,2007,2007Russian Federation,23,34,14,78,6,58,213,27,29,24,69,0,44,193,406
19594,Russian Federation,2007,2007Russian Federation,30,87,99,301,6,0,523,52,97,112,241,11,0,513,1036
19595,Russian Federation,2007,2007Russian Federation,123,0,641,1040,54,0,1858,147,0,680,972,35,0,1834,3692
19596,Russian Federation,2007,2007Russian Federation,150,203,129,619,33,0,1134,173,244,101,442,16,0,976,2110
19597,Russian Federation,2008,2008Russian Federation,0,0,0,0,0,0,0,0,0,0,0,0,0,0,83591
19598,Russian Federation,2008,2008Russian Federation,0,0,0,0,0,0,0,0,0,0,5,0,0,5,20
19599,Russian Federation,2008,2008Russian Federation,0,0,0,0,0,0,0,0,0,0,7,0,0,7,7
19600,Russian Federation,2008,2008Russian Federation,0,0,0,0,0,0,0,0,0,0,8,0,0,8,8
19601,Russian Federation,2008,2008Russian Federation,0,0,0,0,0,0,0,0,0,0,11,0,0,11,11
19602,Russian Federation,2008,2008Russian Federation,0,0,0,0,0,1837,1837,0,0,0,0,0,2144,2144,3981
19603,Russian Federation,2008,2008Russian Federation,0,0,0,0,0,3755,3755,0,0,0,0,0,3860,3860,7615
19604,Russian Federation,2008,2008Russian Federation,0,0,0,0,5,0,5,0,0,0,5,7,0,12,17
19605,Russian Federation,2008,2008Russian Federation,0,0,0,5,0,0,5,0,0,0,0,0,0,0,10
19606,Russian Federation,2008,2008Russian Federation,0,0,0,6,0,0,6,0,0,0,0,0,0,0,6
19607,Russian Federation,2008,2008Russian Federation,0,0,0,8,0,0,8,0,0,0,0,0,0,0,8
19608,Russian Federation,2008,2008Russian Federation,0,0,0,9,0,0,9,0,0,0,11,0,0,11,20
19609,Russian Federation,2008,2008Russian Federation,0,0,5,0,0,0,5,0,0,0,0,0,0,0,10
19610,Russian Federation,2008,2008Russian Federation,0,0,5,10,0,0,15,0,8,0,9,0,0,17,32
19611,Russian Federation,2008,2008Russian Federation,0,0,20,33,7,0,60,0,0,15,39,5,0,59,119
19612,Russian Federation,2008,2008Russian Federation,0,5,0,5,0,0,10,0,0,0,9,0,0,9,19
19613,Russian Federation,2008,2008Russian Federation,5,12,0,39,0,0,56,9,11,8,25,0,0,53,109
19614,Russian Federation,2008,2008Russian Federation,22,41,21,95,9,63,251,24,38,28,81,5,55,231,482
19615,Russian Federation,2008,2008Russian Federation,23,15,12,44,0,0,94,18,15,25,45,0,0,103,553
19616,Russian Federation,2008,2008Russian Federation,29,283,308,1164,65,0,1849,44,321,309,1125,44,0,1843,3692
19617,Russian Federation,2008,2008Russian Federation,39,94,70,280,6,0,489,65,98,80,237,12,0,492,981
19618,Russian Federation,2008,2008Russian Federation,131,169,110,518,24,0,952,134,218,90,361,15,0,818,1770
19619,Russian Federation,2009,2009Russian Federation,0,0,0,0,0,0,0,0,0,0,0,0,0,0,61002
19620,Russian Federation,2009,2009Russian Federation,0,0,0,0,0,0,0,0,0,0,0,9,0,9,9
19621,Russian Federation,2009,2009Russian Federation,0,0,0,0,0,0,0,0,0,0,5,0,0,5,10
19622,Russian Federation,2009,2009Russian Federation,0,0,0,0,0,0,0,0,0,0,6,0,0,6,12
19623,Russian Federation,2009,2009Russian Federation,0,0,0,0,0,0,0,0,0,0,11,0,0,11,11
19624,Russian Federation,2009,2009Russian Federation,0,0,0,0,0,0,0,0,0,5,0,0,0,5,5
19625,Russian Federation,2009,2009Russian Federation,0,0,0,0,0,1595,1595,0,0,0,0,0,1833,1833,3428
19626,Russian Federation,2009,2009Russian Federation,0,0,0,0,5,0,5,0,0,0,5,7,0,12,17
19627,Russian Federation,2009,2009Russian Federation,0,0,0,5,0,0,5,0,0,0,0,0,0,0,15
19628,Russian Federation,2009,2009Russian Federation,0,0,0,5,0,0,5,0,0,7,0,0,0,7,12
19629,Russian Federation,2009,2009Russian Federation,0,0,0,8,0,0,8,0,0,0,0,0,0,0,8
19630,Russian Federation,2009,2009Russian Federation,0,0,0,8,0,0,8,0,0,5,8,0,0,13,21
19631,Russian Federation,2009,2009Russian Federation,0,0,5,0,0,0,5,0,0,0,0,0,0,0,5
19632,Russian Federation,2009,2009Russian Federation,0,0,5,5,0,0,10,0,0,0,13,0,0,13,23
19633,Russian Federation,2009,2009Russian Federation,0,0,5,9,0,0,14,0,8,0,9,0,0,17,31
19634,Russian Federation,2009,2009Russian Federation,0,0,22,32,8,0,62,0,0,15,40,5,0,60,122
19635,Russian Federation,2009,2009Russian Federation,0,12,5,25,0,0,42,7,9,5,26,0,0,47,89
19636,Russian Federation,2009,2009Russian Federation,0,24,10,27,0,0,61,21,17,18,31,0,0,87,579
19637,Russian Federation,2009,2009Russian Federation,21,42,26,95,7,86,277,23,39,30,89,0,70,251,528
19638,Russian Federation,2009,2009Russian Federation,29,283,308,1164,65,0,1849,44,321,309,1125,44,0,1843,3692
19639,Russian Federation,2009,2009Russian Federation,32,92,60,230,16,0,430,57,90,67,181,32,0,427,857
19640,Russian Federation,2009,2009Russian Federation,101,128,81,383,22,0,715,86,156,81,286,10,0,619,1334
19641,Russian Federation,2009,2009Russian Federation,265,1052,1230,10797,7110,0,20454,255,1095,1310,9556,4972,0,17188,37642
19642,Russian Federation,2010,2010Russian Federation,0,0,0,0,0,0,0,0,0,0,0,0,0,0,56540
19643,Russian Federation,2010,2010Russian Federation,0,0,0,0,0,0,0,0,0,0,5,0,0,5,10
19644,Russian Federation,2010,2010Russian Federation,0,0,0,0,0,0,0,0,0,0,6,0,0,6,6
19645,Russian Federation,2010,2010Russian Federation,0,0,0,0,0,0,0,0,0,0,7,0,0,7,7
19646,Russian Federation,2010,2010Russian Federation,0,0,0,0,0,0,0,0,0,0,11,0,0,11,11
19647,Russian Federation,2010,2010Russian Federation,0,0,0,0,0,0,0,0,0,5,0,0,0,5,5
19648,Russian Federation,2010,2010Russian Federation,0,0,0,0,0,0,0,0,0,5,12,0,0,17,578
19649,Russian Federation,2010,2010Russian Federation,0,0,0,0,0,67,67,0,0,0,0,0,64,64,131
19650,Russian Federation,2010,2010Russian Federation,0,0,0,0,0,1385,1385,0,0,0,0,0,1579,1579,2964
19651,Russian Federation,2010,2010Russian Federation,0,0,0,0,0,4989,4989,0,0,0,0,0,4869,4869,9858
19652,Russian Federation,2010,2010Russian Federation,0,0,0,0,5,0,5,0,0,0,5,7,0,12,17
19653,Russian Federation,2010,2010Russian Federation,0,0,0,5,0,0,5,0,0,0,0,0,0,0,5
19654,Russian Federation,2010,2010Russian Federation,0,0,0,5,0,0,5,0,0,7,0,0,0,7,12
19655,Russian Federation,2010,2010Russian Federation,0,0,0,8,0,0,8,0,0,0,0,0,0,0,8
19656,Russian Federation,2010,2010Russian Federation,0,0,0,8,0,0,8,0,0,5,8,0,0,13,21
19657,Russian Federation,2010,2010Russian Federation,0,0,0,9,0,0,9,0,0,0,0,0,0,0,9
19658,Russian Federation,2010,2010Russian Federation,0,0,0,11,0,0,11,0,7,0,8,0,0,15,26
19659,Russian Federation,2010,2010Russian Federation,0,0,5,0,0,0,5,0,0,0,0,0,0,0,10
19660,Russian Federation,2010,2010Russian Federation,0,0,5,5,0,0,10,0,0,0,13,0,0,13,23
19661,Russian Federation,2010,2010Russian Federation,0,5,0,0,0,0,5,0,0,0,0,0,0,0,5
19662,Russian Federation,2010,2010Russian Federation,0,14,0,9,0,0,23,7,5,0,6,0,0,18,41
19663,Russian Federation,2010,2010Russian Federation,16,45,31,95,7,93,287,13,38,32,90,0,86,259,546
19664,Russian Federation,2010,2010Russian Federation,29,45,60,174,5,0,313,31,62,56,150,11,0,310,623
19665,Russian Federation,2010,2010Russian Federation,83,95,64,293,19,0,554,60,116,75,214,9,0,474,1028
19666,Russian Federation,2010,2010Russian Federation,234,962,1217,11196,7850,0,21459,251,1050,1306,9895,5499,0,18001,39460
19667,Russian Federation,2011,2011Russian Federation,0,0,0,0,0,0,0,0,0,0,0,0,0,0,51350
19668,Russian Federation,2011,2011Russian Federation,0,0,0,0,0,0,0,0,0,0,5,0,0,5,10
19669,Russian Federation,2011,2011Russian Federation,0,0,0,0,0,0,0,0,0,0,8,0,0,8,8
19670,Russian Federation,2011,2011Russian Federation,0,0,0,0,0,0,0,0,0,0,9,0,0,9,18
19671,Russian Federation,2011,2011Russian Federation,0,0,0,0,0,0,0,0,0,0,11,0,0,11,11
19672,Russian Federation,2011,2011Russian Federation,0,0,0,0,0,0,0,0,0,5,0,0,0,5,5
19673,Russian Federation,2011,2011Russian Federation,0,0,0,0,0,1375,1375,0,0,0,0,0,1519,1519,2894
19674,Russian Federation,2011,2011Russian Federation,0,0,0,0,0,5523,5523,0,0,0,0,0,5359,5359,10882
19675,Russian Federation,2011,2011Russian Federation,0,0,0,0,5,0,5,0,0,0,5,6,0,11,16
19676,Russian Federation,2011,2011Russian Federation,0,0,0,5,0,0,5,0,0,0,0,0,0,0,20
19677,Russian Federation,2011,2011Russian Federation,0,0,0,5,0,0,5,0,0,6,0,0,0,6,11
19678,Russian Federation,2011,2011Russian Federation,0,0,0,7,0,0,7,0,9,0,0,0,0,9,16
19679,Russian Federation,2011,2011Russian Federation,0,0,0,7,0,0,7,0,12,0,5,0,0,17,583
19680,Russian Federation,2011,2011Russian Federation,0,0,0,8,0,0,8,0,0,0,0,0,0,0,8
19681,Russian Federation,2011,2011Russian Federation,0,0,0,8,0,0,8,0,0,5,8,0,0,13,21
19682,Russian Federation,2011,2011Russian Federation,0,0,0,9,0,0,9,0,0,0,0,0,0,0,9
19683,Russian Federation,2011,2011Russian Federation,0,0,0,19,0,0,19,0,0,0,25,0,0,25,59
19684,Russian Federation,2011,2011Russian Federation,0,0,5,5,0,0,10,0,0,0,13,0,0,13,23
19685,Russian Federation,2011,2011Russian Federation,0,0,5,5,0,0,10,0,0,5,5,0,0,10,124
19686,Russian Federation,2011,2011Russian Federation,0,5,0,0,0,0,5,0,0,0,0,0,0,0,5
19687,Russian Federation,2011,2011Russian Federation,0,7,8,98,15,0,128,5,6,6,79,5,0,101,1931
19688,Russian Federation,2011,2011Russian Federation,6,6,0,7,0,0,19,5,6,0,0,0,0,11,30
19689,Russian Federation,2011,2011Russian Federation,15,26,34,139,5,0,219,25,31,35,122,14,0,227,446
19690,Russian Federation,2011,2011Russian Federation,15,42,35,103,5,111,311,13,37,31,87,5,114,287,598
19691,Russian Federation,2011,2011Russian Federation,68,91,53,255,19,0,486,54,99,62,177,11,0,403,889
19692,Russian Federation,2011,2011Russian Federation,197,905,1138,11243,8253,0,21736,214,933,1243,9950,5740,0,18080,39816
19693,Russian Federation,2012,2012Russian Federation,0,0,0,0,0,0,0,0,0,0,0,0,0,0,51107
19694,Russian Federation,2012,2012Russian Federation,0,0,0,0,0,0,0,0,0,0,5,0,0,5,10
19695,Russian Federation,2012,2012Russian Federation,0,0,0,0,0,0,0,0,0,0,6,0,0,6,6
19696,Russian Federation,2012,2012Russian Federation,0,0,0,0,0,0,0,0,0,0,11,0,0,11,22
19697,Russian Federation,2012,2012Russian Federation,0,0,0,0,0,0,0,0,0,6,5,0,0,11,11
19698,Russian Federation,2012,2012Russian Federation,0,0,0,0,0,51,51,0,0,0,0,0,54,54,105
19699,Russian Federation,2012,2012Russian Federation,0,0,0,0,0,169,169,0,0,0,0,0,173,173,441
19700,Russian Federation,2012,2012Russian Federation,0,0,0,0,0,1261,1261,0,0,0,0,0,1400,1400,2661
19701,Russian Federation,2012,2012Russian Federation,0,0,0,0,0,5974,5974,0,0,0,0,0,5793,5793,11767
19702,Russian Federation,2012,2012Russian Federation,0,0,0,5,0,0,5,0,0,0,0,0,0,0,20
19703,Russian Federation,2012,2012Russian Federation,0,0,0,5,0,0,5,0,0,0,5,6,0,11,16
19704,Russian Federation,2012,2012Russian Federation,0,0,0,5,0,0,5,0,6,0,0,0,0,6,11
19705,Russian Federation,2012,2012Russian Federation,0,0,0,7,0,0,7,0,0,0,0,0,0,0,7
19706,Russian Federation,2012,2012Russian Federation,0,0,0,8,0,0,8,0,0,0,0,0,0,0,16
19707,Russian Federation,2012,2012Russian Federation,0,0,0,8,0,0,8,0,0,5,8,0,0,13,21
19708,Russian Federation,2012,2012Russian Federation,0,0,0,9,0,0,9,0,0,0,0,0,0,0,9
19709,Russian Federation,2012,2012Russian Federation,0,0,0,17,0,0,17,0,0,0,20,5,0,25,60
19710,Russian Federation,2012,2012Russian Federation,0,0,5,0,0,0,5,0,0,0,0,0,0,0,5
19711,Russian Federation,2012,2012Russian Federation,0,0,5,0,0,0,5,0,0,0,5,0,0,5,20
19712,Russian Federation,2012,2012Russian Federation,0,0,5,9,0,0,14,0,0,0,17,0,0,17,31
19713,Russian Federation,2012,2012Russian Federation,0,0,5,10,0,0,15,0,6,0,18,0,0,24,583
19714,Russian Federation,2012,2012Russian Federation,0,0,6,43,6,0,55,0,7,0,42,0,0,49,1756
19715,Russian Federation,2012,2012Russian Federation,0,6,0,9,0,0,15,0,5,0,5,0,0,10,25
19716,Russian Federation,2012,2012Russian Federation,10,22,32,89,0,0,153,6,24,37,66,7,0,140,293
19717,Russian Federation,2012,2012Russian Federation,12,36,35,89,7,134,313,12,37,28,79,5,125,286,599
19718,Russian Federation,2012,2012Russian Federation,55,81,52,220,21,0,429,40,81,53,165,13,0,352,781
19719,Russian Federation,2012,2012Russian Federation,197,820,1111,11260,8627,0,22015,200,857,1189,9972,5971,0,18189,40204
19720,Russian Federation,2013,2013Russian Federation,0,0,0,0,0,0,0,0,0,0,0,0,0,0,50861
19721,Russian Federation,2013,2013Russian Federation,0,0,0,0,0,0,0,0,0,0,5,0,0,5,10
19722,Russian Federation,2013,2013Russian Federation,0,0,0,0,0,0,0,0,0,0,11,0,0,11,11
19723,Russian Federation,2013,2013Russian Federation,0,0,0,0,0,0,0,0,0,0,13,0,0,13,13
19724,Russian Federation,2013,2013Russian Federation,0,0,0,0,0,0,0,0,0,5,6,0,0,11,11
19725,Russian Federation,2013,2013Russian Federation,0,0,0,0,0,0,0,0,5,0,0,0,0,5,5
19726,Russian Federation,2013,2013Russian Federation,0,0,0,0,0,0,0,0,8,0,0,0,0,8,8
19727,Russian Federation,2013,2013Russian Federation,0,0,0,0,0,987,987,0,0,0,0,0,1190,1190,2177
19728,Russian Federation,2013,2013Russian Federation,0,0,0,0,0,6550,6550,0,0,0,0,0,6245,6245,12795
19729,Russian Federation,2013,2013Russian Federation,0,0,0,5,0,0,5,0,0,0,0,0,0,0,5
19730,Russian Federation,2013,2013Russian Federation,0,0,0,5,0,0,5,0,0,0,5,6,0,11,16
19731,Russian Federation,2013,2013Russian Federation,0,0,0,5,0,0,5,0,0,0,7,0,0,7,12
19732,Russian Federation,2013,2013Russian Federation,0,0,0,5,0,0,5,0,0,0,9,0,0,9,14
19733,Russian Federation,2013,2013Russian Federation,0,0,0,6,0,0,6,0,0,0,0,0,0,0,6
19734,Russian Federation,2013,2013Russian Federation,0,0,0,7,0,0,7,0,0,0,0,0,0,0,7
19735,Russian Federation,2013,2013Russian Federation,0,0,0,8,0,0,8,0,0,0,0,0,0,0,16
19736,Russian Federation,2013,2013Russian Federation,0,0,0,8,0,0,8,0,0,5,8,0,0,13,21
19737,Russian Federation,2013,2013Russian Federation,0,0,0,9,0,0,9,0,0,0,0,0,0,0,9
19738,Russian Federation,2013,2013Russian Federation,0,0,0,20,5,0,25,0,0,0,36,0,0,36,61
19739,Russian Federation,2013,2013Russian Federation,0,0,5,0,0,0,5,0,0,0,5,0,0,5,10
19740,Russian Federation,2013,2013Russian Federation,0,0,8,35,5,0,48,0,8,0,41,0,0,49,1527
19741,Russian Federation,2013,2013Russian Federation,0,0,8,60,7,0,75,0,5,7,94,7,0,113,188
19742,Russian Federation,2013,2013Russian Federation,0,5,0,8,0,0,13,0,0,0,16,0,0,16,29
19743,Russian Federation,2013,2013Russian Federation,0,7,0,9,0,0,16,0,5,0,5,0,0,10,26
19744,Russian Federation,2013,2013Russian Federation,6,6,0,5,0,0,17,0,5,8,6,0,0,19,585
19745,Russian Federation,2013,2013Russian Federation,8,13,37,80,0,0,138,5,22,39,62,5,0,133,271
19746,Russian Federation,2013,2013Russian Federation,10,26,33,93,6,146,314,9,37,21,78,5,137,287,601
19747,Russian Federation,2013,2013Russian Federation,44,65,46,175,20,0,350,35,65,55,139,13,0,307,657
19748,Russian Federation,2013,2013Russian Federation,86,339,258,1355,146,0,2184,95,374,306,1318,81,0,2174,4358
19749,Russian Federation,2014,2014Russian Federation,0,0,0,0,0,0,0,0,0,0,0,0,0,0,48614
19750,Russian Federation,2014,2014Russian Federation,0,0,0,0,0,0,0,0,0,0,5,0,0,5,5
19751,Russian Federation,2014,2014Russian Federation,0,0,0,0,0,0,0,0,0,0,9,0,0,9,9
19752,Russian Federation,2014,2014Russian Federation,0,0,0,0,0,0,0,0,0,0,11,0,0,11,11
19753,Russian Federation,2014,2014Russian Federation,0,0,0,0,0,0,0,0,0,0,14,0,0,14,14
19754,Russian Federation,2014,2014Russian Federation,0,0,0,0,0,0,0,0,0,8,0,0,0,8,8
19755,Russian Federation,2014,2014Russian Federation,0,0,0,0,0,8,8,0,0,0,0,0,5,5,13
19756,Russian Federation,2014,2014Russian Federation,0,0,0,0,0,17,17,0,0,0,0,0,17,17,34
19757,Russian Federation,2014,2014Russian Federation,0,0,0,0,0,7051,7051,0,0,0,0,0,6593,6593,13644
19758,Russian Federation,2014,2014Russian Federation,0,0,0,5,0,0,5,0,0,0,0,0,0,0,5
19759,Russian Federation,2014,2014Russian Federation,0,0,0,5,0,0,5,0,0,0,5,6,0,11,16
19760,Russian Federation,2014,2014Russian Federation,0,0,0,5,0,0,5,0,0,0,7,0,0,7,12
19761,Russian Federation,2014,2014Russian Federation,0,0,0,5,0,0,5,0,0,0,9,0,0,9,14
19762,Russian Federation,2014,2014Russian Federation,0,0,0,5,0,0,5,0,0,5,0,0,0,5,10
19763,Russian Federation,2014,2014Russian Federation,0,0,0,6,0,0,6,0,0,0,0,0,0,0,6
19764,Russian Federation,2014,2014Russian Federation,0,0,0,7,0,0,7,0,0,0,0,0,0,0,7
19765,Russian Federation,2014,2014Russian Federation,0,0,0,8,0,0,8,0,0,0,0,0,0,0,8
19766,Russian Federation,2014,2014Russian Federation,0,0,0,20,5,0,25,0,0,0,37,0,0,37,62
19767,Russian Federation,2014,2014Russian Federation,0,0,5,0,0,0,5,0,0,0,5,0,0,5,10
19768,Russian Federation,2014,2014Russian Federation,0,6,0,46,0,0,52,0,0,9,56,0,0,65,1315
19769,Russian Federation,2014,2014Russian Federation,0,7,6,5,0,0,18,0,0,0,0,0,0,0,18
19770,Russian Federation,2014,2014Russian Federation,0,7,8,6,0,0,21,0,0,0,0,0,0,0,610
19771,Russian Federation,2014,2014Russian Federation,9,0,5,0,0,0,14,0,0,7,0,0,0,7,21
19772,Russian Federation,2014,2014Russian Federation,9,17,21,76,0,0,123,7,24,21,65,5,0,122,245
19773,Russian Federation,2014,2014Russian Federation,11,24,36,103,10,164,348,14,37,25,81,5,166,328,676
19774,Russian Federation,2014,2014Russian Federation,30,51,48,146,18,0,293,32,49,50,122,11,0,264,557
19775,Russian Federation,2014,2014Russian Federation,90,363,276,1440,173,0,2342,100,393,325,1352,96,0,2266,4608
19776,Russian Federation,2015,2015Russian Federation,0,0,0,0,0,0,0,0,0,0,0,0,0,0,42526
19777,Russian Federation,2015,2015Russian Federation,0,0,0,0,0,0,0,0,0,0,5,0,0,5,5
19778,Russian Federation,2015,2015Russian Federation,0,0,0,0,0,0,0,0,0,0,9,0,0,9,25
19779,Russian Federation,2015,2015Russian Federation,0,0,0,0,0,0,0,0,0,0,11,0,0,11,11
19780,Russian Federation,2015,2015Russian Federation,0,0,0,0,0,0,0,0,0,8,0,0,0,8,8
19781,Russian Federation,2015,2015Russian Federation,0,0,0,0,0,17,17,0,0,0,0,0,17,17,34
19782,Russian Federation,2015,2015Russian Federation,0,0,0,0,0,53,53,0,0,0,0,0,63,63,116
19783,Russian Federation,2015,2015Russian Federation,0,0,0,0,0,1302,1302,0,0,0,0,0,1431,1431,2733
19784,Russian Federation,2015,2015Russian Federation,0,0,0,0,0,7387,7387,0,0,0,0,0,6808,6808,14195
19785,Russian Federation,2015,2015Russian Federation,0,0,0,5,0,0,5,0,0,0,0,0,0,0,10
19786,Russian Federation,2015,2015Russian Federation,0,0,0,5,0,0,5,0,0,0,8,0,0,8,13
19787,Russian Federation,2015,2015Russian Federation,0,0,0,5,0,0,5,0,0,5,0,0,0,5,10
19788,Russian Federation,2015,2015Russian Federation,0,0,0,7,0,0,7,0,0,0,0,0,0,0,7
19789,Russian Federation,2015,2015Russian Federation,0,0,0,8,0,0,8,0,0,0,0,0,0,0,8
19790,Russian Federation,2015,2015Russian Federation,0,0,5,16,5,0,26,0,0,5,26,5,0,36,62
19791,Russian Federation,2015,2015Russian Federation,0,0,5,52,8,0,65,0,5,5,83,12,0,105,170
19792,Russian Federation,2015,2015Russian Federation,0,0,7,0,0,0,7,0,0,0,6,0,0,6,13
19793,Russian Federation,2015,2015Russian Federation,0,0,7,6,0,0,13,0,0,6,10,0,0,16,29
19794,Russian Federation,2015,2015Russian Federation,0,5,0,0,0,0,5,0,0,0,0,0,0,0,5
19795,Russian Federation,2015,2015Russian Federation,0,6,0,23,0,0,29,0,0,5,24,0,0,29,624
19796,Russian Federation,2015,2015Russian Federation,0,8,5,0,5,0,18,0,7,0,0,0,0,7,25
19797,Russian Federation,2015,2015Russian Federation,5,0,0,0,0,0,5,0,5,0,9,0,0,14,19
19798,Russian Federation,2015,2015Russian Federation,10,15,27,77,0,0,129,11,20,25,65,5,0,126,255
19799,Russian Federation,2015,2015Russian Federation,12,21,29,104,12,8,186,14,35,26,84,5,10,174,710
19800,Russian Federation,2015,2015Russian Federation,29,49,45,143,19,0,285,29,47,48,118,12,0,254,539
19801,Russian Federation,2015,2015Russian Federation,104,370,276,1531,198,0,2479,106,385,344,1432,110,0,2377,4856
19802,Russian Federation,2016,2016Russian Federation,0,0,0,0,0,0,0,0,0,0,0,0,0,0,36837
19803,Russian Federation,2016,2016Russian Federation,0,0,0,0,0,0,0,0,0,0,5,0,0,5,5
19804,Russian Federation,2016,2016Russian Federation,0,0,0,0,0,0,0,0,0,0,12,0,0,12,12
19805,Russian Federation,2016,2016Russian Federation,0,0,0,0,0,8,8,0,0,0,0,0,11,11,19
19806,Russian Federation,2016,2016Russian Federation,0,0,0,0,0,16,16,0,0,0,0,0,17,17,33
19807,Russian Federation,2016,2016Russian Federation,0,0,0,0,0,55,55,0,0,0,0,0,78,78,133
19808,Russian Federation,2016,2016Russian Federation,0,0,0,0,0,1218,1218,0,0,0,0,0,1340,1340,2558
19809,Russian Federation,2016,2016Russian Federation,0,0,0,0,0,7984,7984,0,0,0,0,0,7248,7248,15232
19810,Russian Federation,2016,2016Russian Federation,0,0,0,5,0,0,5,0,0,0,0,0,0,0,10
19811,Russian Federation,2016,2016Russian Federation,0,0,0,5,0,0,5,0,0,0,8,0,0,8,13
19812,Russian Federation,2016,2016Russian Federation,0,0,0,7,0,0,7,0,0,0,0,0,0,0,7
19813,Russian Federation,2016,2016Russian Federation,0,0,0,8,0,0,8,0,0,0,5,0,0,5,13
19814,Russian Federation,2016,2016Russian Federation,0,0,5,18,5,0,28,0,0,5,27,5,0,37,65
19815,Russian Federation,2016,2016Russian Federation,0,0,5,49,7,0,61,0,0,5,75,13,0,93,154
19816,Russian Federation,2016,2016Russian Federation,0,0,6,23,0,0,29,0,0,0,24,0,0,24,849
19817,Russian Federation,2016,2016Russian Federation,0,0,13,5,0,0,18,0,7,0,0,0,0,7,25
19818,Russian Federation,2016,2016Russian Federation,0,5,0,0,0,0,5,0,0,0,0,0,0,0,5
19819,Russian Federation,2016,2016Russian Federation,0,5,0,0,0,0,5,0,0,0,8,0,0,8,13
19820,Russian Federation,2016,2016Russian Federation,0,7,0,0,0,0,7,0,0,0,7,0,0,7,14
19821,Russian Federation,2016,2016Russian Federation,8,8,0,0,0,0,16,0,0,0,0,0,0,0,16
19822,Russian Federation,2016,2016Russian Federation,9,19,18,87,0,0,133,12,24,26,63,7,0,132,265
19823,Russian Federation,2016,2016Russian Federation,13,21,26,105,14,196,375,9,38,20,87,6,190,350,725
19824,Russian Federation,2016,2016Russian Federation,22,43,41,137,16,0,259,25,40,48,117,12,0,242,501
19825,Russian Federation,2016,2016Russian Federation,114,402,324,1657,228,0,2725,104,418,364,1518,126,0,2530,5255
19826,Russian Federation,2017,2017Russian Federation,0,0,0,0,0,0,0,0,0,0,0,0,0,0,37023
19827,Russian Federation,2017,2017Russian Federation,0,0,0,0,0,0,0,0,0,0,5,0,0,5,10
19828,Russian Federation,2017,2017Russian Federation,0,0,0,0,0,0,0,0,0,0,12,0,0,12,12
19829,Russian Federation,2017,2017Russian Federation,0,0,0,0,0,8,8,0,0,0,0,0,11,11,19
19830,Russian Federation,2017,2017Russian Federation,0,0,0,0,0,66,66,0,0,0,0,0,84,84,150
19831,Russian Federation,2017,2017Russian Federation,0,0,0,0,0,8215,8215,0,0,0,0,0,7419,7419,15634
19832,Russian Federation,2017,2017Russian Federation,0,0,0,5,0,0,5,0,0,0,0,0,0,0,10
19833,Russian Federation,2017,2017Russian Federation,0,0,0,5,0,0,5,0,5,0,5,0,0,10,15
19834,Russian Federation,2017,2017Russian Federation,0,0,0,7,0,0,7,0,0,0,0,0,0,0,7
19835,Russian Federation,2017,2017Russian Federation,0,0,0,8,0,0,8,0,0,0,0,0,0,0,8
19836,Russian Federation,2017,2017Russian Federation,0,0,0,8,0,0,8,0,0,0,5,0,0,5,13
19837,Russian Federation,2017,2017Russian Federation,0,0,0,14,0,0,14,0,0,0,11,5,0,16,30
19838,Russian Federation,2017,2017Russian Federation,0,0,5,17,6,0,28,0,0,0,32,5,0,37,65
19839,Russian Federation,2017,2017Russian Federation,0,0,5,54,7,0,66,0,0,5,74,14,0,93,159
19840,Russian Federation,2017,2017Russian Federation,0,0,8,9,0,0,17,0,0,8,0,0,0,8,25
19841,Russian Federation,2017,2017Russian Federation,0,7,0,0,0,0,7,0,0,0,7,0,0,7,14
19842,Russian Federation,2017,2017Russian Federation,5,8,0,0,0,0,13,0,5,0,0,0,0,5,18
19843,Russian Federation,2017,2017Russian Federation,10,13,18,88,0,0,129,15,16,28,62,9,0,130,259
19844,Russian Federation,2017,2017Russian Federation,12,17,26,107,13,204,379,8,30,22,88,6,201,355,734
19845,Russian Federation,2017,2017Russian Federation,17,40,37,100,9,0,203,18,36,43,109,10,0,216,419
19846,Russian Federation,2017,2017Russian Federation,230,573,442,2126,298,0,3669,246,595,455,1844,151,0,3291,6960
19847,Russian Federation,2018,2018Russian Federation,0,0,0,0,0,0,0,0,0,0,0,0,0,0,34899
19848,Russian Federation,2018,2018Russian Federation,0,0,0,0,0,0,0,0,0,0,5,0,0,5,5
19849,Russian Federation,2018,2018Russian Federation,0,0,0,0,0,0,0,0,0,0,7,5,0,12,12
19850,Russian Federation,2018,2018Russian Federation,0,0,0,0,0,0,0,0,0,5,0,0,0,5,5
19851,Russian Federation,2018,2018Russian Federation,0,0,0,0,0,8364,8364,0,0,0,0,0,7534,7534,15898
19852,Russian Federation,2018,2018Russian Federation,0,0,0,5,0,0,5,0,0,0,0,0,0,0,15
19853,Russian Federation,2018,2018Russian Federation,0,0,0,6,0,0,6,0,0,0,9,0,0,9,15
19854,Russian Federation,2018,2018Russian Federation,0,0,0,6,0,0,6,0,5,0,6,0,0,11,17
19855,Russian Federation,2018,2018Russian Federation,0,0,0,8,0,0,8,0,0,0,5,0,0,5,13
19856,Russian Federation,2018,2018Russian Federation,0,0,5,20,6,0,31,0,0,0,33,6,0,39,70
19857,Russian Federation,2018,2018Russian Federation,0,0,5,28,0,0,33,0,0,0,32,5,0,37,70
19858,Russian Federation,2018,2018Russian Federation,0,6,6,43,0,0,55,0,0,6,36,0,0,42,904
19859,Russian Federation,2018,2018Russian Federation,0,7,0,0,0,0,7,0,0,0,0,0,0,0,14
19860,Russian Federation,2018,2018Russian Federation,0,18,0,0,0,0,18,0,0,7,0,0,0,7,25
19861,Russian Federation,2018,2018Russian Federation,6,13,17,83,0,0,119,13,17,26,54,6,0,116,235
19862,Russian Federation,2018,2018Russian Federation,13,39,34,93,6,0,185,24,35,40,93,15,0,207,392
19863,Russian Federation,2018,2018Russian Federation,16,21,26,112,14,197,386,12,30,25,86,7,203,363,749
19864,Russian Federation,2018,2018Russian Federation,258,677,510,2476,349,0,4270,283,709,568,2103,186,0,3849,8119
19865,Russian Federation,2019,2019Russian Federation,0,0,0,0,0,0,0,0,0,0,0,0,0,0,35523
19866,Russian Federation,2019,2019Russian Federation,0,0,0,0,0,0,0,0,0,0,5,0,0,5,10
19867,Russian Federation,2019,2019Russian Federation,0,0,0,0,0,0,0,0,0,0,6,0,0,6,6
19868,Russian Federation,2019,2019Russian Federation,0,0,0,0,0,0,0,0,0,0,7,5,0,12,12
19869,Russian Federation,2019,2019Russian Federation,0,0,0,0,0,0,0,0,0,5,0,0,0,5,5
19870,Russian Federation,2019,2019Russian Federation,0,0,0,0,0,32,32,0,0,0,0,0,90,90,122
19871,Russian Federation,2019,2019Russian Federation,0,0,0,0,0,8648,8648,0,0,0,0,0,7764,7764,16412
19872,Russian Federation,2019,2019Russian Federation,0,0,0,5,0,0,5,0,0,5,5,0,0,10,15
19873,Russian Federation,2019,2019Russian Federation,0,0,0,6,0,0,6,0,0,0,0,0,0,0,6
19874,Russian Federation,2019,2019Russian Federation,0,0,5,26,6,0,37,0,0,0,36,6,0,42,79
19875,Russian Federation,2019,2019Russian Federation,0,0,5,29,0,0,34,0,0,5,35,0,0,40,74
19876,Russian Federation,2019,2019Russian Federation,0,8,0,0,0,0,8,0,0,0,0,0,0,0,8
19877,Russian Federation,2019,2019Russian Federation,0,8,9,0,0,0,17,0,0,7,0,0,0,7,24
19878,Russian Federation,2019,2019Russian Federation,0,18,14,90,0,0,122,8,17,23,65,5,0,118,240
19879,Russian Federation,2019,2019Russian Federation,15,21,18,109,12,0,175,13,26,24,72,6,0,141,723
19880,Russian Federation,2019,2019Russian Federation,15,36,34,88,7,0,180,20,33,32,94,13,0,192,372
19881,Russian Federation,2019,2019Russian Federation,236,734,593,2655,387,0,4605,243,774,630,2256,214,0,4117,8722
19882,Russian Federation,2020,2020Russian Federation,0,0,0,0,0,0,0,0,0,0,0,0,0,0,38295
19883,Russian Federation,2020,2020Russian Federation,0,0,0,0,0,0,0,0,0,0,5,0,0,5,5
19884,Russian Federation,2020,2020Russian Federation,0,0,0,0,0,0,0,0,0,0,6,0,0,6,6
19885,Russian Federation,2020,2020Russian Federation,0,0,0,0,0,0,0,0,0,0,7,5,0,12,12
19886,Russian Federation,2020,2020Russian Federation,0,0,0,0,0,0,0,0,0,5,0,0,0,5,5
19887,Russian Federation,2020,2020Russian Federation,0,0,0,0,0,5,5,0,0,0,0,0,12,12,17
19888,Russian Federation,2020,2020Russian Federation,0,0,0,0,0,8,8,0,0,0,0,0,5,5,13
19889,Russian Federation,2020,2020Russian Federation,0,0,0,0,0,21,21,0,0,0,0,0,12,12,675
19890,Russian Federation,2020,2020Russian Federation,0,0,0,0,0,21,21,0,0,0,0,0,15,15,36
19891,Russian Federation,2020,2020Russian Federation,0,0,0,0,0,51,51,0,0,0,0,0,114,114,165
19892,Russian Federation,2020,2020Russian Federation,0,0,0,0,0,1261,1261,0,0,0,0,0,1299,1299,2560
19893,Russian Federation,2020,2020Russian Federation,0,0,0,5,0,0,5,0,0,0,0,0,0,0,5
19894,Russian Federation,2020,2020Russian Federation,0,0,0,5,0,0,5,0,0,0,5,0,0,5,10
19895,Russian Federation,2020,2020Russian Federation,0,0,0,5,0,0,5,0,0,5,5,0,0,10,15
19896,Russian Federation,2020,2020Russian Federation,0,0,0,6,0,0,6,0,0,0,0,0,0,0,6
19897,Russian Federation,2020,2020Russian Federation,0,0,0,7,0,0,7,0,0,0,5,0,0,5,177
19898,Russian Federation,2020,2020Russian Federation,0,0,0,15,0,0,15,0,0,0,14,5,0,19,34
19899,Russian Federation,2020,2020Russian Federation,0,0,0,28,10,0,38,0,0,0,35,6,0,41,79
19900,Russian Federation,2020,2020Russian Federation,0,0,7,30,0,0,37,0,5,0,35,5,0,45,82
19901,Russian Federation,2020,2020Russian Federation,0,8,0,0,0,0,8,0,0,0,0,0,0,0,8
19902,Russian Federation,2020,2020Russian Federation,0,8,0,9,0,0,17,0,0,7,0,0,0,7,24
19903,Russian Federation,2020,2020Russian Federation,0,15,14,88,5,0,122,5,19,21,64,7,0,116,238
19904,Russian Federation,2020,2020Russian Federation,11,35,25,91,7,0,169,12,35,29,92,13,0,181,350
19905,Russian Federation,2020,2020Russian Federation,15,20,17,103,18,0,173,14,22,25,71,7,0,139,753
19906,Russian Federation,2020,2020Russian Federation,212,741,659,2786,411,0,4809,219,807,673,2423,236,0,4358,9172
19907,Russian Federation,2021,2021Russian Federation,0,0,0,0,0,0,0,0,0,0,0,0,0,0,56298
19908,Russian Federation,2021,2021Russian Federation,0,0,0,0,0,0,0,0,0,0,5,0,0,5,5
19909,Russian Federation,2021,2021Russian Federation,0,0,0,0,0,0,0,0,0,0,6,0,0,6,6
19910,Russian Federation,2021,2021Russian Federation,0,0,0,0,0,0,0,0,0,0,8,5,0,13,13
19911,Russian Federation,2021,2021Russian Federation,0,0,0,0,0,0,0,0,0,0,9,0,0,9,9
19912,Russian Federation,2021,2021Russian Federation,0,0,0,0,0,0,0,0,0,5,0,0,0,5,5
19913,Russian Federation,2021,2021Russian Federation,0,0,0,0,0,0,0,0,0,6,0,0,0,6,6
19914,Russian Federation,2021,2021Russian Federation,0,0,0,0,0,58,58,0,0,0,0,0,117,117,175
19915,Russian Federation,2021,2021Russian Federation,0,0,0,0,0,88,88,0,0,0,0,0,85,85,173
19916,Russian Federation,2021,2021Russian Federation,0,0,0,5,0,0,5,0,0,0,0,0,0,0,15
19917,Russian Federation,2021,2021Russian Federation,0,0,0,5,0,0,5,0,0,0,5,0,0,5,10
19918,Russian Federation,2021,2021Russian Federation,0,0,0,5,0,0,5,0,0,5,5,0,0,10,15
19919,Russian Federation,2021,2021Russian Federation,0,0,0,6,0,0,6,0,0,0,0,0,0,0,6
19920,Russian Federation,2021,2021Russian Federation,0,0,0,16,0,0,16,0,0,0,15,5,0,20,36
19921,Russian Federation,2021,2021Russian Federation,0,0,0,28,11,0,39,0,0,0,37,5,0,42,81
19922,Russian Federation,2021,2021Russian Federation,0,0,5,0,0,0,5,0,0,0,0,0,0,0,5
19923,Russian Federation,2021,2021Russian Federation,0,0,5,13,0,0,18,0,0,0,26,0,0,26,44
19924,Russian Federation,2021,2021Russian Federation,0,0,8,9,0,0,17,0,0,7,0,0,0,7,24
19925,Russian Federation,2021,2021Russian Federation,0,5,5,29,0,0,39,0,5,0,34,5,0,44,83
19926,Russian Federation,2021,2021Russian Federation,0,9,6,32,5,21,73,0,10,0,46,0,12,68,665
19927,Russian Federation,2021,2021Russian Federation,0,15,10,85,5,0,115,0,20,19,61,8,0,108,223
19928,Russian Federation,2021,2021Russian Federation,5,0,0,0,0,0,5,0,6,0,0,0,0,6,11
19929,Russian Federation,2021,2021Russian Federation,11,23,16,97,15,0,162,12,23,21,61,8,0,125,738
19930,Russian Federation,2021,2021Russian Federation,11,28,26,79,8,0,152,8,34,22,86,15,0,165,317
19931,Russian Federation,2021,2021Russian Federation,185,772,712,2944,433,0,5046,198,823,740,2516,261,0,4538,9584
19932,Rwanda,2001,2001Rwanda,0,0,0,0,0,0,0,0,0,0,0,0,0,0,6783
19933,Rwanda,2001,2001Rwanda,0,0,0,0,0,0,0,0,0,0,5,0,0,5,5
19934,Rwanda,2001,2001Rwanda,0,0,0,0,0,0,0,0,0,0,6,0,0,6,14
19935,Rwanda,2001,2001Rwanda,0,0,0,0,0,0,0,0,5,0,7,0,0,12,12
19936,Rwanda,2001,2001Rwanda,0,0,0,0,0,130,130,0,0,0,0,0,133,133,263
19937,Rwanda,2001,2001Rwanda,0,0,0,0,0,678,678,0,0,0,0,0,508,508,1186
19938,Rwanda,2001,2001Rwanda,0,0,0,0,0,768,768,0,0,0,0,0,1484,1484,6688
19939,Rwanda,2001,2001Rwanda,0,0,0,0,0,1087,1087,0,0,0,0,0,1007,1007,2094
19940,Rwanda,2001,2001Rwanda,0,0,0,5,0,0,5,0,0,0,9,0,0,9,14
19941,Rwanda,2001,2001Rwanda,0,0,0,5,0,0,5,0,0,0,10,0,0,10,15
19942,Rwanda,2001,2001Rwanda,0,0,0,8,0,0,8,0,0,0,7,0,0,7,15
19943,Rwanda,2001,2001Rwanda,0,0,0,9,0,0,9,0,0,0,21,0,0,21,30
19944,Rwanda,2001,2001Rwanda,0,0,0,13,0,0,13,0,0,6,5,0,0,11,24
19945,Rwanda,2001,2001Rwanda,0,6,0,0,0,0,6,0,0,0,0,0,0,0,6
19946,Rwanda,2001,2001Rwanda,0,11,6,12,0,0,29,0,6,6,26,0,0,38,67
19947,Rwanda,2001,2001Rwanda,0,15,14,140,0,0,169,6,22,18,72,0,0,118,287
19948,Rwanda,2001,2001Rwanda,5,5,0,20,0,0,30,0,5,5,15,0,0,25,55
19949,Rwanda,2001,2001Rwanda,5,5,5,22,0,0,37,6,8,6,18,0,0,38,80
19950,Rwanda,2001,2001Rwanda,5,10,9,78,5,0,107,8,10,9,173,0,0,200,307
19951,Rwanda,2001,2001Rwanda,12,5,0,36,0,0,53,10,11,5,98,0,0,124,177
19952,Rwanda,2001,2001Rwanda,17,76,65,269,0,0,427,29,77,66,215,6,0,393,820
19953,Rwanda,2001,2001Rwanda,28,64,55,232,6,0,385,25,76,66,418,5,0,590,5048
19954,Rwanda,2001,2001Rwanda,34,40,44,161,5,0,284,27,38,34,193,0,0,292,576
19955,Rwanda,2001,2001Rwanda,40,70,60,197,5,0,372,37,64,54,243,0,0,398,770
19956,Rwanda,2001,2001Rwanda,41,33,29,84,0,0,187,22,31,26,135,0,0,214,401
19957,Rwanda,2001,2001Rwanda,142,102,87,398,12,0,741,160,95,81,322,12,0,670,30414
19958,Rwanda,2001,2001Rwanda,149,128,114,265,8,0,664,156,131,112,152,5,0,556,1220
19959,Rwanda,2001,2001Rwanda,155,148,128,562,9,0,1002,226,327,280,1429,13,0,2275,3277
19960,Rwanda,2001,2001Rwanda,173,120,103,103,0,0,499,88,121,104,1965,0,0,2278,2777
19961,Rwanda,2001,2001Rwanda,318,255,218,649,27,0,1467,302,276,237,728,24,0,1567,3034
19962,Rwanda,2001,2001Rwanda,459,342,293,712,0,0,1806,526,372,318,734,5,0,1955,3761
19963,Rwanda,2001,2001Rwanda,2111,1128,974,2650,38,0,6901,2103,1245,1063,2944,32,0,7387,14288
19964,Rwanda,2002,2002Rwanda,0,0,0,0,0,0,0,0,0,0,0,0,0,0,10531
19965,Rwanda,2002,2002Rwanda,0,0,0,0,0,0,0,0,5,0,7,0,0,12,12
19966,Rwanda,2002,2002Rwanda,0,0,0,0,0,78,78,0,0,0,0,0,75,75,261
19967,Rwanda,2002,2002Rwanda,0,0,0,0,0,534,534,0,0,0,0,0,503,503,5032
19968,Rwanda,2002,2002Rwanda,0,0,0,0,0,759,759,0,0,0,0,0,570,570,1329
19969,Rwanda,2002,2002Rwanda,0,0,0,5,0,0,5,0,0,0,6,0,0,6,11
19970,Rwanda,2002,2002Rwanda,0,0,0,6,0,0,6,0,0,5,7,0,0,12,18
19971,Rwanda,2002,2002Rwanda,0,0,0,7,0,0,7,0,5,0,16,0,0,21,28
19972,Rwanda,2002,2002Rwanda,0,0,0,8,0,0,8,0,0,0,0,0,0,0,8
19973,Rwanda,2002,2002Rwanda,0,0,5,5,0,0,10,0,5,5,20,0,0,30,40
19974,Rwanda,2002,2002Rwanda,0,5,0,11,0,0,16,0,0,6,5,0,0,11,27
19975,Rwanda,2002,2002Rwanda,0,6,0,0,0,0,6,0,0,0,0,0,0,0,6
19976,Rwanda,2002,2002Rwanda,0,10,5,26,0,0,41,5,8,7,22,5,0,47,88
19977,Rwanda,2002,2002Rwanda,5,0,0,9,0,0,14,0,5,6,9,0,0,20,34
19978,Rwanda,2002,2002Rwanda,5,10,9,78,5,0,107,8,10,9,173,0,0,200,307
19979,Rwanda,2002,2002Rwanda,7,0,0,16,0,0,23,0,9,0,14,0,0,23,46
19980,Rwanda,2002,2002Rwanda,7,5,0,39,0,0,51,5,5,13,102,0,0,125,176
19981,Rwanda,2002,2002Rwanda,7,9,8,145,0,0,169,11,22,18,82,0,0,133,302
19982,Rwanda,2002,2002Rwanda,8,0,5,15,0,0,28,5,5,11,18,0,0,39,67
19983,Rwanda,2002,2002Rwanda,25,22,18,36,0,0,101,15,18,16,88,0,0,137,238
19984,Rwanda,2002,2002Rwanda,29,68,58,289,0,0,444,54,85,73,320,6,0,538,982
19985,Rwanda,2002,2002Rwanda,36,45,47,167,5,0,300,27,37,33,196,0,0,293,593
19986,Rwanda,2002,2002Rwanda,44,71,60,202,5,0,382,39,64,55,251,0,0,409,791
19987,Rwanda,2002,2002Rwanda,95,80,69,164,5,0,413,99,51,44,153,5,0,352,765
19988,Rwanda,2002,2002Rwanda,119,120,102,435,5,0,781,164,248,212,1096,8,0,1728,2509
19989,Rwanda,2002,2002Rwanda,167,115,100,429,16,0,827,167,93,81,327,15,0,683,20510
19990,Rwanda,2002,2002Rwanda,179,126,108,114,0,0,527,91,126,108,2049,0,0,2374,2901
19991,Rwanda,2002,2002Rwanda,279,229,196,582,25,0,1311,269,247,212,654,24,0,1406,2717
19992,Rwanda,2002,2002Rwanda,643,273,242,1368,14,0,2540,554,408,343,1974,166,0,3445,5985
19993,Rwanda,2002,2002Rwanda,2974,1550,1325,3070,130,0,9049,3286,1698,1459,3297,148,0,9888,18937
19994,Rwanda,2003,2003Rwanda,0,0,0,0,0,0,0,0,0,0,0,0,0,0,12041
19995,Rwanda,2003,2003Rwanda,0,0,0,0,0,0,0,0,0,0,9,0,0,9,9
19996,Rwanda,2003,2003Rwanda,0,0,0,0,0,0,0,0,0,0,10,0,0,10,10
19997,Rwanda,2003,2003Rwanda,0,0,0,0,0,0,0,0,0,7,0,0,0,7,7
19998,Rwanda,2003,2003Rwanda,0,0,0,0,0,85,85,0,0,0,0,0,83,83,246
19999,Rwanda,2003,2003Rwanda,0,0,0,0,0,798,798,0,0,0,0,0,612,612,1410
20000,Rwanda,2003,2003Rwanda,0,0,0,5,0,0,5,0,0,0,10,0,0,10,15
20001,Rwanda,2003,2003Rwanda,0,0,0,7,0,0,7,0,0,0,0,0,0,0,7
20002,Rwanda,2003,2003Rwanda,0,0,0,14,0,0,14,0,0,0,10,0,0,10,24
20003,Rwanda,2003,2003Rwanda,0,0,7,12,0,0,19,0,6,0,12,0,0,18,37
20004,Rwanda,2003,2003Rwanda,0,11,6,29,0,0,46,14,9,8,27,0,0,58,104
20005,Rwanda,2003,2003Rwanda,5,10,9,78,5,0,107,8,10,9,172,0,0,199,306
20006,Rwanda,2003,2003Rwanda,6,0,0,9,0,0,15,0,5,6,9,0,0,20,35
20007,Rwanda,2003,2003Rwanda,6,0,0,24,0,0,30,0,6,10,74,0,0,90,120
20008,Rwanda,2003,2003Rwanda,6,0,10,18,0,0,34,0,9,7,19,0,0,35,74
20009,Rwanda,2003,2003Rwanda,7,0,0,6,0,0,13,6,0,0,0,5,0,11,24
20010,Rwanda,2003,2003Rwanda,7,7,0,22,0,0,36,7,5,5,32,0,0,49,85
20011,Rwanda,2003,2003Rwanda,7,10,8,148,0,0,173,11,23,19,78,0,0,131,304
20012,Rwanda,2003,2003Rwanda,26,11,9,46,0,0,92,18,13,12,116,0,0,159,251
20013,Rwanda,2003,2003Rwanda,32,76,65,324,0,0,497,60,95,82,359,7,0,603,1193
20014,Rwanda,2003,2003Rwanda,37,45,46,171,5,0,304,29,42,28,201,0,0,300,604
20015,Rwanda,2003,2003Rwanda,39,44,37,99,0,0,219,41,26,23,88,0,0,178,397
20016,Rwanda,2003,2003Rwanda,45,71,60,209,5,0,390,40,66,56,252,5,0,419,809
20017,Rwanda,2003,2003Rwanda,122,121,104,435,5,0,787,164,252,215,1094,8,0,1733,2520
20018,Rwanda,2003,2003Rwanda,168,91,80,450,21,0,810,171,78,76,547,42,0,914,19743
20019,Rwanda,2003,2003Rwanda,253,164,141,255,0,0,813,185,201,173,2219,0,0,2778,3591
20020,Rwanda,2003,2003Rwanda,480,338,290,919,92,0,2119,466,307,264,1564,58,0,2659,5767
20021,Rwanda,2003,2003Rwanda,634,271,239,1316,14,0,2474,561,407,342,1992,145,0,3447,5921
20022,Rwanda,2003,2003Rwanda,3350,1538,1321,3111,101,0,9421,3574,1680,1436,3367,126,0,10183,19604
20023,Rwanda,2004,2004Rwanda,0,0,0,0,0,0,0,0,0,0,0,0,0,0,15402
20024,Rwanda,2004,2004Rwanda,0,0,0,0,0,0,0,0,0,0,9,0,0,9,9
20025,Rwanda,2004,2004Rwanda,0,0,0,0,0,0,0,0,0,0,10,0,0,10,10
20026,Rwanda,2004,2004Rwanda,0,0,0,5,0,0,5,0,0,0,11,0,0,11,32
20027,Rwanda,2004,2004Rwanda,0,0,0,7,0,0,7,0,0,0,0,0,0,0,7
20028,Rwanda,2004,2004Rwanda,0,0,0,14,0,0,14,0,0,0,10,0,0,10,24
20029,Rwanda,2004,2004Rwanda,0,0,6,17,0,95,118,0,0,5,24,0,89,118,236
20030,Rwanda,2004,2004Rwanda,0,0,8,0,0,0,8,0,0,0,0,0,0,0,8
20031,Rwanda,2004,2004Rwanda,0,5,0,0,0,0,5,0,0,0,7,0,0,7,12
20032,Rwanda,2004,2004Rwanda,0,5,0,6,0,0,11,0,5,0,8,0,0,13,188
20033,Rwanda,2004,2004Rwanda,0,6,5,80,0,0,91,0,6,7,200,0,0,213,304
20034,Rwanda,2004,2004Rwanda,0,7,0,0,0,198,205,5,0,0,0,0,168,173,378
20035,Rwanda,2004,2004Rwanda,0,8,0,0,0,0,8,0,0,6,9,0,0,15,23
20036,Rwanda,2004,2004Rwanda,0,11,6,26,0,0,43,13,9,7,31,0,0,60,103
20037,Rwanda,2004,2004Rwanda,5,7,6,112,0,0,130,7,23,19,78,0,0,127,257
20038,Rwanda,2004,2004Rwanda,6,0,0,26,0,0,32,0,6,10,100,0,0,116,148
20039,Rwanda,2004,2004Rwanda,7,0,0,9,0,0,16,0,5,6,8,0,0,19,35
20040,Rwanda,2004,2004Rwanda,7,5,5,23,0,0,40,5,8,7,27,0,0,47,87
20041,Rwanda,2004,2004Rwanda,7,7,0,23,0,0,37,7,5,5,34,0,0,51,88
20042,Rwanda,2004,2004Rwanda,27,8,7,41,0,0,83,29,8,6,115,0,0,158,241
20043,Rwanda,2004,2004Rwanda,38,44,44,176,0,0,302,32,41,27,199,0,0,299,601
20044,Rwanda,2004,2004Rwanda,44,46,39,137,40,0,306,85,122,104,240,0,0,551,857
20045,Rwanda,2004,2004Rwanda,53,73,62,215,5,0,408,43,68,58,258,5,0,432,840
20046,Rwanda,2004,2004Rwanda,106,222,198,277,0,0,803,98,136,121,383,0,0,738,1541
20047,Rwanda,2004,2004Rwanda,164,89,79,447,16,0,795,168,77,75,541,42,0,903,11816
20048,Rwanda,2004,2004Rwanda,313,314,281,1065,14,0,1987,422,520,431,1615,71,0,3059,5852
20049,Rwanda,2004,2004Rwanda,502,349,301,941,97,459,2649,508,330,284,1521,58,441,3142,5791
20050,Rwanda,2004,2004Rwanda,3438,1459,1246,2871,90,0,9104,3657,1604,1371,3063,103,0,9798,18902
20051,Rwanda,2005,2005Rwanda,0,0,0,0,0,0,0,0,0,0,0,0,0,0,17462
20052,Rwanda,2005,2005Rwanda,0,0,0,0,0,0,0,0,0,0,5,0,0,5,10
20053,Rwanda,2005,2005Rwanda,0,0,0,0,0,0,0,0,0,0,7,0,0,7,7
20054,Rwanda,2005,2005Rwanda,0,0,0,0,0,0,0,0,0,0,9,0,0,9,315
20055,Rwanda,2005,2005Rwanda,0,0,0,0,0,0,0,0,0,0,10,0,0,10,10
20056,Rwanda,2005,2005Rwanda,0,0,0,0,0,201,201,0,0,0,0,0,212,212,413
20057,Rwanda,2005,2005Rwanda,0,0,0,0,0,1014,1014,0,0,0,0,0,760,760,1774
20058,Rwanda,2005,2005Rwanda,0,0,0,5,0,0,5,0,0,0,0,0,0,0,5
20059,Rwanda,2005,2005Rwanda,0,0,0,5,0,0,5,0,0,0,11,0,0,11,16
20060,Rwanda,2005,2005Rwanda,0,0,0,8,0,0,8,0,5,0,9,0,0,14,22
20061,Rwanda,2005,2005Rwanda,0,0,0,16,0,0,16,0,5,0,17,0,0,22,38
20062,Rwanda,2005,2005Rwanda,0,0,5,0,0,0,5,0,0,0,0,0,0,0,5
20063,Rwanda,2005,2005Rwanda,0,0,6,15,0,102,123,0,0,5,22,0,93,120,243
20064,Rwanda,2005,2005Rwanda,0,0,6,21,0,0,27,5,5,5,20,0,0,35,62
20065,Rwanda,2005,2005Rwanda,0,5,0,0,0,0,5,0,0,0,0,0,0,0,5
20066,Rwanda,2005,2005Rwanda,0,5,0,0,0,0,5,0,0,0,7,0,0,7,12
20067,Rwanda,2005,2005Rwanda,0,6,5,80,0,0,91,0,6,7,200,0,0,213,304
20068,Rwanda,2005,2005Rwanda,0,7,7,13,0,0,27,5,7,5,31,0,0,48,80
20069,Rwanda,2005,2005Rwanda,0,10,10,100,0,0,120,0,14,13,100,0,0,127,247
20070,Rwanda,2005,2005Rwanda,6,0,0,26,0,0,32,0,6,10,100,0,0,116,148
20071,Rwanda,2005,2005Rwanda,6,13,12,15,0,0,46,5,12,12,22,0,0,51,97
20072,Rwanda,2005,2005Rwanda,7,7,0,22,0,0,36,7,5,5,32,0,0,49,85
20073,Rwanda,2005,2005Rwanda,8,0,0,9,0,0,17,0,5,6,8,0,0,19,36
20074,Rwanda,2005,2005Rwanda,8,6,6,25,0,0,45,5,8,12,28,0,0,53,98
20075,Rwanda,2005,2005Rwanda,27,27,23,50,0,0,127,29,12,11,90,0,0,142,269
20076,Rwanda,2005,2005Rwanda,40,43,44,175,0,0,302,32,37,32,196,0,0,297,599
20077,Rwanda,2005,2005Rwanda,47,221,197,924,0,0,1389,53,173,152,594,0,0,972,2361
20078,Rwanda,2005,2005Rwanda,49,69,60,207,5,0,390,45,66,56,247,5,0,419,809
20079,Rwanda,2005,2005Rwanda,156,82,78,431,16,0,763,166,76,70,509,42,0,863,42360
20080,Rwanda,2005,2005Rwanda,270,429,361,1572,19,0,2651,314,575,486,2391,61,0,3827,6478
20081,Rwanda,2005,2005Rwanda,497,349,299,935,65,0,2145,432,328,283,1524,57,0,2624,5669
20082,Rwanda,2005,2005Rwanda,2258,1270,1088,3036,87,2199,9938,2104,1298,1113,3433,128,2199,10275,20213
20083,Rwanda,2006,2006Rwanda,0,0,0,0,0,0,0,0,0,0,0,0,0,0,11439
20084,Rwanda,2006,2006Rwanda,0,0,0,0,0,0,0,0,0,0,7,0,0,7,7
20085,Rwanda,2006,2006Rwanda,0,0,0,0,0,0,0,0,0,0,8,0,0,8,8
20086,Rwanda,2006,2006Rwanda,0,0,0,0,0,0,0,0,0,5,0,0,0,5,5
20087,Rwanda,2006,2006Rwanda,0,0,0,0,0,0,0,5,0,0,0,0,0,5,5
20088,Rwanda,2006,2006Rwanda,0,0,0,0,0,5,5,0,0,0,0,0,12,12,17
20089,Rwanda,2006,2006Rwanda,0,0,0,0,0,134,134,0,0,0,0,0,133,133,267
20090,Rwanda,2006,2006Rwanda,0,0,0,0,0,255,255,0,0,0,0,0,310,310,580
20091,Rwanda,2006,2006Rwanda,0,0,0,0,0,959,959,0,0,0,0,0,874,874,1833
20092,Rwanda,2006,2006Rwanda,0,0,0,0,0,1087,1087,0,0,0,0,0,821,821,1908
20093,Rwanda,2006,2006Rwanda,0,0,0,5,0,0,5,0,0,0,7,0,0,7,12
20094,Rwanda,2006,2006Rwanda,0,0,0,6,0,0,6,0,0,0,0,0,0,0,6
20095,Rwanda,2006,2006Rwanda,0,0,0,7,0,0,7,0,0,0,10,0,0,10,17
20096,Rwanda,2006,2006Rwanda,0,0,5,0,0,0,5,0,0,0,0,0,0,0,5
20097,Rwanda,2006,2006Rwanda,0,0,5,15,0,0,20,0,0,0,15,0,0,15,35
20098,Rwanda,2006,2006Rwanda,0,0,6,5,0,0,11,0,0,5,8,0,0,13,24
20099,Rwanda,2006,2006Rwanda,0,0,6,11,0,0,17,0,5,11,58,0,0,74,91
20100,Rwanda,2006,2006Rwanda,0,0,8,0,0,0,8,0,0,0,0,0,0,0,8
20101,Rwanda,2006,2006Rwanda,0,0,9,79,0,0,88,5,0,8,199,0,0,212,300
20102,Rwanda,2006,2006Rwanda,0,5,0,0,0,0,5,0,0,0,7,0,0,7,12
20103,Rwanda,2006,2006Rwanda,0,6,0,18,0,0,24,5,9,0,20,0,0,34,58
20104,Rwanda,2006,2006Rwanda,5,8,15,109,5,0,142,0,11,16,95,5,0,127,269
20105,Rwanda,2006,2006Rwanda,6,0,8,22,0,0,36,8,9,0,32,0,0,49,85
20106,Rwanda,2006,2006Rwanda,6,28,0,16,0,0,50,0,0,21,24,0,0,45,95
20107,Rwanda,2006,2006Rwanda,7,7,6,25,0,0,45,5,11,9,27,0,0,52,97
20108,Rwanda,2006,2006Rwanda,8,8,16,29,5,0,66,5,14,5,54,0,0,78,144
20109,Rwanda,2006,2006Rwanda,20,24,16,62,5,0,127,21,24,28,40,5,0,118,551
20110,Rwanda,2006,2006Rwanda,27,30,20,50,0,0,127,29,14,9,97,0,0,149,276
20111,Rwanda,2006,2006Rwanda,33,62,33,123,5,0,256,29,62,34,149,5,0,279,535
20112,Rwanda,2006,2006Rwanda,39,88,74,456,10,0,667,42,76,61,445,12,0,636,1303
20113,Rwanda,2006,2006Rwanda,48,193,219,922,0,0,1382,51,165,149,588,0,0,953,2335
20114,Rwanda,2006,2006Rwanda,52,48,82,205,5,0,392,47,53,70,252,5,0,427,819
20115,Rwanda,2006,2006Rwanda,157,179,0,387,6,0,729,159,164,0,427,11,0,761,37313
20116,Rwanda,2006,2006Rwanda,205,154,212,666,64,0,1301,135,185,270,1215,61,0,1866,4067
20117,Rwanda,2006,2006Rwanda,207,334,475,1671,10,0,2697,219,446,617,2527,58,0,3867,6564
20118,Rwanda,2006,2006Rwanda,1957,1938,951,3467,116,0,8429,1873,1922,994,3623,159,0,8571,21866
20119,Rwanda,2007,2007Rwanda,0,0,0,0,0,0,0,0,0,0,0,0,0,0,39581
20120,Rwanda,2007,2007Rwanda,0,0,0,0,0,0,0,0,0,0,0,0,7,7,7
20121,Rwanda,2007,2007Rwanda,0,0,0,0,0,0,0,0,0,5,0,0,0,5,5
20122,Rwanda,2007,2007Rwanda,0,0,0,0,0,0,0,5,0,0,0,0,0,5,5
20123,Rwanda,2007,2007Rwanda,0,0,0,0,0,691,691,0,0,0,0,0,659,659,1350
20124,Rwanda,2007,2007Rwanda,0,0,0,0,0,1147,1147,0,0,0,0,0,902,902,2049
20125,Rwanda,2007,2007Rwanda,0,0,0,5,0,0,5,0,0,0,5,0,0,5,20
20126,Rwanda,2007,2007Rwanda,0,0,0,5,0,0,5,0,0,0,8,0,0,8,13
20127,Rwanda,2007,2007Rwanda,0,0,0,5,0,0,5,0,5,0,7,0,0,12,17
20128,Rwanda,2007,2007Rwanda,0,0,0,7,0,0,7,0,0,0,9,0,0,9,16
20129,Rwanda,2007,2007Rwanda,0,0,5,0,0,0,5,0,0,0,0,0,0,0,5
20130,Rwanda,2007,2007Rwanda,0,0,5,13,0,0,18,0,0,6,12,0,0,18,36
20131,Rwanda,2007,2007Rwanda,0,0,6,12,0,105,123,0,5,0,19,0,99,123,246
20132,Rwanda,2007,2007Rwanda,0,0,7,0,0,0,7,0,0,0,0,0,0,0,7
20133,Rwanda,2007,2007Rwanda,0,0,7,13,0,0,20,5,6,6,21,0,0,38,58
20134,Rwanda,2007,2007Rwanda,0,0,9,79,0,0,88,5,0,8,199,0,0,212,300
20135,Rwanda,2007,2007Rwanda,0,5,0,0,0,0,5,0,0,0,7,0,0,7,12
20136,Rwanda,2007,2007Rwanda,0,5,0,6,0,0,11,0,5,0,8,0,0,13,24
20137,Rwanda,2007,2007Rwanda,0,5,6,15,0,0,26,0,0,6,22,0,0,28,54
20138,Rwanda,2007,2007Rwanda,5,5,6,16,0,0,32,0,6,5,18,0,0,29,61
20139,Rwanda,2007,2007Rwanda,5,10,11,30,0,0,56,5,13,8,35,0,0,61,117
20140,Rwanda,2007,2007Rwanda,6,0,8,22,0,0,36,8,9,0,31,0,0,48,84
20141,Rwanda,2007,2007Rwanda,7,11,11,31,5,0,65,8,12,5,55,0,0,80,145
20142,Rwanda,2007,2007Rwanda,7,15,13,14,0,0,49,0,8,13,23,0,0,44,93
20143,Rwanda,2007,2007Rwanda,27,28,20,47,0,0,122,27,13,21,59,0,0,120,242
20144,Rwanda,2007,2007Rwanda,28,12,25,67,5,0,137,22,19,26,344,5,0,416,562
20145,Rwanda,2007,2007Rwanda,40,72,45,162,5,0,324,48,76,47,198,5,0,374,698
20146,Rwanda,2007,2007Rwanda,45,86,77,466,12,0,686,48,87,52,475,14,0,676,1362
20147,Rwanda,2007,2007Rwanda,46,66,31,139,0,0,282,52,65,44,192,0,0,353,635
20148,Rwanda,2007,2007Rwanda,51,205,227,971,0,0,1454,51,183,169,641,0,0,1044,2498
20149,Rwanda,2007,2007Rwanda,52,48,82,205,5,0,392,51,53,70,250,5,0,429,821
20150,Rwanda,2007,2007Rwanda,269,191,263,643,58,0,1424,192,190,288,992,59,0,1721,4045
20151,Rwanda,2007,2007Rwanda,275,487,697,1855,10,0,3324,290,612,784,2866,65,0,4617,7941
20152,Rwanda,2007,2007Rwanda,2268,2022,949,3482,118,0,8839,2104,1999,1014,3726,164,0,9007,17846
20153,Rwanda,2008,2008Rwanda,0,0,0,0,0,0,0,0,0,0,0,0,0,0,30566
20154,Rwanda,2008,2008Rwanda,0,0,0,0,0,0,0,0,0,0,5,0,0,5,15
20155,Rwanda,2008,2008Rwanda,0,0,0,0,0,0,0,0,0,0,6,0,0,6,6
20156,Rwanda,2008,2008Rwanda,0,0,0,0,0,0,0,0,0,0,7,0,0,7,7
20157,Rwanda,2008,2008Rwanda,0,0,0,0,0,0,0,0,5,0,0,0,0,5,5
20158,Rwanda,2008,2008Rwanda,0,0,0,0,0,0,0,0,9,0,0,0,0,9,9
20159,Rwanda,2008,2008Rwanda,0,0,0,0,0,574,574,0,0,0,0,0,534,534,1108
20160,Rwanda,2008,2008Rwanda,0,0,0,0,0,1219,1219,0,0,0,0,0,965,965,2184
20161,Rwanda,2008,2008Rwanda,0,0,0,5,0,0,5,0,0,0,6,0,0,6,11
20162,Rwanda,2008,2008Rwanda,0,0,0,5,0,0,5,0,5,0,6,0,0,11,16
20163,Rwanda,2008,2008Rwanda,0,0,0,6,0,0,6,0,0,0,10,0,0,10,16
20164,Rwanda,2008,2008Rwanda,0,0,0,7,0,0,7,0,0,0,0,0,0,0,7
20165,Rwanda,2008,2008Rwanda,0,0,5,13,0,0,18,0,0,6,12,0,0,18,36
20166,Rwanda,2008,2008Rwanda,0,0,5,15,0,100,120,0,5,5,13,0,94,117,237
20167,Rwanda,2008,2008Rwanda,0,0,9,79,0,0,88,5,0,8,199,0,0,212,300
20168,Rwanda,2008,2008Rwanda,0,5,0,0,0,0,5,0,0,0,0,0,0,0,5
20169,Rwanda,2008,2008Rwanda,0,5,0,6,0,0,11,0,5,0,8,0,0,13,24
20170,Rwanda,2008,2008Rwanda,0,5,8,17,0,0,30,0,0,7,25,0,0,32,62
20171,Rwanda,2008,2008Rwanda,0,6,0,15,0,0,21,0,12,6,23,0,0,41,62
20172,Rwanda,2008,2008Rwanda,5,5,5,23,0,0,38,7,7,0,28,0,0,42,80
20173,Rwanda,2008,2008Rwanda,5,7,5,22,0,0,39,0,9,6,24,0,0,39,78
20174,Rwanda,2008,2008Rwanda,6,5,11,26,0,0,48,11,6,14,29,0,0,60,108
20175,Rwanda,2008,2008Rwanda,7,15,13,12,0,0,47,5,7,12,19,0,0,43,90
20176,Rwanda,2008,2008Rwanda,13,10,13,36,0,0,72,10,12,5,55,0,0,82,154
20177,Rwanda,2008,2008Rwanda,27,27,21,47,0,0,122,27,13,41,88,0,0,169,291
20178,Rwanda,2008,2008Rwanda,34,56,38,133,0,0,261,53,61,41,176,0,0,331,592
20179,Rwanda,2008,2008Rwanda,35,16,23,90,0,0,164,31,33,26,56,0,0,146,310
20180,Rwanda,2008,2008Rwanda,39,85,77,466,12,0,679,60,87,51,478,14,0,690,1369
20181,Rwanda,2008,2008Rwanda,46,68,48,167,5,0,334,48,78,44,211,5,0,386,720
20182,Rwanda,2008,2008Rwanda,55,48,79,204,0,0,386,49,54,66,246,5,0,420,806
20183,Rwanda,2008,2008Rwanda,71,175,263,759,12,0,1280,75,187,227,727,28,0,1244,2524
20184,Rwanda,2008,2008Rwanda,100,184,144,380,5,0,813,160,222,152,422,5,0,961,1774
20185,Rwanda,2008,2008Rwanda,149,496,718,1921,20,0,3304,154,636,813,2917,73,0,4593,7897
20186,Rwanda,2008,2008Rwanda,384,304,259,774,33,0,1754,338,298,247,1317,44,0,2244,4898
20187,Rwanda,2008,2008Rwanda,1788,2099,945,3150,118,0,8100,1726,1996,967,3224,149,0,8062,16162
20188,Rwanda,2009,2009Rwanda,0,0,0,0,0,0,0,0,0,0,0,0,0,0,9094
20189,Rwanda,2009,2009Rwanda,0,0,0,0,0,0,0,0,0,0,5,0,0,5,15
20190,Rwanda,2009,2009Rwanda,0,0,0,0,0,0,0,0,0,0,6,0,0,6,6
20191,Rwanda,2009,2009Rwanda,0,0,0,0,0,0,0,0,0,5,0,0,0,5,5
20192,Rwanda,2009,2009Rwanda,0,0,0,0,0,214,214,0,0,0,0,0,208,208,422
20193,Rwanda,2009,2009Rwanda,0,0,0,0,0,549,549,0,0,0,0,0,497,497,1046
20194,Rwanda,2009,2009Rwanda,0,0,0,5,0,0,5,0,0,0,8,0,0,8,13
20195,Rwanda,2009,2009Rwanda,0,0,0,5,0,0,5,0,5,0,8,0,0,13,18
20196,Rwanda,2009,2009Rwanda,0,0,0,6,0,0,6,0,0,0,0,0,0,0,6
20197,Rwanda,2009,2009Rwanda,0,0,0,7,0,0,7,0,0,0,11,0,0,11,18
20198,Rwanda,2009,2009Rwanda,0,0,5,13,0,0,18,0,0,6,11,0,0,17,35
20199,Rwanda,2009,2009Rwanda,0,0,5,14,0,95,114,0,5,5,12,0,89,111,225
20200,Rwanda,2009,2009Rwanda,0,5,0,0,0,0,5,0,0,0,0,0,0,0,5
20201,Rwanda,2009,2009Rwanda,0,5,0,0,0,0,5,0,0,0,5,0,0,5,10
20202,Rwanda,2009,2009Rwanda,0,5,0,0,0,0,5,5,0,0,8,0,0,13,18
20203,Rwanda,2009,2009Rwanda,0,5,5,81,0,0,91,5,0,10,199,0,0,214,305
20204,Rwanda,2009,2009Rwanda,0,5,11,21,0,0,37,0,5,5,33,0,0,43,80
20205,Rwanda,2009,2009Rwanda,0,6,0,15,0,0,21,0,14,0,27,0,0,41,62
20206,Rwanda,2009,2009Rwanda,0,7,0,6,0,0,13,0,5,0,8,0,0,13,26
20207,Rwanda,2009,2009Rwanda,5,5,6,23,0,0,39,6,8,5,33,0,0,52,91
20208,Rwanda,2009,2009Rwanda,5,6,6,20,0,0,37,0,7,6,23,0,0,36,73
20209,Rwanda,2009,2009Rwanda,6,5,11,26,0,0,48,5,14,6,35,0,0,60,108
20210,Rwanda,2009,2009Rwanda,6,7,14,79,0,0,106,5,10,18,85,0,0,118,224
20211,Rwanda,2009,2009Rwanda,6,8,7,11,0,0,32,0,5,5,19,0,0,29,61
20212,Rwanda,2009,2009Rwanda,6,14,20,61,5,0,106,10,12,26,85,0,0,133,239
20213,Rwanda,2009,2009Rwanda,9,15,12,9,0,0,45,5,7,10,13,0,0,35,80
20214,Rwanda,2009,2009Rwanda,14,16,5,34,0,0,69,8,10,5,53,0,0,76,145
20215,Rwanda,2009,2009Rwanda,27,27,26,57,0,0,137,27,13,41,111,0,0,192,329
20216,Rwanda,2009,2009Rwanda,34,19,24,96,0,0,173,36,39,23,56,0,0,154,327
20217,Rwanda,2009,2009Rwanda,35,74,46,174,6,0,335,32,85,53,219,6,0,395,730
20218,Rwanda,2009,2009Rwanda,41,90,81,478,18,0,708,70,89,53,497,21,0,730,1438
20219,Rwanda,2009,2009Rwanda,54,67,30,144,0,0,295,58,72,43,184,0,0,357,652
20220,Rwanda,2009,2009Rwanda,57,157,231,813,16,0,1274,52,170,225,702,45,0,1194,2468
20221,Rwanda,2009,2009Rwanda,59,207,73,438,26,0,803,55,209,55,513,29,0,861,80525
20222,Rwanda,2009,2009Rwanda,136,288,160,480,11,0,1075,180,260,179,520,12,0,1151,2226
20223,Rwanda,2009,2009Rwanda,206,479,636,1627,24,0,2972,223,658,593,2610,65,0,4149,7121
20224,Rwanda,2009,2009Rwanda,393,427,159,827,39,0,1845,358,374,210,1415,43,0,2400,5145
20225,Rwanda,2009,2009Rwanda,1617,2005,1015,3087,121,0,7845,1549,1905,1057,3184,177,0,7872,15717
20226,Rwanda,2010,2010Rwanda,0,0,0,0,0,0,0,0,0,0,0,0,0,0,8565
20227,Rwanda,2010,2010Rwanda,0,0,0,0,0,0,0,0,0,0,0,0,6,6,6
20228,Rwanda,2010,2010Rwanda,0,0,0,0,0,0,0,0,0,0,5,0,0,5,10
20229,Rwanda,2010,2010Rwanda,0,0,0,0,0,0,0,0,0,0,6,0,0,6,12
20230,Rwanda,2010,2010Rwanda,0,0,0,0,0,227,227,0,0,0,0,0,217,217,444
20231,Rwanda,2010,2010Rwanda,0,0,0,0,0,514,514,0,0,0,0,0,467,467,981
20232,Rwanda,2010,2010Rwanda,0,0,0,0,0,1368,1368,0,0,0,0,0,1128,1128,2496
20233,Rwanda,2010,2010Rwanda,0,0,0,5,0,0,5,0,0,0,13,0,0,13,18
20234,Rwanda,2010,2010Rwanda,0,0,0,7,0,0,7,0,0,0,10,0,0,10,17
20235,Rwanda,2010,2010Rwanda,0,0,5,0,0,0,5,0,0,0,9,0,0,9,14
20236,Rwanda,2010,2010Rwanda,0,0,5,0,0,0,5,0,0,9,0,0,0,9,14
20237,Rwanda,2010,2010Rwanda,0,0,5,10,0,84,99,0,5,5,11,0,84,105,204
20238,Rwanda,2010,2010Rwanda,0,0,5,13,0,0,18,0,0,6,12,0,0,18,36
20239,Rwanda,2010,2010Rwanda,0,0,7,76,0,0,83,5,0,5,193,0,0,203,286
20240,Rwanda,2010,2010Rwanda,0,5,0,0,0,0,5,0,0,0,7,0,0,7,12
20241,Rwanda,2010,2010Rwanda,0,5,0,5,0,0,10,5,6,0,12,0,0,23,33
20242,Rwanda,2010,2010Rwanda,0,5,13,21,0,0,39,0,7,5,33,0,0,45,84
20243,Rwanda,2010,2010Rwanda,0,6,0,5,0,0,11,0,5,0,6,0,0,11,22
20244,Rwanda,2010,2010Rwanda,0,6,0,15,0,0,21,0,13,0,21,5,0,39,60
20245,Rwanda,2010,2010Rwanda,0,7,0,0,0,0,7,0,0,0,0,0,0,0,7
20246,Rwanda,2010,2010Rwanda,0,9,7,23,0,0,39,0,5,5,19,0,0,29,79
20247,Rwanda,2010,2010Rwanda,5,5,6,25,0,0,41,6,8,5,36,0,0,55,96
20248,Rwanda,2010,2010Rwanda,5,7,10,76,0,0,98,5,10,10,95,0,0,120,218
20249,Rwanda,2010,2010Rwanda,6,14,20,64,5,0,109,10,12,26,88,0,0,136,245
20250,Rwanda,2010,2010Rwanda,10,15,12,8,0,0,45,5,7,9,11,0,0,32,77
20251,Rwanda,2010,2010Rwanda,14,14,5,33,0,0,66,9,10,5,51,0,0,75,141
20252,Rwanda,2010,2010Rwanda,27,27,27,57,0,0,138,27,13,42,111,0,0,193,331
20253,Rwanda,2010,2010Rwanda,38,28,23,105,5,0,199,33,42,26,66,0,0,167,366
20254,Rwanda,2010,2010Rwanda,49,74,57,195,6,0,381,38,86,66,238,11,0,439,820
20255,Rwanda,2010,2010Rwanda,51,73,43,158,0,0,325,46,82,40,195,0,0,363,688
20256,Rwanda,2010,2010Rwanda,51,86,82,506,24,0,749,83,92,65,522,24,0,786,1535
20257,Rwanda,2010,2010Rwanda,51,90,117,514,12,0,784,47,122,111,581,20,0,881,1665
20258,Rwanda,2010,2010Rwanda,412,566,269,879,50,0,2176,419,521,250,1408,63,0,2661,5736
20259,Rwanda,2010,2010Rwanda,498,1013,325,1341,44,0,3221,468,1035,352,2664,35,0,4554,7775
20260,Rwanda,2010,2010Rwanda,1294,1613,856,2428,105,0,6296,1231,1527,905,2467,164,0,6294,12590
20261,Rwanda,2010,2010Rwanda,5220,5825,9073,11799,667,0,32584,5937,6691,12194,11689,741,0,37252,69836
20262,Rwanda,2011,2011Rwanda,0,0,0,0,0,0,0,0,0,0,0,0,0,0,4702
20263,Rwanda,2011,2011Rwanda,0,0,0,0,0,0,0,0,0,0,5,0,0,5,15
20264,Rwanda,2011,2011Rwanda,0,0,0,0,0,0,0,0,0,5,0,0,0,5,5
20265,Rwanda,2011,2011Rwanda,0,0,0,0,0,538,538,0,0,0,0,0,488,488,1026
20266,Rwanda,2011,2011Rwanda,0,0,0,0,0,1403,1403,0,0,0,0,0,1195,1195,2598
20267,Rwanda,2011,2011Rwanda,0,0,0,5,0,0,5,0,0,0,10,0,0,10,30
20268,Rwanda,2011,2011Rwanda,0,0,0,5,0,0,5,0,0,0,13,0,0,13,18
20269,Rwanda,2011,2011Rwanda,0,0,5,0,0,0,5,0,0,0,0,0,0,0,5
20270,Rwanda,2011,2011Rwanda,0,0,5,0,0,0,5,0,5,0,5,0,0,10,15
20271,Rwanda,2011,2011Rwanda,0,0,5,5,0,73,83,0,0,7,11,0,77,95,178
20272,Rwanda,2011,2011Rwanda,0,0,5,13,0,0,18,0,0,6,12,0,0,18,36
20273,Rwanda,2011,2011Rwanda,0,0,7,76,0,0,83,5,0,5,183,0,0,193,276
20274,Rwanda,2011,2011Rwanda,0,0,8,0,0,0,8,0,0,0,0,0,0,0,8
20275,Rwanda,2011,2011Rwanda,0,5,0,13,0,0,18,0,0,8,26,0,0,34,52
20276,Rwanda,2011,2011Rwanda,0,5,13,31,0,0,49,5,11,10,27,0,0,53,102
20277,Rwanda,2011,2011Rwanda,0,6,0,0,0,0,6,0,0,0,7,0,0,7,13
20278,Rwanda,2011,2011Rwanda,0,6,0,5,0,0,11,0,5,0,10,0,0,15,26
20279,Rwanda,2011,2011Rwanda,0,6,0,5,0,0,11,5,6,0,11,0,0,22,33
20280,Rwanda,2011,2011Rwanda,0,9,7,26,0,0,42,0,5,5,20,0,0,30,72
20281,Rwanda,2011,2011Rwanda,5,5,6,16,0,0,32,7,8,6,17,0,0,38,70
20282,Rwanda,2011,2011Rwanda,5,8,9,79,0,0,101,0,12,13,91,0,0,116,217
20283,Rwanda,2011,2011Rwanda,6,14,20,64,5,0,109,10,12,26,89,0,0,137,246
20284,Rwanda,2011,2011Rwanda,8,6,8,16,0,0,38,0,6,6,18,0,0,30,68
20285,Rwanda,2011,2011Rwanda,8,30,15,170,12,0,235,14,22,14,148,5,0,203,1537
20286,Rwanda,2011,2011Rwanda,9,15,13,5,0,0,42,5,7,9,16,0,0,37,79
20287,Rwanda,2011,2011Rwanda,14,14,5,35,0,0,68,9,8,5,48,0,0,70,138
20288,Rwanda,2011,2011Rwanda,27,33,15,43,0,0,118,20,35,11,73,0,0,139,257
20289,Rwanda,2011,2011Rwanda,33,33,33,117,5,0,221,28,41,34,71,5,0,179,400
20290,Rwanda,2011,2011Rwanda,40,76,61,198,12,0,387,27,76,78,245,14,0,440,827
20291,Rwanda,2011,2011Rwanda,42,99,107,480,19,0,747,50,111,101,468,28,0,758,1505
20292,Rwanda,2011,2011Rwanda,54,65,56,222,10,0,407,67,89,46,249,6,0,457,864
20293,Rwanda,2011,2011Rwanda,57,71,60,151,0,0,339,47,85,58,184,0,0,374,713
20294,Rwanda,2011,2011Rwanda,132,264,203,505,18,0,1122,153,259,196,535,24,0,1167,2289
20295,Rwanda,2011,2011Rwanda,396,599,441,639,25,0,2100,405,545,963,624,22,0,2559,5559
20296,Rwanda,2011,2011Rwanda,496,1039,534,1468,51,0,3588,479,1048,549,2676,34,0,4786,8374
20297,Rwanda,2011,2011Rwanda,1210,1603,1137,2442,123,0,6515,1171,1546,1117,2465,184,0,6483,12998
20298,Rwanda,2011,2011Rwanda,4346,4556,8320,10569,537,0,28328,5059,6611,11154,9668,661,0,33153,61481
20299,Rwanda,2012,2012Rwanda,0,0,0,0,0,0,0,0,0,0,0,0,0,0,3991
20300,Rwanda,2012,2012Rwanda,0,0,0,0,0,0,0,0,0,0,0,0,5,5,5
20301,Rwanda,2012,2012Rwanda,0,0,0,0,0,0,0,0,0,0,5,0,0,5,15
20302,Rwanda,2012,2012Rwanda,0,0,0,0,0,0,0,0,0,5,0,0,0,5,5
20303,Rwanda,2012,2012Rwanda,0,0,0,0,0,0,0,0,0,9,0,0,0,9,9
20304,Rwanda,2012,2012Rwanda,0,0,0,0,0,0,0,5,0,0,0,0,0,5,5
20305,Rwanda,2012,2012Rwanda,0,0,0,0,0,506,506,0,0,0,0,0,460,460,966
20306,Rwanda,2012,2012Rwanda,0,0,0,0,0,1470,1470,0,0,0,0,0,1253,1253,2723
20307,Rwanda,2012,2012Rwanda,0,0,0,5,0,0,5,0,0,0,13,0,0,13,18
20308,Rwanda,2012,2012Rwanda,0,0,0,5,0,0,5,0,0,5,5,0,0,10,15
20309,Rwanda,2012,2012Rwanda,0,0,0,5,0,0,5,0,0,12,0,0,0,12,17
20310,Rwanda,2012,2012Rwanda,0,0,0,10,0,0,10,0,0,0,5,0,0,5,15
20311,Rwanda,2012,2012Rwanda,0,0,0,19,0,0,19,0,0,0,17,0,0,17,36
20312,Rwanda,2012,2012Rwanda,0,0,5,5,0,72,82,0,0,7,11,0,76,94,176
20313,Rwanda,2012,2012Rwanda,0,0,7,75,0,0,82,5,0,5,182,0,0,192,274
20314,Rwanda,2012,2012Rwanda,0,0,8,0,0,0,8,0,0,0,0,0,0,0,8
20315,Rwanda,2012,2012Rwanda,0,0,8,20,0,0,28,0,5,11,35,5,0,56,84
20316,Rwanda,2012,2012Rwanda,0,5,0,0,0,0,5,0,0,0,7,0,0,7,12
20317,Rwanda,2012,2012Rwanda,0,5,0,13,0,0,18,0,0,8,26,0,0,34,52
20318,Rwanda,2012,2012Rwanda,0,5,0,48,5,0,58,6,9,0,25,0,0,40,1654
20319,Rwanda,2012,2012Rwanda,0,6,0,5,0,0,11,0,5,0,11,0,0,16,27
20320,Rwanda,2012,2012Rwanda,0,6,13,33,0,0,52,5,7,11,34,0,0,57,109
20321,Rwanda,2012,2012Rwanda,0,7,5,27,0,0,39,0,0,8,20,0,0,28,67
20322,Rwanda,2012,2012Rwanda,0,8,0,0,0,0,8,0,9,0,9,0,0,18,26
20323,Rwanda,2012,2012Rwanda,5,5,5,25,0,0,40,6,5,5,31,0,0,47,87
20324,Rwanda,2012,2012Rwanda,5,8,8,83,0,0,104,0,12,14,87,0,0,113,217
20325,Rwanda,2012,2012Rwanda,6,10,6,14,0,0,36,0,5,8,18,0,0,31,67
20326,Rwanda,2012,2012Rwanda,6,14,20,59,5,0,104,10,12,26,72,0,0,120,224
20327,Rwanda,2012,2012Rwanda,7,0,0,10,0,0,17,5,0,0,8,0,0,13,30
20328,Rwanda,2012,2012Rwanda,9,15,13,5,0,0,42,5,7,9,15,0,0,36,78
20329,Rwanda,2012,2012Rwanda,25,31,13,38,0,0,107,20,27,9,68,0,0,124,231
20330,Rwanda,2012,2012Rwanda,29,44,26,130,10,0,239,25,54,30,75,5,0,189,428
20331,Rwanda,2012,2012Rwanda,36,73,58,194,5,0,366,22,65,73,234,17,0,411,777
20332,Rwanda,2012,2012Rwanda,39,99,112,395,27,0,672,48,97,98,399,29,0,671,1343
20333,Rwanda,2012,2012Rwanda,53,55,64,217,10,0,399,58,81,50,236,6,0,431,830
20334,Rwanda,2012,2012Rwanda,59,67,52,158,0,0,336,48,84,44,192,0,0,368,723
20335,Rwanda,2012,2012Rwanda,126,242,223,503,20,0,1114,116,264,192,512,28,0,1112,2226
20336,Rwanda,2012,2012Rwanda,289,596,340,962,58,0,2245,300,600,285,1473,86,0,2744,5963
20337,Rwanda,2012,2012Rwanda,429,989,650,1446,55,0,3569,430,1030,626,2709,40,0,4835,8404
20338,Rwanda,2012,2012Rwanda,1115,2074,1678,2357,121,0,7345,1120,2038,1654,2350,177,0,7339,14684
20339,Rwanda,2012,2012Rwanda,3391,7510,4643,11264,444,0,27252,4050,5790,4516,8856,272,0,23484,50736
20340,Rwanda,2013,2013Rwanda,0,0,0,0,0,0,0,0,0,0,0,0,0,0,3903
20341,Rwanda,2013,2013Rwanda,0,0,0,0,0,0,0,0,0,0,5,0,0,5,10
20342,Rwanda,2013,2013Rwanda,0,0,0,0,0,0,0,0,0,5,0,0,0,5,5
20343,Rwanda,2013,2013Rwanda,0,0,0,0,0,0,0,0,0,8,0,0,0,8,8
20344,Rwanda,2013,2013Rwanda,0,0,0,0,0,403,403,0,0,0,0,0,395,395,798
20345,Rwanda,2013,2013Rwanda,0,0,0,0,0,1534,1534,0,0,0,0,0,1306,1306,2840
20346,Rwanda,2013,2013Rwanda,0,0,0,5,0,0,5,0,0,0,13,0,0,13,18
20347,Rwanda,2013,2013Rwanda,0,0,0,14,0,0,14,0,0,0,0,0,0,0,14
20348,Rwanda,2013,2013Rwanda,0,0,5,0,0,0,5,0,0,0,0,0,0,0,10
20349,Rwanda,2013,2013Rwanda,0,0,5,6,0,69,80,0,0,6,12,0,70,88,168
20350,Rwanda,2013,2013Rwanda,0,0,5,13,0,0,18,0,7,8,16,0,0,31,49
20351,Rwanda,2013,2013Rwanda,0,0,6,5,0,0,11,0,0,5,10,0,0,15,26
20352,Rwanda,2013,2013Rwanda,0,0,7,21,0,0,28,0,5,5,39,5,0,54,82
20353,Rwanda,2013,2013Rwanda,0,0,7,27,0,0,34,0,0,5,31,0,0,36,70
20354,Rwanda,2013,2013Rwanda,0,0,7,75,0,0,82,5,0,5,182,0,0,192,274
20355,Rwanda,2013,2013Rwanda,0,0,8,0,0,0,8,0,0,0,0,0,0,0,8
20356,Rwanda,2013,2013Rwanda,0,5,0,0,0,0,5,0,0,0,5,0,0,5,10
20357,Rwanda,2013,2013Rwanda,0,5,0,0,0,0,5,0,0,0,6,0,0,6,11
20358,Rwanda,2013,2013Rwanda,0,5,5,0,0,0,10,5,0,0,13,0,0,18,28
20359,Rwanda,2013,2013Rwanda,0,5,8,77,0,0,90,5,5,7,63,0,0,80,170
20360,Rwanda,2013,2013Rwanda,0,7,0,0,0,0,7,0,0,5,7,0,0,12,19
20361,Rwanda,2013,2013Rwanda,0,8,5,31,0,0,44,0,0,8,22,0,0,30,74
20362,Rwanda,2013,2013Rwanda,0,9,5,25,0,0,39,0,7,7,25,0,0,39,1655
20363,Rwanda,2013,2013Rwanda,5,5,10,34,0,0,54,6,8,15,37,0,0,66,120
20364,Rwanda,2013,2013Rwanda,6,9,6,14,0,0,35,0,5,6,16,0,0,27,62
20365,Rwanda,2013,2013Rwanda,6,14,20,59,5,0,104,10,12,26,72,0,0,120,224
20366,Rwanda,2013,2013Rwanda,7,0,0,10,0,0,17,5,0,0,8,0,0,13,30
20367,Rwanda,2013,2013Rwanda,8,17,11,5,0,0,41,5,7,8,13,0,0,33,74
20368,Rwanda,2013,2013Rwanda,29,74,61,197,10,0,371,14,64,76,242,18,0,414,785
20369,Rwanda,2013,2013Rwanda,30,45,17,86,5,0,183,22,35,34,72,0,0,163,346
20370,Rwanda,2013,2013Rwanda,36,61,62,285,12,0,456,37,65,58,293,22,0,475,931
20371,Rwanda,2013,2013Rwanda,51,81,57,167,0,0,356,42,90,47,206,0,0,385,822
20372,Rwanda,2013,2013Rwanda,53,56,61,214,9,0,393,46,95,58,223,8,0,430,823
20373,Rwanda,2013,2013Rwanda,100,209,219,453,18,0,999,97,217,169,423,30,0,936,1935
20374,Rwanda,2013,2013Rwanda,220,182,194,170,108,0,874,203,286,297,212,123,0,1121,1995
20375,Rwanda,2013,2013Rwanda,383,976,744,1464,61,0,3628,381,1021,722,2695,49,0,4868,8496
20376,Rwanda,2013,2013Rwanda,1241,2503,2127,797,38,0,6706,1265,2373,2096,886,50,0,6670,13376
20377,Rwanda,2013,2013Rwanda,2920,6448,3978,9737,376,0,23459,3457,4989,3849,7659,261,0,20215,43674
20378,Rwanda,2014,2014Rwanda,0,0,0,0,0,0,0,0,0,0,0,0,0,0,2910
20379,Rwanda,2014,2014Rwanda,0,0,0,0,0,0,0,0,0,0,5,0,0,5,15
20380,Rwanda,2014,2014Rwanda,0,0,0,0,0,0,0,0,0,0,7,0,0,7,7
20381,Rwanda,2014,2014Rwanda,0,0,0,0,0,0,0,0,0,6,0,0,0,6,6
20382,Rwanda,2014,2014Rwanda,0,0,0,0,0,0,0,0,0,9,0,0,0,9,9
20383,Rwanda,2014,2014Rwanda,0,0,0,0,0,9,9,0,0,0,0,0,11,11,20
20384,Rwanda,2014,2014Rwanda,0,0,0,0,0,807,807,0,0,0,0,0,1007,1007,1814
20385,Rwanda,2014,2014Rwanda,0,0,0,0,0,1512,1512,0,0,0,0,0,1321,1321,2833
20386,Rwanda,2014,2014Rwanda,0,0,0,7,0,0,7,0,0,0,0,0,0,0,7
20387,Rwanda,2014,2014Rwanda,0,0,0,7,0,70,77,0,0,5,11,0,70,86,163
20388,Rwanda,2014,2014Rwanda,0,0,0,11,0,0,11,0,9,5,6,0,0,20,31
20389,Rwanda,2014,2014Rwanda,0,0,0,18,0,0,18,0,0,0,0,0,0,0,18
20390,Rwanda,2014,2014Rwanda,0,0,5,0,0,0,5,0,0,0,0,0,0,0,5
20391,Rwanda,2014,2014Rwanda,0,0,5,0,0,0,5,0,0,0,6,0,0,6,11
20392,Rwanda,2014,2014Rwanda,0,0,6,5,0,0,11,0,0,5,10,0,0,15,26
20393,Rwanda,2014,2014Rwanda,0,0,7,26,0,0,33,6,0,0,24,0,0,30,1647
20394,Rwanda,2014,2014Rwanda,0,0,7,75,0,0,82,5,0,5,182,0,0,192,274
20395,Rwanda,2014,2014Rwanda,0,0,8,0,0,0,8,0,9,0,0,0,0,9,17
20396,Rwanda,2014,2014Rwanda,0,0,10,0,0,0,10,9,0,0,9,0,0,18,28
20397,Rwanda,2014,2014Rwanda,0,5,0,0,0,0,5,0,0,0,5,0,0,5,10
20398,Rwanda,2014,2014Rwanda,0,7,7,74,5,0,93,0,7,9,64,0,0,80,173
20399,Rwanda,2014,2014Rwanda,0,9,0,0,0,0,9,0,0,5,8,0,0,13,22
20400,Rwanda,2014,2014Rwanda,0,10,6,32,0,0,48,0,0,9,20,5,0,34,82
20401,Rwanda,2014,2014Rwanda,0,12,0,25,0,0,37,0,5,18,41,5,0,69,106
20402,Rwanda,2014,2014Rwanda,0,13,0,7,0,0,20,0,5,0,11,0,0,16,36
20403,Rwanda,2014,2014Rwanda,5,5,15,64,5,0,94,7,12,8,88,5,0,120,214
20404,Rwanda,2014,2014Rwanda,5,7,5,12,0,0,29,5,0,6,13,0,0,24,53
20405,Rwanda,2014,2014Rwanda,7,12,0,29,0,0,48,7,12,10,28,5,0,62,110
20406,Rwanda,2014,2014Rwanda,9,0,0,11,0,0,20,5,0,0,8,0,0,13,33
20407,Rwanda,2014,2014Rwanda,14,33,19,86,0,0,152,12,20,29,58,10,0,129,281
20408,Rwanda,2014,2014Rwanda,16,23,11,28,0,0,78,16,13,16,54,0,0,99,177
20409,Rwanda,2014,2014Rwanda,16,55,37,113,5,0,226,14,59,29,148,8,0,258,484
20410,Rwanda,2014,2014Rwanda,16,73,64,206,15,0,374,12,64,72,251,23,0,422,796
20411,Rwanda,2014,2014Rwanda,25,51,52,258,15,0,401,28,52,57,262,25,0,424,825
20412,Rwanda,2014,2014Rwanda,49,59,65,213,8,0,394,43,97,64,217,10,0,431,825
20413,Rwanda,2014,2014Rwanda,81,245,127,329,23,0,805,88,248,109,623,31,0,1099,1904
20414,Rwanda,2014,2014Rwanda,89,196,215,490,22,0,1012,81,216,171,464,36,0,968,1980
20415,Rwanda,2014,2014Rwanda,393,985,858,1570,68,0,3874,388,1001,869,2922,50,0,5230,9104
20416,Rwanda,2014,2014Rwanda,1180,1822,1310,2768,155,0,7235,1154,1764,1201,2740,218,0,7077,14312
20417,Rwanda,2014,2014Rwanda,3108,4607,2682,8682,450,0,19529,3228,4248,2869,7770,384,0,18499,38028
20418,Rwanda,2015,2015Rwanda,0,0,0,0,0,0,0,0,0,0,0,0,0,0,5357
20419,Rwanda,2015,2015Rwanda,0,0,0,0,0,0,0,0,0,0,0,0,5,5,5
20420,Rwanda,2015,2015Rwanda,0,0,0,0,0,0,0,0,0,0,5,0,0,5,10
20421,Rwanda,2015,2015Rwanda,0,0,0,0,0,0,0,0,0,0,8,0,0,8,8
20422,Rwanda,2015,2015Rwanda,0,0,0,0,0,0,0,0,0,6,0,0,0,6,6
20423,Rwanda,2015,2015Rwanda,0,0,0,0,0,9,9,0,0,0,0,0,11,11,20
20424,Rwanda,2015,2015Rwanda,0,0,0,0,0,443,443,0,0,0,0,0,454,454,897
20425,Rwanda,2015,2015Rwanda,0,0,0,0,0,1492,1492,0,0,0,0,0,1303,1303,2795
20426,Rwanda,2015,2015Rwanda,0,0,0,5,0,0,5,0,0,0,0,0,0,0,5
20427,Rwanda,2015,2015Rwanda,0,0,0,5,0,0,5,0,0,0,8,0,0,8,13
20428,Rwanda,2015,2015Rwanda,0,0,0,6,0,0,6,0,0,0,0,0,6,6,12
20429,Rwanda,2015,2015Rwanda,0,0,0,6,0,0,6,0,0,0,12,0,0,12,18
20430,Rwanda,2015,2015Rwanda,0,0,0,13,0,0,13,0,0,14,6,0,0,20,33
20431,Rwanda,2015,2015Rwanda,0,0,0,28,0,0,28,0,0,0,34,0,0,34,62
20432,Rwanda,2015,2015Rwanda,0,0,5,0,0,0,5,0,0,0,0,0,0,0,5
20433,Rwanda,2015,2015Rwanda,0,0,5,0,0,0,5,0,0,0,6,0,0,6,11
20434,Rwanda,2015,2015Rwanda,0,0,6,5,0,0,11,0,0,5,10,0,0,15,26
20435,Rwanda,2015,2015Rwanda,0,0,7,75,0,0,82,5,0,5,182,0,0,192,274
20436,Rwanda,2015,2015Rwanda,0,0,8,0,0,0,8,0,9,0,0,0,0,9,17
20437,Rwanda,2015,2015Rwanda,0,0,15,0,0,0,15,0,14,7,0,0,0,21,36
20438,Rwanda,2015,2015Rwanda,0,5,0,0,0,0,5,0,0,0,5,0,0,5,20
20439,Rwanda,2015,2015Rwanda,0,6,0,7,0,0,13,0,0,6,9,0,0,15,28
20440,Rwanda,2015,2015Rwanda,0,7,10,8,0,0,25,0,5,6,10,0,0,21,46
20441,Rwanda,2015,2015Rwanda,0,8,5,39,0,0,52,0,7,18,54,5,0,84,136
20442,Rwanda,2015,2015Rwanda,0,10,6,32,0,0,48,0,0,9,20,5,0,34,82
20443,Rwanda,2015,2015Rwanda,5,5,15,64,5,0,94,7,12,8,85,5,0,117,211
20444,Rwanda,2015,2015Rwanda,5,8,5,85,5,0,108,0,5,7,63,5,0,80,188
20445,Rwanda,2015,2015Rwanda,6,11,10,35,0,0,62,7,10,12,36,5,0,70,132
20446,Rwanda,2015,2015Rwanda,9,11,5,40,5,0,70,14,11,8,56,5,0,94,164
20447,Rwanda,2015,2015Rwanda,10,25,12,30,0,0,77,12,10,21,53,0,0,96,173
20448,Rwanda,2015,2015Rwanda,11,75,67,227,17,0,397,18,60,79,272,23,0,452,849
20449,Rwanda,2015,2015Rwanda,15,28,30,79,5,0,157,15,21,34,67,10,0,147,304
20450,Rwanda,2015,2015Rwanda,25,45,52,251,11,0,384,34,50,64,258,23,0,429,813
20451,Rwanda,2015,2015Rwanda,40,78,62,183,5,0,368,38,80,55,214,9,0,396,764
20452,Rwanda,2015,2015Rwanda,51,63,61,224,11,0,410,49,95,66,226,12,0,448,858
20453,Rwanda,2015,2015Rwanda,58,187,115,338,17,0,715,60,191,105,455,22,0,833,1548
20454,Rwanda,2015,2015Rwanda,90,198,229,532,24,0,1073,93,211,184,510,45,0,1043,2116
20455,Rwanda,2015,2015Rwanda,482,858,835,1400,54,0,3629,463,885,850,2672,50,0,4920,8549
20456,Rwanda,2015,2015Rwanda,942,1882,1296,3223,184,0,7527,910,1738,1181,3090,268,0,7187,14714
20457,Rwanda,2015,2015Rwanda,27062,32744,21933,40363,2182,0,124284,23659,33552,23324,37513,2720,0,120768,245052
20458,Rwanda,2016,2016Rwanda,0,0,0,0,0,0,0,0,0,0,0,0,0,0,1822
20459,Rwanda,2016,2016Rwanda,0,0,0,0,0,0,0,0,0,0,0,0,5,5,5
20460,Rwanda,2016,2016Rwanda,0,0,0,0,0,0,0,0,0,0,5,0,0,5,5
20461,Rwanda,2016,2016Rwanda,0,0,0,0,0,0,0,0,0,0,9,0,0,9,9
20462,Rwanda,2016,2016Rwanda,0,0,0,0,0,0,0,0,0,5,0,0,0,5,5
20463,Rwanda,2016,2016Rwanda,0,0,0,0,0,0,0,0,0,6,0,0,0,6,6
20464,Rwanda,2016,2016Rwanda,0,0,0,0,0,9,9,0,0,0,0,0,10,10,19
20465,Rwanda,2016,2016Rwanda,0,0,0,0,0,397,397,0,0,0,0,0,406,406,803
20466,Rwanda,2016,2016Rwanda,0,0,0,0,0,627,627,0,0,0,0,0,754,754,1381
20467,Rwanda,2016,2016Rwanda,0,0,0,0,0,1494,1494,0,0,0,0,0,1314,1314,2808
20468,Rwanda,2016,2016Rwanda,0,0,0,5,0,0,5,0,0,0,11,0,0,11,16
20469,Rwanda,2016,2016Rwanda,0,0,0,6,0,0,6,0,0,0,12,0,0,12,18
20470,Rwanda,2016,2016Rwanda,0,0,0,6,0,0,6,0,0,5,7,0,0,12,18
20471,Rwanda,2016,2016Rwanda,0,0,0,9,0,61,70,0,0,5,8,0,68,81,151
20472,Rwanda,2016,2016Rwanda,0,0,0,12,0,0,12,0,0,14,5,0,0,19,31
20473,Rwanda,2016,2016Rwanda,0,0,5,0,0,0,5,0,0,0,0,0,0,0,5
20474,Rwanda,2016,2016Rwanda,0,0,5,0,0,0,5,0,0,0,6,0,0,6,11
20475,Rwanda,2016,2016Rwanda,0,0,5,22,0,0,27,0,0,0,38,0,0,38,65
20476,Rwanda,2016,2016Rwanda,0,0,5,26,0,0,31,0,0,5,20,0,0,25,1048
20477,Rwanda,2016,2016Rwanda,0,0,6,0,0,0,6,0,0,5,6,0,0,11,17
20478,Rwanda,2016,2016Rwanda,0,0,7,75,0,0,82,0,5,5,182,0,0,192,274
20479,Rwanda,2016,2016Rwanda,0,0,9,0,0,0,9,0,0,5,12,0,0,17,26
20480,Rwanda,2016,2016Rwanda,0,0,15,8,0,0,23,0,5,0,5,0,0,10,33
20481,Rwanda,2016,2016Rwanda,0,5,0,0,0,0,5,0,0,0,5,0,0,5,10
20482,Rwanda,2016,2016Rwanda,0,5,0,5,0,0,10,0,9,0,0,0,0,9,19
20483,Rwanda,2016,2016Rwanda,0,5,11,39,0,0,55,0,12,5,65,0,0,82,137
20484,Rwanda,2016,2016Rwanda,0,6,0,0,0,0,6,0,5,0,0,0,0,5,11
20485,Rwanda,2016,2016Rwanda,0,7,5,42,0,0,54,0,7,14,58,6,0,85,139
20486,Rwanda,2016,2016Rwanda,0,8,0,17,0,0,25,0,0,5,8,5,0,18,43
20487,Rwanda,2016,2016Rwanda,0,9,5,14,0,0,28,0,6,0,17,0,0,23,51
20488,Rwanda,2016,2016Rwanda,5,10,6,34,0,0,55,7,7,11,37,5,0,67,122
20489,Rwanda,2016,2016Rwanda,6,9,8,87,6,0,116,0,6,7,63,5,0,81,197
20490,Rwanda,2016,2016Rwanda,12,25,6,20,0,0,63,15,8,14,46,0,0,83,146
20491,Rwanda,2016,2016Rwanda,20,48,41,232,12,0,353,26,46,51,224,20,0,367,720
20492,Rwanda,2016,2016Rwanda,31,38,25,94,5,0,193,21,33,33,83,12,0,182,375
20493,Rwanda,2016,2016Rwanda,31,75,56,179,10,0,351,46,69,56,185,14,0,370,721
20494,Rwanda,2016,2016Rwanda,41,67,59,190,15,0,372,37,49,69,237,23,0,415,787
20495,Rwanda,2016,2016Rwanda,46,185,111,331,16,0,689,45,178,110,450,24,0,807,1496
20496,Rwanda,2016,2016Rwanda,49,56,56,205,10,0,376,41,81,72,203,12,0,409,785
20497,Rwanda,2016,2016Rwanda,102,211,230,554,29,0,1126,113,228,189,533,54,0,1117,2243
20498,Rwanda,2016,2016Rwanda,453,897,891,1606,61,0,3908,429,925,932,2939,69,0,5294,9202
20499,Rwanda,2016,2016Rwanda,988,1844,1412,3266,197,0,7707,942,1824,1323,3148,287,0,7524,15231
20500,Rwanda,2016,2016Rwanda,27038,32716,21964,40357,2163,0,124238,23640,33586,23340,37541,2707,0,120814,245052
20501,Rwanda,2017,2017Rwanda,0,0,0,0,0,0,0,0,0,0,0,0,0,0,3361
20502,Rwanda,2017,2017Rwanda,0,0,0,0,0,0,0,0,0,0,0,0,5,5,5
20503,Rwanda,2017,2017Rwanda,0,0,0,0,0,0,0,0,0,0,0,0,273,273,273
20504,Rwanda,2017,2017Rwanda,0,0,0,0,0,0,0,0,0,0,8,0,0,8,8
20505,Rwanda,2017,2017Rwanda,0,0,0,0,0,0,0,0,0,5,0,0,0,5,5
20506,Rwanda,2017,2017Rwanda,0,0,0,0,0,0,0,0,0,6,0,0,0,6,6
20507,Rwanda,2017,2017Rwanda,0,0,0,0,0,589,589,0,0,0,0,0,706,706,1295
20508,Rwanda,2017,2017Rwanda,0,0,0,0,0,1485,1485,0,0,0,0,0,1322,1322,2807
20509,Rwanda,2017,2017Rwanda,0,0,0,5,0,0,5,0,0,0,14,0,0,14,19
20510,Rwanda,2017,2017Rwanda,0,0,0,5,0,0,5,0,0,0,15,0,0,15,20
20511,Rwanda,2017,2017Rwanda,0,0,0,5,0,0,5,0,5,0,8,0,0,13,18
20512,Rwanda,2017,2017Rwanda,0,0,0,9,0,65,74,0,0,5,7,0,54,66,140
20513,Rwanda,2017,2017Rwanda,0,0,0,27,0,0,27,0,0,0,39,0,0,39,66
20514,Rwanda,2017,2017Rwanda,0,0,5,0,0,0,5,0,0,0,0,0,0,0,5
20515,Rwanda,2017,2017Rwanda,0,0,5,0,0,0,5,0,0,0,5,0,0,5,10
20516,Rwanda,2017,2017Rwanda,0,0,5,18,0,0,23,0,6,0,7,0,0,13,36
20517,Rwanda,2017,2017Rwanda,0,0,6,0,0,0,6,0,5,6,0,0,0,11,17
20518,Rwanda,2017,2017Rwanda,0,0,7,0,0,0,7,0,0,0,0,0,0,0,7
20519,Rwanda,2017,2017Rwanda,0,0,7,75,0,0,82,0,0,10,182,0,0,192,274
20520,Rwanda,2017,2017Rwanda,0,0,8,19,0,0,27,0,0,6,9,5,0,20,47
20521,Rwanda,2017,2017Rwanda,0,5,0,0,0,0,5,0,0,0,5,0,0,5,10
20522,Rwanda,2017,2017Rwanda,0,5,0,5,0,0,10,0,5,0,5,0,0,10,20
20523,Rwanda,2017,2017Rwanda,0,5,10,36,5,0,56,0,11,6,59,5,0,81,137
20524,Rwanda,2017,2017Rwanda,0,6,0,5,0,0,11,0,5,0,7,0,0,12,23
20525,Rwanda,2017,2017Rwanda,5,5,5,45,0,0,60,0,7,15,65,6,0,93,153
20526,Rwanda,2017,2017Rwanda,5,15,11,35,0,0,66,8,6,17,42,6,0,79,145
20527,Rwanda,2017,2017Rwanda,8,12,7,89,5,0,121,0,6,6,68,6,0,86,207
20528,Rwanda,2017,2017Rwanda,9,26,12,27,0,0,74,19,14,15,62,0,0,110,184
20529,Rwanda,2017,2017Rwanda,19,54,47,144,5,0,269,23,46,60,91,11,0,231,500
20530,Rwanda,2017,2017Rwanda,20,43,36,183,8,0,290,24,35,52,162,13,0,286,576
20531,Rwanda,2017,2017Rwanda,26,48,32,111,5,0,222,17,42,33,87,21,0,200,422
20532,Rwanda,2017,2017Rwanda,27,54,58,212,10,0,361,25,38,58,258,26,0,405,766
20533,Rwanda,2017,2017Rwanda,33,72,61,150,13,0,329,42,77,56,196,15,0,386,715
20534,Rwanda,2017,2017Rwanda,49,61,53,232,12,0,407,37,92,74,212,10,0,425,832
20535,Rwanda,2017,2017Rwanda,89,166,186,497,28,0,966,101,189,165,462,60,0,977,1943
20536,Rwanda,2017,2017Rwanda,409,843,879,1735,71,0,3937,365,903,910,3065,95,0,5338,9275
20537,Rwanda,2017,2017Rwanda,929,1660,1319,3170,192,0,7270,897,1668,1269,2892,286,0,7012,14282
20538,Rwanda,2017,2017Rwanda,23620,29384,19413,36673,2131,0,111221,20388,30253,20919,34900,2696,0,109156,220377
20539,Rwanda,2018,2018Rwanda,0,0,0,0,0,0,0,0,0,0,0,0,0,0,4223
20540,Rwanda,2018,2018Rwanda,0,0,0,0,0,0,0,0,0,0,5,0,0,5,5
20541,Rwanda,2018,2018Rwanda,0,0,0,0,0,0,0,0,0,0,7,0,0,7,7
20542,Rwanda,2018,2018Rwanda,0,0,0,0,0,0,0,0,0,6,0,0,0,6,6
20543,Rwanda,2018,2018Rwanda,0,0,0,0,0,13,13,0,0,0,0,0,15,15,28
20544,Rwanda,2018,2018Rwanda,0,0,0,0,0,1513,1513,0,0,0,0,0,1377,1377,2890
20545,Rwanda,2018,2018Rwanda,0,0,0,5,0,0,5,0,0,0,0,0,0,0,5
20546,Rwanda,2018,2018Rwanda,0,0,0,5,0,0,5,0,0,0,14,0,0,14,19
20547,Rwanda,2018,2018Rwanda,0,0,0,5,0,0,5,0,0,0,15,0,0,15,20
20548,Rwanda,2018,2018Rwanda,0,0,0,5,0,0,5,0,5,0,8,0,0,13,18
20549,Rwanda,2018,2018Rwanda,0,0,0,8,0,53,61,0,0,0,12,0,65,77,138
20550,Rwanda,2018,2018Rwanda,0,0,5,0,0,0,5,0,0,0,6,0,0,6,11
20551,Rwanda,2018,2018Rwanda,0,0,5,0,0,0,5,0,0,0,8,0,0,8,26
20552,Rwanda,2018,2018Rwanda,0,0,5,9,0,0,14,0,0,0,23,0,0,23,37
20553,Rwanda,2018,2018Rwanda,0,0,5,18,0,0,23,0,6,0,7,0,0,13,36
20554,Rwanda,2018,2018Rwanda,0,0,7,19,0,0,26,0,0,5,10,5,0,20,46
20555,Rwanda,2018,2018Rwanda,0,0,8,0,0,0,8,0,0,0,0,0,0,0,8
20556,Rwanda,2018,2018Rwanda,0,5,0,0,0,0,5,0,0,0,5,0,0,5,10
20557,Rwanda,2018,2018Rwanda,0,6,0,5,0,0,11,0,0,0,9,0,0,9,20
20558,Rwanda,2018,2018Rwanda,5,5,6,38,5,0,59,0,10,6,59,5,0,80,139
20559,Rwanda,2018,2018Rwanda,5,9,7,33,5,0,59,0,5,10,47,6,0,68,127
20560,Rwanda,2018,2018Rwanda,5,17,9,101,8,0,140,0,7,7,78,7,0,99,239
20561,Rwanda,2018,2018Rwanda,7,28,16,28,0,0,79,18,16,21,65,0,0,120,199
20562,Rwanda,2018,2018Rwanda,8,7,5,50,0,0,70,0,6,12,73,7,0,98,168
20563,Rwanda,2018,2018Rwanda,14,20,17,99,5,0,155,7,16,11,96,5,0,135,936
20564,Rwanda,2018,2018Rwanda,20,43,36,199,13,0,311,26,42,48,205,16,0,337,648
20565,Rwanda,2018,2018Rwanda,22,57,47,219,15,0,360,20,34,50,281,28,0,413,773
20566,Rwanda,2018,2018Rwanda,24,79,95,279,15,0,492,19,69,82,309,20,0,499,991
20567,Rwanda,2018,2018Rwanda,28,58,39,117,11,0,253,20,49,37,98,22,0,226,479
20568,Rwanda,2018,2018Rwanda,28,84,58,167,14,0,351,34,98,54,204,14,0,404,755
20569,Rwanda,2018,2018Rwanda,31,77,52,237,16,0,413,40,78,88,233,11,0,450,863
20570,Rwanda,2018,2018Rwanda,36,50,33,160,5,0,284,33,48,47,143,17,0,288,572
20571,Rwanda,2018,2018Rwanda,89,164,172,542,31,0,998,107,188,161,496,67,0,1019,2017
20572,Rwanda,2018,2018Rwanda,894,1594,1311,3166,202,0,7167,889,1613,1221,2833,301,0,6857,14024
20573,Rwanda,2018,2018Rwanda,23195,28920,19243,35852,2104,0,109314,19954,29839,20777,34454,2648,0,107672,216986
20574,Rwanda,2019,2019Rwanda,0,0,0,0,0,0,0,0,0,0,0,0,0,0,4956
20575,Rwanda,2019,2019Rwanda,0,0,0,0,0,0,0,0,0,0,5,0,0,5,5
20576,Rwanda,2019,2019Rwanda,0,0,0,0,0,0,0,0,0,0,7,0,0,7,7
20577,Rwanda,2019,2019Rwanda,0,0,0,0,0,0,0,0,0,5,0,0,0,5,5
20578,Rwanda,2019,2019Rwanda,0,0,0,0,0,0,0,0,0,6,0,0,0,6,6
20579,Rwanda,2019,2019Rwanda,0,0,0,0,0,0,0,0,14,0,0,0,0,14,14
20580,Rwanda,2019,2019Rwanda,0,0,0,0,0,5,5,0,0,0,0,0,0,0,5
20581,Rwanda,2019,2019Rwanda,0,0,0,0,0,1564,1564,0,0,0,0,0,1431,1431,2995
20582,Rwanda,2019,2019Rwanda,0,0,0,5,0,0,5,0,0,0,0,0,0,0,10
20583,Rwanda,2019,2019Rwanda,0,0,0,5,0,0,5,0,0,0,8,0,0,8,13
20584,Rwanda,2019,2019Rwanda,0,0,0,5,0,0,5,0,5,0,8,0,0,13,18
20585,Rwanda,2019,2019Rwanda,0,0,0,6,0,0,6,0,0,0,12,0,0,12,126
20586,Rwanda,2019,2019Rwanda,0,0,5,0,0,0,5,0,0,0,6,0,0,6,11
20587,Rwanda,2019,2019Rwanda,0,0,5,0,0,0,5,0,0,0,8,0,0,8,13
20588,Rwanda,2019,2019Rwanda,0,0,5,5,0,0,10,0,5,0,5,0,0,10,20
20589,Rwanda,2019,2019Rwanda,0,0,5,9,0,0,14,0,0,0,22,0,0,22,36
20590,Rwanda,2019,2019Rwanda,0,0,5,18,0,0,23,0,6,0,7,0,0,13,36
20591,Rwanda,2019,2019Rwanda,0,0,7,0,0,0,7,0,0,0,0,0,0,0,7
20592,Rwanda,2019,2019Rwanda,0,5,0,0,0,0,5,0,0,0,5,0,0,5,10
20593,Rwanda,2019,2019Rwanda,0,6,6,36,5,0,53,0,10,5,52,0,0,67,120
20594,Rwanda,2019,2019Rwanda,0,8,0,21,0,0,29,0,5,0,14,5,0,24,53
20595,Rwanda,2019,2019Rwanda,0,9,0,0,0,0,9,0,0,0,7,0,0,7,16
20596,Rwanda,2019,2019Rwanda,5,7,7,32,5,0,56,0,5,5,50,5,0,65,121
20597,Rwanda,2019,2019Rwanda,5,22,12,107,9,0,155,5,6,7,89,8,0,115,270
20598,Rwanda,2019,2019Rwanda,7,7,0,16,5,0,35,10,5,5,10,0,0,30,65
20599,Rwanda,2019,2019Rwanda,8,7,10,50,0,0,75,5,11,5,79,9,0,109,184
20600,Rwanda,2019,2019Rwanda,11,27,17,32,0,0,87,17,21,13,71,0,0,122,209
20601,Rwanda,2019,2019Rwanda,12,21,18,98,6,0,155,15,24,34,98,8,0,179,334
20602,Rwanda,2019,2019Rwanda,19,80,73,174,23,0,369,34,79,68,207,17,0,405,774
20603,Rwanda,2019,2019Rwanda,20,79,80,241,13,0,433,13,66,60,224,15,0,378,811
20604,Rwanda,2019,2019Rwanda,21,41,31,212,16,0,321,22,31,37,247,29,0,366,687
20605,Rwanda,2019,2019Rwanda,25,46,34,222,15,0,342,21,52,48,244,25,0,390,732
20606,Rwanda,2019,2019Rwanda,35,53,45,175,7,0,315,31,55,50,178,20,0,334,649
20607,Rwanda,2019,2019Rwanda,39,89,41,140,11,0,320,31,49,33,120,22,0,255,575
20608,Rwanda,2019,2019Rwanda,98,176,177,596,33,0,1080,118,172,191,531,71,0,1083,2163
20609,Rwanda,2019,2019Rwanda,1037,1636,1418,3517,241,0,7849,1098,1631,1340,3063,381,0,7513,15362
20610,Rwanda,2019,2019Rwanda,22887,28608,19099,35501,2069,0,108164,19631,29604,20590,34374,2626,0,106825,214989
20611,Rwanda,2020,2020Rwanda,0,0,0,0,0,0,0,0,0,0,0,0,0,0,5240
20612,Rwanda,2020,2020Rwanda,0,0,0,0,0,0,0,0,0,0,0,0,5,5,5
20613,Rwanda,2020,2020Rwanda,0,0,0,0,0,0,0,0,0,0,5,0,0,5,5
20614,Rwanda,2020,2020Rwanda,0,0,0,0,0,0,0,0,0,0,7,0,0,7,7
20615,Rwanda,2020,2020Rwanda,0,0,0,0,0,0,0,0,0,0,9,0,0,9,9
20616,Rwanda,2020,2020Rwanda,0,0,0,0,0,0,0,0,0,5,0,0,0,5,5
20617,Rwanda,2020,2020Rwanda,0,0,0,0,0,0,0,0,0,6,0,0,0,6,6
20618,Rwanda,2020,2020Rwanda,0,0,0,0,0,6,6,0,0,0,0,0,7,7,13
20619,Rwanda,2020,2020Rwanda,0,0,0,0,0,361,361,0,0,0,0,0,420,420,781
20620,Rwanda,2020,2020Rwanda,0,0,0,5,0,0,5,0,0,0,0,0,0,0,10
20621,Rwanda,2020,2020Rwanda,0,0,0,5,0,0,5,0,0,0,8,0,0,8,13
20622,Rwanda,2020,2020Rwanda,0,0,0,5,0,0,5,0,5,0,8,0,0,13,18
20623,Rwanda,2020,2020Rwanda,0,0,0,5,0,0,5,0,6,0,7,0,0,13,18
20624,Rwanda,2020,2020Rwanda,0,0,0,6,0,0,6,0,0,0,10,0,0,10,110
20625,Rwanda,2020,2020Rwanda,0,0,0,23,0,0,23,0,6,0,8,0,0,14,37
20626,Rwanda,2020,2020Rwanda,0,0,0,67,0,25,92,0,0,0,60,0,18,78,811
20627,Rwanda,2020,2020Rwanda,0,0,5,0,0,0,5,0,0,0,5,0,0,5,10
20628,Rwanda,2020,2020Rwanda,0,0,5,0,0,0,5,0,0,0,8,0,0,8,13
20629,Rwanda,2020,2020Rwanda,0,0,5,0,0,0,5,0,0,0,9,0,0,9,14
20630,Rwanda,2020,2020Rwanda,0,0,5,10,0,0,15,0,0,5,19,0,0,24,39
20631,Rwanda,2020,2020Rwanda,0,0,7,0,0,0,7,0,0,0,0,0,0,0,7
20632,Rwanda,2020,2020Rwanda,0,0,9,0,0,0,9,0,0,0,7,0,0,7,16
20633,Rwanda,2020,2020Rwanda,0,5,0,6,0,0,11,0,13,0,5,0,0,18,29
20634,Rwanda,2020,2020Rwanda,0,7,5,34,5,0,51,0,10,7,43,5,0,65,116
20635,Rwanda,2020,2020Rwanda,0,9,0,21,0,0,30,0,5,0,13,5,0,23,53
20636,Rwanda,2020,2020Rwanda,5,0,0,0,0,0,5,0,0,0,0,0,0,0,5
20637,Rwanda,2020,2020Rwanda,5,25,16,115,9,0,170,12,6,8,93,8,0,127,297
20638,Rwanda,2020,2020Rwanda,5,63,52,321,14,0,455,7,68,61,411,14,0,561,1016
20639,Rwanda,2020,2020Rwanda,6,7,6,34,5,0,58,0,5,7,51,5,0,68,126
20640,Rwanda,2020,2020Rwanda,6,9,0,16,5,0,36,12,6,0,13,0,0,31,67
20641,Rwanda,2020,2020Rwanda,6,9,10,50,0,0,75,7,0,13,81,9,0,110,185
20642,Rwanda,2020,2020Rwanda,15,25,14,71,8,0,133,11,22,24,100,8,0,165,298
20643,Rwanda,2020,2020Rwanda,19,73,80,174,25,0,371,30,74,71,211,20,0,406,777
20644,Rwanda,2020,2020Rwanda,20,63,35,191,30,0,339,28,33,39,207,53,0,360,699
20645,Rwanda,2020,2020Rwanda,20,69,89,227,14,0,419,15,57,63,227,15,0,377,796
20646,Rwanda,2020,2020Rwanda,21,24,12,71,0,0,128,6,23,18,37,0,0,84,212
20647,Rwanda,2020,2020Rwanda,22,50,30,235,15,0,352,22,50,45,245,30,0,392,744
20648,Rwanda,2020,2020Rwanda,33,54,42,183,9,0,321,30,50,52,188,21,0,341,662
20649,Rwanda,2020,2020Rwanda,38,40,40,120,10,0,248,35,34,31,106,26,0,232,480
20650,Rwanda,2020,2020Rwanda,99,171,174,638,42,0,1124,117,183,179,594,80,0,1153,2277
20651,Rwanda,2020,2020Rwanda,340,768,605,1333,75,104300,107421,370,805,624,1461,108,102988,106356,213777
20652,Rwanda,2020,2020Rwanda,1013,1600,1512,3773,270,0,8168,1066,1617,1420,3308,399,0,7810,15978
20653,Rwanda,2021,2021Rwanda,0,0,0,0,0,0,0,0,0,0,0,0,0,0,7395
20654,Rwanda,2021,2021Rwanda,0,0,0,0,0,0,0,0,0,0,0,0,5,5,5
20655,Rwanda,2021,2021Rwanda,0,0,0,0,0,0,0,0,0,0,5,0,0,5,5
20656,Rwanda,2021,2021Rwanda,0,0,0,0,0,0,0,0,0,0,18,0,0,18,18
20657,Rwanda,2021,2021Rwanda,0,0,0,0,0,0,0,0,0,6,0,0,0,6,6
20658,Rwanda,2021,2021Rwanda,0,0,0,0,0,0,0,0,6,0,6,0,0,12,12
20659,Rwanda,2021,2021Rwanda,0,0,0,0,0,0,0,5,0,0,0,0,0,5,5
20660,Rwanda,2021,2021Rwanda,0,0,0,5,0,0,5,0,0,0,0,0,0,0,10
20661,Rwanda,2021,2021Rwanda,0,0,0,5,0,0,5,0,0,0,6,0,0,6,11
20662,Rwanda,2021,2021Rwanda,0,0,0,5,0,0,5,0,0,0,8,0,0,8,103
20663,Rwanda,2021,2021Rwanda,0,0,0,5,0,0,5,0,5,0,7,0,0,12,17
20664,Rwanda,2021,2021Rwanda,0,0,0,5,0,0,5,0,7,0,0,0,0,7,12
20665,Rwanda,2021,2021Rwanda,0,0,0,8,0,0,8,0,0,0,0,0,0,0,8
20666,Rwanda,2021,2021Rwanda,0,0,0,9,0,0,9,0,0,6,0,0,0,6,15
20667,Rwanda,2021,2021Rwanda,0,0,0,13,0,0,13,0,0,5,17,0,0,22,35
20668,Rwanda,2021,2021Rwanda,0,0,0,16,0,0,16,0,5,0,8,0,0,13,29
20669,Rwanda,2021,2021Rwanda,0,0,5,0,0,0,5,0,0,0,5,0,0,5,10
20670,Rwanda,2021,2021Rwanda,0,0,5,0,0,0,5,5,0,0,5,0,0,10,15
20671,Rwanda,2021,2021Rwanda,0,0,8,0,0,0,8,0,0,0,8,0,0,8,16
20672,Rwanda,2021,2021Rwanda,0,0,9,19,0,0,28,0,5,0,11,5,0,21,49
20673,Rwanda,2021,2021Rwanda,0,0,17,39,0,0,56,0,13,9,62,5,0,89,145
20674,Rwanda,2021,2021Rwanda,0,6,5,36,0,0,47,0,13,5,43,5,0,66,113
20675,Rwanda,2021,2021Rwanda,0,7,0,9,0,0,16,5,7,0,7,0,0,19,35
20676,Rwanda,2021,2021Rwanda,5,0,0,0,0,0,5,0,0,0,0,0,0,0,10
20677,Rwanda,2021,2021Rwanda,5,5,5,16,5,0,36,13,6,0,14,0,0,33,69
20678,Rwanda,2021,2021Rwanda,5,20,28,38,0,0,91,6,38,7,77,0,0,128,219
20679,Rwanda,2021,2021Rwanda,5,41,53,336,20,0,455,0,51,61,427,20,0,559,1014
20680,Rwanda,2021,2021Rwanda,6,18,19,131,8,0,182,14,6,8,105,9,0,142,324
20681,Rwanda,2021,2021Rwanda,7,6,7,36,5,0,61,0,5,6,47,6,0,64,125
20682,Rwanda,2021,2021Rwanda,8,7,7,181,6,25,234,6,7,13,192,0,18,236,995
20683,Rwanda,2021,2021Rwanda,8,188,249,707,28,0,1180,15,156,258,879,68,0,1376,2556
20684,Rwanda,2021,2021Rwanda,10,24,12,66,8,0,120,9,20,21,83,7,0,140,260
20685,Rwanda,2021,2021Rwanda,10,42,31,227,21,0,331,10,36,30,258,32,0,366,697
20686,Rwanda,2021,2021Rwanda,19,43,41,240,21,0,364,17,54,45,253,33,0,402,766
20687,Rwanda,2021,2021Rwanda,20,77,74,197,25,0,393,28,69,70,232,20,0,419,812
20688,Rwanda,2021,2021Rwanda,29,48,49,179,14,0,319,25,54,51,188,23,0,341,660
20689,Rwanda,2021,2021Rwanda,50,49,44,176,5,0,324,32,53,40,136,29,0,290,614
20690,Rwanda,2021,2021Rwanda,122,183,174,721,45,0,1245,141,183,196,664,85,0,1269,2514
20691,Rwanda,2021,2021Rwanda,1133,1654,1634,4245,312,0,8978,1230,1709,1544,3621,455,0,8559,17537
20692,Rwanda,2021,2021Rwanda,22311,27970,19074,34879,2047,0,106281,19111,29253,20377,33383,2573,0,104697,210978
20693,Senegal,2001,2001Senegal,0,0,0,0,0,0,0,0,0,0,0,0,0,0,249
20694,Senegal,2001,2001Senegal,0,0,0,0,0,0,0,0,0,0,0,0,5,5,5
20695,Senegal,2001,2001Senegal,0,0,0,0,0,13,13,0,0,0,0,0,48,48,61
20696,Senegal,2001,2001Senegal,0,0,6,0,0,0,6,0,5,0,7,0,0,12,18
20697,Senegal,2001,2001Senegal,22,32,28,78,7,0,167,18,39,33,69,11,0,170,889
20698,Senegal,2001,2001Senegal,490,685,586,1878,229,0,3868,503,735,630,1325,271,0,3464,7332
20699,Senegal,2002,2002Senegal,0,0,0,0,0,0,0,0,0,0,0,0,0,0,400
20700,Senegal,2002,2002Senegal,0,0,0,0,0,17,17,0,0,0,0,0,64,64,81
20701,Senegal,2002,2002Senegal,0,0,0,6,0,0,6,0,5,0,7,0,0,12,18
20702,Senegal,2002,2002Senegal,0,0,6,0,0,0,6,0,5,0,7,0,0,12,18
20703,Senegal,2002,2002Senegal,22,32,28,78,7,0,167,18,39,33,69,11,0,170,4230
20704,Senegal,2002,2002Senegal,490,686,586,1879,229,0,3870,511,733,627,1310,271,0,3452,7322
20705,Senegal,2003,2003Senegal,0,0,0,0,0,0,0,0,0,0,0,0,0,0,381
20706,Senegal,2003,2003Senegal,0,0,0,0,0,27,27,0,0,0,0,0,74,74,101
20707,Senegal,2003,2003Senegal,34,15,13,203,28,0,293,26,18,15,158,38,0,255,548
20708,Senegal,2003,2003Senegal,490,686,586,1877,229,0,3868,511,733,627,1307,271,0,3449,7317
20709,Senegal,2004,2004Senegal,0,0,0,0,0,0,0,0,0,0,0,0,0,0,938
20710,Senegal,2004,2004Senegal,0,0,9,7,0,0,16,8,5,0,36,0,0,49,65
20711,Senegal,2004,2004Senegal,0,5,0,0,0,0,5,0,0,0,0,0,0,0,5
20712,Senegal,2004,2004Senegal,685,797,683,1493,113,0,3771,719,773,662,1223,169,0,3546,7317
20713,Senegal,2005,2005Senegal,0,0,0,0,0,0,0,0,0,0,0,0,0,0,1139
20714,Senegal,2005,2005Senegal,0,0,0,0,0,36,36,0,0,0,0,0,96,96,132
20715,Senegal,2005,2005Senegal,0,0,9,7,0,0,16,8,5,0,37,0,0,50,66
20716,Senegal,2005,2005Senegal,0,5,0,0,0,0,5,0,0,0,0,0,0,0,5
20717,Senegal,2005,2005Senegal,686,797,684,1494,113,0,3774,719,773,662,1223,169,0,3546,7320
20718,Senegal,2006,2006Senegal,0,0,0,0,0,0,0,0,0,0,0,0,0,0,535
20719,Senegal,2006,2006Senegal,0,0,0,0,0,0,0,0,0,0,0,0,6,6,6
20720,Senegal,2006,2006Senegal,0,0,0,0,0,5,5,0,0,0,0,0,0,0,5
20721,Senegal,2006,2006Senegal,0,0,0,0,0,42,42,0,0,0,0,0,96,96,138
20722,Senegal,2006,2006Senegal,0,0,6,6,0,0,12,0,5,0,49,0,0,54,66
20723,Senegal,2006,2006Senegal,538,814,1596,682,233,0,3863,535,713,767,796,272,0,3083,6946
20724,Senegal,2006,2006Senegal,687,1460,962,635,119,0,3863,722,600,853,1244,172,0,3591,7454
20725,Senegal,2007,2007Senegal,0,0,0,0,0,0,0,0,0,0,0,0,0,0,624
20726,Senegal,2007,2007Senegal,0,0,0,0,0,0,0,0,0,0,0,0,11,11,11
20727,Senegal,2007,2007Senegal,0,0,0,0,0,50,50,0,0,0,0,0,98,98,148
20728,Senegal,2007,2007Senegal,0,0,6,5,0,0,11,0,6,0,47,0,0,53,64
20729,Senegal,2007,2007Senegal,0,5,0,0,0,0,5,0,0,0,0,0,0,0,5
20730,Senegal,2007,2007Senegal,538,814,1596,922,233,0,4103,535,713,767,1156,272,0,3443,7546
20731,Senegal,2007,2007Senegal,687,1460,962,649,119,0,3877,722,600,853,1264,172,0,3611,7488
20732,Senegal,2008,2008Senegal,0,0,0,0,0,0,0,0,0,0,0,0,0,0,755
20733,Senegal,2008,2008Senegal,0,0,0,0,0,0,0,0,0,0,5,0,0,5,10
20734,Senegal,2008,2008Senegal,0,0,0,0,0,5,5,0,0,0,0,0,15,15,20
20735,Senegal,2008,2008Senegal,0,0,0,0,0,77,77,0,0,0,0,0,102,102,179
20736,Senegal,2008,2008Senegal,0,5,0,0,0,0,5,0,0,0,0,0,0,0,5
20737,Senegal,2008,2008Senegal,538,814,1596,922,233,0,4103,535,713,767,1156,272,0,3443,7546
20738,Senegal,2008,2008Senegal,687,1460,963,650,119,0,3879,722,600,854,1265,172,0,3613,7492
20739,Senegal,2009,2009Senegal,0,0,0,0,0,0,0,0,0,0,0,0,0,0,1031
20740,Senegal,2009,2009Senegal,0,0,0,0,0,0,0,0,0,0,5,0,0,5,10
20741,Senegal,2009,2009Senegal,0,0,0,0,0,0,0,0,0,0,7,0,0,7,7
20742,Senegal,2009,2009Senegal,0,0,0,0,0,0,0,0,0,0,27,0,0,27,27
20743,Senegal,2009,2009Senegal,0,0,0,0,0,6,6,0,0,0,0,0,0,0,6
20744,Senegal,2009,2009Senegal,0,0,0,0,0,8,8,0,0,0,0,0,27,27,35
20745,Senegal,2009,2009Senegal,0,0,5,21,0,0,26,0,8,0,113,5,0,126,152
20746,Senegal,2009,2009Senegal,542,922,1659,845,280,0,4248,535,825,876,781,281,0,3298,7546
20747,Senegal,2009,2009Senegal,687,1460,963,650,119,0,3879,722,600,854,1265,172,0,3613,7492
20748,Senegal,2010,2010Senegal,0,0,0,0,0,0,0,0,0,0,0,0,0,0,759
20749,Senegal,2010,2010Senegal,0,0,0,0,0,0,0,0,0,0,6,0,0,6,6
20750,Senegal,2010,2010Senegal,0,0,0,0,0,0,0,0,0,0,27,0,0,27,27
20751,Senegal,2010,2010Senegal,0,0,0,0,0,13,13,0,0,0,0,0,62,62,75
20752,Senegal,2010,2010Senegal,0,0,0,0,0,237,237,0,0,0,0,0,159,159,396
20753,Senegal,2010,2010Senegal,0,0,0,8,0,0,8,0,0,0,0,0,0,0,8
20754,Senegal,2010,2010Senegal,0,0,5,21,0,0,26,5,6,0,103,5,0,119,145
20755,Senegal,2010,2010Senegal,654,885,485,1588,249,0,3861,690,852,576,1149,0,231,3498,7359
20756,Senegal,2010,2010Senegal,754,746,392,1944,224,0,4060,736,845,384,1258,197,0,3420,7480
20757,Senegal,2011,2011Senegal,0,0,0,0,0,0,0,0,0,0,0,0,0,0,603
20758,Senegal,2011,2011Senegal,0,0,0,0,0,0,0,0,0,0,7,0,0,7,7
20759,Senegal,2011,2011Senegal,0,0,0,0,0,0,0,0,0,0,8,0,0,8,8
20760,Senegal,2011,2011Senegal,0,0,0,0,0,35,35,0,0,0,0,0,110,110,182
20761,Senegal,2011,2011Senegal,0,0,0,0,0,303,303,0,0,0,0,0,185,185,488
20762,Senegal,2011,2011Senegal,0,0,0,5,0,0,5,0,0,0,0,0,5,5,10
20763,Senegal,2011,2011Senegal,0,0,5,0,0,0,5,0,0,5,29,0,0,34,67
20764,Senegal,2011,2011Senegal,0,0,5,14,0,0,19,0,0,0,15,0,0,15,177
20765,Senegal,2011,2011Senegal,0,0,5,26,0,0,31,0,9,0,105,6,0,120,151
20766,Senegal,2011,2011Senegal,546,856,466,2019,240,0,4127,552,936,462,1362,219,0,3531,7658
20767,Senegal,2011,2011Senegal,707,950,528,1917,273,0,4375,761,932,629,1416,246,0,3984,8359
20768,Senegal,2012,2012Senegal,0,0,0,0,0,0,0,0,0,0,0,0,0,0,787
20769,Senegal,2012,2012Senegal,0,0,0,0,0,0,0,0,0,0,5,0,0,5,5
20770,Senegal,2012,2012Senegal,0,0,0,0,0,0,0,0,0,0,9,0,0,9,9
20771,Senegal,2012,2012Senegal,0,0,0,0,0,49,49,0,0,0,0,0,160,160,209
20772,Senegal,2012,2012Senegal,0,0,0,0,0,347,347,0,0,0,0,0,204,204,551
20773,Senegal,2012,2012Senegal,0,0,0,5,0,0,5,0,0,0,0,0,5,5,10
20774,Senegal,2012,2012Senegal,0,0,0,19,0,0,19,0,0,0,10,0,0,10,183
20775,Senegal,2012,2012Senegal,0,0,5,0,0,0,5,0,0,0,31,0,0,31,67
20776,Senegal,2012,2012Senegal,0,0,5,25,0,0,30,0,0,7,108,9,0,124,154
20777,Senegal,2012,2012Senegal,468,888,504,2025,265,0,4150,477,951,506,1384,232,0,3550,7700
20778,Senegal,2012,2012Senegal,747,1060,648,2083,293,0,4831,776,982,651,1516,286,0,4211,9042
20779,Senegal,2013,2013Senegal,0,0,0,0,0,0,0,0,0,0,0,0,0,0,1097
20780,Senegal,2013,2013Senegal,0,0,0,0,0,0,0,0,0,0,5,0,0,5,5
20781,Senegal,2013,2013Senegal,0,0,0,0,0,0,0,0,0,0,7,0,0,7,7
20782,Senegal,2013,2013Senegal,0,0,0,0,0,0,0,0,0,0,9,0,0,9,9
20783,Senegal,2013,2013Senegal,0,0,0,0,0,6,6,0,0,0,0,0,5,5,11
20784,Senegal,2013,2013Senegal,0,0,0,0,0,54,54,0,0,0,0,0,198,198,293
20785,Senegal,2013,2013Senegal,0,0,0,0,0,408,408,0,0,0,0,0,221,221,629
20786,Senegal,2013,2013Senegal,0,0,0,13,0,0,13,0,5,0,13,0,0,18,31
20787,Senegal,2013,2013Senegal,0,0,5,5,0,0,10,0,0,0,51,5,0,56,66
20788,Senegal,2013,2013Senegal,0,0,5,11,0,0,16,0,0,0,18,0,0,18,197
20789,Senegal,2013,2013Senegal,562,1003,547,2139,315,0,4566,550,1058,591,1446,234,0,3879,8445
20790,Senegal,2013,2013Senegal,750,1059,648,2078,286,0,4821,778,982,651,1513,280,0,4204,9025
20791,Senegal,2014,2014Senegal,0,0,0,0,0,0,0,0,0,0,0,0,0,0,2378
20792,Senegal,2014,2014Senegal,0,0,0,0,0,0,0,0,0,0,0,0,5,5,5
20793,Senegal,2014,2014Senegal,0,0,0,0,0,0,0,0,0,0,7,0,0,7,7
20794,Senegal,2014,2014Senegal,0,0,0,0,0,0,0,0,0,0,9,0,0,9,9
20795,Senegal,2014,2014Senegal,0,0,0,0,0,0,0,0,0,0,27,0,0,27,27
20796,Senegal,2014,2014Senegal,0,0,0,0,0,471,471,0,0,0,0,0,235,235,706
20797,Senegal,2014,2014Senegal,0,0,0,15,0,0,15,0,5,0,16,0,0,21,36
20798,Senegal,2014,2014Senegal,0,0,5,5,0,0,10,0,0,0,50,5,0,55,65
20799,Senegal,2014,2014Senegal,0,0,6,14,0,0,20,0,0,0,21,0,0,21,216
20800,Senegal,2014,2014Senegal,5,0,0,5,0,5,15,0,0,0,0,0,9,9,24
20801,Senegal,2014,2014Senegal,579,1020,558,2172,323,0,4652,564,1070,593,1479,243,0,3949,8601
20802,Senegal,2014,2014Senegal,610,1663,1349,1874,210,0,5706,590,1768,1219,1544,209,0,5330,11036
20803,Senegal,2015,2015Senegal,0,0,0,0,0,0,0,0,0,0,0,0,0,0,12456
20804,Senegal,2015,2015Senegal,0,0,0,0,0,0,0,0,0,0,5,0,0,5,5
20805,Senegal,2015,2015Senegal,0,0,0,0,0,0,0,0,0,0,9,0,0,9,9
20806,Senegal,2015,2015Senegal,0,0,0,0,0,94,94,0,0,0,0,0,310,310,404
20807,Senegal,2015,2015Senegal,0,0,0,0,0,537,537,0,0,0,0,0,261,261,798
20808,Senegal,2015,2015Senegal,0,0,0,5,0,0,5,0,0,0,31,0,0,31,36
20809,Senegal,2015,2015Senegal,0,0,0,5,0,0,5,0,0,0,43,0,0,43,48
20810,Senegal,2015,2015Senegal,0,0,0,5,0,14,19,0,0,0,0,0,12,12,31
20811,Senegal,2015,2015Senegal,0,0,0,9,0,0,9,0,0,0,33,5,0,38,47
20812,Senegal,2015,2015Senegal,0,0,0,14,0,0,14,0,5,0,22,0,0,27,41
20813,Senegal,2015,2015Senegal,441,808,556,1782,225,0,3812,399,838,558,1512,273,0,3580,7392
20814,Senegal,2016,2016Senegal,0,0,0,0,0,0,0,0,0,0,0,0,0,0,5368
20815,Senegal,2016,2016Senegal,0,0,0,0,0,0,0,0,0,0,14,0,0,14,14
20816,Senegal,2016,2016Senegal,0,0,0,0,0,106,106,0,0,0,0,0,329,329,435
20817,Senegal,2016,2016Senegal,0,0,0,0,0,624,624,0,0,0,0,0,315,315,939
20818,Senegal,2016,2016Senegal,0,0,0,5,0,0,5,0,0,0,0,0,0,0,5
20819,Senegal,2016,2016Senegal,0,0,0,5,0,0,5,0,0,0,48,0,0,48,53
20820,Senegal,2016,2016Senegal,0,0,0,5,0,0,5,0,0,5,25,0,0,30,35
20821,Senegal,2016,2016Senegal,0,0,0,9,0,0,9,0,0,0,29,5,0,34,43
20822,Senegal,2016,2016Senegal,0,0,0,13,0,0,13,0,0,0,18,0,0,18,228
20823,Senegal,2016,2016Senegal,0,0,0,15,0,0,15,5,0,0,34,0,0,39,54
20824,Senegal,2016,2016Senegal,0,7,0,6,0,7,20,0,0,0,9,0,7,16,36
20825,Senegal,2016,2016Senegal,464,817,560,1780,223,0,3844,436,844,557,1517,272,0,3626,7470
20826,Senegal,2016,2016Senegal,566,990,547,2121,320,0,4544,549,1038,577,1423,243,0,3830,8374
20827,Senegal,2017,2017Senegal,0,0,0,0,0,0,0,0,0,0,0,0,0,0,7521
20828,Senegal,2017,2017Senegal,0,0,0,0,0,0,0,0,5,0,0,0,0,5,5
20829,Senegal,2017,2017Senegal,0,0,0,0,0,739,739,0,0,0,0,0,355,355,1094
20830,Senegal,2017,2017Senegal,0,0,0,5,0,0,5,0,0,0,0,0,0,0,5
20831,Senegal,2017,2017Senegal,0,0,0,5,0,0,5,0,0,0,52,0,0,52,57
20832,Senegal,2017,2017Senegal,0,0,0,5,0,0,5,0,0,0,65,0,0,65,70
20833,Senegal,2017,2017Senegal,0,0,0,8,0,0,8,0,0,0,29,5,0,34,42
20834,Senegal,2017,2017Senegal,0,8,0,32,0,0,40,5,5,0,80,0,0,90,130
20835,Senegal,2017,2017Senegal,0,9,0,9,0,7,25,5,0,0,5,0,7,17,42
20836,Senegal,2017,2017Senegal,390,1115,756,2505,399,0,5165,378,1001,836,1922,247,0,4384,10061
20837,Senegal,2017,2017Senegal,491,826,571,1784,219,0,3891,463,847,561,1527,268,0,3666,7557
20838,Senegal,2018,2018Senegal,0,0,0,0,0,0,0,0,0,0,0,0,0,0,12496
20839,Senegal,2018,2018Senegal,0,0,0,0,0,886,886,0,0,0,0,0,465,465,1351
20840,Senegal,2018,2018Senegal,0,0,0,5,0,0,5,0,0,0,0,0,0,0,5
20841,Senegal,2018,2018Senegal,0,0,0,6,0,0,6,0,0,0,73,0,0,73,79
20842,Senegal,2018,2018Senegal,0,0,0,9,0,0,9,0,0,0,28,5,0,33,42
20843,Senegal,2018,2018Senegal,0,0,6,0,0,0,6,0,5,0,0,0,0,5,11
20844,Senegal,2018,2018Senegal,0,5,0,0,0,0,5,0,0,0,52,0,0,52,57
20845,Senegal,2018,2018Senegal,0,5,0,23,0,0,28,0,5,0,28,0,0,33,248
20846,Senegal,2018,2018Senegal,5,7,0,10,0,11,33,9,0,0,0,0,11,20,53
20847,Senegal,2018,2018Senegal,7,5,0,38,0,0,50,8,0,0,99,0,0,107,157
20848,Senegal,2018,2018Senegal,180,410,350,873,108,0,1921,210,421,326,675,156,0,1788,3709
20849,Senegal,2019,2019Senegal,0,0,0,0,0,0,0,0,0,0,0,0,0,0,9343
20850,Senegal,2019,2019Senegal,0,0,0,0,0,0,0,0,0,0,45,0,0,45,45
20851,Senegal,2019,2019Senegal,0,0,0,0,0,1058,1058,0,0,0,0,0,629,629,1687
20852,Senegal,2019,2019Senegal,0,0,0,6,0,0,6,0,0,0,76,0,0,76,82
20853,Senegal,2019,2019Senegal,0,0,0,8,0,0,8,0,0,0,28,5,0,33,41
20854,Senegal,2019,2019Senegal,0,0,5,0,0,0,5,0,0,5,0,0,0,5,10
20855,Senegal,2019,2019Senegal,0,6,5,12,0,0,23,0,0,0,9,0,0,9,56
20856,Senegal,2019,2019Senegal,0,261,164,412,157,0,994,0,218,186,326,94,0,824,1818
20857,Senegal,2019,2019Senegal,11,13,0,43,0,0,67,9,7,0,95,5,0,116,183
20858,Senegal,2019,2019Senegal,149,400,387,1014,88,0,2038,173,426,363,812,131,0,1905,3943
20859,Senegal,2020,2020Senegal,0,0,0,0,0,0,0,0,0,0,0,0,0,0,7272
20860,Senegal,2020,2020Senegal,0,0,0,0,0,0,0,0,0,0,0,0,5,5,5
20861,Senegal,2020,2020Senegal,0,0,0,0,0,0,0,0,0,0,5,0,0,5,10
20862,Senegal,2020,2020Senegal,0,0,0,0,0,114,114,0,0,0,0,0,257,257,371
20863,Senegal,2020,2020Senegal,0,0,0,8,0,0,8,0,0,0,28,5,0,33,41
20864,Senegal,2020,2020Senegal,0,0,0,10,0,0,10,0,0,0,76,0,0,76,86
20865,Senegal,2020,2020Senegal,0,0,0,14,0,0,14,0,0,0,74,0,0,74,88
20866,Senegal,2020,2020Senegal,0,7,5,14,0,0,26,8,0,0,6,0,0,14,63
20867,Senegal,2020,2020Senegal,0,261,164,412,157,0,994,0,218,186,326,94,0,824,1818
20868,Senegal,2020,2020Senegal,5,0,0,0,0,0,5,0,5,0,0,0,0,5,10
20869,Senegal,2020,2020Senegal,11,17,0,43,0,0,71,10,9,0,108,5,0,132,203
20870,Senegal,2020,2020Senegal,93,355,377,1083,163,0,2071,101,375,385,890,197,0,1948,4019
20871,Senegal,2021,2021Senegal,0,0,0,0,0,0,0,0,0,0,0,0,0,0,8440
20872,Senegal,2021,2021Senegal,0,0,0,0,0,0,0,0,0,0,5,0,0,5,5
20873,Senegal,2021,2021Senegal,0,0,0,5,0,0,5,0,0,0,0,0,0,0,5
20874,Senegal,2021,2021Senegal,0,0,0,9,0,0,9,0,0,0,29,5,0,34,43
20875,Senegal,2021,2021Senegal,0,0,0,19,0,0,19,0,0,0,88,0,0,88,107
20876,Senegal,2021,2021Senegal,0,0,0,24,0,0,24,0,0,0,53,5,0,58,277
20877,Senegal,2021,2021Senegal,0,5,0,0,0,0,5,0,0,0,0,0,0,0,5
20878,Senegal,2021,2021Senegal,0,5,0,0,0,0,5,0,5,0,0,0,0,5,10
20879,Senegal,2021,2021Senegal,0,6,6,14,0,0,26,7,0,0,8,0,0,15,66
20880,Senegal,2021,2021Senegal,0,261,164,412,157,0,994,0,218,186,326,94,0,824,1818
20881,Senegal,2021,2021Senegal,5,0,0,10,0,0,15,0,0,0,91,0,0,91,106
20882,Senegal,2021,2021Senegal,7,16,0,43,0,0,66,8,8,5,110,5,0,136,202
20883,Senegal,2021,2021Senegal,70,345,389,1117,166,0,2087,82,379,397,902,198,0,1958,4045
20884,Serbia and Kosovo: S/RES/1244 (1999),2001,2001Serbia and Kosovo: S/RES/1244 (1999),0,0,0,0,0,0,0,0,0,0,0,0,0,0,110880
20885,Serbia and Kosovo: S/RES/1244 (1999),2001,2001Serbia and Kosovo: S/RES/1244 (1999),0,0,0,0,0,0,0,0,0,0,0,5,0,5,5
20886,Serbia and Kosovo: S/RES/1244 (1999),2001,2001Serbia and Kosovo: S/RES/1244 (1999),0,0,0,0,0,0,0,0,0,0,5,0,0,5,5
20887,Serbia and Kosovo: S/RES/1244 (1999),2001,2001Serbia and Kosovo: S/RES/1244 (1999),0,0,0,0,0,0,0,0,0,0,7,0,0,7,7
20888,Serbia and Kosovo: S/RES/1244 (1999),2001,2001Serbia and Kosovo: S/RES/1244 (1999),0,0,0,0,0,0,0,0,0,0,9,0,0,9,9
20889,Serbia and Kosovo: S/RES/1244 (1999),2001,2001Serbia and Kosovo: S/RES/1244 (1999),0,0,0,0,0,0,0,0,0,5,0,0,0,5,5
20890,Serbia and Kosovo: S/RES/1244 (1999),2001,2001Serbia and Kosovo: S/RES/1244 (1999),0,0,0,0,0,421,421,0,0,0,0,0,556,556,977
20891,Serbia and Kosovo: S/RES/1244 (1999),2001,2001Serbia and Kosovo: S/RES/1244 (1999),0,0,0,0,0,1462,1462,0,0,0,0,0,2453,2453,3915
20892,Serbia and Kosovo: S/RES/1244 (1999),2001,2001Serbia and Kosovo: S/RES/1244 (1999),0,0,0,0,0,5963,5963,0,0,0,0,0,6530,6530,12493
20893,Serbia and Kosovo: S/RES/1244 (1999),2001,2001Serbia and Kosovo: S/RES/1244 (1999),0,0,0,5,0,0,5,0,0,0,0,0,0,0,10
20894,Serbia and Kosovo: S/RES/1244 (1999),2001,2001Serbia and Kosovo: S/RES/1244 (1999),0,0,0,5,0,0,5,0,0,0,5,0,0,5,10
20895,Serbia and Kosovo: S/RES/1244 (1999),2001,2001Serbia and Kosovo: S/RES/1244 (1999),0,0,0,5,0,0,5,0,0,0,8,0,0,8,13
20896,Serbia and Kosovo: S/RES/1244 (1999),2001,2001Serbia and Kosovo: S/RES/1244 (1999),0,0,0,8,0,0,8,0,0,0,7,0,0,7,15
20897,Serbia and Kosovo: S/RES/1244 (1999),2001,2001Serbia and Kosovo: S/RES/1244 (1999),0,0,0,25,35,0,60,0,0,0,64,0,0,64,124
20898,Serbia and Kosovo: S/RES/1244 (1999),2001,2001Serbia and Kosovo: S/RES/1244 (1999),0,0,6,0,0,0,6,0,0,0,0,0,0,0,6
20899,Serbia and Kosovo: S/RES/1244 (1999),2001,2001Serbia and Kosovo: S/RES/1244 (1999),0,5,0,0,0,0,5,0,0,0,5,0,0,5,382
20900,Serbia and Kosovo: S/RES/1244 (1999),2001,2001Serbia and Kosovo: S/RES/1244 (1999),0,8,0,6,0,0,14,0,8,0,8,0,0,16,275
20901,Serbia and Kosovo: S/RES/1244 (1999),2001,2001Serbia and Kosovo: S/RES/1244 (1999),7,0,0,0,0,0,7,0,5,0,7,0,0,12,19
20902,Serbia and Kosovo: S/RES/1244 (1999),2001,2001Serbia and Kosovo: S/RES/1244 (1999),13,56,49,365,84,0,567,63,149,129,413,75,0,829,1396
20903,Serbia and Kosovo: S/RES/1244 (1999),2001,2001Serbia and Kosovo: S/RES/1244 (1999),14,20,18,89,8,0,149,14,18,16,45,18,0,111,278
20904,Serbia and Kosovo: S/RES/1244 (1999),2001,2001Serbia and Kosovo: S/RES/1244 (1999),130,129,111,330,18,0,718,112,152,131,395,17,0,807,9100
20905,Serbia and Kosovo: S/RES/1244 (1999),2001,2001Serbia and Kosovo: S/RES/1244 (1999),250,281,241,825,97,0,1694,263,311,267,761,61,0,1663,4307
20906,Serbia and Kosovo: S/RES/1244 (1999),2002,2002Serbia and Kosovo: S/RES/1244 (1999),0,0,0,0,0,0,0,0,0,0,0,0,0,0,300065
20907,Serbia and Kosovo: S/RES/1244 (1999),2002,2002Serbia and Kosovo: S/RES/1244 (1999),0,0,0,0,0,0,0,0,0,0,0,5,0,5,5
20908,Serbia and Kosovo: S/RES/1244 (1999),2002,2002Serbia and Kosovo: S/RES/1244 (1999),0,0,0,0,0,0,0,0,0,0,8,0,0,8,8
20909,Serbia and Kosovo: S/RES/1244 (1999),2002,2002Serbia and Kosovo: S/RES/1244 (1999),0,0,0,0,0,8,8,0,0,0,0,0,12,12,20
20910,Serbia and Kosovo: S/RES/1244 (1999),2002,2002Serbia and Kosovo: S/RES/1244 (1999),0,0,0,0,0,1547,1547,0,0,0,0,0,1812,1812,12001
20911,Serbia and Kosovo: S/RES/1244 (1999),2002,2002Serbia and Kosovo: S/RES/1244 (1999),0,0,0,0,0,2401,2401,0,0,0,0,0,3188,3188,5589
20912,Serbia and Kosovo: S/RES/1244 (1999),2002,2002Serbia and Kosovo: S/RES/1244 (1999),0,0,0,0,35,0,35,0,0,0,0,89,0,89,124
20913,Serbia and Kosovo: S/RES/1244 (1999),2002,2002Serbia and Kosovo: S/RES/1244 (1999),0,0,0,5,0,0,5,0,0,0,0,0,0,0,5
20914,Serbia and Kosovo: S/RES/1244 (1999),2002,2002Serbia and Kosovo: S/RES/1244 (1999),0,0,0,5,0,0,5,0,0,0,8,0,0,8,13
20915,Serbia and Kosovo: S/RES/1244 (1999),2002,2002Serbia and Kosovo: S/RES/1244 (1999),0,0,0,6,0,0,6,0,0,0,0,0,0,0,6
20916,Serbia and Kosovo: S/RES/1244 (1999),2002,2002Serbia and Kosovo: S/RES/1244 (1999),0,0,0,8,0,0,8,0,0,0,6,0,0,6,14
20917,Serbia and Kosovo: S/RES/1244 (1999),2002,2002Serbia and Kosovo: S/RES/1244 (1999),0,0,0,9,0,0,9,0,0,0,0,0,0,0,9
20918,Serbia and Kosovo: S/RES/1244 (1999),2002,2002Serbia and Kosovo: S/RES/1244 (1999),0,0,5,0,0,0,5,0,0,0,0,0,0,0,5
20919,Serbia and Kosovo: S/RES/1244 (1999),2002,2002Serbia and Kosovo: S/RES/1244 (1999),5,9,7,98,12,0,131,10,18,22,86,8,0,144,275
20920,Serbia and Kosovo: S/RES/1244 (1999),2002,2002Serbia and Kosovo: S/RES/1244 (1999),5,21,19,138,50,0,233,23,81,71,211,60,0,446,679
20921,Serbia and Kosovo: S/RES/1244 (1999),2002,2002Serbia and Kosovo: S/RES/1244 (1999),162,273,238,650,76,0,1399,162,267,232,643,46,0,1350,2765
20922,Serbia and Kosovo: S/RES/1244 (1999),2002,2002Serbia and Kosovo: S/RES/1244 (1999),221,375,322,1952,235,0,3105,225,409,350,1716,194,0,2894,5999
20923,Serbia and Kosovo: S/RES/1244 (1999),2003,2003Serbia and Kosovo: S/RES/1244 (1999),0,0,0,0,0,0,0,0,0,0,0,0,0,0,275813
20924,Serbia and Kosovo: S/RES/1244 (1999),2003,2003Serbia and Kosovo: S/RES/1244 (1999),0,0,0,0,0,0,0,0,0,0,0,5,0,5,5
20925,Serbia and Kosovo: S/RES/1244 (1999),2003,2003Serbia and Kosovo: S/RES/1244 (1999),0,0,0,0,0,0,0,0,0,0,7,0,0,7,7
20926,Serbia and Kosovo: S/RES/1244 (1999),2003,2003Serbia and Kosovo: S/RES/1244 (1999),0,0,0,0,0,13,13,0,0,0,0,0,18,18,37
20927,Serbia and Kosovo: S/RES/1244 (1999),2003,2003Serbia and Kosovo: S/RES/1244 (1999),0,0,0,0,0,1485,1485,0,0,0,0,0,1699,1699,11249
20928,Serbia and Kosovo: S/RES/1244 (1999),2003,2003Serbia and Kosovo: S/RES/1244 (1999),0,0,0,0,0,2449,2449,0,0,0,0,0,3193,3193,5642
20929,Serbia and Kosovo: S/RES/1244 (1999),2003,2003Serbia and Kosovo: S/RES/1244 (1999),0,0,0,0,33,0,33,0,0,0,0,89,0,89,122
20930,Serbia and Kosovo: S/RES/1244 (1999),2003,2003Serbia and Kosovo: S/RES/1244 (1999),0,0,0,5,0,0,5,0,0,0,8,0,0,8,13
20931,Serbia and Kosovo: S/RES/1244 (1999),2003,2003Serbia and Kosovo: S/RES/1244 (1999),0,0,0,8,0,0,8,0,0,0,0,0,0,0,8
20932,Serbia and Kosovo: S/RES/1244 (1999),2003,2003Serbia and Kosovo: S/RES/1244 (1999),0,0,5,0,0,0,5,0,0,5,0,0,0,5,10
20933,Serbia and Kosovo: S/RES/1244 (1999),2003,2003Serbia and Kosovo: S/RES/1244 (1999),0,5,0,5,0,0,10,0,0,0,10,0,0,10,20
20934,Serbia and Kosovo: S/RES/1244 (1999),2003,2003Serbia and Kosovo: S/RES/1244 (1999),0,9,12,87,40,0,148,5,68,59,125,50,0,307,455
20935,Serbia and Kosovo: S/RES/1244 (1999),2003,2003Serbia and Kosovo: S/RES/1244 (1999),5,8,6,73,10,0,102,8,17,14,66,6,0,111,213
20936,Serbia and Kosovo: S/RES/1244 (1999),2003,2003Serbia and Kosovo: S/RES/1244 (1999),97,186,158,977,114,0,1532,98,214,182,904,103,0,1501,3033
20937,Serbia and Kosovo: S/RES/1244 (1999),2004,2004Serbia and Kosovo: S/RES/1244 (1999),0,0,0,0,0,0,0,0,0,0,0,0,0,0,220635
20938,Serbia and Kosovo: S/RES/1244 (1999),2004,2004Serbia and Kosovo: S/RES/1244 (1999),0,0,0,0,0,0,0,0,0,0,0,5,0,5,5
20939,Serbia and Kosovo: S/RES/1244 (1999),2004,2004Serbia and Kosovo: S/RES/1244 (1999),0,0,0,0,0,0,0,0,0,0,7,0,0,7,7
20940,Serbia and Kosovo: S/RES/1244 (1999),2004,2004Serbia and Kosovo: S/RES/1244 (1999),0,0,0,0,0,0,0,0,0,5,0,0,0,5,5
20941,Serbia and Kosovo: S/RES/1244 (1999),2004,2004Serbia and Kosovo: S/RES/1244 (1999),0,0,0,0,0,19,19,0,0,0,0,0,27,27,46
20942,Serbia and Kosovo: S/RES/1244 (1999),2004,2004Serbia and Kosovo: S/RES/1244 (1999),0,0,0,0,29,0,29,0,0,0,0,84,0,84,113
20943,Serbia and Kosovo: S/RES/1244 (1999),2004,2004Serbia and Kosovo: S/RES/1244 (1999),0,0,0,5,0,0,5,0,0,0,6,0,0,6,11
20944,Serbia and Kosovo: S/RES/1244 (1999),2004,2004Serbia and Kosovo: S/RES/1244 (1999),0,0,0,9,0,0,9,0,0,0,0,0,0,0,9
20945,Serbia and Kosovo: S/RES/1244 (1999),2004,2004Serbia and Kosovo: S/RES/1244 (1999),0,0,0,22,0,0,22,0,0,0,38,0,0,38,60
20946,Serbia and Kosovo: S/RES/1244 (1999),2004,2004Serbia and Kosovo: S/RES/1244 (1999),0,0,5,22,0,0,27,0,5,0,32,0,0,37,64
20947,Serbia and Kosovo: S/RES/1244 (1999),2004,2004Serbia and Kosovo: S/RES/1244 (1999),0,5,0,5,0,0,10,9,0,0,14,0,0,23,33
20948,Serbia and Kosovo: S/RES/1244 (1999),2004,2004Serbia and Kosovo: S/RES/1244 (1999),0,6,0,0,0,0,6,0,0,0,7,0,0,7,390
20949,Serbia and Kosovo: S/RES/1244 (1999),2004,2004Serbia and Kosovo: S/RES/1244 (1999),0,8,0,13,0,0,21,0,0,0,19,0,0,19,40
20950,Serbia and Kosovo: S/RES/1244 (1999),2004,2004Serbia and Kosovo: S/RES/1244 (1999),5,8,6,73,10,0,102,8,17,14,66,6,0,111,213
20951,Serbia and Kosovo: S/RES/1244 (1999),2004,2004Serbia and Kosovo: S/RES/1244 (1999),5,15,19,87,35,0,161,16,63,53,132,33,0,297,458
20952,Serbia and Kosovo: S/RES/1244 (1999),2004,2004Serbia and Kosovo: S/RES/1244 (1999),58,101,86,237,18,0,500,64,92,80,231,12,0,479,979
20953,Serbia and Kosovo: S/RES/1244 (1999),2004,2004Serbia and Kosovo: S/RES/1244 (1999),100,189,161,971,114,0,1535,95,209,177,871,104,0,1456,2991
20954,Serbia and Kosovo: S/RES/1244 (1999),2004,2004Serbia and Kosovo: S/RES/1244 (1999),334,792,679,2026,177,1399,5407,394,853,731,1858,101,1612,5549,10956
20955,Serbia and Kosovo: S/RES/1244 (1999),2005,2005Serbia and Kosovo: S/RES/1244 (1999),0,0,0,0,0,0,0,0,0,0,0,0,0,0,166928
20956,Serbia and Kosovo: S/RES/1244 (1999),2005,2005Serbia and Kosovo: S/RES/1244 (1999),0,0,0,0,0,0,0,0,0,0,0,5,0,5,5
20957,Serbia and Kosovo: S/RES/1244 (1999),2005,2005Serbia and Kosovo: S/RES/1244 (1999),0,0,0,0,0,0,0,0,0,0,7,0,0,7,7
20958,Serbia and Kosovo: S/RES/1244 (1999),2005,2005Serbia and Kosovo: S/RES/1244 (1999),0,0,0,0,0,0,0,0,0,5,0,0,0,5,5
20959,Serbia and Kosovo: S/RES/1244 (1999),2005,2005Serbia and Kosovo: S/RES/1244 (1999),0,0,0,0,0,21,21,0,0,0,0,0,19,19,40
20960,Serbia and Kosovo: S/RES/1244 (1999),2005,2005Serbia and Kosovo: S/RES/1244 (1999),0,0,0,0,0,27,27,0,0,0,0,0,37,37,64
20961,Serbia and Kosovo: S/RES/1244 (1999),2005,2005Serbia and Kosovo: S/RES/1244 (1999),0,0,0,0,0,3120,3120,0,0,0,0,0,3868,3868,6988
20962,Serbia and Kosovo: S/RES/1244 (1999),2005,2005Serbia and Kosovo: S/RES/1244 (1999),0,0,0,0,28,0,28,0,0,0,0,82,0,82,110
20963,Serbia and Kosovo: S/RES/1244 (1999),2005,2005Serbia and Kosovo: S/RES/1244 (1999),0,0,0,5,0,0,5,0,0,0,0,0,0,0,5
20964,Serbia and Kosovo: S/RES/1244 (1999),2005,2005Serbia and Kosovo: S/RES/1244 (1999),0,0,0,5,0,0,5,0,0,0,7,0,0,7,12
20965,Serbia and Kosovo: S/RES/1244 (1999),2005,2005Serbia and Kosovo: S/RES/1244 (1999),0,0,0,7,0,0,7,0,0,5,11,0,0,16,23
20966,Serbia and Kosovo: S/RES/1244 (1999),2005,2005Serbia and Kosovo: S/RES/1244 (1999),0,0,0,9,0,0,9,0,0,0,0,0,0,0,9
20967,Serbia and Kosovo: S/RES/1244 (1999),2005,2005Serbia and Kosovo: S/RES/1244 (1999),0,0,6,11,0,0,17,0,0,11,16,0,0,27,44
20968,Serbia and Kosovo: S/RES/1244 (1999),2005,2005Serbia and Kosovo: S/RES/1244 (1999),0,0,8,0,0,0,8,0,0,0,0,0,0,0,390
20969,Serbia and Kosovo: S/RES/1244 (1999),2005,2005Serbia and Kosovo: S/RES/1244 (1999),0,9,0,12,0,0,21,5,6,0,8,0,0,19,40
20970,Serbia and Kosovo: S/RES/1244 (1999),2005,2005Serbia and Kosovo: S/RES/1244 (1999),11,11,17,73,22,0,134,15,51,43,119,20,0,248,382
20971,Serbia and Kosovo: S/RES/1244 (1999),2005,2005Serbia and Kosovo: S/RES/1244 (1999),73,124,112,293,26,0,628,85,118,109,296,13,0,621,1249
20972,Serbia and Kosovo: S/RES/1244 (1999),2005,2005Serbia and Kosovo: S/RES/1244 (1999),105,207,177,991,110,0,1590,110,215,182,904,97,0,1508,3098
20973,Serbia and Kosovo: S/RES/1244 (1999),2005,2005Serbia and Kosovo: S/RES/1244 (1999),284,773,663,1996,179,1345,5240,290,858,736,1842,102,1518,5346,10586
20974,Serbia and Kosovo: S/RES/1244 (1999),2006,2006Serbia and Kosovo: S/RES/1244 (1999),0,0,0,0,0,0,0,0,0,0,0,0,0,0,149924
20975,Serbia and Kosovo: S/RES/1244 (1999),2006,2006Serbia and Kosovo: S/RES/1244 (1999),0,0,0,0,0,0,0,0,0,0,0,5,0,5,5
20976,Serbia and Kosovo: S/RES/1244 (1999),2006,2006Serbia and Kosovo: S/RES/1244 (1999),0,0,0,0,0,0,0,0,0,0,7,0,0,7,7
20977,Serbia and Kosovo: S/RES/1244 (1999),2006,2006Serbia and Kosovo: S/RES/1244 (1999),0,0,0,0,0,0,0,0,0,0,8,0,0,8,8
20978,Serbia and Kosovo: S/RES/1244 (1999),2006,2006Serbia and Kosovo: S/RES/1244 (1999),0,0,0,0,0,0,0,0,0,5,0,0,0,5,5
20979,Serbia and Kosovo: S/RES/1244 (1999),2006,2006Serbia and Kosovo: S/RES/1244 (1999),0,0,0,0,0,21,21,0,0,0,0,0,19,19,40
20980,Serbia and Kosovo: S/RES/1244 (1999),2006,2006Serbia and Kosovo: S/RES/1244 (1999),0,0,0,0,0,27,27,0,0,0,0,0,42,42,69
20981,Serbia and Kosovo: S/RES/1244 (1999),2006,2006Serbia and Kosovo: S/RES/1244 (1999),0,0,0,0,0,747,747,0,0,0,0,0,859,859,1606
20982,Serbia and Kosovo: S/RES/1244 (1999),2006,2006Serbia and Kosovo: S/RES/1244 (1999),0,0,0,0,0,3278,3278,0,0,0,0,0,4056,4056,7334
20983,Serbia and Kosovo: S/RES/1244 (1999),2006,2006Serbia and Kosovo: S/RES/1244 (1999),0,0,0,0,0,4868,4868,0,0,0,0,0,4959,4959,9827
20984,Serbia and Kosovo: S/RES/1244 (1999),2006,2006Serbia and Kosovo: S/RES/1244 (1999),0,0,0,0,28,0,28,0,0,0,0,80,0,80,108
20985,Serbia and Kosovo: S/RES/1244 (1999),2006,2006Serbia and Kosovo: S/RES/1244 (1999),0,0,0,5,0,0,5,0,0,0,0,0,0,0,5
20986,Serbia and Kosovo: S/RES/1244 (1999),2006,2006Serbia and Kosovo: S/RES/1244 (1999),0,0,0,9,0,0,9,0,0,0,0,0,0,0,9
20987,Serbia and Kosovo: S/RES/1244 (1999),2006,2006Serbia and Kosovo: S/RES/1244 (1999),0,0,5,0,0,0,5,0,0,0,7,0,0,7,12
20988,Serbia and Kosovo: S/RES/1244 (1999),2006,2006Serbia and Kosovo: S/RES/1244 (1999),0,0,5,0,0,0,5,0,0,5,0,0,0,5,390
20989,Serbia and Kosovo: S/RES/1244 (1999),2006,2006Serbia and Kosovo: S/RES/1244 (1999),0,0,6,11,0,0,17,0,0,11,16,0,0,27,44
20990,Serbia and Kosovo: S/RES/1244 (1999),2006,2006Serbia and Kosovo: S/RES/1244 (1999),0,0,6,12,0,0,18,0,0,9,13,0,0,22,40
20991,Serbia and Kosovo: S/RES/1244 (1999),2006,2006Serbia and Kosovo: S/RES/1244 (1999),0,0,19,67,28,0,114,10,30,48,109,28,0,225,339
20992,Serbia and Kosovo: S/RES/1244 (1999),2006,2006Serbia and Kosovo: S/RES/1244 (1999),69,127,102,291,20,0,609,76,114,100,304,15,0,609,1218
20993,Serbia and Kosovo: S/RES/1244 (1999),2006,2006Serbia and Kosovo: S/RES/1244 (1999),143,185,199,929,111,0,1567,129,200,218,830,88,0,1465,3032
20994,Serbia and Kosovo: S/RES/1244 (1999),2007,2007Serbia and Kosovo: S/RES/1244 (1999),0,0,0,0,0,0,0,0,0,0,0,0,0,0,146119
20995,Serbia and Kosovo: S/RES/1244 (1999),2007,2007Serbia and Kosovo: S/RES/1244 (1999),0,0,0,0,0,0,0,0,0,0,0,5,0,5,5
20996,Serbia and Kosovo: S/RES/1244 (1999),2007,2007Serbia and Kosovo: S/RES/1244 (1999),0,0,0,0,0,0,0,0,0,0,7,0,0,7,7
20997,Serbia and Kosovo: S/RES/1244 (1999),2007,2007Serbia and Kosovo: S/RES/1244 (1999),0,0,0,0,0,0,0,0,0,0,8,0,0,8,8
20998,Serbia and Kosovo: S/RES/1244 (1999),2007,2007Serbia and Kosovo: S/RES/1244 (1999),0,0,0,0,0,5,5,0,0,0,0,0,0,0,5
20999,Serbia and Kosovo: S/RES/1244 (1999),2007,2007Serbia and Kosovo: S/RES/1244 (1999),0,0,0,0,0,600,600,0,0,0,0,0,720,720,1320
21000,Serbia and Kosovo: S/RES/1244 (1999),2007,2007Serbia and Kosovo: S/RES/1244 (1999),0,0,0,0,0,1360,1360,0,0,0,0,0,6488,6488,7848
21001,Serbia and Kosovo: S/RES/1244 (1999),2007,2007Serbia and Kosovo: S/RES/1244 (1999),0,0,0,0,26,0,26,0,0,0,0,78,0,78,104
21002,Serbia and Kosovo: S/RES/1244 (1999),2007,2007Serbia and Kosovo: S/RES/1244 (1999),0,0,0,5,0,0,5,0,0,0,9,0,0,9,14
21003,Serbia and Kosovo: S/RES/1244 (1999),2007,2007Serbia and Kosovo: S/RES/1244 (1999),0,0,0,9,0,0,9,0,0,0,0,0,0,0,9
21004,Serbia and Kosovo: S/RES/1244 (1999),2007,2007Serbia and Kosovo: S/RES/1244 (1999),0,0,5,0,0,0,5,0,0,0,7,0,0,7,12
21005,Serbia and Kosovo: S/RES/1244 (1999),2007,2007Serbia and Kosovo: S/RES/1244 (1999),0,0,5,23,0,0,28,0,0,5,37,0,0,42,70
21006,Serbia and Kosovo: S/RES/1244 (1999),2007,2007Serbia and Kosovo: S/RES/1244 (1999),0,0,6,11,0,0,17,0,0,11,16,0,0,27,44
21007,Serbia and Kosovo: S/RES/1244 (1999),2007,2007Serbia and Kosovo: S/RES/1244 (1999),0,5,8,13,0,0,26,0,5,5,15,0,0,25,51
21008,Serbia and Kosovo: S/RES/1244 (1999),2007,2007Serbia and Kosovo: S/RES/1244 (1999),5,0,12,66,23,0,106,11,23,48,97,20,0,199,305
21009,Serbia and Kosovo: S/RES/1244 (1999),2007,2007Serbia and Kosovo: S/RES/1244 (1999),10,26,18,45,0,0,99,20,18,7,43,0,0,88,187
21010,Serbia and Kosovo: S/RES/1244 (1999),2007,2007Serbia and Kosovo: S/RES/1244 (1999),51,102,101,296,25,0,575,72,95,78,304,18,0,567,1213
21011,Serbia and Kosovo: S/RES/1244 (1999),2007,2007Serbia and Kosovo: S/RES/1244 (1999),179,539,503,1601,175,1140,4137,199,608,572,1424,99,1276,4178,8315
21012,Serbia and Kosovo: S/RES/1244 (1999),2008,2008Serbia and Kosovo: S/RES/1244 (1999),0,0,0,0,0,0,0,0,0,0,0,0,0,0,150375
21013,Serbia and Kosovo: S/RES/1244 (1999),2008,2008Serbia and Kosovo: S/RES/1244 (1999),0,0,0,0,0,0,0,0,0,0,0,5,0,5,5
21014,Serbia and Kosovo: S/RES/1244 (1999),2008,2008Serbia and Kosovo: S/RES/1244 (1999),0,0,0,0,0,0,0,0,0,0,5,0,0,5,5
21015,Serbia and Kosovo: S/RES/1244 (1999),2008,2008Serbia and Kosovo: S/RES/1244 (1999),0,0,0,0,0,0,0,0,0,0,7,0,0,7,7
21016,Serbia and Kosovo: S/RES/1244 (1999),2008,2008Serbia and Kosovo: S/RES/1244 (1999),0,0,0,0,0,0,0,0,0,0,8,0,0,8,8
21017,Serbia and Kosovo: S/RES/1244 (1999),2008,2008Serbia and Kosovo: S/RES/1244 (1999),0,0,0,0,0,505,505,0,0,0,0,0,667,667,1172
21018,Serbia and Kosovo: S/RES/1244 (1999),2008,2008Serbia and Kosovo: S/RES/1244 (1999),0,0,0,0,0,3431,3431,0,0,0,0,0,4964,4964,8395
21019,Serbia and Kosovo: S/RES/1244 (1999),2008,2008Serbia and Kosovo: S/RES/1244 (1999),0,0,0,0,26,0,26,0,0,0,0,77,0,77,103
21020,Serbia and Kosovo: S/RES/1244 (1999),2008,2008Serbia and Kosovo: S/RES/1244 (1999),0,0,0,5,0,0,5,0,0,0,9,0,0,9,14
21021,Serbia and Kosovo: S/RES/1244 (1999),2008,2008Serbia and Kosovo: S/RES/1244 (1999),0,0,5,23,0,0,28,0,0,5,37,0,0,42,70
21022,Serbia and Kosovo: S/RES/1244 (1999),2008,2008Serbia and Kosovo: S/RES/1244 (1999),0,0,6,15,0,0,21,5,0,9,12,0,0,26,47
21023,Serbia and Kosovo: S/RES/1244 (1999),2008,2008Serbia and Kosovo: S/RES/1244 (1999),10,20,23,42,0,0,95,12,16,9,38,0,0,75,170
21024,Serbia and Kosovo: S/RES/1244 (1999),2008,2008Serbia and Kosovo: S/RES/1244 (1999),12,0,5,63,21,5,106,12,15,43,104,17,0,191,302
21025,Serbia and Kosovo: S/RES/1244 (1999),2008,2008Serbia and Kosovo: S/RES/1244 (1999),62,104,102,289,21,0,578,67,116,80,294,17,0,574,1650
21026,Serbia and Kosovo: S/RES/1244 (1999),2008,2008Serbia and Kosovo: S/RES/1244 (1999),145,427,442,1483,171,1030,3698,153,499,506,1291,96,1154,3699,7397
21027,Serbia and Kosovo: S/RES/1244 (1999),2008,2008Serbia and Kosovo: S/RES/1244 (1999),351,1108,1108,4392,1359,0,8318,424,1190,1226,4081,971,0,7892,16210
21028,Serbia and Kosovo: S/RES/1244 (1999),2009,2009Serbia and Kosovo: S/RES/1244 (1999),0,0,0,0,0,0,0,0,0,0,0,0,0,0,45941
21029,Serbia and Kosovo: S/RES/1244 (1999),2009,2009Serbia and Kosovo: S/RES/1244 (1999),0,0,0,0,0,0,0,0,0,0,0,5,0,5,5
21030,Serbia and Kosovo: S/RES/1244 (1999),2009,2009Serbia and Kosovo: S/RES/1244 (1999),0,0,0,0,0,0,0,0,0,0,5,0,0,5,5
21031,Serbia and Kosovo: S/RES/1244 (1999),2009,2009Serbia and Kosovo: S/RES/1244 (1999),0,0,0,0,0,0,0,0,0,0,7,0,0,7,7
21032,Serbia and Kosovo: S/RES/1244 (1999),2009,2009Serbia and Kosovo: S/RES/1244 (1999),0,0,0,0,0,0,0,0,0,0,8,0,0,8,8
21033,Serbia and Kosovo: S/RES/1244 (1999),2009,2009Serbia and Kosovo: S/RES/1244 (1999),0,0,0,0,0,442,442,0,0,0,0,0,617,617,1059
21034,Serbia and Kosovo: S/RES/1244 (1999),2009,2009Serbia and Kosovo: S/RES/1244 (1999),0,0,0,5,0,0,5,0,0,0,0,0,0,0,5
21035,Serbia and Kosovo: S/RES/1244 (1999),2009,2009Serbia and Kosovo: S/RES/1244 (1999),0,0,0,5,0,0,5,0,0,0,9,0,0,9,14
21036,Serbia and Kosovo: S/RES/1244 (1999),2009,2009Serbia and Kosovo: S/RES/1244 (1999),0,0,5,23,0,0,28,0,0,5,39,5,0,49,77
21037,Serbia and Kosovo: S/RES/1244 (1999),2009,2009Serbia and Kosovo: S/RES/1244 (1999),0,5,0,0,23,0,28,0,0,0,5,72,0,77,105
21038,Serbia and Kosovo: S/RES/1244 (1999),2009,2009Serbia and Kosovo: S/RES/1244 (1999),5,0,6,10,0,0,21,0,5,9,13,0,0,27,48
21039,Serbia and Kosovo: S/RES/1244 (1999),2009,2009Serbia and Kosovo: S/RES/1244 (1999),7,20,21,46,0,0,94,12,13,12,43,0,0,80,174
21040,Serbia and Kosovo: S/RES/1244 (1999),2009,2009Serbia and Kosovo: S/RES/1244 (1999),12,0,7,55,17,0,91,13,14,35,97,14,0,173,269
21041,Serbia and Kosovo: S/RES/1244 (1999),2009,2009Serbia and Kosovo: S/RES/1244 (1999),57,104,84,277,21,0,543,59,105,71,275,11,0,521,1520
21042,Serbia and Kosovo: S/RES/1244 (1999),2009,2009Serbia and Kosovo: S/RES/1244 (1999),125,354,366,1315,155,926,3241,135,406,422,1126,101,1060,3250,6491
21043,Serbia and Kosovo: S/RES/1244 (1999),2009,2009Serbia and Kosovo: S/RES/1244 (1999),316,1018,1134,4427,1406,0,8301,384,1097,1243,4174,998,0,7896,16197
21044,Serbia and Kosovo: S/RES/1244 (1999),2009,2009Serbia and Kosovo: S/RES/1244 (1999),1293,5714,8825,37552,1626,0,55010,1413,5869,9054,50575,1779,0,68690,123700
21045,Serbia and Kosovo: S/RES/1244 (1999),2010,2010Serbia and Kosovo: S/RES/1244 (1999),0,0,0,0,0,0,0,0,0,0,0,0,0,0,31640
21046,Serbia and Kosovo: S/RES/1244 (1999),2010,2010Serbia and Kosovo: S/RES/1244 (1999),0,0,0,0,0,0,0,0,0,0,0,0,5,5,5
21047,Serbia and Kosovo: S/RES/1244 (1999),2010,2010Serbia and Kosovo: S/RES/1244 (1999),0,0,0,0,0,0,0,0,0,0,0,5,0,5,5
21048,Serbia and Kosovo: S/RES/1244 (1999),2010,2010Serbia and Kosovo: S/RES/1244 (1999),0,0,0,0,0,0,0,0,0,0,7,0,0,7,7
21049,Serbia and Kosovo: S/RES/1244 (1999),2010,2010Serbia and Kosovo: S/RES/1244 (1999),0,0,0,0,0,0,0,0,0,0,8,0,0,8,8
21050,Serbia and Kosovo: S/RES/1244 (1999),2010,2010Serbia and Kosovo: S/RES/1244 (1999),0,0,0,0,0,434,434,0,0,0,0,0,606,606,1040
21051,Serbia and Kosovo: S/RES/1244 (1999),2010,2010Serbia and Kosovo: S/RES/1244 (1999),0,0,0,0,0,4574,4574,0,0,0,0,0,5411,5411,9985
21052,Serbia and Kosovo: S/RES/1244 (1999),2010,2010Serbia and Kosovo: S/RES/1244 (1999),0,0,0,5,0,0,5,0,0,0,9,0,0,9,14
21053,Serbia and Kosovo: S/RES/1244 (1999),2010,2010Serbia and Kosovo: S/RES/1244 (1999),0,0,0,25,5,0,30,0,0,5,37,5,0,47,77
21054,Serbia and Kosovo: S/RES/1244 (1999),2010,2010Serbia and Kosovo: S/RES/1244 (1999),0,5,0,0,20,0,25,0,0,0,5,69,0,74,99
21055,Serbia and Kosovo: S/RES/1244 (1999),2010,2010Serbia and Kosovo: S/RES/1244 (1999),5,0,0,17,0,0,22,5,6,0,16,0,0,27,49
21056,Serbia and Kosovo: S/RES/1244 (1999),2010,2010Serbia and Kosovo: S/RES/1244 (1999),5,5,6,50,15,0,81,7,10,10,97,35,0,159,240
21057,Serbia and Kosovo: S/RES/1244 (1999),2010,2010Serbia and Kosovo: S/RES/1244 (1999),9,14,20,46,0,0,89,5,18,10,41,0,0,74,163
21058,Serbia and Kosovo: S/RES/1244 (1999),2010,2010Serbia and Kosovo: S/RES/1244 (1999),51,84,76,262,16,0,489,56,84,66,252,11,0,469,1376
21059,Serbia and Kosovo: S/RES/1244 (1999),2010,2010Serbia and Kosovo: S/RES/1244 (1999),107,284,314,1116,120,720,2661,112,317,349,952,87,810,2627,5288
21060,Serbia and Kosovo: S/RES/1244 (1999),2010,2010Serbia and Kosovo: S/RES/1244 (1999),288,643,728,2877,921,0,5457,328,702,816,2973,672,0,5491,10948
21061,Serbia and Kosovo: S/RES/1244 (1999),2010,2010Serbia and Kosovo: S/RES/1244 (1999),1129,5015,8226,38445,1902,0,54717,1251,5249,8399,50638,2086,0,67623,122340
21062,Serbia and Kosovo: S/RES/1244 (1999),2011,2011Serbia and Kosovo: S/RES/1244 (1999),0,0,0,0,0,0,0,0,0,0,0,0,0,0,23242
21063,Serbia and Kosovo: S/RES/1244 (1999),2011,2011Serbia and Kosovo: S/RES/1244 (1999),0,0,0,0,0,0,0,0,0,0,0,5,0,5,5
21064,Serbia and Kosovo: S/RES/1244 (1999),2011,2011Serbia and Kosovo: S/RES/1244 (1999),0,0,0,0,0,0,0,0,0,0,7,0,0,7,7
21065,Serbia and Kosovo: S/RES/1244 (1999),2011,2011Serbia and Kosovo: S/RES/1244 (1999),0,0,0,0,0,0,0,0,0,0,8,0,0,8,8
21066,Serbia and Kosovo: S/RES/1244 (1999),2011,2011Serbia and Kosovo: S/RES/1244 (1999),0,0,0,0,0,0,0,0,5,0,0,0,0,5,5
21067,Serbia and Kosovo: S/RES/1244 (1999),2011,2011Serbia and Kosovo: S/RES/1244 (1999),0,0,0,0,0,455,455,0,0,0,0,0,611,611,1066
21068,Serbia and Kosovo: S/RES/1244 (1999),2011,2011Serbia and Kosovo: S/RES/1244 (1999),0,0,0,0,0,5044,5044,0,0,0,0,0,5411,5411,10891
21069,Serbia and Kosovo: S/RES/1244 (1999),2011,2011Serbia and Kosovo: S/RES/1244 (1999),0,0,0,5,0,0,5,0,0,0,9,0,0,9,14
21070,Serbia and Kosovo: S/RES/1244 (1999),2011,2011Serbia and Kosovo: S/RES/1244 (1999),0,0,0,25,5,0,30,0,0,5,37,5,0,47,77
21071,Serbia and Kosovo: S/RES/1244 (1999),2011,2011Serbia and Kosovo: S/RES/1244 (1999),0,5,0,0,19,0,24,0,0,0,5,65,0,70,94
21072,Serbia and Kosovo: S/RES/1244 (1999),2011,2011Serbia and Kosovo: S/RES/1244 (1999),0,9,5,47,12,0,73,0,17,28,99,10,0,154,227
21073,Serbia and Kosovo: S/RES/1244 (1999),2011,2011Serbia and Kosovo: S/RES/1244 (1999),0,13,9,32,0,0,54,6,8,6,43,0,0,63,443
21074,Serbia and Kosovo: S/RES/1244 (1999),2011,2011Serbia and Kosovo: S/RES/1244 (1999),5,0,5,12,0,0,22,5,6,0,17,0,0,28,50
21075,Serbia and Kosovo: S/RES/1244 (1999),2011,2011Serbia and Kosovo: S/RES/1244 (1999),7,8,16,43,0,0,74,5,18,10,36,5,0,74,148
21076,Serbia and Kosovo: S/RES/1244 (1999),2011,2011Serbia and Kosovo: S/RES/1244 (1999),42,69,62,231,12,0,416,42,68,50,213,11,0,384,1108
21077,Serbia and Kosovo: S/RES/1244 (1999),2011,2011Serbia and Kosovo: S/RES/1244 (1999),98,232,250,989,100,565,2234,104,275,285,876,72,611,2223,4457
21078,Serbia and Kosovo: S/RES/1244 (1999),2011,2011Serbia and Kosovo: S/RES/1244 (1999),275,578,655,2369,851,0,4728,295,643,737,2396,568,0,4639,9367
21079,Serbia and Kosovo: S/RES/1244 (1999),2011,2011Serbia and Kosovo: S/RES/1244 (1999),795,3709,6875,35921,1935,0,49235,849,3896,6870,47348,2257,0,61220,110455
21080,Serbia and Kosovo: S/RES/1244 (1999),2012,2012Serbia and Kosovo: S/RES/1244 (1999),0,0,0,0,0,0,0,0,0,0,0,0,0,0,17835
21081,Serbia and Kosovo: S/RES/1244 (1999),2012,2012Serbia and Kosovo: S/RES/1244 (1999),0,0,0,0,0,0,0,0,0,0,0,0,5,5,5
21082,Serbia and Kosovo: S/RES/1244 (1999),2012,2012Serbia and Kosovo: S/RES/1244 (1999),0,0,0,0,0,0,0,0,0,0,0,5,0,5,5
21083,Serbia and Kosovo: S/RES/1244 (1999),2012,2012Serbia and Kosovo: S/RES/1244 (1999),0,0,0,0,0,0,0,0,0,0,0,7,0,7,7
21084,Serbia and Kosovo: S/RES/1244 (1999),2012,2012Serbia and Kosovo: S/RES/1244 (1999),0,0,0,0,0,0,0,0,0,8,0,0,0,8,8
21085,Serbia and Kosovo: S/RES/1244 (1999),2012,2012Serbia and Kosovo: S/RES/1244 (1999),0,0,0,0,0,0,0,0,5,0,0,0,0,5,5
21086,Serbia and Kosovo: S/RES/1244 (1999),2012,2012Serbia and Kosovo: S/RES/1244 (1999),0,0,0,0,0,5,5,0,0,0,0,0,0,0,1036
21087,Serbia and Kosovo: S/RES/1244 (1999),2012,2012Serbia and Kosovo: S/RES/1244 (1999),0,0,0,0,0,5383,5383,0,0,0,0,0,6123,6123,11506
21088,Serbia and Kosovo: S/RES/1244 (1999),2012,2012Serbia and Kosovo: S/RES/1244 (1999),0,0,0,5,0,0,5,0,0,0,9,0,0,9,14
21089,Serbia and Kosovo: S/RES/1244 (1999),2012,2012Serbia and Kosovo: S/RES/1244 (1999),0,0,0,5,14,0,19,0,0,0,0,61,0,61,80
21090,Serbia and Kosovo: S/RES/1244 (1999),2012,2012Serbia and Kosovo: S/RES/1244 (1999),0,0,0,25,5,0,30,0,0,5,37,5,0,47,77
21091,Serbia and Kosovo: S/RES/1244 (1999),2012,2012Serbia and Kosovo: S/RES/1244 (1999),0,0,5,10,0,0,15,0,0,6,19,0,0,25,400
21092,Serbia and Kosovo: S/RES/1244 (1999),2012,2012Serbia and Kosovo: S/RES/1244 (1999),0,0,8,12,0,0,20,0,7,5,25,0,0,37,63
21093,Serbia and Kosovo: S/RES/1244 (1999),2012,2012Serbia and Kosovo: S/RES/1244 (1999),0,5,5,13,0,0,23,0,0,12,19,0,0,31,54
21094,Serbia and Kosovo: S/RES/1244 (1999),2012,2012Serbia and Kosovo: S/RES/1244 (1999),5,10,21,42,0,0,78,0,18,8,42,0,0,68,146
21095,Serbia and Kosovo: S/RES/1244 (1999),2012,2012Serbia and Kosovo: S/RES/1244 (1999),5,12,0,49,7,0,73,0,10,25,96,7,0,138,211
21096,Serbia and Kosovo: S/RES/1244 (1999),2012,2012Serbia and Kosovo: S/RES/1244 (1999),32,55,67,217,16,0,387,35,62,50,202,13,0,362,1055
21097,Serbia and Kosovo: S/RES/1244 (1999),2012,2012Serbia and Kosovo: S/RES/1244 (1999),98,198,233,932,94,503,2058,91,231,253,833,63,554,2025,4083
21098,Serbia and Kosovo: S/RES/1244 (1999),2012,2012Serbia and Kosovo: S/RES/1244 (1999),264,538,627,2068,784,0,4281,288,607,684,2116,528,0,4223,8504
21099,Serbia and Kosovo: S/RES/1244 (1999),2012,2012Serbia and Kosovo: S/RES/1244 (1999),721,3395,6999,37901,2197,0,51213,765,3571,6915,48727,2618,0,62596,113809
21100,Serbia and Kosovo: S/RES/1244 (1999),2013,2013Serbia and Kosovo: S/RES/1244 (1999),0,0,0,0,0,0,0,0,0,0,0,0,0,0,14961
21101,Serbia and Kosovo: S/RES/1244 (1999),2013,2013Serbia and Kosovo: S/RES/1244 (1999),0,0,0,0,0,0,0,0,0,0,0,5,0,5,5
21102,Serbia and Kosovo: S/RES/1244 (1999),2013,2013Serbia and Kosovo: S/RES/1244 (1999),0,0,0,0,0,0,0,0,0,0,0,7,0,7,7
21103,Serbia and Kosovo: S/RES/1244 (1999),2013,2013Serbia and Kosovo: S/RES/1244 (1999),0,0,0,0,0,0,0,0,0,0,8,0,0,8,8
21104,Serbia and Kosovo: S/RES/1244 (1999),2013,2013Serbia and Kosovo: S/RES/1244 (1999),0,0,0,0,0,104,104,0,0,0,0,0,96,96,200
21105,Serbia and Kosovo: S/RES/1244 (1999),2013,2013Serbia and Kosovo: S/RES/1244 (1999),0,0,0,0,0,357,357,0,0,0,0,0,465,465,822
21106,Serbia and Kosovo: S/RES/1244 (1999),2013,2013Serbia and Kosovo: S/RES/1244 (1999),0,0,0,0,0,5490,5490,0,0,0,0,0,6248,6248,11738
21107,Serbia and Kosovo: S/RES/1244 (1999),2013,2013Serbia and Kosovo: S/RES/1244 (1999),0,0,0,5,0,0,5,0,0,0,9,0,0,9,14
21108,Serbia and Kosovo: S/RES/1244 (1999),2013,2013Serbia and Kosovo: S/RES/1244 (1999),0,0,0,7,0,0,7,0,0,0,5,5,0,10,17
21109,Serbia and Kosovo: S/RES/1244 (1999),2013,2013Serbia and Kosovo: S/RES/1244 (1999),0,0,0,16,0,0,16,0,0,0,0,55,0,55,71
21110,Serbia and Kosovo: S/RES/1244 (1999),2013,2013Serbia and Kosovo: S/RES/1244 (1999),0,0,0,17,0,0,17,0,0,5,18,0,0,23,418
21111,Serbia and Kosovo: S/RES/1244 (1999),2013,2013Serbia and Kosovo: S/RES/1244 (1999),0,0,0,25,5,0,30,0,0,5,52,5,0,62,92
21112,Serbia and Kosovo: S/RES/1244 (1999),2013,2013Serbia and Kosovo: S/RES/1244 (1999),0,0,8,12,0,0,20,0,7,5,25,0,0,37,64
21113,Serbia and Kosovo: S/RES/1244 (1999),2013,2013Serbia and Kosovo: S/RES/1244 (1999),0,0,10,48,7,0,65,0,0,7,134,8,0,149,214
21114,Serbia and Kosovo: S/RES/1244 (1999),2013,2013Serbia and Kosovo: S/RES/1244 (1999),0,5,5,12,0,0,22,0,0,8,24,0,0,32,54
21115,Serbia and Kosovo: S/RES/1244 (1999),2013,2013Serbia and Kosovo: S/RES/1244 (1999),5,9,20,42,5,0,81,0,20,9,37,0,0,66,147
21116,Serbia and Kosovo: S/RES/1244 (1999),2013,2013Serbia and Kosovo: S/RES/1244 (1999),26,54,60,188,17,0,345,29,54,59,185,13,0,340,974
21117,Serbia and Kosovo: S/RES/1244 (1999),2013,2013Serbia and Kosovo: S/RES/1244 (1999),39,182,350,3156,546,0,4273,31,185,400,2973,548,0,4137,8410
21118,Serbia and Kosovo: S/RES/1244 (1999),2013,2013Serbia and Kosovo: S/RES/1244 (1999),86,157,190,818,87,430,1768,78,170,228,761,69,468,1774,3542
21119,Serbia and Kosovo: S/RES/1244 (1999),2013,2013Serbia and Kosovo: S/RES/1244 (1999),224,462,488,1634,667,0,3475,249,507,601,1677,458,0,3492,6967
21120,Serbia and Kosovo: S/RES/1244 (1999),2014,2014Serbia and Kosovo: S/RES/1244 (1999),0,0,0,0,0,0,0,0,0,0,0,0,0,0,13081
21121,Serbia and Kosovo: S/RES/1244 (1999),2014,2014Serbia and Kosovo: S/RES/1244 (1999),0,0,0,0,0,0,0,0,0,0,0,5,0,5,5
21122,Serbia and Kosovo: S/RES/1244 (1999),2014,2014Serbia and Kosovo: S/RES/1244 (1999),0,0,0,0,0,0,0,0,0,0,0,7,0,7,7
21123,Serbia and Kosovo: S/RES/1244 (1999),2014,2014Serbia and Kosovo: S/RES/1244 (1999),0,0,0,0,0,0,0,0,0,8,0,0,0,8,8
21124,Serbia and Kosovo: S/RES/1244 (1999),2014,2014Serbia and Kosovo: S/RES/1244 (1999),0,0,0,0,0,101,101,0,0,0,0,0,93,93,206
21125,Serbia and Kosovo: S/RES/1244 (1999),2014,2014Serbia and Kosovo: S/RES/1244 (1999),0,0,0,0,0,126,126,0,0,0,0,0,144,144,270
21126,Serbia and Kosovo: S/RES/1244 (1999),2014,2014Serbia and Kosovo: S/RES/1244 (1999),0,0,0,0,0,5711,5711,0,0,0,0,0,6408,6408,12119
21127,Serbia and Kosovo: S/RES/1244 (1999),2014,2014Serbia and Kosovo: S/RES/1244 (1999),0,0,0,5,9,0,14,0,0,0,0,50,0,50,64
21128,Serbia and Kosovo: S/RES/1244 (1999),2014,2014Serbia and Kosovo: S/RES/1244 (1999),0,0,0,7,0,0,7,0,0,0,16,0,0,16,429
21129,Serbia and Kosovo: S/RES/1244 (1999),2014,2014Serbia and Kosovo: S/RES/1244 (1999),0,0,0,31,0,0,31,0,0,0,61,0,0,61,92
21130,Serbia and Kosovo: S/RES/1244 (1999),2014,2014Serbia and Kosovo: S/RES/1244 (1999),0,0,5,0,0,0,5,0,0,0,0,0,0,0,5
21131,Serbia and Kosovo: S/RES/1244 (1999),2014,2014Serbia and Kosovo: S/RES/1244 (1999),0,0,8,12,0,0,20,0,7,5,33,0,0,45,65
21132,Serbia and Kosovo: S/RES/1244 (1999),2014,2014Serbia and Kosovo: S/RES/1244 (1999),0,5,10,15,0,0,30,0,0,17,17,0,0,34,64
21133,Serbia and Kosovo: S/RES/1244 (1999),2014,2014Serbia and Kosovo: S/RES/1244 (1999),5,0,0,0,0,0,5,0,0,0,0,0,0,0,5
21134,Serbia and Kosovo: S/RES/1244 (1999),2014,2014Serbia and Kosovo: S/RES/1244 (1999),5,9,11,47,5,0,77,0,13,9,41,0,0,63,140
21135,Serbia and Kosovo: S/RES/1244 (1999),2014,2014Serbia and Kosovo: S/RES/1244 (1999),13,54,41,173,19,0,300,17,51,43,173,16,0,300,863
21136,Serbia and Kosovo: S/RES/1244 (1999),2014,2014Serbia and Kosovo: S/RES/1244 (1999),40,183,345,3435,670,0,4673,40,184,411,3295,691,0,4621,9294
21137,Serbia and Kosovo: S/RES/1244 (1999),2014,2014Serbia and Kosovo: S/RES/1244 (1999),94,153,161,808,73,391,1680,82,174,216,737,60,431,1700,3380
21138,Serbia and Kosovo: S/RES/1244 (1999),2014,2014Serbia and Kosovo: S/RES/1244 (1999),153,353,385,1321,599,0,2811,187,385,480,1358,412,0,2822,5633
21139,Serbia and Kosovo: S/RES/1244 (1999),2015,2015Serbia and Kosovo: S/RES/1244 (1999),0,0,0,0,0,0,0,0,0,0,0,0,0,0,10628
21140,Serbia and Kosovo: S/RES/1244 (1999),2015,2015Serbia and Kosovo: S/RES/1244 (1999),0,0,0,0,0,0,0,0,0,0,0,7,0,7,7
21141,Serbia and Kosovo: S/RES/1244 (1999),2015,2015Serbia and Kosovo: S/RES/1244 (1999),0,0,0,0,0,0,0,0,0,0,5,0,0,5,5
21142,Serbia and Kosovo: S/RES/1244 (1999),2015,2015Serbia and Kosovo: S/RES/1244 (1999),0,0,0,0,0,5,5,0,0,0,0,0,0,0,5
21143,Serbia and Kosovo: S/RES/1244 (1999),2015,2015Serbia and Kosovo: S/RES/1244 (1999),0,0,0,0,0,50,50,0,0,0,0,0,42,42,92
21144,Serbia and Kosovo: S/RES/1244 (1999),2015,2015Serbia and Kosovo: S/RES/1244 (1999),0,0,0,0,0,130,130,0,0,0,0,0,140,140,270
21145,Serbia and Kosovo: S/RES/1244 (1999),2015,2015Serbia and Kosovo: S/RES/1244 (1999),0,0,0,0,0,5916,5916,0,0,0,0,0,6584,6584,12500
21146,Serbia and Kosovo: S/RES/1244 (1999),2015,2015Serbia and Kosovo: S/RES/1244 (1999),0,0,0,5,0,0,5,0,0,0,87,0,0,87,92
21147,Serbia and Kosovo: S/RES/1244 (1999),2015,2015Serbia and Kosovo: S/RES/1244 (1999),0,0,0,9,0,0,9,0,0,0,60,0,0,60,3158
21148,Serbia and Kosovo: S/RES/1244 (1999),2015,2015Serbia and Kosovo: S/RES/1244 (1999),0,0,5,20,0,0,25,0,0,10,30,0,0,40,65
21149,Serbia and Kosovo: S/RES/1244 (1999),2015,2015Serbia and Kosovo: S/RES/1244 (1999),0,0,5,53,7,0,65,0,0,5,120,10,0,135,200
21150,Serbia and Kosovo: S/RES/1244 (1999),2015,2015Serbia and Kosovo: S/RES/1244 (1999),0,5,5,16,0,0,26,0,0,7,26,0,0,33,59
21151,Serbia and Kosovo: S/RES/1244 (1999),2015,2015Serbia and Kosovo: S/RES/1244 (1999),0,12,8,33,0,0,53,0,5,9,19,0,0,33,86
21152,Serbia and Kosovo: S/RES/1244 (1999),2015,2015Serbia and Kosovo: S/RES/1244 (1999),5,0,0,0,0,0,5,0,0,0,0,0,0,0,5
21153,Serbia and Kosovo: S/RES/1244 (1999),2015,2015Serbia and Kosovo: S/RES/1244 (1999),11,45,40,144,13,0,253,23,39,53,133,12,0,260,678
21154,Serbia and Kosovo: S/RES/1244 (1999),2015,2015Serbia and Kosovo: S/RES/1244 (1999),34,153,308,3395,750,0,4640,37,154,325,3268,733,0,4517,9157
21155,Serbia and Kosovo: S/RES/1244 (1999),2015,2015Serbia and Kosovo: S/RES/1244 (1999),57,138,117,350,83,0,745,73,163,175,384,73,0,868,1613
21156,Serbia and Kosovo: S/RES/1244 (1999),2016,2016Serbia and Kosovo: S/RES/1244 (1999),0,0,0,0,0,0,0,0,0,0,0,0,0,0,8922
21157,Serbia and Kosovo: S/RES/1244 (1999),2016,2016Serbia and Kosovo: S/RES/1244 (1999),0,0,0,0,0,0,0,0,0,0,0,7,0,7,7
21158,Serbia and Kosovo: S/RES/1244 (1999),2016,2016Serbia and Kosovo: S/RES/1244 (1999),0,0,0,0,0,5,5,0,0,0,0,0,0,0,5
21159,Serbia and Kosovo: S/RES/1244 (1999),2016,2016Serbia and Kosovo: S/RES/1244 (1999),0,0,0,0,0,85,85,0,0,0,0,0,70,70,155
21160,Serbia and Kosovo: S/RES/1244 (1999),2016,2016Serbia and Kosovo: S/RES/1244 (1999),0,0,0,0,0,128,128,0,0,0,0,0,137,137,265
21161,Serbia and Kosovo: S/RES/1244 (1999),2016,2016Serbia and Kosovo: S/RES/1244 (1999),0,0,0,0,0,6238,6238,0,0,0,0,0,6916,6916,13154
21162,Serbia and Kosovo: S/RES/1244 (1999),2016,2016Serbia and Kosovo: S/RES/1244 (1999),0,0,0,5,0,0,5,0,0,0,87,0,0,87,92
21163,Serbia and Kosovo: S/RES/1244 (1999),2016,2016Serbia and Kosovo: S/RES/1244 (1999),0,0,5,6,0,0,11,0,0,6,5,0,0,11,266
21164,Serbia and Kosovo: S/RES/1244 (1999),2016,2016Serbia and Kosovo: S/RES/1244 (1999),0,0,6,52,9,0,67,0,0,5,120,9,0,134,201
21165,Serbia and Kosovo: S/RES/1244 (1999),2016,2016Serbia and Kosovo: S/RES/1244 (1999),0,6,7,11,0,0,24,5,5,8,18,5,0,41,65
21166,Serbia and Kosovo: S/RES/1244 (1999),2016,2016Serbia and Kosovo: S/RES/1244 (1999),0,11,7,23,0,0,41,0,6,8,17,0,0,31,72
21167,Serbia and Kosovo: S/RES/1244 (1999),2016,2016Serbia and Kosovo: S/RES/1244 (1999),5,5,0,17,0,0,27,0,0,7,26,0,0,33,60
21168,Serbia and Kosovo: S/RES/1244 (1999),2016,2016Serbia and Kosovo: S/RES/1244 (1999),11,38,43,234,59,0,385,18,65,62,324,29,0,498,883
21169,Serbia and Kosovo: S/RES/1244 (1999),2016,2016Serbia and Kosovo: S/RES/1244 (1999),12,40,29,137,13,0,231,22,32,41,121,9,0,225,616
21170,Serbia and Kosovo: S/RES/1244 (1999),2016,2016Serbia and Kosovo: S/RES/1244 (1999),32,152,277,3422,794,0,4677,45,157,303,3230,777,0,4512,9189
21171,Serbia and Kosovo: S/RES/1244 (1999),2016,2016Serbia and Kosovo: S/RES/1244 (1999),76,150,143,721,73,335,1498,72,133,183,661,65,364,1478,2976
21172,Serbia and Kosovo: S/RES/1244 (1999),2017,2017Serbia and Kosovo: S/RES/1244 (1999),0,0,0,0,0,0,0,0,0,0,0,0,0,0,6332
21173,Serbia and Kosovo: S/RES/1244 (1999),2017,2017Serbia and Kosovo: S/RES/1244 (1999),0,0,0,0,0,0,0,0,0,0,0,0,5,5,5
21174,Serbia and Kosovo: S/RES/1244 (1999),2017,2017Serbia and Kosovo: S/RES/1244 (1999),0,0,0,0,0,0,0,0,0,0,7,0,0,7,7
21175,Serbia and Kosovo: S/RES/1244 (1999),2017,2017Serbia and Kosovo: S/RES/1244 (1999),0,0,0,0,0,6380,6380,0,0,0,0,0,6996,6996,13376
21176,Serbia and Kosovo: S/RES/1244 (1999),2017,2017Serbia and Kosovo: S/RES/1244 (1999),0,0,5,53,9,0,67,0,5,0,118,10,0,133,200
21177,Serbia and Kosovo: S/RES/1244 (1999),2017,2017Serbia and Kosovo: S/RES/1244 (1999),0,5,7,11,0,0,23,5,5,8,19,5,0,42,65
21178,Serbia and Kosovo: S/RES/1244 (1999),2017,2017Serbia and Kosovo: S/RES/1244 (1999),0,11,7,21,0,0,39,0,0,14,16,0,0,30,69
21179,Serbia and Kosovo: S/RES/1244 (1999),2017,2017Serbia and Kosovo: S/RES/1244 (1999),5,5,0,17,0,0,27,0,0,12,21,0,0,33,60
21180,Serbia and Kosovo: S/RES/1244 (1999),2017,2017Serbia and Kosovo: S/RES/1244 (1999),5,14,19,94,5,0,137,8,24,27,77,6,0,142,394
21181,Serbia and Kosovo: S/RES/1244 (1999),2017,2017Serbia and Kosovo: S/RES/1244 (1999),10,30,26,229,59,0,354,5,40,51,251,28,0,375,729
21182,Serbia and Kosovo: S/RES/1244 (1999),2017,2017Serbia and Kosovo: S/RES/1244 (1999),43,155,265,3426,853,0,4742,45,158,290,3165,832,0,4490,9232
21183,Serbia and Kosovo: S/RES/1244 (1999),2017,2017Serbia and Kosovo: S/RES/1244 (1999),67,141,138,681,71,338,1436,69,127,141,634,67,303,1341,2777
21184,Serbia and Kosovo: S/RES/1244 (1999),2018,2018Serbia and Kosovo: S/RES/1244 (1999),0,0,0,0,0,0,0,0,0,0,0,0,0,0,5229
21185,Serbia and Kosovo: S/RES/1244 (1999),2018,2018Serbia and Kosovo: S/RES/1244 (1999),0,0,0,0,0,0,0,0,0,0,7,0,0,7,7
21186,Serbia and Kosovo: S/RES/1244 (1999),2018,2018Serbia and Kosovo: S/RES/1244 (1999),0,0,0,0,0,6618,6618,0,0,0,0,0,7160,7160,13778
21187,Serbia and Kosovo: S/RES/1244 (1999),2018,2018Serbia and Kosovo: S/RES/1244 (1999),0,0,0,15,0,0,15,0,5,0,12,0,0,17,322
21188,Serbia and Kosovo: S/RES/1244 (1999),2018,2018Serbia and Kosovo: S/RES/1244 (1999),0,0,5,15,0,0,20,0,0,5,33,0,0,38,58
21189,Serbia and Kosovo: S/RES/1244 (1999),2018,2018Serbia and Kosovo: S/RES/1244 (1999),0,5,7,11,0,0,23,5,5,8,19,5,0,42,65
21190,Serbia and Kosovo: S/RES/1244 (1999),2018,2018Serbia and Kosovo: S/RES/1244 (1999),0,10,7,18,0,0,35,0,0,13,14,0,0,27,62
21191,Serbia and Kosovo: S/RES/1244 (1999),2018,2018Serbia and Kosovo: S/RES/1244 (1999),0,16,27,133,15,0,191,8,29,37,101,15,0,190,381
21192,Serbia and Kosovo: S/RES/1244 (1999),2018,2018Serbia and Kosovo: S/RES/1244 (1999),5,0,5,18,0,0,28,0,5,0,20,5,0,30,58
21193,Serbia and Kosovo: S/RES/1244 (1999),2018,2018Serbia and Kosovo: S/RES/1244 (1999),5,34,26,213,46,0,324,5,39,29,249,12,0,334,658
21194,Serbia and Kosovo: S/RES/1244 (1999),2018,2018Serbia and Kosovo: S/RES/1244 (1999),28,153,228,3373,916,0,4698,54,154,245,3121,883,0,4457,9155
21195,Serbia and Kosovo: S/RES/1244 (1999),2018,2018Serbia and Kosovo: S/RES/1244 (1999),63,131,120,643,70,283,1310,57,120,117,608,74,309,1285,2595
21196,Serbia and Kosovo: S/RES/1244 (1999),2019,2019Serbia and Kosovo: S/RES/1244 (1999),0,0,0,0,0,0,0,0,0,0,0,0,0,0,4953
21197,Serbia and Kosovo: S/RES/1244 (1999),2019,2019Serbia and Kosovo: S/RES/1244 (1999),0,0,0,0,0,5,5,0,0,0,0,0,0,0,5
21198,Serbia and Kosovo: S/RES/1244 (1999),2019,2019Serbia and Kosovo: S/RES/1244 (1999),0,0,0,0,0,6814,6814,0,0,0,0,0,7327,7327,14141
21199,Serbia and Kosovo: S/RES/1244 (1999),2019,2019Serbia and Kosovo: S/RES/1244 (1999),0,0,0,0,7,0,7,0,0,0,0,0,0,0,7
21200,Serbia and Kosovo: S/RES/1244 (1999),2019,2019Serbia and Kosovo: S/RES/1244 (1999),0,0,0,22,0,0,22,0,0,0,33,5,0,38,60
21201,Serbia and Kosovo: S/RES/1244 (1999),2019,2019Serbia and Kosovo: S/RES/1244 (1999),0,0,0,340,0,0,340,0,0,0,270,0,0,270,610
21202,Serbia and Kosovo: S/RES/1244 (1999),2019,2019Serbia and Kosovo: S/RES/1244 (1999),0,5,5,11,5,0,26,0,9,0,30,0,0,39,65
21203,Serbia and Kosovo: S/RES/1244 (1999),2019,2019Serbia and Kosovo: S/RES/1244 (1999),0,7,9,18,0,0,34,0,0,12,14,0,0,26,60
21204,Serbia and Kosovo: S/RES/1244 (1999),2019,2019Serbia and Kosovo: S/RES/1244 (1999),0,7,27,108,12,0,154,6,24,28,97,13,0,168,322
21205,Serbia and Kosovo: S/RES/1244 (1999),2019,2019Serbia and Kosovo: S/RES/1244 (1999),28,142,199,3135,956,0,4460,38,158,214,2880,889,0,4179,8639
21206,Serbia and Kosovo: S/RES/1244 (1999),2019,2019Serbia and Kosovo: S/RES/1244 (1999),41,129,111,601,73,0,955,48,122,91,548,76,0,885,2389
21207,Serbia and Kosovo: S/RES/1244 (1999),2020,2020Serbia and Kosovo: S/RES/1244 (1999),0,0,0,0,0,0,0,0,0,0,0,0,0,0,18129
21208,Serbia and Kosovo: S/RES/1244 (1999),2020,2020Serbia and Kosovo: S/RES/1244 (1999),0,0,0,0,0,5,5,0,0,0,0,0,0,0,5
21209,Serbia and Kosovo: S/RES/1244 (1999),2020,2020Serbia and Kosovo: S/RES/1244 (1999),0,0,0,0,0,18,18,0,0,0,0,0,30,30,48
21210,Serbia and Kosovo: S/RES/1244 (1999),2020,2020Serbia and Kosovo: S/RES/1244 (1999),0,0,0,0,0,60,60,0,0,0,0,0,70,70,130
21211,Serbia and Kosovo: S/RES/1244 (1999),2020,2020Serbia and Kosovo: S/RES/1244 (1999),0,0,0,0,0,443,443,0,0,0,0,0,455,455,898
21212,Serbia and Kosovo: S/RES/1244 (1999),2020,2020Serbia and Kosovo: S/RES/1244 (1999),0,0,0,0,5,0,5,0,0,0,0,0,0,0,5
21213,Serbia and Kosovo: S/RES/1244 (1999),2020,2020Serbia and Kosovo: S/RES/1244 (1999),0,0,0,23,0,0,23,0,0,0,33,5,0,38,61
21214,Serbia and Kosovo: S/RES/1244 (1999),2020,2020Serbia and Kosovo: S/RES/1244 (1999),0,5,7,20,0,0,32,0,0,10,12,0,0,22,54
21215,Serbia and Kosovo: S/RES/1244 (1999),2020,2020Serbia and Kosovo: S/RES/1244 (1999),0,6,5,8,5,0,24,0,8,0,20,5,0,33,57
21216,Serbia and Kosovo: S/RES/1244 (1999),2020,2020Serbia and Kosovo: S/RES/1244 (1999),0,8,23,85,10,0,126,6,23,25,79,11,0,144,270
21217,Serbia and Kosovo: S/RES/1244 (1999),2020,2020Serbia and Kosovo: S/RES/1244 (1999),0,12,13,39,0,0,64,0,17,5,44,0,0,66,130
21218,Serbia and Kosovo: S/RES/1244 (1999),2020,2020Serbia and Kosovo: S/RES/1244 (1999),22,139,163,2850,935,0,4109,28,135,178,2625,851,0,3817,7926
21219,Serbia and Kosovo: S/RES/1244 (1999),2020,2020Serbia and Kosovo: S/RES/1244 (1999),39,108,106,575,74,0,902,43,109,92,516,80,0,840,2263
21220,Serbia and Kosovo: S/RES/1244 (1999),2021,2021Serbia and Kosovo: S/RES/1244 (1999),0,0,0,0,0,0,0,0,0,0,0,0,0,0,22502
21221,Serbia and Kosovo: S/RES/1244 (1999),2021,2021Serbia and Kosovo: S/RES/1244 (1999),0,0,0,0,0,0,0,0,0,0,0,0,5,5,5
21222,Serbia and Kosovo: S/RES/1244 (1999),2021,2021Serbia and Kosovo: S/RES/1244 (1999),0,0,0,0,0,5,5,0,0,0,0,0,0,0,15
21223,Serbia and Kosovo: S/RES/1244 (1999),2021,2021Serbia and Kosovo: S/RES/1244 (1999),0,0,0,19,0,0,19,0,0,0,31,5,0,36,55
21224,Serbia and Kosovo: S/RES/1244 (1999),2021,2021Serbia and Kosovo: S/RES/1244 (1999),0,0,6,10,0,0,16,0,0,0,8,0,0,8,183
21225,Serbia and Kosovo: S/RES/1244 (1999),2021,2021Serbia and Kosovo: S/RES/1244 (1999),0,0,9,19,0,0,28,0,0,6,10,0,0,16,44
21226,Serbia and Kosovo: S/RES/1244 (1999),2021,2021Serbia and Kosovo: S/RES/1244 (1999),0,5,5,8,5,0,23,0,8,0,21,5,0,34,57
21227,Serbia and Kosovo: S/RES/1244 (1999),2021,2021Serbia and Kosovo: S/RES/1244 (1999),0,5,12,42,0,0,59,0,8,13,45,0,0,66,125
21228,Serbia and Kosovo: S/RES/1244 (1999),2021,2021Serbia and Kosovo: S/RES/1244 (1999),5,10,18,68,10,0,111,7,24,25,75,10,0,141,252
21229,Serbia and Kosovo: S/RES/1244 (1999),2021,2021Serbia and Kosovo: S/RES/1244 (1999),18,114,146,2260,831,0,3369,15,141,152,2022,688,0,3018,6387
21230,Serbia and Kosovo: S/RES/1244 (1999),2021,2021Serbia and Kosovo: S/RES/1244 (1999),41,86,96,530,75,0,828,43,86,92,477,76,0,774,2110
21231,Sierra Leone,2001,2001Sierra Leone,0,0,0,0,0,0,0,0,0,0,0,0,0,0,14831
21232,Sierra Leone,2001,2001Sierra Leone,0,0,0,0,0,0,0,0,0,0,0,0,11,11,11
21233,Sierra Leone,2001,2001Sierra Leone,0,0,0,0,0,0,0,0,0,0,5,0,0,5,20
21234,Sierra Leone,2001,2001Sierra Leone,0,0,0,0,0,0,0,0,0,0,6,0,0,6,6
21235,Sierra Leone,2001,2001Sierra Leone,0,0,0,0,0,0,0,0,0,0,8,0,0,8,13
21236,Sierra Leone,2001,2001Sierra Leone,0,0,0,0,0,0,0,0,0,0,9,0,0,9,9
21237,Sierra Leone,2001,2001Sierra Leone,0,0,0,0,0,0,0,0,0,0,24,0,0,24,24
21238,Sierra Leone,2001,2001Sierra Leone,0,0,0,0,0,5,5,0,0,0,0,0,13,13,18
21239,Sierra Leone,2001,2001Sierra Leone,0,0,0,0,0,33,33,0,0,0,0,0,80,80,113
21240,Sierra Leone,2001,2001Sierra Leone,0,0,0,5,0,0,5,0,0,0,5,0,0,5,10
21241,Sierra Leone,2001,2001Sierra Leone,0,0,0,5,0,0,5,0,0,0,10,0,0,10,15
21242,Sierra Leone,2001,2001Sierra Leone,0,0,0,18,0,0,18,0,0,0,25,0,0,25,43
21243,Sierra Leone,2001,2001Sierra Leone,0,0,6,0,0,0,6,0,7,0,0,0,0,7,13
21244,Sierra Leone,2001,2001Sierra Leone,0,5,0,0,0,0,5,0,0,0,5,0,0,5,20
21245,Sierra Leone,2001,2001Sierra Leone,0,5,5,13,5,0,28,0,0,6,32,0,0,38,66
21246,Sierra Leone,2001,2001Sierra Leone,0,9,0,24,0,0,33,0,8,0,47,0,0,55,88
21247,Sierra Leone,2001,2001Sierra Leone,5,7,5,49,0,0,66,5,6,6,107,0,0,124,190
21248,Sierra Leone,2001,2001Sierra Leone,8,0,0,10,0,0,18,0,5,0,12,0,0,17,107
21249,Sierra Leone,2001,2001Sierra Leone,43,92,79,216,5,0,435,52,112,96,365,0,0,625,7101
21250,Sierra Leone,2001,2001Sierra Leone,43,180,153,621,20,0,1017,54,155,132,623,17,0,981,1998
21251,Sierra Leone,2001,2001Sierra Leone,52,55,47,1009,0,0,1163,63,47,40,723,5,0,878,2041
21252,Sierra Leone,2001,2001Sierra Leone,133,245,215,430,25,0,1048,129,256,225,428,30,0,1068,2116
21253,Sierra Leone,2001,2001Sierra Leone,3782,2502,2144,8163,752,0,17343,3370,2652,2273,7437,682,0,16414,54717
21254,Sierra Leone,2001,2001Sierra Leone,4226,5124,4398,12275,2275,0,28298,4117,5338,4576,11937,1835,0,27803,95527
21255,Sierra Leone,2002,2002Sierra Leone,0,0,0,0,0,0,0,0,0,0,0,0,0,0,19380
21256,Sierra Leone,2002,2002Sierra Leone,0,0,0,0,0,0,0,0,0,0,0,0,6,6,6
21257,Sierra Leone,2002,2002Sierra Leone,0,0,0,0,0,0,0,0,0,0,5,0,0,5,77
21258,Sierra Leone,2002,2002Sierra Leone,0,0,0,0,0,0,0,0,0,0,6,0,0,6,28
21259,Sierra Leone,2002,2002Sierra Leone,0,0,0,0,0,0,0,0,0,0,13,0,0,13,13
21260,Sierra Leone,2002,2002Sierra Leone,0,0,0,0,0,0,0,0,0,5,0,0,0,5,5
21261,Sierra Leone,2002,2002Sierra Leone,0,0,0,0,0,0,0,5,0,0,0,0,0,5,5
21262,Sierra Leone,2002,2002Sierra Leone,0,0,0,0,0,44,44,0,0,0,0,0,136,136,180
21263,Sierra Leone,2002,2002Sierra Leone,0,0,0,5,0,0,5,0,0,0,5,0,0,5,10
21264,Sierra Leone,2002,2002Sierra Leone,0,0,0,5,0,0,5,0,0,0,10,0,0,10,15
21265,Sierra Leone,2002,2002Sierra Leone,0,0,0,9,0,0,9,0,0,0,0,0,0,0,9
21266,Sierra Leone,2002,2002Sierra Leone,0,0,0,18,0,0,18,0,0,0,25,0,0,25,43
21267,Sierra Leone,2002,2002Sierra Leone,0,0,6,0,0,0,6,0,0,0,7,0,0,7,13
21268,Sierra Leone,2002,2002Sierra Leone,0,5,0,0,0,0,5,0,0,0,5,0,0,5,10
21269,Sierra Leone,2002,2002Sierra Leone,0,5,5,18,0,0,28,0,8,0,28,0,0,36,64
21270,Sierra Leone,2002,2002Sierra Leone,5,6,0,22,0,0,33,0,5,0,50,0,0,55,88
21271,Sierra Leone,2002,2002Sierra Leone,5,7,5,49,0,0,66,5,6,6,109,0,0,126,192
21272,Sierra Leone,2002,2002Sierra Leone,6,0,0,0,0,0,6,0,0,0,7,0,0,7,13
21273,Sierra Leone,2002,2002Sierra Leone,8,0,0,0,0,0,8,0,7,0,0,0,0,7,96
21274,Sierra Leone,2002,2002Sierra Leone,12,29,48,67,0,0,156,15,34,19,136,0,0,204,360
21275,Sierra Leone,2002,2002Sierra Leone,13,12,10,99,8,0,142,8,11,9,164,10,0,202,344
21276,Sierra Leone,2002,2002Sierra Leone,14,10,9,45,0,0,78,19,15,12,183,0,0,229,307
21277,Sierra Leone,2002,2002Sierra Leone,42,145,123,508,18,0,836,47,125,106,517,14,0,809,4316
21278,Sierra Leone,2002,2002Sierra Leone,43,38,33,973,0,0,1087,48,29,24,684,5,0,790,1877
21279,Sierra Leone,2002,2002Sierra Leone,43,92,79,216,5,0,435,52,112,96,365,0,0,625,7734
21280,Sierra Leone,2002,2002Sierra Leone,2922,4024,3455,9325,1405,0,21131,2970,4118,3524,8578,1082,0,20272,60553
21281,Sierra Leone,2002,2002Sierra Leone,3808,2431,2084,5142,571,0,14036,3431,2158,1849,4508,500,0,12446,45735
21282,Sierra Leone,2003,2003Sierra Leone,0,0,0,0,0,0,0,0,0,0,0,0,0,0,19653
21283,Sierra Leone,2003,2003Sierra Leone,0,0,0,0,0,0,0,0,0,0,0,0,5,5,24
21284,Sierra Leone,2003,2003Sierra Leone,0,0,0,0,0,0,0,0,0,0,0,0,6,6,6
21285,Sierra Leone,2003,2003Sierra Leone,0,0,0,0,0,0,0,0,0,0,5,0,0,5,72
21286,Sierra Leone,2003,2003Sierra Leone,0,0,0,0,0,0,0,0,0,0,6,0,0,6,6
21287,Sierra Leone,2003,2003Sierra Leone,0,0,0,0,0,0,0,0,0,0,7,0,0,7,7
21288,Sierra Leone,2003,2003Sierra Leone,0,0,0,0,0,0,0,0,0,0,10,0,0,10,10
21289,Sierra Leone,2003,2003Sierra Leone,0,0,0,0,0,0,0,0,0,0,57,0,0,57,57
21290,Sierra Leone,2003,2003Sierra Leone,0,0,0,0,0,70,70,0,0,0,0,0,159,159,229
21291,Sierra Leone,2003,2003Sierra Leone,0,0,0,5,0,0,5,0,0,0,5,0,0,5,10
21292,Sierra Leone,2003,2003Sierra Leone,0,0,0,9,0,0,9,0,0,5,0,0,0,5,14
21293,Sierra Leone,2003,2003Sierra Leone,0,0,0,14,0,0,14,0,0,0,36,0,0,36,50
21294,Sierra Leone,2003,2003Sierra Leone,0,0,6,0,0,0,6,0,0,0,7,0,0,7,13
21295,Sierra Leone,2003,2003Sierra Leone,5,7,5,47,0,0,64,5,6,6,108,0,0,125,189
21296,Sierra Leone,2003,2003Sierra Leone,6,0,0,0,0,0,6,0,0,0,7,0,0,7,13
21297,Sierra Leone,2003,2003Sierra Leone,6,6,0,20,0,0,32,0,5,0,51,0,0,56,88
21298,Sierra Leone,2003,2003Sierra Leone,7,0,6,20,0,0,33,0,0,9,27,0,0,36,69
21299,Sierra Leone,2003,2003Sierra Leone,12,10,9,32,0,0,63,15,13,12,105,0,0,145,208
21300,Sierra Leone,2003,2003Sierra Leone,13,11,10,98,8,0,140,8,11,9,163,10,0,201,341
21301,Sierra Leone,2003,2003Sierra Leone,16,26,30,73,5,0,150,18,22,19,125,0,0,184,334
21302,Sierra Leone,2003,2003Sierra Leone,37,31,26,931,0,0,1025,39,22,18,647,5,0,731,1756
21303,Sierra Leone,2003,2003Sierra Leone,45,88,63,238,6,0,440,39,76,63,325,0,0,503,943
21304,Sierra Leone,2003,2003Sierra Leone,56,115,98,340,17,0,626,86,90,77,520,12,0,785,1411
21305,Sierra Leone,2003,2003Sierra Leone,200,176,150,732,523,0,1781,2009,1032,885,355,65,0,4346,6127
21306,Sierra Leone,2003,2003Sierra Leone,1084,1443,1247,3061,370,0,7205,1174,1494,1278,3018,330,0,7294,25000
21307,Sierra Leone,2003,2003Sierra Leone,1323,1318,1128,3250,361,0,7380,1330,1368,1171,2423,269,0,6561,13941
21308,Sierra Leone,2004,2004Sierra Leone,0,0,0,0,0,0,0,0,0,0,0,0,0,0,26649
21309,Sierra Leone,2004,2004Sierra Leone,0,0,0,0,0,0,0,0,0,0,0,0,9,9,9
21310,Sierra Leone,2004,2004Sierra Leone,0,0,0,0,0,0,0,0,0,0,5,0,0,5,39
21311,Sierra Leone,2004,2004Sierra Leone,0,0,0,0,0,0,0,0,0,0,8,0,0,8,8
21312,Sierra Leone,2004,2004Sierra Leone,0,0,0,0,0,0,0,0,0,0,68,0,0,68,68
21313,Sierra Leone,2004,2004Sierra Leone,0,0,0,5,0,0,5,0,0,0,5,0,0,5,10
21314,Sierra Leone,2004,2004Sierra Leone,0,0,0,8,0,0,8,0,0,0,28,0,0,28,36
21315,Sierra Leone,2004,2004Sierra Leone,0,0,0,9,0,0,9,0,0,5,0,0,0,5,14
21316,Sierra Leone,2004,2004Sierra Leone,0,0,6,0,0,0,6,0,0,0,7,0,0,7,13
21317,Sierra Leone,2004,2004Sierra Leone,0,0,6,45,0,0,51,0,7,0,112,0,0,119,170
21318,Sierra Leone,2004,2004Sierra Leone,0,5,0,10,0,0,15,0,0,5,6,0,5,16,31
21319,Sierra Leone,2004,2004Sierra Leone,0,6,0,0,0,0,6,0,0,0,8,0,0,8,14
21320,Sierra Leone,2004,2004Sierra Leone,0,6,6,11,0,0,23,12,11,10,38,0,0,71,94
21321,Sierra Leone,2004,2004Sierra Leone,5,0,0,7,0,0,12,0,0,5,12,0,0,17,29
21322,Sierra Leone,2004,2004Sierra Leone,5,7,6,79,8,0,105,8,8,7,151,8,0,182,287
21323,Sierra Leone,2004,2004Sierra Leone,7,0,0,6,0,0,13,5,0,0,133,0,0,138,151
21324,Sierra Leone,2004,2004Sierra Leone,7,0,0,11,0,0,18,9,0,0,44,0,0,53,71
21325,Sierra Leone,2004,2004Sierra Leone,8,0,0,18,0,0,26,0,0,0,52,0,0,52,78
21326,Sierra Leone,2004,2004Sierra Leone,16,19,17,38,0,0,90,18,19,16,30,5,0,88,178
21327,Sierra Leone,2004,2004Sierra Leone,16,26,22,73,5,0,142,18,25,21,133,0,0,197,339
21328,Sierra Leone,2004,2004Sierra Leone,41,58,37,138,6,0,280,35,54,43,220,0,0,352,632
21329,Sierra Leone,2004,2004Sierra Leone,44,20,17,846,0,0,927,37,22,18,624,5,0,706,1633
21330,Sierra Leone,2004,2004Sierra Leone,54,111,95,320,17,0,597,83,85,72,495,12,0,747,1344
21331,Sierra Leone,2004,2004Sierra Leone,166,251,215,595,36,0,1263,220,253,216,746,37,0,1472,2735
21332,Sierra Leone,2004,2004Sierra Leone,243,796,686,1234,100,0,3059,267,1086,939,1664,133,0,4089,7165
21333,Sierra Leone,2005,2005Sierra Leone,0,0,0,0,0,0,0,0,0,0,0,0,0,0,26950
21334,Sierra Leone,2005,2005Sierra Leone,0,0,0,0,0,0,0,0,0,0,0,0,9,9,9
21335,Sierra Leone,2005,2005Sierra Leone,0,0,0,0,0,0,0,0,0,0,5,0,0,5,44
21336,Sierra Leone,2005,2005Sierra Leone,0,0,0,0,0,0,0,0,0,0,7,0,0,7,24
21337,Sierra Leone,2005,2005Sierra Leone,0,0,0,0,0,0,0,0,0,0,76,0,0,76,76
21338,Sierra Leone,2005,2005Sierra Leone,0,0,0,0,0,0,0,0,0,9,0,0,0,9,9
21339,Sierra Leone,2005,2005Sierra Leone,0,0,0,0,0,6,6,0,0,0,0,0,8,8,14
21340,Sierra Leone,2005,2005Sierra Leone,0,0,0,0,0,90,90,0,0,0,0,0,214,214,304
21341,Sierra Leone,2005,2005Sierra Leone,0,0,0,5,0,0,5,0,0,0,5,0,0,5,10
21342,Sierra Leone,2005,2005Sierra Leone,0,0,0,9,0,0,9,5,0,0,59,0,0,64,73
21343,Sierra Leone,2005,2005Sierra Leone,0,0,0,36,0,0,36,5,0,0,104,0,0,109,145
21344,Sierra Leone,2005,2005Sierra Leone,0,0,5,5,0,0,10,0,0,5,19,0,0,24,34
21345,Sierra Leone,2005,2005Sierra Leone,0,0,6,0,0,0,6,0,0,0,7,0,0,7,13
21346,Sierra Leone,2005,2005Sierra Leone,0,5,0,0,0,0,5,0,0,0,5,0,0,5,10
21347,Sierra Leone,2005,2005Sierra Leone,5,0,0,13,0,0,18,0,5,0,7,0,5,17,35
21348,Sierra Leone,2005,2005Sierra Leone,6,0,0,6,0,0,12,0,0,0,8,0,0,8,20
21349,Sierra Leone,2005,2005Sierra Leone,7,0,0,14,0,0,21,0,0,0,40,0,0,40,61
21350,Sierra Leone,2005,2005Sierra Leone,9,38,33,124,5,0,209,0,22,20,83,5,0,130,339
21351,Sierra Leone,2005,2005Sierra Leone,10,15,5,16,0,0,46,17,11,5,46,0,0,79,125
21352,Sierra Leone,2005,2005Sierra Leone,17,19,17,40,0,0,93,20,20,18,39,5,0,102,195
21353,Sierra Leone,2005,2005Sierra Leone,44,28,19,844,0,0,935,37,40,35,618,5,0,735,1670
21354,Sierra Leone,2005,2005Sierra Leone,54,111,95,320,17,0,597,83,85,72,495,12,0,747,1344
21355,Sierra Leone,2005,2005Sierra Leone,172,331,289,762,34,0,1588,241,379,331,967,40,0,1958,3546
21356,Sierra Leone,2005,2005Sierra Leone,187,466,395,1326,25,0,2399,201,474,413,1885,51,0,3024,5423
21357,Sierra Leone,2006,2006Sierra Leone,0,0,0,0,0,0,0,0,0,0,0,0,0,0,23061
21358,Sierra Leone,2006,2006Sierra Leone,0,0,0,0,0,0,0,0,0,0,5,0,0,5,15
21359,Sierra Leone,2006,2006Sierra Leone,0,0,0,0,0,0,0,0,0,0,6,0,0,6,6
21360,Sierra Leone,2006,2006Sierra Leone,0,0,0,0,0,0,0,0,0,0,9,0,0,9,9
21361,Sierra Leone,2006,2006Sierra Leone,0,0,0,0,0,0,0,0,0,0,68,0,0,68,68
21362,Sierra Leone,2006,2006Sierra Leone,0,0,0,0,0,0,0,0,9,0,0,0,0,9,9
21363,Sierra Leone,2006,2006Sierra Leone,0,0,0,0,0,5,5,0,0,0,0,0,5,5,10
21364,Sierra Leone,2006,2006Sierra Leone,0,0,0,0,0,5,5,0,0,0,0,0,11,11,16
21365,Sierra Leone,2006,2006Sierra Leone,0,0,0,0,0,6,6,0,0,0,0,0,8,8,14
21366,Sierra Leone,2006,2006Sierra Leone,0,0,0,0,0,8,8,0,0,0,0,0,122,122,130
21367,Sierra Leone,2006,2006Sierra Leone,0,0,0,0,0,26,26,0,0,0,0,0,22,22,48
21368,Sierra Leone,2006,2006Sierra Leone,0,0,0,0,0,92,92,0,0,0,0,0,216,216,308
21369,Sierra Leone,2006,2006Sierra Leone,0,0,0,5,0,0,5,0,0,0,5,0,0,5,10
21370,Sierra Leone,2006,2006Sierra Leone,0,0,0,9,0,0,9,0,0,0,0,0,0,0,9
21371,Sierra Leone,2006,2006Sierra Leone,0,0,0,34,0,0,34,5,0,0,102,0,0,107,141
21372,Sierra Leone,2006,2006Sierra Leone,0,0,6,0,0,0,6,0,0,0,7,0,0,7,13
21373,Sierra Leone,2006,2006Sierra Leone,0,6,6,19,0,0,31,0,9,0,68,0,0,77,108
21374,Sierra Leone,2006,2006Sierra Leone,0,7,0,14,0,0,21,0,0,0,40,0,0,40,61
21375,Sierra Leone,2006,2006Sierra Leone,0,10,5,28,5,0,48,5,7,5,33,5,0,55,103
21376,Sierra Leone,2006,2006Sierra Leone,5,0,0,7,0,0,12,5,0,0,58,0,0,63,75
21377,Sierra Leone,2006,2006Sierra Leone,9,28,25,92,5,0,159,12,29,31,106,5,0,183,342
21378,Sierra Leone,2006,2006Sierra Leone,10,11,6,80,8,0,115,14,10,6,151,8,0,189,304
21379,Sierra Leone,2006,2006Sierra Leone,17,20,16,39,0,0,92,20,28,9,44,5,0,106,198
21380,Sierra Leone,2006,2006Sierra Leone,50,49,22,759,0,0,880,36,18,58,670,5,0,787,1667
21381,Sierra Leone,2006,2006Sierra Leone,54,79,127,320,17,0,597,83,82,75,495,12,0,747,1344
21382,Sierra Leone,2006,2006Sierra Leone,167,374,402,1393,22,0,2358,183,362,448,1863,45,0,2901,5259
21383,Sierra Leone,2006,2006Sierra Leone,190,297,318,756,33,0,1594,245,361,355,970,41,0,1972,3566
21384,Sierra Leone,2006,2006Sierra Leone,518,655,800,1055,198,0,3226,497,627,729,720,156,0,2729,5955
21385,Sierra Leone,2007,2007Sierra Leone,0,0,0,0,0,0,0,0,0,0,0,0,0,0,12170
21386,Sierra Leone,2007,2007Sierra Leone,0,0,0,0,0,0,0,0,0,0,0,0,7,7,7
21387,Sierra Leone,2007,2007Sierra Leone,0,0,0,0,0,0,0,0,0,0,5,0,0,5,10
21388,Sierra Leone,2007,2007Sierra Leone,0,0,0,0,0,0,0,0,0,0,10,0,0,10,10
21389,Sierra Leone,2007,2007Sierra Leone,0,0,0,0,0,0,0,0,5,0,0,0,0,5,5
21390,Sierra Leone,2007,2007Sierra Leone,0,0,0,0,0,0,0,0,5,0,5,0,0,10,10
21391,Sierra Leone,2007,2007Sierra Leone,0,0,0,0,0,7,7,0,0,0,0,0,10,10,17
21392,Sierra Leone,2007,2007Sierra Leone,0,0,0,0,0,106,106,0,0,0,0,0,227,227,333
21393,Sierra Leone,2007,2007Sierra Leone,0,0,0,5,0,0,5,0,0,0,5,0,0,5,10
21394,Sierra Leone,2007,2007Sierra Leone,0,0,0,5,0,0,5,5,0,0,6,0,0,11,16
21395,Sierra Leone,2007,2007Sierra Leone,0,0,0,6,0,0,6,0,0,0,0,0,0,0,6
21396,Sierra Leone,2007,2007Sierra Leone,0,0,0,8,0,0,8,0,0,14,108,0,0,122,130
21397,Sierra Leone,2007,2007Sierra Leone,0,0,0,35,0,0,35,5,0,0,102,0,0,107,142
21398,Sierra Leone,2007,2007Sierra Leone,0,0,6,0,0,0,6,0,0,0,7,0,0,7,13
21399,Sierra Leone,2007,2007Sierra Leone,0,5,0,5,0,0,10,0,0,5,21,0,0,26,36
21400,Sierra Leone,2007,2007Sierra Leone,0,7,0,15,0,0,22,0,0,0,36,0,0,36,58
21401,Sierra Leone,2007,2007Sierra Leone,0,8,0,17,0,0,25,0,7,0,60,0,0,67,92
21402,Sierra Leone,2007,2007Sierra Leone,0,9,0,87,5,0,101,19,15,12,90,5,0,141,242
21403,Sierra Leone,2007,2007Sierra Leone,5,0,0,0,0,0,5,0,0,0,0,0,0,0,5
21404,Sierra Leone,2007,2007Sierra Leone,5,0,0,7,0,0,12,5,0,0,58,0,0,63,75
21405,Sierra Leone,2007,2007Sierra Leone,5,0,0,10,0,5,20,5,5,0,11,0,5,26,46
21406,Sierra Leone,2007,2007Sierra Leone,5,6,5,28,5,0,49,5,7,5,30,5,0,52,101
21407,Sierra Leone,2007,2007Sierra Leone,6,6,0,8,0,0,20,0,7,0,8,0,0,15,35
21408,Sierra Leone,2007,2007Sierra Leone,10,11,6,85,8,0,120,15,10,6,154,8,0,193,313
21409,Sierra Leone,2007,2007Sierra Leone,17,20,16,42,0,0,95,20,28,9,47,5,0,109,204
21410,Sierra Leone,2007,2007Sierra Leone,36,97,86,467,50,0,736,32,99,104,615,20,0,870,1606
21411,Sierra Leone,2007,2007Sierra Leone,168,478,494,1706,45,0,2891,191,460,537,2241,74,0,3503,6394
21412,Sierra Leone,2007,2007Sierra Leone,174,300,293,801,33,0,1601,192,372,347,1010,41,0,1962,3563
21413,Sierra Leone,2007,2007Sierra Leone,518,651,800,1354,198,0,3521,497,627,729,935,156,0,2944,6465
21414,Sierra Leone,2008,2008Sierra Leone,0,0,0,0,0,0,0,0,0,0,0,0,0,0,12097
21415,Sierra Leone,2008,2008Sierra Leone,0,0,0,0,0,0,0,0,0,0,5,0,0,5,10
21416,Sierra Leone,2008,2008Sierra Leone,0,0,0,0,0,0,0,0,0,0,8,0,0,8,16
21417,Sierra Leone,2008,2008Sierra Leone,0,0,0,0,0,0,0,0,5,0,0,0,0,5,5
21418,Sierra Leone,2008,2008Sierra Leone,0,0,0,0,0,0,0,0,5,0,7,0,0,12,12
21419,Sierra Leone,2008,2008Sierra Leone,0,0,0,0,0,13,13,0,0,0,0,0,12,12,25
21420,Sierra Leone,2008,2008Sierra Leone,0,0,0,0,0,110,110,0,0,0,0,0,239,239,349
21421,Sierra Leone,2008,2008Sierra Leone,0,0,0,5,0,0,5,0,0,0,0,0,0,0,5
21422,Sierra Leone,2008,2008Sierra Leone,0,0,0,5,0,0,5,0,0,0,5,0,0,5,20
21423,Sierra Leone,2008,2008Sierra Leone,0,0,0,7,0,0,7,0,0,13,104,0,0,117,124
21424,Sierra Leone,2008,2008Sierra Leone,0,0,0,35,0,0,35,5,0,0,101,0,0,106,141
21425,Sierra Leone,2008,2008Sierra Leone,0,0,6,0,0,0,6,0,0,0,7,0,0,7,13
21426,Sierra Leone,2008,2008Sierra Leone,0,7,0,15,0,0,22,0,0,0,36,0,0,36,58
21427,Sierra Leone,2008,2008Sierra Leone,0,8,0,0,0,0,8,0,0,0,12,0,0,12,20
21428,Sierra Leone,2008,2008Sierra Leone,0,13,0,7,0,0,20,0,9,0,10,0,0,19,39
21429,Sierra Leone,2008,2008Sierra Leone,5,0,0,9,0,5,19,0,9,0,6,0,5,20,39
21430,Sierra Leone,2008,2008Sierra Leone,5,13,5,40,5,0,68,5,7,5,47,0,0,64,132
21431,Sierra Leone,2008,2008Sierra Leone,9,0,0,17,0,0,26,0,7,0,61,0,0,68,94
21432,Sierra Leone,2008,2008Sierra Leone,10,11,6,87,8,0,122,15,10,6,156,8,0,195,317
21433,Sierra Leone,2008,2008Sierra Leone,17,20,16,42,0,0,95,20,28,9,52,5,0,114,209
21434,Sierra Leone,2008,2008Sierra Leone,25,39,33,193,22,0,312,44,49,42,197,21,0,353,665
21435,Sierra Leone,2008,2008Sierra Leone,46,97,96,384,50,0,673,22,88,118,483,250,0,961,1634
21436,Sierra Leone,2008,2008Sierra Leone,170,313,284,832,35,0,1634,169,356,341,1034,45,0,1945,3579
21437,Sierra Leone,2008,2008Sierra Leone,193,452,469,1725,38,0,2877,214,450,500,2347,72,0,3583,6460
21438,Sierra Leone,2008,2008Sierra Leone,518,651,800,1343,198,0,3510,497,627,729,935,156,0,2944,6454
21439,Sierra Leone,2009,2009Sierra Leone,0,0,0,0,0,0,0,0,0,0,0,0,0,0,10922
21440,Sierra Leone,2009,2009Sierra Leone,0,0,0,0,0,0,0,0,0,0,5,0,0,5,5
21441,Sierra Leone,2009,2009Sierra Leone,0,0,0,0,0,0,0,0,0,0,6,0,0,6,6
21442,Sierra Leone,2009,2009Sierra Leone,0,0,0,0,0,0,0,0,0,0,8,0,0,8,8
21443,Sierra Leone,2009,2009Sierra Leone,0,0,0,0,0,0,0,0,0,0,9,0,0,9,9
21444,Sierra Leone,2009,2009Sierra Leone,0,0,0,0,0,0,0,0,5,0,0,0,0,5,5
21445,Sierra Leone,2009,2009Sierra Leone,0,0,0,0,0,0,0,0,5,0,7,0,0,12,12
21446,Sierra Leone,2009,2009Sierra Leone,0,0,0,0,0,20,20,0,0,0,0,0,14,14,34
21447,Sierra Leone,2009,2009Sierra Leone,0,0,0,0,0,30,30,0,0,0,0,0,186,186,216
21448,Sierra Leone,2009,2009Sierra Leone,0,0,0,5,0,0,5,0,0,0,5,0,0,5,10
21449,Sierra Leone,2009,2009Sierra Leone,0,0,0,10,0,0,10,0,0,14,114,0,0,128,138
21450,Sierra Leone,2009,2009Sierra Leone,0,0,6,0,0,0,6,0,0,7,0,0,0,7,13
21451,Sierra Leone,2009,2009Sierra Leone,0,6,0,8,0,5,19,0,9,0,5,0,5,19,38
21452,Sierra Leone,2009,2009Sierra Leone,0,14,0,7,0,0,21,0,9,0,10,0,0,19,40
21453,Sierra Leone,2009,2009Sierra Leone,5,9,5,42,5,0,66,5,8,5,48,0,0,66,132
21454,Sierra Leone,2009,2009Sierra Leone,5,11,14,44,0,0,74,5,8,31,50,0,0,94,168
21455,Sierra Leone,2009,2009Sierra Leone,17,20,16,44,0,0,97,20,28,9,53,5,0,115,212
21456,Sierra Leone,2009,2009Sierra Leone,17,28,23,138,5,0,211,8,18,9,432,8,0,475,686
21457,Sierra Leone,2009,2009Sierra Leone,20,37,53,116,15,0,241,21,37,44,134,23,0,259,500
21458,Sierra Leone,2009,2009Sierra Leone,27,19,20,84,0,0,150,0,17,33,33,223,0,306,456
21459,Sierra Leone,2009,2009Sierra Leone,145,182,254,335,56,0,972,143,187,204,240,42,0,816,1788
21460,Sierra Leone,2010,2010Sierra Leone,0,0,0,0,0,0,0,0,0,0,0,0,0,0,8946
21461,Sierra Leone,2010,2010Sierra Leone,0,0,0,0,0,0,0,0,0,0,0,0,5,5,5
21462,Sierra Leone,2010,2010Sierra Leone,0,0,0,0,0,0,0,0,0,0,5,0,0,5,5
21463,Sierra Leone,2010,2010Sierra Leone,0,0,0,0,0,0,0,0,0,0,8,0,0,8,8
21464,Sierra Leone,2010,2010Sierra Leone,0,0,0,0,0,0,0,0,5,0,0,0,0,5,5
21465,Sierra Leone,2010,2010Sierra Leone,0,0,0,0,0,0,0,0,5,0,7,0,0,12,12
21466,Sierra Leone,2010,2010Sierra Leone,0,0,0,0,0,18,18,0,0,0,0,0,12,12,30
21467,Sierra Leone,2010,2010Sierra Leone,0,0,0,0,0,30,30,0,0,0,0,0,189,189,219
21468,Sierra Leone,2010,2010Sierra Leone,0,0,0,0,0,142,142,0,0,0,0,0,260,260,402
21469,Sierra Leone,2010,2010Sierra Leone,0,0,0,5,0,0,5,0,0,10,121,0,0,131,136
21470,Sierra Leone,2010,2010Sierra Leone,0,0,14,18,0,0,32,0,14,0,12,0,0,26,58
21471,Sierra Leone,2010,2010Sierra Leone,0,6,0,0,0,0,6,0,5,0,16,0,0,21,27
21472,Sierra Leone,2010,2010Sierra Leone,0,8,0,9,0,5,22,7,0,0,7,0,5,19,41
21473,Sierra Leone,2010,2010Sierra Leone,5,13,26,36,6,0,86,6,12,27,34,5,0,84,170
21474,Sierra Leone,2010,2010Sierra Leone,5,20,48,5,0,0,78,10,31,53,5,0,0,99,177
21475,Sierra Leone,2010,2010Sierra Leone,7,0,8,34,12,0,61,11,23,8,24,0,7,73,134
21476,Sierra Leone,2010,2010Sierra Leone,8,10,6,47,5,0,76,6,7,10,50,0,0,73,149
21477,Sierra Leone,2010,2010Sierra Leone,15,30,19,158,5,0,227,7,24,12,455,12,0,510,737
21478,Sierra Leone,2011,2011Sierra Leone,0,0,0,0,0,0,0,0,0,0,0,0,0,0,5564
21479,Sierra Leone,2011,2011Sierra Leone,0,0,0,0,0,0,0,0,0,0,5,0,0,5,10
21480,Sierra Leone,2011,2011Sierra Leone,0,0,0,0,0,0,0,0,0,0,49,0,0,49,56
21481,Sierra Leone,2011,2011Sierra Leone,0,0,0,0,0,0,0,0,0,5,0,0,0,5,5
21482,Sierra Leone,2011,2011Sierra Leone,0,0,0,0,0,0,0,0,6,0,0,0,0,6,6
21483,Sierra Leone,2011,2011Sierra Leone,0,0,0,0,0,0,0,0,7,5,0,0,0,12,12
21484,Sierra Leone,2011,2011Sierra Leone,0,0,0,0,0,20,20,0,0,0,0,0,15,15,40
21485,Sierra Leone,2011,2011Sierra Leone,0,0,0,0,0,151,151,0,0,0,0,0,269,269,420
21486,Sierra Leone,2011,2011Sierra Leone,0,0,0,5,0,0,5,0,0,10,121,0,0,131,136
21487,Sierra Leone,2011,2011Sierra Leone,0,0,7,8,0,0,15,0,7,0,8,0,0,15,30
21488,Sierra Leone,2011,2011Sierra Leone,0,0,14,18,0,0,32,0,14,0,11,0,0,25,57
21489,Sierra Leone,2011,2011Sierra Leone,0,5,0,10,0,0,15,0,0,6,21,0,0,27,221
21490,Sierra Leone,2011,2011Sierra Leone,0,7,0,10,0,5,22,5,0,0,7,0,5,17,39
21491,Sierra Leone,2011,2011Sierra Leone,5,5,20,49,0,0,79,0,15,15,62,0,0,92,171
21492,Sierra Leone,2011,2011Sierra Leone,7,0,8,34,12,0,61,11,23,8,24,7,0,73,134
21493,Sierra Leone,2011,2011Sierra Leone,12,8,6,47,5,0,78,8,7,10,50,0,0,75,153
21494,Sierra Leone,2011,2011Sierra Leone,14,35,22,160,5,0,236,9,20,16,455,12,0,512,748
21495,Sierra Leone,2011,2011Sierra Leone,17,21,19,32,9,0,98,11,14,21,30,9,0,85,183
21496,Sierra Leone,2012,2012Sierra Leone,0,0,0,0,0,0,0,0,0,0,0,0,0,0,3674
21497,Sierra Leone,2012,2012Sierra Leone,0,0,0,0,0,0,0,0,0,0,0,0,5,5,10
21498,Sierra Leone,2012,2012Sierra Leone,0,0,0,0,0,0,0,0,0,0,5,0,0,5,15
21499,Sierra Leone,2012,2012Sierra Leone,0,0,0,0,0,0,0,0,0,0,40,0,0,40,53
21500,Sierra Leone,2012,2012Sierra Leone,0,0,0,0,0,0,0,0,0,5,0,0,0,5,5
21501,Sierra Leone,2012,2012Sierra Leone,0,0,0,0,0,0,0,0,6,0,0,0,0,6,6
21502,Sierra Leone,2012,2012Sierra Leone,0,0,0,0,0,0,0,0,7,5,0,0,0,12,12
21503,Sierra Leone,2012,2012Sierra Leone,0,0,0,0,0,20,20,0,0,0,0,0,14,14,34
21504,Sierra Leone,2012,2012Sierra Leone,0,0,0,0,0,159,159,0,0,0,0,0,284,284,443
21505,Sierra Leone,2012,2012Sierra Leone,0,0,0,5,0,0,5,0,0,10,121,0,0,131,136
21506,Sierra Leone,2012,2012Sierra Leone,0,0,0,5,0,0,5,0,5,0,7,0,0,12,206
21507,Sierra Leone,2012,2012Sierra Leone,0,0,5,6,0,0,11,0,0,5,6,0,0,11,22
21508,Sierra Leone,2012,2012Sierra Leone,0,0,5,25,0,0,30,0,0,5,15,0,0,20,50
21509,Sierra Leone,2012,2012Sierra Leone,0,7,0,10,0,5,22,0,5,0,7,0,5,17,39
21510,Sierra Leone,2012,2012Sierra Leone,5,6,15,54,0,0,80,0,12,14,65,0,0,91,171
21511,Sierra Leone,2012,2012Sierra Leone,7,0,8,34,12,0,61,11,23,8,24,7,0,73,134
21512,Sierra Leone,2012,2012Sierra Leone,9,18,23,83,0,0,133,5,18,26,92,5,0,146,279
21513,Sierra Leone,2012,2012Sierra Leone,9,39,19,163,5,0,235,9,22,18,453,12,0,514,749
21514,Sierra Leone,2012,2012Sierra Leone,10,10,6,47,5,0,78,5,9,11,50,0,0,75,153
21515,Sierra Leone,2013,2013Sierra Leone,0,0,0,0,0,0,0,0,0,0,0,0,0,0,3184
21516,Sierra Leone,2013,2013Sierra Leone,0,0,0,0,0,0,0,0,0,0,5,0,0,5,20
21517,Sierra Leone,2013,2013Sierra Leone,0,0,0,0,0,0,0,0,0,0,41,0,0,41,41
21518,Sierra Leone,2013,2013Sierra Leone,0,0,0,0,0,0,0,0,0,5,0,0,0,5,5
21519,Sierra Leone,2013,2013Sierra Leone,0,0,0,0,0,0,0,0,0,12,0,0,0,12,12
21520,Sierra Leone,2013,2013Sierra Leone,0,0,0,0,0,16,16,0,0,0,0,0,8,8,29
21521,Sierra Leone,2013,2013Sierra Leone,0,0,0,0,0,167,167,0,0,0,0,0,290,290,457
21522,Sierra Leone,2013,2013Sierra Leone,0,0,0,10,0,0,10,0,0,10,117,0,0,127,137
21523,Sierra Leone,2013,2013Sierra Leone,0,0,0,12,0,0,12,0,0,5,7,0,0,12,24
21524,Sierra Leone,2013,2013Sierra Leone,0,0,5,0,0,0,5,0,0,0,0,0,0,0,187
21525,Sierra Leone,2013,2013Sierra Leone,0,0,5,14,0,0,19,0,0,0,37,0,0,37,56
21526,Sierra Leone,2013,2013Sierra Leone,0,5,0,9,0,5,19,0,5,0,5,0,5,15,34
21527,Sierra Leone,2013,2013Sierra Leone,0,7,5,22,0,0,34,0,0,9,23,0,0,32,66
21528,Sierra Leone,2013,2013Sierra Leone,5,0,0,0,0,0,5,0,0,0,0,0,0,0,5
21529,Sierra Leone,2013,2013Sierra Leone,6,0,0,6,0,0,12,0,0,5,5,0,0,10,22
21530,Sierra Leone,2013,2013Sierra Leone,7,0,8,34,12,0,61,11,23,8,25,7,0,74,135
21531,Sierra Leone,2013,2013Sierra Leone,7,23,12,86,5,0,133,5,5,5,175,0,0,190,323
21532,Sierra Leone,2013,2013Sierra Leone,7,26,32,114,0,0,179,8,28,32,119,9,0,196,375
21533,Sierra Leone,2013,2013Sierra Leone,12,12,18,52,0,0,94,5,13,15,66,0,0,99,193
21534,Sierra Leone,2014,2014Sierra Leone,0,0,0,0,0,0,0,0,0,0,0,0,0,0,2933
21535,Sierra Leone,2014,2014Sierra Leone,0,0,0,0,0,0,0,0,0,0,5,0,0,5,20
21536,Sierra Leone,2014,2014Sierra Leone,0,0,0,0,0,0,0,0,0,0,41,0,0,41,41
21537,Sierra Leone,2014,2014Sierra Leone,0,0,0,0,0,0,0,0,0,5,0,0,0,5,5
21538,Sierra Leone,2014,2014Sierra Leone,0,0,0,0,0,5,5,0,0,0,0,0,26,26,31
21539,Sierra Leone,2014,2014Sierra Leone,0,0,0,0,0,171,171,0,0,0,0,0,291,291,462
21540,Sierra Leone,2014,2014Sierra Leone,0,0,0,5,0,0,5,0,0,0,0,0,0,0,158
21541,Sierra Leone,2014,2014Sierra Leone,0,0,0,19,0,0,19,0,0,0,118,0,0,118,137
21542,Sierra Leone,2014,2014Sierra Leone,0,0,5,0,0,0,5,0,0,0,0,0,0,0,5
21543,Sierra Leone,2014,2014Sierra Leone,0,0,5,0,0,0,5,0,0,0,5,0,0,5,10
21544,Sierra Leone,2014,2014Sierra Leone,0,0,5,7,0,0,12,0,0,0,9,0,0,9,21
21545,Sierra Leone,2014,2014Sierra Leone,0,0,8,19,0,0,27,5,0,0,20,0,0,25,52
21546,Sierra Leone,2014,2014Sierra Leone,0,5,0,9,0,5,19,0,5,0,8,0,5,18,37
21547,Sierra Leone,2014,2014Sierra Leone,5,0,0,0,0,0,5,0,0,0,0,0,0,0,5
21548,Sierra Leone,2014,2014Sierra Leone,6,0,0,7,0,0,13,0,9,0,0,0,0,9,22
21549,Sierra Leone,2014,2014Sierra Leone,7,0,8,34,12,0,61,11,23,8,24,7,0,73,134
21550,Sierra Leone,2014,2014Sierra Leone,7,24,11,88,5,0,135,0,8,6,175,0,0,189,324
21551,Sierra Leone,2014,2014Sierra Leone,7,26,32,114,0,0,179,8,28,32,119,9,0,196,375
21552,Sierra Leone,2014,2014Sierra Leone,13,16,22,56,0,0,107,10,12,16,71,0,0,109,216
21553,Sierra Leone,2015,2015Sierra Leone,0,0,0,0,0,0,0,0,0,0,0,0,0,0,2881
21554,Sierra Leone,2015,2015Sierra Leone,0,0,0,0,0,0,0,0,0,0,0,0,5,5,5
21555,Sierra Leone,2015,2015Sierra Leone,0,0,0,0,0,0,0,0,0,0,5,0,0,5,25
21556,Sierra Leone,2015,2015Sierra Leone,0,0,0,0,0,0,0,0,0,0,39,0,0,39,39
21557,Sierra Leone,2015,2015Sierra Leone,0,0,0,0,0,0,0,0,0,5,0,0,0,5,5
21558,Sierra Leone,2015,2015Sierra Leone,0,0,0,0,0,17,17,0,0,0,0,0,13,13,30
21559,Sierra Leone,2015,2015Sierra Leone,0,0,0,0,0,176,176,0,0,0,0,0,302,302,478
21560,Sierra Leone,2015,2015Sierra Leone,0,0,0,12,0,0,12,0,0,6,5,0,0,11,23
21561,Sierra Leone,2015,2015Sierra Leone,0,0,0,13,0,0,13,0,0,7,119,0,0,126,139
21562,Sierra Leone,2015,2015Sierra Leone,0,0,0,16,0,0,16,0,0,0,38,0,0,38,54
21563,Sierra Leone,2015,2015Sierra Leone,0,0,5,0,0,0,5,0,0,0,0,0,0,0,5
21564,Sierra Leone,2015,2015Sierra Leone,0,0,5,0,0,0,5,0,0,0,5,0,0,5,10
21565,Sierra Leone,2015,2015Sierra Leone,0,0,5,12,0,9,26,0,0,6,9,0,0,15,41
21566,Sierra Leone,2015,2015Sierra Leone,5,0,0,0,0,0,5,0,0,0,0,0,0,0,5
21567,Sierra Leone,2015,2015Sierra Leone,5,12,17,53,5,0,92,0,20,14,71,5,0,110,202
21568,Sierra Leone,2015,2015Sierra Leone,5,19,11,97,5,0,137,0,8,6,184,6,0,204,341
21569,Sierra Leone,2015,2015Sierra Leone,8,10,8,36,0,0,62,6,11,14,26,0,0,57,119
21570,Sierra Leone,2015,2015Sierra Leone,9,26,32,114,0,0,181,11,28,32,119,9,0,199,380
21571,Sierra Leone,2015,2015Sierra Leone,13,0,10,34,0,0,57,6,10,5,40,0,0,61,118
21572,Sierra Leone,2016,2016Sierra Leone,0,0,0,0,0,0,0,0,0,0,0,0,0,0,2644
21573,Sierra Leone,2016,2016Sierra Leone,0,0,0,0,0,0,0,0,0,0,0,0,5,5,5
21574,Sierra Leone,2016,2016Sierra Leone,0,0,0,0,0,0,0,0,0,0,5,0,0,5,35
21575,Sierra Leone,2016,2016Sierra Leone,0,0,0,0,0,0,0,0,0,0,37,0,0,37,37
21576,Sierra Leone,2016,2016Sierra Leone,0,0,0,0,0,5,5,0,0,0,0,0,0,0,5
21577,Sierra Leone,2016,2016Sierra Leone,0,0,0,0,0,5,5,0,0,0,0,0,15,15,20
21578,Sierra Leone,2016,2016Sierra Leone,0,0,0,0,0,15,15,0,0,0,0,0,11,11,26
21579,Sierra Leone,2016,2016Sierra Leone,0,0,0,0,0,197,197,0,0,0,0,0,314,314,511
21580,Sierra Leone,2016,2016Sierra Leone,0,0,0,10,0,0,10,0,0,5,11,0,9,25,35
21581,Sierra Leone,2016,2016Sierra Leone,0,0,0,12,0,0,12,0,0,0,9,0,0,9,21
21582,Sierra Leone,2016,2016Sierra Leone,0,0,0,16,0,0,16,0,0,0,37,0,0,37,53
21583,Sierra Leone,2016,2016Sierra Leone,0,0,0,17,0,0,17,0,0,7,126,0,0,133,150
21584,Sierra Leone,2016,2016Sierra Leone,0,0,5,0,0,0,5,0,0,0,5,0,0,5,10
21585,Sierra Leone,2016,2016Sierra Leone,0,5,0,0,0,0,5,0,0,0,0,0,0,0,5
21586,Sierra Leone,2016,2016Sierra Leone,0,5,5,28,0,0,38,0,6,0,33,0,0,39,77
21587,Sierra Leone,2016,2016Sierra Leone,0,7,17,52,0,0,76,0,12,11,65,5,0,93,169
21588,Sierra Leone,2016,2016Sierra Leone,5,18,12,95,5,0,135,0,5,7,186,5,0,203,338
21589,Sierra Leone,2016,2016Sierra Leone,5,18,31,127,0,0,181,5,18,36,126,10,0,195,376
21590,Sierra Leone,2016,2016Sierra Leone,6,0,0,7,0,0,13,0,9,0,0,0,0,9,22
21591,Sierra Leone,2016,2016Sierra Leone,8,10,8,36,0,0,62,6,11,14,27,0,0,58,120
21592,Sierra Leone,2016,2016Sierra Leone,14,0,0,0,0,0,14,0,0,0,5,0,0,5,19
21593,Sierra Leone,2017,2017Sierra Leone,0,0,0,0,0,0,0,0,0,0,0,0,0,0,2384
21594,Sierra Leone,2017,2017Sierra Leone,0,0,0,0,0,0,0,0,0,0,0,0,5,5,5
21595,Sierra Leone,2017,2017Sierra Leone,0,0,0,0,0,0,0,0,0,0,0,0,374,374,374
21596,Sierra Leone,2017,2017Sierra Leone,0,0,0,0,0,0,0,0,0,0,5,0,0,5,25
21597,Sierra Leone,2017,2017Sierra Leone,0,0,0,0,0,0,0,0,0,0,37,0,0,37,37
21598,Sierra Leone,2017,2017Sierra Leone,0,0,0,0,0,0,0,0,0,5,0,0,0,5,5
21599,Sierra Leone,2017,2017Sierra Leone,0,0,0,0,0,204,204,0,0,0,0,0,337,337,541
21600,Sierra Leone,2017,2017Sierra Leone,0,0,0,9,0,9,18,0,0,5,11,0,0,16,34
21601,Sierra Leone,2017,2017Sierra Leone,0,0,0,12,0,0,12,0,0,0,9,0,0,9,21
21602,Sierra Leone,2017,2017Sierra Leone,0,0,0,17,0,0,17,0,0,0,36,0,0,36,53
21603,Sierra Leone,2017,2017Sierra Leone,0,5,0,0,0,0,5,0,0,0,0,0,0,0,10
21604,Sierra Leone,2017,2017Sierra Leone,0,5,6,32,0,0,43,7,8,0,29,0,0,44,87
21605,Sierra Leone,2017,2017Sierra Leone,0,6,0,0,0,0,6,0,0,6,0,0,0,6,12
21606,Sierra Leone,2017,2017Sierra Leone,5,0,0,0,0,0,5,0,0,0,0,0,0,0,5
21607,Sierra Leone,2017,2017Sierra Leone,5,0,9,0,0,0,14,0,0,0,5,0,0,5,19
21608,Sierra Leone,2017,2017Sierra Leone,7,7,9,39,0,0,62,5,10,8,34,0,0,57,119
21609,Sierra Leone,2017,2017Sierra Leone,10,9,18,59,0,0,96,6,11,16,68,5,0,106,202
21610,Sierra Leone,2017,2017Sierra Leone,35,29,22,180,6,0,272,18,17,13,237,6,0,291,563
21611,Sierra Leone,2018,2018Sierra Leone,0,0,0,0,0,0,0,0,0,0,0,0,0,0,2834
21612,Sierra Leone,2018,2018Sierra Leone,0,0,0,0,0,0,0,0,0,0,5,0,0,5,30
21613,Sierra Leone,2018,2018Sierra Leone,0,0,0,0,0,0,0,0,0,0,37,0,0,37,37
21614,Sierra Leone,2018,2018Sierra Leone,0,0,0,0,0,216,216,0,0,0,0,0,364,364,580
21615,Sierra Leone,2018,2018Sierra Leone,0,0,0,5,0,0,5,0,0,0,0,0,0,0,5
21616,Sierra Leone,2018,2018Sierra Leone,0,0,0,8,0,0,8,0,0,5,11,0,8,24,32
21617,Sierra Leone,2018,2018Sierra Leone,0,0,0,9,0,0,9,0,0,0,13,0,0,13,22
21618,Sierra Leone,2018,2018Sierra Leone,0,0,0,12,0,0,12,0,0,0,9,0,0,9,21
21619,Sierra Leone,2018,2018Sierra Leone,0,5,0,0,0,0,5,0,0,0,0,0,0,0,10
21620,Sierra Leone,2018,2018Sierra Leone,0,5,0,6,0,0,11,0,0,0,7,0,0,7,82
21621,Sierra Leone,2018,2018Sierra Leone,0,5,5,34,0,0,44,7,0,9,28,0,0,44,88
21622,Sierra Leone,2018,2018Sierra Leone,5,0,0,0,0,0,5,0,0,0,0,0,0,0,5
21623,Sierra Leone,2018,2018Sierra Leone,5,0,9,0,0,0,14,0,0,0,5,0,0,5,19
21624,Sierra Leone,2018,2018Sierra Leone,5,11,7,40,0,0,63,5,8,7,23,0,0,43,106
21625,Sierra Leone,2018,2018Sierra Leone,5,16,23,70,0,0,114,9,15,20,82,5,0,131,245
21626,Sierra Leone,2018,2018Sierra Leone,50,34,30,230,6,0,350,37,33,24,278,8,0,380,730
21627,Sierra Leone,2019,2019Sierra Leone,0,0,0,0,0,0,0,0,0,0,0,0,0,0,2923
21628,Sierra Leone,2019,2019Sierra Leone,0,0,0,0,0,0,0,0,0,0,0,0,5,5,5
21629,Sierra Leone,2019,2019Sierra Leone,0,0,0,0,0,0,0,0,0,0,0,5,0,5,5
21630,Sierra Leone,2019,2019Sierra Leone,0,0,0,0,0,0,0,0,0,0,5,0,0,5,15
21631,Sierra Leone,2019,2019Sierra Leone,0,0,0,0,0,0,0,0,0,0,37,0,0,37,37
21632,Sierra Leone,2019,2019Sierra Leone,0,0,0,0,0,0,0,5,0,0,0,0,0,5,5
21633,Sierra Leone,2019,2019Sierra Leone,0,0,0,0,0,251,251,0,0,0,0,0,420,420,671
21634,Sierra Leone,2019,2019Sierra Leone,0,0,0,5,0,0,5,0,0,0,0,0,0,0,5
21635,Sierra Leone,2019,2019Sierra Leone,0,0,0,5,0,0,5,0,0,0,6,0,0,6,11
21636,Sierra Leone,2019,2019Sierra Leone,0,0,0,9,0,0,9,0,0,5,10,0,0,15,30
21637,Sierra Leone,2019,2019Sierra Leone,0,0,0,13,0,0,13,0,0,5,5,0,0,10,23
21638,Sierra Leone,2019,2019Sierra Leone,0,5,0,0,0,0,5,0,5,0,0,0,0,5,10
21639,Sierra Leone,2019,2019Sierra Leone,0,10,9,45,0,0,64,0,10,8,25,0,0,43,107
21640,Sierra Leone,2019,2019Sierra Leone,5,0,0,9,0,0,14,0,0,0,5,0,0,5,19
21641,Sierra Leone,2019,2019Sierra Leone,5,0,0,13,0,0,18,0,0,0,16,0,0,16,34
21642,Sierra Leone,2019,2019Sierra Leone,5,5,0,35,0,0,45,6,0,9,29,0,0,44,89
21643,Sierra Leone,2019,2019Sierra Leone,15,37,60,145,5,0,262,16,40,42,157,13,0,268,530
21644,Sierra Leone,2019,2019Sierra Leone,55,38,23,244,6,0,366,42,37,23,292,9,0,403,769
21645,Sierra Leone,2020,2020Sierra Leone,0,0,0,0,0,0,0,0,0,0,0,0,0,0,3204
21646,Sierra Leone,2020,2020Sierra Leone,0,0,0,0,0,0,0,0,0,0,0,0,5,5,10
21647,Sierra Leone,2020,2020Sierra Leone,0,0,0,0,0,0,0,0,0,0,0,5,0,5,5
21648,Sierra Leone,2020,2020Sierra Leone,0,0,0,0,0,0,0,0,0,0,5,0,0,5,15
21649,Sierra Leone,2020,2020Sierra Leone,0,0,0,0,0,0,0,0,0,0,37,0,0,37,37
21650,Sierra Leone,2020,2020Sierra Leone,0,0,0,0,0,0,0,5,0,0,0,0,0,5,10
21651,Sierra Leone,2020,2020Sierra Leone,0,0,0,0,0,18,18,0,0,0,0,0,9,9,27
21652,Sierra Leone,2020,2020Sierra Leone,0,0,0,5,0,0,5,0,0,5,9,0,0,14,19
21653,Sierra Leone,2020,2020Sierra Leone,0,0,0,6,0,0,6,0,0,0,5,0,0,5,11
21654,Sierra Leone,2020,2020Sierra Leone,0,0,0,11,0,0,11,0,0,0,12,0,0,12,23
21655,Sierra Leone,2020,2020Sierra Leone,0,0,6,7,0,0,13,0,0,5,12,0,0,17,36
21656,Sierra Leone,2020,2020Sierra Leone,0,5,0,0,0,0,5,0,5,0,0,0,0,5,10
21657,Sierra Leone,2020,2020Sierra Leone,0,7,0,22,0,0,29,5,0,0,17,0,0,22,51
21658,Sierra Leone,2020,2020Sierra Leone,0,14,8,42,0,0,64,0,7,6,30,0,0,43,107
21659,Sierra Leone,2020,2020Sierra Leone,5,0,0,9,0,0,14,0,0,0,5,0,0,5,19
21660,Sierra Leone,2020,2020Sierra Leone,5,5,0,36,0,0,46,0,6,8,30,0,0,44,90
21661,Sierra Leone,2020,2020Sierra Leone,18,87,92,377,17,0,591,42,98,99,424,18,0,681,1272
21662,Sierra Leone,2020,2020Sierra Leone,62,43,26,259,5,0,395,43,44,15,281,10,0,393,788
21663,Sierra Leone,2021,2021Sierra Leone,0,0,0,0,0,0,0,0,0,0,0,0,0,0,3632
21664,Sierra Leone,2021,2021Sierra Leone,0,0,0,0,0,0,0,0,0,0,0,0,5,5,10
21665,Sierra Leone,2021,2021Sierra Leone,0,0,0,0,0,0,0,0,0,0,0,5,0,5,5
21666,Sierra Leone,2021,2021Sierra Leone,0,0,0,0,0,0,0,0,0,0,5,0,0,5,15
21667,Sierra Leone,2021,2021Sierra Leone,0,0,0,0,0,0,0,0,0,0,37,0,0,37,37
21668,Sierra Leone,2021,2021Sierra Leone,0,0,0,0,0,0,0,0,0,5,6,0,0,11,11
21669,Sierra Leone,2021,2021Sierra Leone,0,0,0,0,0,0,0,5,0,0,0,0,0,5,5
21670,Sierra Leone,2021,2021Sierra Leone,0,0,0,5,0,0,5,0,0,0,0,0,0,0,5
21671,Sierra Leone,2021,2021Sierra Leone,0,0,0,5,0,0,5,0,0,0,14,0,0,14,19
21672,Sierra Leone,2021,2021Sierra Leone,0,0,0,8,0,0,8,0,0,0,5,0,0,5,28
21673,Sierra Leone,2021,2021Sierra Leone,0,0,0,9,0,0,9,0,0,0,0,0,0,0,9
21674,Sierra Leone,2021,2021Sierra Leone,0,0,0,9,0,0,9,0,0,0,6,0,0,6,15
21675,Sierra Leone,2021,2021Sierra Leone,0,0,0,12,0,0,12,0,0,0,12,0,0,12,24
21676,Sierra Leone,2021,2021Sierra Leone,0,0,6,7,0,0,13,0,0,5,16,0,0,21,39
21677,Sierra Leone,2021,2021Sierra Leone,0,5,0,0,0,0,5,0,5,0,0,0,0,5,10
21678,Sierra Leone,2021,2021Sierra Leone,0,7,0,28,0,0,35,8,0,0,20,0,0,28,63
21679,Sierra Leone,2021,2021Sierra Leone,0,8,0,35,0,0,43,0,7,8,29,0,0,44,87
21680,Sierra Leone,2021,2021Sierra Leone,0,10,0,5,0,0,15,0,0,0,5,0,0,5,20
21681,Sierra Leone,2021,2021Sierra Leone,0,14,8,41,0,0,63,0,6,6,30,0,0,42,105
21682,Sierra Leone,2021,2021Sierra Leone,28,104,106,545,11,0,794,46,92,127,587,5,0,857,1651
21683,Sierra Leone,2021,2021Sierra Leone,60,53,25,272,5,0,415,49,45,16,290,10,0,410,825
21684,Somalia,2001,2001Somalia,0,0,0,0,0,0,0,0,0,0,0,0,0,0,115145
21685,Somalia,2001,2001Somalia,0,0,0,0,0,0,0,0,0,0,5,0,0,5,10
21686,Somalia,2001,2001Somalia,0,0,0,0,0,0,0,0,0,0,7,0,0,7,390
21687,Somalia,2001,2001Somalia,0,0,0,0,0,0,0,0,0,0,10,0,0,10,10
21688,Somalia,2001,2001Somalia,0,0,0,0,0,0,0,0,0,0,14,0,0,14,22
21689,Somalia,2001,2001Somalia,0,0,0,0,0,0,0,0,0,6,6,0,0,12,12
21690,Somalia,2001,2001Somalia,0,0,0,0,0,72,72,0,0,0,0,0,115,115,187
21691,Somalia,2001,2001Somalia,0,0,0,0,0,263,263,0,0,0,0,0,280,280,543
21692,Somalia,2001,2001Somalia,0,0,0,0,0,2180,2180,0,0,0,0,0,2197,2197,4377
21693,Somalia,2001,2001Somalia,0,0,0,5,0,0,5,0,0,0,0,0,0,0,5
21694,Somalia,2001,2001Somalia,0,0,0,5,0,0,5,0,0,0,43,0,0,43,48
21695,Somalia,2001,2001Somalia,0,0,5,0,0,0,5,0,0,0,8,0,0,8,13
21696,Somalia,2001,2001Somalia,0,0,5,0,0,0,5,0,0,0,10,0,0,10,15
21697,Somalia,2001,2001Somalia,0,0,5,6,0,0,11,0,5,0,15,0,0,20,31
21698,Somalia,2001,2001Somalia,0,5,0,0,0,0,5,0,0,0,0,0,0,0,5
21699,Somalia,2001,2001Somalia,0,5,0,5,0,0,10,5,0,0,5,0,0,10,20
21700,Somalia,2001,2001Somalia,0,6,5,0,0,0,11,0,0,0,41,0,0,41,52
21701,Somalia,2001,2001Somalia,0,6,5,14,0,0,25,0,7,7,29,0,0,43,68
21702,Somalia,2001,2001Somalia,0,7,0,0,0,0,7,0,8,0,0,0,0,8,15
21703,Somalia,2001,2001Somalia,0,7,6,26,0,0,39,0,9,0,21,0,0,30,69
21704,Somalia,2001,2001Somalia,0,9,0,0,0,0,9,0,0,8,5,0,0,13,22
21705,Somalia,2001,2001Somalia,5,0,0,0,0,0,5,0,0,0,0,0,0,0,5
21706,Somalia,2001,2001Somalia,5,0,0,0,0,0,5,0,5,0,5,0,0,10,15
21707,Somalia,2001,2001Somalia,5,24,21,35,0,0,85,6,26,23,35,0,0,90,175
21708,Somalia,2001,2001Somalia,6,0,0,0,0,0,6,5,0,0,10,0,0,15,21
21709,Somalia,2001,2001Somalia,6,0,0,32,0,0,38,0,6,6,19,0,0,31,69
21710,Somalia,2001,2001Somalia,8,0,0,39,5,0,52,5,5,5,85,7,0,107,159
21711,Somalia,2001,2001Somalia,9,41,36,117,6,0,209,13,41,36,93,5,0,188,397
21712,Somalia,2001,2001Somalia,15,59,50,195,0,0,319,14,99,84,430,0,0,627,5336
21713,Somalia,2001,2001Somalia,21,35,14,85,0,0,155,28,41,37,152,5,0,263,418
21714,Somalia,2001,2001Somalia,22,24,20,38,12,0,116,19,41,35,78,32,0,205,321
21715,Somalia,2001,2001Somalia,30,59,50,232,11,0,382,47,71,61,362,10,0,551,940
21716,Somalia,2001,2001Somalia,38,102,87,319,31,0,577,43,110,95,334,18,0,600,1177
21717,Somalia,2001,2001Somalia,50,71,62,215,13,0,411,57,70,55,221,5,0,408,819
21718,Somalia,2001,2001Somalia,66,43,32,75,0,0,216,70,36,31,103,5,0,245,461
21719,Somalia,2001,2001Somalia,120,65,55,180,180,0,600,40,65,55,80,160,0,400,2906
21720,Somalia,2001,2001Somalia,208,153,131,282,18,0,792,218,185,159,366,23,0,951,1743
21721,Somalia,2001,2001Somalia,305,377,323,680,142,0,1827,402,380,325,400,90,0,1597,3424
21722,Somalia,2001,2001Somalia,991,2628,2252,5016,253,484,11624,775,2292,1965,3499,245,246,9022,21712
21723,Somalia,2001,2001Somalia,1457,8397,7203,17000,1030,0,35087,1261,8631,7407,13075,1668,0,32042,67129
21724,Somalia,2001,2001Somalia,3028,5307,4546,14069,2209,0,29159,3114,4817,4138,12530,1954,0,26553,67485
21725,Somalia,2001,2001Somalia,9842,13151,11273,34636,1800,0,70702,10515,14952,12816,33277,2087,0,73647,144349
21726,Somalia,2002,2002Somalia,0,0,0,0,0,0,0,0,0,0,0,0,0,0,132773
21727,Somalia,2002,2002Somalia,0,0,0,0,0,0,0,0,0,0,5,0,0,5,15
21728,Somalia,2002,2002Somalia,0,0,0,0,0,0,0,0,0,0,7,0,0,7,7
21729,Somalia,2002,2002Somalia,0,0,0,0,0,0,0,0,0,0,8,0,0,8,8
21730,Somalia,2002,2002Somalia,0,0,0,0,0,0,0,0,0,0,13,0,0,13,22
21731,Somalia,2002,2002Somalia,0,0,0,0,0,0,0,0,0,0,20,0,0,20,20
21732,Somalia,2002,2002Somalia,0,0,0,0,0,0,0,0,5,0,5,0,0,10,10
21733,Somalia,2002,2002Somalia,0,0,0,0,0,157,157,0,0,0,0,0,160,160,3894
21734,Somalia,2002,2002Somalia,0,0,0,0,0,264,264,0,0,0,0,0,299,299,563
21735,Somalia,2002,2002Somalia,0,0,0,0,0,472,472,0,0,0,0,0,469,469,941
21736,Somalia,2002,2002Somalia,0,0,0,5,0,0,5,0,0,0,0,0,0,0,10
21737,Somalia,2002,2002Somalia,0,0,0,5,0,0,5,0,0,0,7,0,0,7,12
21738,Somalia,2002,2002Somalia,0,0,0,8,0,0,8,0,0,0,0,0,0,0,8
21739,Somalia,2002,2002Somalia,0,0,0,8,0,0,8,0,0,0,5,0,0,5,13
21740,Somalia,2002,2002Somalia,0,0,5,0,0,0,5,0,0,0,0,0,0,0,5
21741,Somalia,2002,2002Somalia,0,0,5,0,0,0,5,0,0,0,10,0,0,10,15
21742,Somalia,2002,2002Somalia,0,0,9,0,0,0,9,0,0,6,5,0,0,11,20
21743,Somalia,2002,2002Somalia,0,0,9,40,0,0,49,7,7,0,68,5,0,87,136
21744,Somalia,2002,2002Somalia,0,5,6,19,0,0,30,0,6,6,26,0,0,38,68
21745,Somalia,2002,2002Somalia,0,6,0,0,0,0,6,0,0,0,0,0,0,0,6
21746,Somalia,2002,2002Somalia,0,6,0,0,0,0,6,0,0,8,0,0,0,8,14
21747,Somalia,2002,2002Somalia,0,6,5,0,0,0,11,0,0,0,42,0,0,42,53
21748,Somalia,2002,2002Somalia,0,9,0,0,0,0,9,0,0,5,11,0,0,16,25
21749,Somalia,2002,2002Somalia,0,9,0,0,0,0,9,0,6,0,10,0,0,16,25
21750,Somalia,2002,2002Somalia,5,0,0,0,0,0,5,0,0,0,6,0,0,6,11
21751,Somalia,2002,2002Somalia,5,8,7,43,0,0,63,0,7,7,30,0,0,44,107
21752,Somalia,2002,2002Somalia,6,0,0,20,0,0,26,5,8,7,23,0,0,43,69
21753,Somalia,2002,2002Somalia,7,30,25,109,0,0,171,12,28,24,219,0,0,283,6515
21754,Somalia,2002,2002Somalia,9,41,36,121,6,0,213,15,41,36,97,0,0,189,402
21755,Somalia,2002,2002Somalia,49,125,107,446,32,0,759,64,135,116,549,16,0,880,1639
21756,Somalia,2002,2002Somalia,55,43,37,120,45,0,300,40,40,35,180,55,0,350,2899
21757,Somalia,2002,2002Somalia,65,72,62,240,0,0,439,65,77,61,231,6,0,440,879
21758,Somalia,2002,2002Somalia,79,48,37,86,0,0,250,89,43,37,151,5,0,325,575
21759,Somalia,2002,2002Somalia,315,379,324,685,148,0,1851,410,389,333,411,99,0,1642,3493
21760,Somalia,2002,2002Somalia,354,151,129,640,13,0,1287,204,266,228,983,22,0,1703,2990
21761,Somalia,2002,2002Somalia,1055,4663,3998,8400,644,0,18760,1036,5165,4426,7387,758,0,18772,37532
21762,Somalia,2002,2002Somalia,1761,6396,5481,22206,1461,0,37305,1804,6573,5635,28271,1175,0,43458,80763
21763,Somalia,2002,2002Somalia,12952,13658,11706,35737,1808,0,75861,14015,15662,13422,34687,2120,0,79906,155767
21764,Somalia,2003,2003Somalia,0,0,0,0,0,0,0,0,0,0,0,0,0,0,133315
21765,Somalia,2003,2003Somalia,0,0,0,0,0,0,0,0,0,0,0,0,5,5,5
21766,Somalia,2003,2003Somalia,0,0,0,0,0,0,0,0,0,0,5,0,0,5,5
21767,Somalia,2003,2003Somalia,0,0,0,0,0,0,0,0,0,0,6,0,0,6,12
21768,Somalia,2003,2003Somalia,0,0,0,0,0,0,0,0,0,0,7,0,0,7,7
21769,Somalia,2003,2003Somalia,0,0,0,0,0,0,0,0,0,0,8,0,0,8,8
21770,Somalia,2003,2003Somalia,0,0,0,0,0,0,0,0,0,0,13,0,0,13,13
21771,Somalia,2003,2003Somalia,0,0,0,0,0,0,0,5,0,0,0,0,0,5,5
21772,Somalia,2003,2003Somalia,0,0,0,0,0,150,150,0,0,0,0,0,151,151,3812
21773,Somalia,2003,2003Somalia,0,0,0,0,0,258,258,0,0,0,0,0,285,285,543
21774,Somalia,2003,2003Somalia,0,0,0,5,0,0,5,0,0,0,0,0,0,0,5
21775,Somalia,2003,2003Somalia,0,0,0,5,0,0,5,0,0,0,6,0,0,6,11
21776,Somalia,2003,2003Somalia,0,0,0,7,0,0,7,0,0,0,0,0,0,0,7
21777,Somalia,2003,2003Somalia,0,0,0,7,0,0,7,0,6,0,0,0,0,6,13
21778,Somalia,2003,2003Somalia,0,0,0,8,0,0,8,0,0,0,5,0,0,5,13
21779,Somalia,2003,2003Somalia,0,0,5,0,0,0,5,0,0,0,0,0,0,0,17
21780,Somalia,2003,2003Somalia,0,0,6,0,0,0,6,0,0,0,6,0,0,6,12
21781,Somalia,2003,2003Somalia,0,0,9,39,0,0,48,8,5,5,63,5,0,86,134
21782,Somalia,2003,2003Somalia,0,5,0,0,0,0,5,0,0,0,10,0,0,10,15
21783,Somalia,2003,2003Somalia,0,5,0,0,0,0,5,0,0,0,11,0,0,11,16
21784,Somalia,2003,2003Somalia,0,5,0,5,0,0,10,6,0,0,30,0,0,36,46
21785,Somalia,2003,2003Somalia,0,5,5,27,0,0,37,0,6,5,18,0,0,29,66
21786,Somalia,2003,2003Somalia,0,6,6,7,0,0,19,0,5,0,119,0,0,124,143
21787,Somalia,2003,2003Somalia,0,6,6,22,0,0,34,0,8,7,124,5,0,144,2906
21788,Somalia,2003,2003Somalia,0,15,0,0,0,0,15,5,0,9,0,0,0,14,29
21789,Somalia,2003,2003Somalia,5,0,0,0,0,0,5,0,0,0,6,0,0,6,11
21790,Somalia,2003,2003Somalia,5,8,7,43,0,0,63,0,7,7,30,0,0,44,107
21791,Somalia,2003,2003Somalia,6,0,0,20,0,0,26,5,8,7,23,0,0,43,69
21792,Somalia,2003,2003Somalia,7,30,25,109,0,0,171,12,28,24,219,0,0,283,6890
21793,Somalia,2003,2003Somalia,8,44,37,148,7,0,244,14,44,38,113,0,0,209,453
21794,Somalia,2003,2003Somalia,8,65,56,260,16,0,405,26,69,59,407,21,0,582,987
21795,Somalia,2003,2003Somalia,13,0,5,77,37,0,132,11,38,27,101,0,0,177,309
21796,Somalia,2003,2003Somalia,61,73,69,237,5,0,445,70,77,62,232,6,0,447,892
21797,Somalia,2003,2003Somalia,112,248,213,848,42,0,1463,117,269,230,966,23,0,1605,3068
21798,Somalia,2003,2003Somalia,249,281,240,649,22,0,1441,296,306,262,929,27,0,1820,3261
21799,Somalia,2003,2003Somalia,330,344,295,651,141,0,1761,430,352,302,391,94,0,1569,3330
21800,Somalia,2003,2003Somalia,916,3405,2919,6437,559,0,14236,917,3704,3175,5584,660,0,14040,28276
21801,Somalia,2003,2003Somalia,1867,4810,4119,11749,1353,0,23898,1820,5073,4350,10691,1119,0,23053,59246
21802,Somalia,2003,2003Somalia,11526,13619,11672,36584,1752,0,75153,12377,15578,13352,35707,2105,0,79119,154272
21803,Somalia,2004,2004Somalia,0,0,0,0,0,0,0,0,0,0,0,0,0,0,134686
21804,Somalia,2004,2004Somalia,0,0,0,0,0,0,0,0,0,0,5,0,0,5,15
21805,Somalia,2004,2004Somalia,0,0,0,0,0,0,0,0,0,0,6,0,0,6,12
21806,Somalia,2004,2004Somalia,0,0,0,0,0,0,0,0,0,0,7,0,0,7,7
21807,Somalia,2004,2004Somalia,0,0,0,0,0,0,0,0,0,0,9,0,0,9,9
21808,Somalia,2004,2004Somalia,0,0,0,0,0,0,0,0,0,0,24,0,0,24,24
21809,Somalia,2004,2004Somalia,0,0,0,0,0,0,0,0,0,8,0,0,0,8,8
21810,Somalia,2004,2004Somalia,0,0,0,0,0,0,0,5,0,0,0,0,0,5,5
21811,Somalia,2004,2004Somalia,0,0,0,5,0,0,5,0,0,0,0,0,0,0,10
21812,Somalia,2004,2004Somalia,0,0,0,7,0,0,7,0,0,0,0,0,0,0,7
21813,Somalia,2004,2004Somalia,0,0,0,7,0,0,7,0,0,0,5,0,0,5,12
21814,Somalia,2004,2004Somalia,0,0,5,0,0,0,5,0,0,0,10,0,0,10,15
21815,Somalia,2004,2004Somalia,0,0,5,6,0,0,11,0,5,0,11,0,0,16,27
21816,Somalia,2004,2004Somalia,0,0,6,0,0,0,6,0,0,0,6,0,0,6,12
21817,Somalia,2004,2004Somalia,0,0,7,6,0,0,13,0,8,0,26,0,0,34,47
21818,Somalia,2004,2004Somalia,0,5,0,0,0,0,5,0,0,0,11,0,0,11,16
21819,Somalia,2004,2004Somalia,0,5,0,7,0,0,12,0,0,0,17,0,0,17,99
21820,Somalia,2004,2004Somalia,0,7,6,24,0,0,37,0,25,22,133,0,0,180,217
21821,Somalia,2004,2004Somalia,5,0,0,0,0,0,5,0,0,0,6,0,0,6,11
21822,Somalia,2004,2004Somalia,5,8,7,43,0,0,63,0,7,7,30,0,0,44,107
21823,Somalia,2004,2004Somalia,6,0,0,20,0,0,26,5,8,7,23,0,0,43,69
21824,Somalia,2004,2004Somalia,7,0,0,22,0,0,29,7,0,0,43,0,0,50,79
21825,Somalia,2004,2004Somalia,8,65,57,265,16,0,411,29,71,60,382,22,0,564,1675
21826,Somalia,2004,2004Somalia,9,7,0,26,0,0,42,5,5,5,13,0,0,28,70
21827,Somalia,2004,2004Somalia,9,46,40,145,5,0,245,17,52,44,109,0,0,222,467
21828,Somalia,2004,2004Somalia,34,131,112,630,23,0,930,146,311,266,1266,19,0,2008,2938
21829,Somalia,2004,2004Somalia,37,1985,1701,4421,165,0,8309,33,2053,1759,4037,279,0,8161,16470
21830,Somalia,2004,2004Somalia,86,91,87,271,5,0,540,89,97,82,273,8,0,549,1089
21831,Somalia,2004,2004Somalia,139,310,265,1027,42,0,1783,155,339,290,1222,20,0,2026,3809
21832,Somalia,2004,2004Somalia,211,275,236,852,71,143,1788,247,273,234,1017,42,146,1959,3747
21833,Somalia,2004,2004Somalia,221,380,326,613,67,0,1607,200,289,247,463,61,0,1260,2867
21834,Somalia,2004,2004Somalia,293,298,255,690,24,0,1560,346,335,287,968,27,0,1963,3523
21835,Somalia,2004,2004Somalia,1796,5154,4414,14499,1364,0,27227,1781,5481,4700,23186,1136,0,36284,63511
21836,Somalia,2004,2004Somalia,10810,13538,11603,37128,1783,0,74862,11688,15259,13079,36535,2204,0,78765,153627
21837,Somalia,2005,2005Somalia,0,0,0,0,0,0,0,0,0,0,0,0,0,0,130443
21838,Somalia,2005,2005Somalia,0,0,0,0,0,0,0,0,0,0,5,0,0,5,20
21839,Somalia,2005,2005Somalia,0,0,0,0,0,0,0,0,0,0,9,0,0,9,9
21840,Somalia,2005,2005Somalia,0,0,0,0,0,0,0,0,0,0,10,0,0,10,10
21841,Somalia,2005,2005Somalia,0,0,0,0,0,0,0,0,0,0,14,0,0,14,14
21842,Somalia,2005,2005Somalia,0,0,0,0,0,0,0,0,0,0,25,0,0,25,25
21843,Somalia,2005,2005Somalia,0,0,0,0,0,0,0,0,0,5,0,0,0,5,5
21844,Somalia,2005,2005Somalia,0,0,0,0,0,0,0,0,5,0,5,0,0,10,10
21845,Somalia,2005,2005Somalia,0,0,0,0,0,5,5,0,0,0,0,0,5,5,10
21846,Somalia,2005,2005Somalia,0,0,0,0,0,291,291,0,0,0,0,0,296,296,587
21847,Somalia,2005,2005Somalia,0,0,0,5,0,0,5,0,0,0,0,0,0,0,10
21848,Somalia,2005,2005Somalia,0,0,0,5,0,0,5,0,0,0,14,0,0,14,19
21849,Somalia,2005,2005Somalia,0,0,0,6,0,0,6,0,0,0,0,0,0,0,109
21850,Somalia,2005,2005Somalia,0,0,0,6,0,0,6,0,5,0,15,0,0,20,26
21851,Somalia,2005,2005Somalia,0,0,0,7,0,0,7,0,0,0,5,0,0,5,12
21852,Somalia,2005,2005Somalia,0,0,0,7,0,0,7,0,0,0,8,0,0,8,15
21853,Somalia,2005,2005Somalia,0,0,0,7,0,0,7,0,0,0,20,0,0,20,27
21854,Somalia,2005,2005Somalia,0,0,0,8,0,0,8,5,0,0,16,0,0,21,29
21855,Somalia,2005,2005Somalia,0,5,0,0,0,0,5,0,0,0,9,0,0,9,14
21856,Somalia,2005,2005Somalia,0,6,0,0,0,0,6,0,0,0,8,0,0,8,14
21857,Somalia,2005,2005Somalia,0,6,5,23,0,0,34,0,15,13,42,0,0,70,104
21858,Somalia,2005,2005Somalia,0,7,0,0,0,0,7,0,0,0,6,0,0,6,13
21859,Somalia,2005,2005Somalia,0,13,0,29,0,0,42,0,5,6,13,0,0,24,66
21860,Somalia,2005,2005Somalia,5,0,0,0,0,0,5,0,0,0,6,0,0,6,11
21861,Somalia,2005,2005Somalia,6,0,0,20,0,0,26,5,8,7,23,0,0,43,69
21862,Somalia,2005,2005Somalia,8,9,7,33,10,0,67,5,5,5,25,0,0,40,107
21863,Somalia,2005,2005Somalia,8,65,56,269,15,0,413,34,78,62,387,19,0,580,1693
21864,Somalia,2005,2005Somalia,13,18,22,71,0,0,124,6,25,22,78,0,0,131,255
21865,Somalia,2005,2005Somalia,17,62,54,183,7,0,323,19,69,60,117,5,0,270,593
21866,Somalia,2005,2005Somalia,39,52,44,89,0,0,224,46,38,32,183,5,0,304,543
21867,Somalia,2005,2005Somalia,99,167,139,464,16,0,885,123,157,135,503,8,0,926,1811
21868,Somalia,2005,2005Somalia,149,334,287,1075,40,0,1885,158,346,296,1239,16,0,2055,3940
21869,Somalia,2005,2005Somalia,184,255,219,858,67,143,1726,209,265,227,1102,41,136,1980,3706
21870,Somalia,2005,2005Somalia,227,386,330,511,51,0,1505,218,234,201,450,55,0,1158,2663
21871,Somalia,2005,2005Somalia,353,298,255,668,30,0,1604,412,332,285,955,32,0,2016,3620
21872,Somalia,2005,2005Somalia,1687,5013,4294,16828,1338,0,29160,1658,5375,4609,36658,1122,0,49422,78582
21873,Somalia,2005,2005Somalia,1994,1474,1263,3261,123,0,8115,2041,1535,1316,2726,0,168,7786,15901
21874,Somalia,2005,2005Somalia,9665,12927,11080,38195,1764,0,73631,10519,14459,12392,36943,2515,0,76828,150459
21875,Somalia,2006,2006Somalia,0,0,0,0,0,0,0,0,0,0,0,0,0,0,159323
21876,Somalia,2006,2006Somalia,0,0,0,0,0,0,0,0,0,0,5,0,0,5,20
21877,Somalia,2006,2006Somalia,0,0,0,0,0,0,0,0,0,0,7,0,0,7,7
21878,Somalia,2006,2006Somalia,0,0,0,0,0,0,0,0,0,0,8,0,0,8,8
21879,Somalia,2006,2006Somalia,0,0,0,0,0,0,0,0,0,0,9,0,0,9,9
21880,Somalia,2006,2006Somalia,0,0,0,0,0,0,0,0,0,0,10,0,0,10,20
21881,Somalia,2006,2006Somalia,0,0,0,0,0,0,0,0,0,0,12,0,0,12,12
21882,Somalia,2006,2006Somalia,0,0,0,0,0,0,0,0,0,0,21,0,0,21,21
21883,Somalia,2006,2006Somalia,0,0,0,0,0,0,0,0,0,7,0,0,0,7,7
21884,Somalia,2006,2006Somalia,0,0,0,0,0,5,5,0,0,0,0,0,23,23,28
21885,Somalia,2006,2006Somalia,0,0,0,0,0,50,50,0,0,0,0,0,61,61,111
21886,Somalia,2006,2006Somalia,0,0,0,0,0,306,306,0,0,0,0,0,306,306,612
21887,Somalia,2006,2006Somalia,0,0,0,0,0,1636,1636,0,0,0,0,0,1905,1905,3541
21888,Somalia,2006,2006Somalia,0,0,0,5,0,0,5,0,0,0,0,0,0,0,121
21889,Somalia,2006,2006Somalia,0,0,0,5,0,0,5,0,0,0,6,0,0,6,11
21890,Somalia,2006,2006Somalia,0,0,0,5,0,0,5,0,0,0,8,0,0,8,13
21891,Somalia,2006,2006Somalia,0,0,0,5,0,0,5,0,0,0,12,0,0,12,17
21892,Somalia,2006,2006Somalia,0,0,0,6,0,0,6,0,0,0,9,0,0,9,15
21893,Somalia,2006,2006Somalia,0,0,0,6,0,0,6,0,0,0,18,0,0,18,24
21894,Somalia,2006,2006Somalia,0,0,0,7,0,0,7,0,0,5,18,0,0,23,30
21895,Somalia,2006,2006Somalia,0,0,5,0,0,0,5,0,0,0,7,0,0,7,12
21896,Somalia,2006,2006Somalia,0,0,5,0,0,0,5,0,7,0,10,0,0,17,22
21897,Somalia,2006,2006Somalia,0,0,7,8,0,0,15,0,0,0,8,0,0,8,23
21898,Somalia,2006,2006Somalia,0,0,9,0,0,0,9,0,0,0,0,0,0,0,9
21899,Somalia,2006,2006Somalia,0,6,0,0,0,0,6,0,0,7,0,0,0,7,13
21900,Somalia,2006,2006Somalia,5,0,5,6,0,0,16,5,0,14,17,0,0,36,52
21901,Somalia,2006,2006Somalia,5,8,8,25,0,0,46,0,10,20,54,0,0,84,130
21902,Somalia,2006,2006Somalia,5,56,39,112,5,0,217,9,55,43,159,5,0,271,488
21903,Somalia,2006,2006Somalia,6,0,0,20,0,0,26,5,5,10,23,0,0,43,69
21904,Somalia,2006,2006Somalia,6,0,41,70,0,0,117,6,0,50,71,0,0,127,244
21905,Somalia,2006,2006Somalia,8,0,0,11,0,0,19,0,0,0,28,0,0,28,47
21906,Somalia,2006,2006Somalia,11,7,11,65,0,0,94,0,6,7,32,0,0,45,139
21907,Somalia,2006,2006Somalia,11,15,109,269,13,0,417,34,54,81,388,19,0,576,1694
21908,Somalia,2006,2006Somalia,36,121,168,405,17,0,747,43,140,148,237,7,0,575,1322
21909,Somalia,2006,2006Somalia,122,294,279,1367,57,0,2119,110,247,306,1514,21,0,2198,4317
21910,Somalia,2006,2006Somalia,171,197,360,947,29,0,1704,169,165,406,1208,12,0,1960,3752
21911,Somalia,2006,2006Somalia,220,215,235,486,47,0,1203,118,190,215,310,50,0,883,2086
21912,Somalia,2006,2006Somalia,393,390,164,694,31,0,1672,456,377,260,996,31,0,2120,3792
21913,Somalia,2006,2006Somalia,1466,2036,1102,3711,145,0,8460,1498,2003,1238,3174,203,0,8116,16576
21914,Somalia,2006,2006Somalia,1751,4828,4826,19250,1324,0,31979,1711,5171,5172,46419,1135,0,59608,91587
21915,Somalia,2006,2006Somalia,11218,15946,11529,43331,2275,0,84299,12061,17347,13608,43348,3039,0,89403,173702
21916,Somalia,2007,2007Somalia,0,0,0,0,0,0,0,0,0,0,0,0,0,0,96196
21917,Somalia,2007,2007Somalia,0,0,0,0,0,0,0,0,0,0,0,0,21,21,21
21918,Somalia,2007,2007Somalia,0,0,0,0,0,0,0,0,0,0,5,0,0,5,25
21919,Somalia,2007,2007Somalia,0,0,0,0,0,0,0,0,0,0,6,0,0,6,18
21920,Somalia,2007,2007Somalia,0,0,0,0,0,0,0,0,0,0,8,0,0,8,8
21921,Somalia,2007,2007Somalia,0,0,0,0,0,0,0,0,0,0,9,0,0,9,9
21922,Somalia,2007,2007Somalia,0,0,0,0,0,0,0,0,0,7,0,0,0,7,7
21923,Somalia,2007,2007Somalia,0,0,0,0,0,0,0,0,0,8,9,0,0,17,17
21924,Somalia,2007,2007Somalia,0,0,0,0,0,47,47,0,0,0,0,0,47,47,94
21925,Somalia,2007,2007Somalia,0,0,0,0,0,325,325,0,0,0,0,0,325,325,650
21926,Somalia,2007,2007Somalia,0,0,0,5,0,0,5,0,0,0,0,0,0,0,10
21927,Somalia,2007,2007Somalia,0,0,0,5,0,0,5,0,0,5,20,0,0,25,30
21928,Somalia,2007,2007Somalia,0,0,0,9,0,0,9,0,0,0,5,0,0,5,14
21929,Somalia,2007,2007Somalia,0,0,0,11,0,0,11,0,0,0,14,0,0,14,25
21930,Somalia,2007,2007Somalia,0,0,5,0,0,0,5,0,0,0,10,0,0,10,15
21931,Somalia,2007,2007Somalia,0,0,5,0,0,0,5,0,0,0,15,0,0,15,20
21932,Somalia,2007,2007Somalia,0,5,0,0,0,0,5,0,0,0,6,0,0,6,11
21933,Somalia,2007,2007Somalia,0,6,0,0,0,0,6,0,0,7,0,0,0,7,13
21934,Somalia,2007,2007Somalia,0,7,0,0,0,0,7,0,0,0,9,0,0,9,16
21935,Somalia,2007,2007Somalia,0,7,6,12,0,0,25,5,6,0,13,0,0,24,49
21936,Somalia,2007,2007Somalia,5,0,0,6,0,0,11,0,0,0,12,0,0,12,23
21937,Somalia,2007,2007Somalia,5,5,11,22,5,0,48,5,9,5,26,0,0,45,93
21938,Somalia,2007,2007Somalia,6,0,0,20,0,0,26,5,5,10,23,0,0,43,69
21939,Somalia,2007,2007Somalia,7,0,0,0,0,0,7,0,0,8,11,0,0,19,26
21940,Somalia,2007,2007Somalia,8,0,0,10,0,0,18,5,5,5,23,0,0,38,56
21941,Somalia,2007,2007Somalia,10,8,38,111,10,0,177,26,33,59,246,18,0,382,559
21942,Somalia,2007,2007Somalia,10,56,45,115,5,0,231,10,57,46,164,5,0,282,513
21943,Somalia,2007,2007Somalia,11,13,23,42,0,0,89,6,15,20,91,0,0,132,221
21944,Somalia,2007,2007Somalia,28,66,167,202,14,0,477,29,144,71,290,14,0,548,1725
21945,Somalia,2007,2007Somalia,29,70,33,224,0,0,356,28,56,59,169,0,0,312,668
21946,Somalia,2007,2007Somalia,52,188,217,763,23,0,1243,72,202,206,339,18,0,837,2080
21947,Somalia,2007,2007Somalia,142,319,342,1744,69,0,2616,125,292,330,1753,23,0,2523,5139
21948,Somalia,2007,2007Somalia,157,246,138,737,60,133,1471,183,290,131,964,35,132,1735,3206
21949,Somalia,2007,2007Somalia,225,250,305,432,41,0,1253,94,103,220,344,45,0,806,2059
21950,Somalia,2007,2007Somalia,231,385,300,1168,36,0,2120,242,364,354,1483,10,0,2453,4573
21951,Somalia,2007,2007Somalia,491,838,0,1685,66,0,3080,535,922,0,1356,87,0,2900,5980
21952,Somalia,2007,2007Somalia,495,406,182,747,33,0,1863,565,390,273,1105,32,0,2365,4228
21953,Somalia,2007,2007Somalia,2190,5542,5860,21830,1406,0,36828,2086,5820,8440,56272,1170,0,73788,110616
21954,Somalia,2007,2007Somalia,2477,3304,1902,5571,242,0,13496,2489,3252,1934,4409,263,0,12347,25843
21955,Somalia,2007,2007Somalia,12907,17586,12095,47664,2656,0,92908,13795,19052,14298,49045,3322,0,99512,192420
21956,Somalia,2008,2008Somalia,0,0,0,0,0,0,0,0,0,0,0,0,0,0,96407
21957,Somalia,2008,2008Somalia,0,0,0,0,0,0,0,0,0,0,5,0,0,5,45
21958,Somalia,2008,2008Somalia,0,0,0,0,0,0,0,0,0,0,6,0,0,6,6
21959,Somalia,2008,2008Somalia,0,0,0,0,0,0,0,0,0,0,7,0,0,7,7
21960,Somalia,2008,2008Somalia,0,0,0,0,0,0,0,0,0,0,9,0,0,9,9
21961,Somalia,2008,2008Somalia,0,0,0,0,0,0,0,0,0,0,11,0,0,11,11
21962,Somalia,2008,2008Somalia,0,0,0,0,0,0,0,0,0,0,20,0,0,20,20
21963,Somalia,2008,2008Somalia,0,0,0,0,0,0,0,0,0,7,0,0,0,7,7
21964,Somalia,2008,2008Somalia,0,0,0,0,0,40,40,0,0,0,0,0,49,49,89
21965,Somalia,2008,2008Somalia,0,0,0,0,0,340,340,0,0,0,0,0,346,346,686
21966,Somalia,2008,2008Somalia,0,0,0,5,0,0,5,0,0,0,0,0,0,0,15
21967,Somalia,2008,2008Somalia,0,0,0,5,0,0,5,0,0,0,14,0,0,14,19
21968,Somalia,2008,2008Somalia,0,0,0,5,0,0,5,0,0,5,19,0,0,24,29
21969,Somalia,2008,2008Somalia,0,0,0,5,0,0,5,7,0,0,9,0,0,16,21
21970,Somalia,2008,2008Somalia,0,0,0,6,0,0,6,0,0,0,11,0,0,11,17
21971,Somalia,2008,2008Somalia,0,0,0,9,0,0,9,0,0,0,5,0,0,5,14
21972,Somalia,2008,2008Somalia,0,0,5,0,0,0,5,0,0,0,5,0,0,5,10
21973,Somalia,2008,2008Somalia,0,0,6,20,0,0,26,5,5,10,23,0,0,43,69
21974,Somalia,2008,2008Somalia,0,5,0,0,0,0,5,5,0,0,0,0,0,5,10
21975,Somalia,2008,2008Somalia,0,5,0,5,0,0,10,5,9,0,13,0,0,27,37
21976,Somalia,2008,2008Somalia,0,7,0,0,0,0,7,0,0,8,0,0,0,8,15
21977,Somalia,2008,2008Somalia,5,0,0,0,0,0,5,0,0,0,8,0,0,8,13
21978,Somalia,2008,2008Somalia,6,0,0,7,0,0,13,7,0,0,15,0,0,22,35
21979,Somalia,2008,2008Somalia,6,0,5,45,0,0,56,5,6,0,137,0,0,148,204
21980,Somalia,2008,2008Somalia,7,6,0,13,0,0,26,5,7,0,37,0,0,49,75
21981,Somalia,2008,2008Somalia,9,5,11,22,0,0,47,5,6,20,45,0,0,76,123
21982,Somalia,2008,2008Somalia,9,7,66,146,0,0,228,10,13,68,172,0,0,263,491
21983,Somalia,2008,2008Somalia,10,34,69,143,5,0,261,5,38,77,181,11,0,312,573
21984,Somalia,2008,2008Somalia,11,14,10,57,0,0,92,6,10,5,21,0,0,42,134
21985,Somalia,2008,2008Somalia,19,18,46,88,7,0,178,26,33,36,87,5,0,187,365
21986,Somalia,2008,2008Somalia,21,47,47,104,0,0,219,20,45,43,162,0,0,270,489
21987,Somalia,2008,2008Somalia,41,68,33,90,0,0,232,42,54,26,155,5,0,282,514
21988,Somalia,2008,2008Somalia,53,84,53,274,0,0,464,39,80,87,192,0,0,398,862
21989,Somalia,2008,2008Somalia,56,74,72,257,7,0,466,66,84,67,471,14,0,702,1868
21990,Somalia,2008,2008Somalia,106,339,364,1187,45,0,2041,128,371,332,463,23,0,1317,3358
21991,Somalia,2008,2008Somalia,125,200,250,330,31,0,936,83,98,110,269,24,0,584,1525
21992,Somalia,2008,2008Somalia,148,219,120,683,55,119,1344,174,278,128,990,38,118,1726,3070
21993,Somalia,2008,2008Somalia,151,352,371,1929,79,0,2882,141,321,355,1873,28,0,2718,5600
21994,Somalia,2008,2008Somalia,287,461,370,1641,37,0,2796,320,431,392,2117,29,0,3289,6085
21995,Somalia,2008,2008Somalia,621,422,185,791,32,0,2051,715,391,277,1206,35,0,2624,4675
21996,Somalia,2008,2008Somalia,626,858,458,2319,100,0,4361,670,915,477,1983,116,0,4161,8522
21997,Somalia,2008,2008Somalia,2584,5783,6429,25349,1418,0,41563,2458,6160,9757,71158,1179,0,90712,132275
21998,Somalia,2008,2008Somalia,3429,3952,2907,6963,344,0,17595,3480,4025,2900,5320,305,0,16030,33625
21999,Somalia,2008,2008Somalia,17825,26383,16234,62319,3711,0,126472,18896,28878,19537,61504,3834,0,132649,259121
22000,Somalia,2009,2009Somalia,0,0,0,0,0,0,0,0,0,0,0,0,0,0,101311
22001,Somalia,2009,2009Somalia,0,0,0,0,0,0,0,0,0,0,5,0,0,5,35
22002,Somalia,2009,2009Somalia,0,0,0,0,0,0,0,0,0,0,7,0,0,7,7
22003,Somalia,2009,2009Somalia,0,0,0,0,0,0,0,0,0,0,9,0,0,9,27
22004,Somalia,2009,2009Somalia,0,0,0,0,0,0,0,0,0,0,11,0,0,11,11
22005,Somalia,2009,2009Somalia,0,0,0,0,0,0,0,0,0,0,12,0,0,12,12
22006,Somalia,2009,2009Somalia,0,0,0,0,0,0,0,0,0,0,20,0,0,20,20
22007,Somalia,2009,2009Somalia,0,0,0,0,0,0,0,0,0,7,0,0,0,7,7
22008,Somalia,2009,2009Somalia,0,0,0,0,0,0,0,0,8,0,5,0,0,13,13
22009,Somalia,2009,2009Somalia,0,0,0,0,0,5,5,0,0,0,0,0,30,30,35
22010,Somalia,2009,2009Somalia,0,0,0,0,0,45,45,0,0,0,0,0,53,53,98
22011,Somalia,2009,2009Somalia,0,0,0,5,0,0,5,0,0,0,0,0,0,0,10
22012,Somalia,2009,2009Somalia,0,0,0,5,0,0,5,0,0,0,5,0,0,5,10
22013,Somalia,2009,2009Somalia,0,0,0,5,0,0,5,0,0,0,10,0,0,10,15
22014,Somalia,2009,2009Somalia,0,0,0,5,0,0,5,0,0,0,15,0,0,15,20
22015,Somalia,2009,2009Somalia,0,0,0,5,0,0,5,0,0,5,24,0,0,29,34
22016,Somalia,2009,2009Somalia,0,0,0,7,0,0,7,0,9,0,8,0,0,17,24
22017,Somalia,2009,2009Somalia,0,0,0,8,0,0,8,0,0,0,5,0,0,5,13
22018,Somalia,2009,2009Somalia,0,0,0,9,0,0,9,0,0,0,11,0,0,11,20
22019,Somalia,2009,2009Somalia,0,0,5,0,0,0,5,0,0,0,5,0,0,5,10
22020,Somalia,2009,2009Somalia,0,0,8,0,0,0,8,0,9,0,0,0,0,9,17
22021,Somalia,2009,2009Somalia,0,0,8,13,0,12,33,0,10,8,27,0,12,57,90
22022,Somalia,2009,2009Somalia,0,0,13,8,0,0,21,6,0,0,13,0,0,19,40
22023,Somalia,2009,2009Somalia,0,5,0,0,0,0,5,0,0,0,0,0,0,0,5
22024,Somalia,2009,2009Somalia,0,6,0,12,0,0,18,0,5,8,13,0,0,26,44
22025,Somalia,2009,2009Somalia,6,0,0,20,0,0,26,5,5,10,23,0,0,43,69
22026,Somalia,2009,2009Somalia,6,35,31,145,5,0,222,7,34,62,203,0,0,306,528
22027,Somalia,2009,2009Somalia,8,5,8,26,0,0,47,7,6,10,52,0,0,75,122
22028,Somalia,2009,2009Somalia,8,7,0,18,0,0,33,5,6,5,40,0,0,56,89
22029,Somalia,2009,2009Somalia,10,24,73,163,5,0,275,5,32,82,231,18,0,368,643
22030,Somalia,2009,2009Somalia,15,19,16,79,0,0,129,17,21,16,29,0,0,83,212
22031,Somalia,2009,2009Somalia,26,32,46,187,10,0,301,42,41,43,215,5,0,346,647
22032,Somalia,2009,2009Somalia,28,54,58,133,5,0,278,17,50,66,244,0,0,377,655
22033,Somalia,2009,2009Somalia,40,59,32,81,0,0,212,39,51,26,155,5,0,276,488
22034,Somalia,2009,2009Somalia,40,119,162,725,81,0,1127,41,130,153,896,60,0,1280,2407
22035,Somalia,2009,2009Somalia,50,229,292,775,44,0,1390,48,273,276,252,21,0,870,2260
22036,Somalia,2009,2009Somalia,52,69,68,294,0,0,483,40,60,66,273,0,0,439,922
22037,Somalia,2009,2009Somalia,61,76,59,264,5,0,465,67,60,89,535,11,0,762,1927
22038,Somalia,2009,2009Somalia,120,194,208,342,28,0,892,92,92,118,246,7,0,555,1447
22039,Somalia,2009,2009Somalia,146,193,123,650,51,122,1285,169,245,130,1199,32,137,1912,3197
22040,Somalia,2009,2009Somalia,153,327,336,2218,96,0,3130,139,289,364,2139,35,0,2966,6096
22041,Somalia,2009,2009Somalia,341,598,509,2219,68,0,3735,384,562,541,2894,56,0,4437,8172
22042,Somalia,2009,2009Somalia,466,409,259,969,28,0,2131,516,421,296,1163,34,0,2430,4561
22043,Somalia,2009,2009Somalia,708,1104,737,3048,117,0,5714,743,1229,680,2696,136,0,5484,11198
22044,Somalia,2009,2009Somalia,4635,6336,6516,31802,1017,0,50306,5422,6539,9847,88531,823,0,111162,161468
22045,Somalia,2009,2009Somalia,5788,7971,3952,12408,720,0,30839,5885,8143,4162,9382,569,0,28141,58980
22046,Somalia,2009,2009Somalia,23095,34612,18874,72081,4899,0,153561,24280,36999,22450,68156,4834,0,156719,310280
22047,Somalia,2010,2010Somalia,0,0,0,0,0,0,0,0,0,0,0,0,0,0,102582
22048,Somalia,2010,2010Somalia,0,0,0,0,0,0,0,0,0,0,5,0,0,5,25
22049,Somalia,2010,2010Somalia,0,0,0,0,0,0,0,0,0,0,7,0,0,7,14
22050,Somalia,2010,2010Somalia,0,0,0,0,0,0,0,0,0,0,8,0,0,8,16
22051,Somalia,2010,2010Somalia,0,0,0,0,0,0,0,0,0,0,9,0,0,9,18
22052,Somalia,2010,2010Somalia,0,0,0,0,0,0,0,0,0,0,11,0,0,11,11
22053,Somalia,2010,2010Somalia,0,0,0,0,0,0,0,0,0,0,15,0,0,15,15
22054,Somalia,2010,2010Somalia,0,0,0,0,0,0,0,0,0,9,0,0,0,9,9
22055,Somalia,2010,2010Somalia,0,0,0,0,0,0,0,0,5,0,0,0,0,5,5
22056,Somalia,2010,2010Somalia,0,0,0,0,0,0,0,5,0,0,0,0,0,5,5
22057,Somalia,2010,2010Somalia,0,0,0,0,0,0,0,8,0,0,0,0,0,8,8
22058,Somalia,2010,2010Somalia,0,0,0,0,0,5,5,0,0,0,0,0,23,23,28
22059,Somalia,2010,2010Somalia,0,0,0,0,0,5,5,0,0,0,0,0,32,32,37
22060,Somalia,2010,2010Somalia,0,0,0,0,0,49,49,0,0,0,0,0,68,68,117
22061,Somalia,2010,2010Somalia,0,0,0,0,0,449,449,0,0,0,0,0,578,578,1027
22062,Somalia,2010,2010Somalia,0,0,0,5,0,0,5,0,0,0,0,0,0,0,10
22063,Somalia,2010,2010Somalia,0,0,0,5,0,0,5,0,0,0,15,0,0,15,20
22064,Somalia,2010,2010Somalia,0,0,0,5,0,0,5,0,0,0,19,0,0,19,37
22065,Somalia,2010,2010Somalia,0,0,0,5,0,0,5,0,0,0,31,0,0,31,36
22066,Somalia,2010,2010Somalia,0,0,0,5,0,0,5,0,9,0,6,0,0,15,20
22067,Somalia,2010,2010Somalia,0,0,0,8,0,0,8,5,0,0,14,0,0,19,27
22068,Somalia,2010,2010Somalia,0,0,5,0,0,0,5,0,0,0,0,0,0,0,5
22069,Somalia,2010,2010Somalia,0,0,5,6,0,0,11,0,0,0,9,0,0,9,20
22070,Somalia,2010,2010Somalia,0,0,5,9,0,0,14,0,0,0,26,0,0,26,40
22071,Somalia,2010,2010Somalia,0,0,8,0,0,0,8,0,0,0,9,0,0,9,17
22072,Somalia,2010,2010Somalia,0,0,8,0,0,0,8,0,9,0,0,0,0,9,17
22073,Somalia,2010,2010Somalia,0,0,12,0,0,0,12,0,0,7,0,0,0,7,19
22074,Somalia,2010,2010Somalia,0,5,0,5,0,0,10,0,0,7,0,0,0,7,17
22075,Somalia,2010,2010Somalia,0,7,0,15,0,0,22,0,7,9,25,0,0,41,63
22076,Somalia,2010,2010Somalia,5,0,0,0,0,0,5,0,0,0,13,0,0,13,18
22077,Somalia,2010,2010Somalia,5,41,35,141,5,0,227,7,37,67,199,0,0,310,537
22078,Somalia,2010,2010Somalia,6,6,0,16,0,0,28,5,6,5,28,0,0,44,72
22079,Somalia,2010,2010Somalia,7,8,29,70,0,0,114,7,18,14,77,0,0,116,230
22080,Somalia,2010,2010Somalia,8,0,0,5,0,0,13,0,6,5,5,0,0,16,29
22081,Somalia,2010,2010Somalia,9,0,0,13,0,13,35,0,6,0,33,0,12,51,86
22082,Somalia,2010,2010Somalia,9,5,5,32,0,0,51,7,5,6,53,0,0,71,122
22083,Somalia,2010,2010Somalia,10,11,32,77,0,0,130,5,19,25,158,5,0,212,342
22084,Somalia,2010,2010Somalia,29,67,70,154,5,0,325,16,59,83,264,0,0,422,747
22085,Somalia,2010,2010Somalia,33,56,70,313,0,0,472,27,73,71,289,0,0,460,932
22086,Somalia,2010,2010Somalia,34,44,60,242,22,0,402,48,50,54,272,5,0,429,831
22087,Somalia,2010,2010Somalia,57,110,153,730,96,0,1146,54,113,157,1086,64,0,1474,2620
22088,Somalia,2010,2010Somalia,62,103,78,243,6,0,492,55,101,109,538,18,0,821,2008
22089,Somalia,2010,2010Somalia,106,263,343,938,53,0,1703,108,288,309,325,0,29,1059,2762
22090,Somalia,2010,2010Somalia,156,288,338,2263,101,0,3146,145,262,366,2219,34,0,3026,6172
22091,Somalia,2010,2010Somalia,192,184,108,750,50,173,1457,206,216,128,1815,33,237,2635,4092
22092,Somalia,2010,2010Somalia,211,172,148,286,31,0,848,163,159,120,172,26,0,640,1488
22093,Somalia,2010,2010Somalia,488,786,697,2981,128,0,5080,547,722,722,3986,94,0,6071,11151
22094,Somalia,2010,2010Somalia,493,420,262,806,38,0,2019,509,432,274,1279,43,0,2537,4556
22095,Somalia,2010,2010Somalia,954,1311,890,3859,148,0,7162,983,1435,791,3664,181,0,7054,14216
22096,Somalia,2010,2010Somalia,4931,6644,8991,43743,734,0,65043,5110,7281,13024,88797,590,0,114802,179845
22097,Somalia,2010,2010Somalia,8412,12141,5457,16710,941,0,43661,8514,12340,5482,10496,754,0,37586,81247
22098,Somalia,2010,2010Somalia,26310,40091,22257,81106,5817,0,175581,27421,42834,26406,73944,5587,0,176192,351773
22099,Somalia,2011,2011Somalia,0,0,0,0,0,0,0,0,0,0,0,0,0,0,98368
22100,Somalia,2011,2011Somalia,0,0,0,0,0,0,0,0,0,0,5,0,0,5,30
22101,Somalia,2011,2011Somalia,0,0,0,0,0,0,0,0,0,0,7,0,0,7,47
22102,Somalia,2011,2011Somalia,0,0,0,0,0,0,0,0,0,0,8,0,0,8,16
22103,Somalia,2011,2011Somalia,0,0,0,0,0,0,0,0,0,0,9,0,0,9,9
22104,Somalia,2011,2011Somalia,0,0,0,0,0,0,0,0,0,0,11,0,0,11,11
22105,Somalia,2011,2011Somalia,0,0,0,0,0,0,0,0,0,0,15,0,0,15,15
22106,Somalia,2011,2011Somalia,0,0,0,0,0,0,0,0,0,9,0,0,0,9,9
22107,Somalia,2011,2011Somalia,0,0,0,0,0,0,0,0,8,0,0,0,0,8,8
22108,Somalia,2011,2011Somalia,0,0,0,0,0,0,0,5,0,0,0,0,0,5,5
22109,Somalia,2011,2011Somalia,0,0,0,0,0,82,82,0,0,0,0,0,113,113,247
22110,Somalia,2011,2011Somalia,0,0,0,0,0,495,495,0,0,0,0,0,808,808,1303
22111,Somalia,2011,2011Somalia,0,0,0,5,0,0,5,0,0,0,0,0,0,0,10
22112,Somalia,2011,2011Somalia,0,0,0,5,0,0,5,0,0,0,16,0,0,16,21
22113,Somalia,2011,2011Somalia,0,0,0,5,0,0,5,0,0,0,38,0,0,38,80
22114,Somalia,2011,2011Somalia,0,0,0,5,0,0,5,0,0,5,5,0,0,10,15
22115,Somalia,2011,2011Somalia,0,0,0,6,0,0,6,0,0,0,14,0,0,14,20
22116,Somalia,2011,2011Somalia,0,0,0,7,0,0,7,0,0,0,9,0,0,9,21
22117,Somalia,2011,2011Somalia,0,0,0,7,0,0,7,0,0,0,15,0,0,15,22
22118,Somalia,2011,2011Somalia,0,0,0,8,0,0,8,11,0,0,13,0,0,24,32
22119,Somalia,2011,2011Somalia,0,0,0,10,0,0,10,0,0,0,31,0,0,31,41
22120,Somalia,2011,2011Somalia,0,0,5,5,0,0,10,0,0,5,7,0,0,12,22
22121,Somalia,2011,2011Somalia,0,0,5,6,0,0,11,0,0,0,9,0,0,9,20
22122,Somalia,2011,2011Somalia,0,0,6,11,0,0,17,0,0,7,20,0,0,27,2213
22123,Somalia,2011,2011Somalia,0,0,6,14,0,0,20,9,0,0,26,0,0,35,55
22124,Somalia,2011,2011Somalia,0,0,8,0,0,0,8,0,0,0,0,0,0,0,8
22125,Somalia,2011,2011Somalia,0,0,12,0,0,0,12,0,0,7,0,0,0,7,19
22126,Somalia,2011,2011Somalia,0,5,0,0,0,0,5,0,0,0,0,0,0,0,5
22127,Somalia,2011,2011Somalia,0,5,0,6,0,0,11,0,0,0,29,0,0,29,40
22128,Somalia,2011,2011Somalia,0,5,5,11,0,0,21,0,5,8,8,0,0,21,42
22129,Somalia,2011,2011Somalia,0,6,0,9,0,0,15,5,5,6,38,0,0,54,69
22130,Somalia,2011,2011Somalia,5,7,0,16,0,0,28,5,5,5,30,0,0,45,73
22131,Somalia,2011,2011Somalia,5,35,23,220,5,0,288,5,30,48,165,0,0,248,536
22132,Somalia,2011,2011Somalia,6,11,6,12,0,15,50,0,18,0,47,0,15,80,130
22133,Somalia,2011,2011Somalia,8,0,0,5,0,0,13,0,6,5,5,0,0,16,29
22134,Somalia,2011,2011Somalia,9,0,0,0,0,0,9,0,5,5,0,0,0,10,19
22135,Somalia,2011,2011Somalia,9,8,31,71,0,0,119,7,13,9,94,0,0,123,242
22136,Somalia,2011,2011Somalia,12,8,5,42,0,0,67,8,5,12,50,0,0,75,142
22137,Somalia,2011,2011Somalia,27,7,16,131,0,0,181,28,6,60,673,5,0,772,953
22138,Somalia,2011,2011Somalia,27,65,61,171,5,0,329,13,59,79,286,0,0,437,766
22139,Somalia,2011,2011Somalia,34,42,52,254,18,0,400,40,49,44,271,8,0,412,812
22140,Somalia,2011,2011Somalia,42,50,42,87,5,0,226,35,54,35,160,6,0,290,516
22141,Somalia,2011,2011Somalia,45,79,59,194,9,0,386,44,74,114,492,16,0,740,1842
22142,Somalia,2011,2011Somalia,46,81,67,343,0,0,537,42,112,80,334,0,0,568,1105
22143,Somalia,2011,2011Somalia,84,140,161,849,94,0,1328,67,141,175,1363,65,0,1811,3139
22144,Somalia,2011,2011Somalia,87,237,312,880,41,0,1557,101,248,293,312,27,0,981,2538
22145,Somalia,2011,2011Somalia,121,129,102,501,93,0,946,115,153,116,515,46,0,945,3629
22146,Somalia,2011,2011Somalia,155,268,329,2354,111,0,3217,157,243,339,2331,41,0,3111,6328
22147,Somalia,2011,2011Somalia,202,168,102,712,45,225,1454,188,211,114,1823,35,323,2694,4148
22148,Somalia,2011,2011Somalia,236,172,148,286,31,0,873,180,159,120,172,26,0,657,1530
22149,Somalia,2011,2011Somalia,622,1069,1280,3260,136,0,6367,685,1071,1570,4231,99,0,7656,14023
22150,Somalia,2011,2011Somalia,985,1552,1247,5096,166,0,9046,1019,1615,1020,6510,216,0,10380,19426
22151,Somalia,2011,2011Somalia,1015,370,320,555,98,0,2358,917,363,298,529,7,0,2114,4472
22152,Somalia,2011,2011Somalia,5274,7007,7624,51546,992,0,72443,5434,7714,10919,107383,792,0,132242,204685
22153,Somalia,2011,2011Somalia,21530,27803,10547,36502,2236,0,98618,22152,28750,11452,22383,2111,0,86848,185466
22154,Somalia,2011,2011Somalia,41282,63985,31066,115273,9237,0,260843,42549,68062,36732,100960,8520,0,256823,517666
22155,Somalia,2012,2012Somalia,0,0,0,0,0,0,0,0,0,0,0,0,0,0,101065
22156,Somalia,2012,2012Somalia,0,0,0,0,0,0,0,0,0,0,5,0,0,5,124
22157,Somalia,2012,2012Somalia,0,0,0,0,0,0,0,0,0,0,7,0,0,7,21
22158,Somalia,2012,2012Somalia,0,0,0,0,0,0,0,0,0,0,9,0,0,9,9
22159,Somalia,2012,2012Somalia,0,0,0,0,0,0,0,0,0,0,11,0,0,11,11
22160,Somalia,2012,2012Somalia,0,0,0,0,0,0,0,0,0,5,7,0,0,12,12
22161,Somalia,2012,2012Somalia,0,0,0,0,0,0,0,0,5,0,17,0,0,22,22
22162,Somalia,2012,2012Somalia,0,0,0,0,0,0,0,0,8,0,0,0,0,8,8
22163,Somalia,2012,2012Somalia,0,0,0,0,0,0,0,5,0,0,0,0,0,5,5
22164,Somalia,2012,2012Somalia,0,0,0,0,0,15,15,0,0,0,0,0,15,15,30
22165,Somalia,2012,2012Somalia,0,0,0,0,0,36,36,0,0,0,0,0,76,76,112
22166,Somalia,2012,2012Somalia,0,0,0,0,0,119,119,0,0,0,0,0,169,169,288
22167,Somalia,2012,2012Somalia,0,0,0,0,0,566,566,0,0,0,0,0,923,923,1489
22168,Somalia,2012,2012Somalia,0,0,0,5,0,0,5,0,0,0,0,0,0,0,10
22169,Somalia,2012,2012Somalia,0,0,0,5,0,0,5,0,0,0,37,0,0,37,161
22170,Somalia,2012,2012Somalia,0,0,0,5,0,0,5,0,0,0,38,0,0,38,43
22171,Somalia,2012,2012Somalia,0,0,0,5,0,0,5,0,0,5,5,0,0,10,15
22172,Somalia,2012,2012Somalia,0,0,0,5,0,0,5,0,0,5,10,0,0,15,20
22173,Somalia,2012,2012Somalia,0,0,0,7,0,0,7,0,0,0,14,0,0,14,21
22174,Somalia,2012,2012Somalia,0,0,0,9,0,0,9,0,0,0,7,5,0,12,21
22175,Somalia,2012,2012Somalia,0,0,0,9,0,0,9,0,0,0,8,0,0,8,22
22176,Somalia,2012,2012Somalia,0,0,0,12,0,0,12,0,0,0,7,0,0,7,19
22177,Somalia,2012,2012Somalia,0,0,0,15,0,0,15,0,0,0,8,0,0,8,23
22178,Somalia,2012,2012Somalia,0,0,5,5,0,0,10,0,0,0,10,0,0,10,20
22179,Somalia,2012,2012Somalia,0,0,5,6,0,0,11,0,0,0,9,0,0,9,20
22180,Somalia,2012,2012Somalia,0,0,8,0,0,0,8,0,0,0,0,0,0,0,8
22181,Somalia,2012,2012Somalia,0,0,9,14,0,0,23,0,0,5,20,0,0,25,48
22182,Somalia,2012,2012Somalia,0,5,0,0,0,0,5,0,0,0,0,0,0,0,5
22183,Somalia,2012,2012Somalia,0,5,0,13,0,0,18,0,0,7,25,0,0,32,50
22184,Somalia,2012,2012Somalia,0,5,7,60,0,0,72,0,5,8,75,5,0,93,165
22185,Somalia,2012,2012Somalia,0,6,0,0,0,0,6,0,0,0,6,0,0,6,12
22186,Somalia,2012,2012Somalia,0,8,0,5,0,0,13,0,6,5,5,0,0,16,29
22187,Somalia,2012,2012Somalia,5,0,0,0,0,0,5,0,0,0,0,0,0,0,5
22188,Somalia,2012,2012Somalia,5,5,12,41,0,0,63,6,10,13,24,5,0,58,121
22189,Somalia,2012,2012Somalia,5,10,13,18,0,118,164,5,12,5,62,0,124,208,372
22190,Somalia,2012,2012Somalia,5,10,35,5,0,0,55,0,18,69,18,0,0,105,160
22191,Somalia,2012,2012Somalia,5,37,23,220,5,0,290,6,34,30,157,0,0,227,517
22192,Somalia,2012,2012Somalia,6,0,0,18,0,0,24,6,0,5,20,0,0,31,55
22193,Somalia,2012,2012Somalia,9,0,0,0,0,0,9,0,7,0,5,0,0,12,21
22194,Somalia,2012,2012Somalia,11,6,5,48,0,0,70,10,0,8,48,0,0,66,136
22195,Somalia,2012,2012Somalia,12,0,0,22,0,0,34,0,6,0,49,0,0,55,89
22196,Somalia,2012,2012Somalia,12,0,0,42,0,0,54,17,0,27,412,0,0,456,510
22197,Somalia,2012,2012Somalia,15,55,60,173,7,0,310,12,45,69,303,0,0,429,739
22198,Somalia,2012,2012Somalia,16,21,28,104,0,0,169,10,25,16,98,0,0,149,318
22199,Somalia,2012,2012Somalia,22,17,9,90,24,0,162,20,21,14,125,12,0,192,3459
22200,Somalia,2012,2012Somalia,36,43,39,74,5,0,197,36,49,31,127,5,0,248,445
22201,Somalia,2012,2012Somalia,37,108,74,278,12,0,509,38,94,73,735,23,0,963,2177
22202,Somalia,2012,2012Somalia,41,48,54,310,25,0,478,45,61,59,276,10,0,451,929
22203,Somalia,2012,2012Somalia,66,136,129,506,5,0,842,65,141,155,466,0,0,827,1669
22204,Somalia,2012,2012Somalia,66,180,276,780,43,0,1345,79,205,276,286,26,0,872,2217
22205,Somalia,2012,2012Somalia,112,160,152,975,97,0,1496,91,176,162,1632,77,0,2138,3634
22206,Somalia,2012,2012Somalia,132,232,323,2353,116,0,3156,144,235,329,2347,39,0,3094,6250
22207,Somalia,2012,2012Somalia,151,208,170,525,45,0,1099,150,226,219,352,59,0,1006,2105
22208,Somalia,2012,2012Somalia,206,165,106,681,44,274,1476,195,205,135,1719,31,374,2659,4135
22209,Somalia,2012,2012Somalia,307,422,228,643,30,0,1630,367,435,262,713,33,0,1810,3440
22210,Somalia,2012,2012Somalia,834,1779,2503,3193,137,0,8446,862,1919,3557,4118,98,0,10554,19000
22211,Somalia,2012,2012Somalia,1036,1623,1193,4957,203,0,9012,1061,1633,1050,5302,231,0,9277,18289
22212,Somalia,2012,2012Somalia,3678,7458,11488,56820,1257,0,80701,4858,6838,8579,124781,1152,0,146208,226909
22213,Somalia,2012,2012Somalia,24312,35039,13533,42385,2563,0,117832,24402,36110,15175,26887,2625,0,105199,223031
22214,Somalia,2012,2012Somalia,43729,64193,31191,112263,8616,0,259992,45256,68409,36739,93965,7708,0,252077,512069
22215,Somalia,2013,2013Somalia,0,0,0,0,0,0,0,0,0,0,0,0,0,0,107001
22216,Somalia,2013,2013Somalia,0,0,0,0,0,0,0,0,0,0,0,0,5,5,5
22217,Somalia,2013,2013Somalia,0,0,0,0,0,0,0,0,0,0,5,0,0,5,25
22218,Somalia,2013,2013Somalia,0,0,0,0,0,0,0,0,0,0,7,0,0,7,14
22219,Somalia,2013,2013Somalia,0,0,0,0,0,0,0,0,0,0,8,0,0,8,8
22220,Somalia,2013,2013Somalia,0,0,0,0,0,0,0,0,0,0,9,0,0,9,9
22221,Somalia,2013,2013Somalia,0,0,0,0,0,0,0,0,0,0,11,0,0,11,11
22222,Somalia,2013,2013Somalia,0,0,0,0,0,0,0,0,0,5,7,0,0,12,12
22223,Somalia,2013,2013Somalia,0,0,0,0,0,0,0,0,0,7,0,0,0,7,7
22224,Somalia,2013,2013Somalia,0,0,0,0,0,0,0,0,5,0,0,0,0,5,5
22225,Somalia,2013,2013Somalia,0,0,0,0,0,0,0,0,5,0,17,0,0,22,22
22226,Somalia,2013,2013Somalia,0,0,0,0,0,0,0,5,0,0,0,0,0,5,5
22227,Somalia,2013,2013Somalia,0,0,0,0,0,115,115,0,0,0,0,0,192,192,559
22228,Somalia,2013,2013Somalia,0,0,0,0,0,596,596,0,0,0,0,0,1078,1078,1674
22229,Somalia,2013,2013Somalia,0,0,0,5,0,0,5,0,0,0,0,0,0,0,10
22230,Somalia,2013,2013Somalia,0,0,0,5,0,0,5,0,0,0,40,0,0,40,45
22231,Somalia,2013,2013Somalia,0,0,0,5,0,0,5,0,0,5,5,0,0,10,15
22232,Somalia,2013,2013Somalia,0,0,0,5,0,0,5,0,0,6,12,0,0,18,23
22233,Somalia,2013,2013Somalia,0,0,0,6,0,0,6,0,0,6,10,0,0,16,22
22234,Somalia,2013,2013Somalia,0,0,0,9,0,0,9,0,0,6,18,0,0,24,33
22235,Somalia,2013,2013Somalia,0,0,0,15,0,0,15,0,0,0,8,0,0,8,23
22236,Somalia,2013,2013Somalia,0,0,5,5,0,0,10,0,6,0,10,0,0,16,26
22237,Somalia,2013,2013Somalia,0,0,5,6,0,0,11,0,0,0,9,0,0,9,20
22238,Somalia,2013,2013Somalia,0,0,8,0,0,0,8,0,0,0,0,0,0,0,8
22239,Somalia,2013,2013Somalia,0,0,9,11,0,0,20,0,0,9,6,5,0,20,40
22240,Somalia,2013,2013Somalia,0,5,0,9,0,0,14,0,5,0,14,0,0,19,33
22241,Somalia,2013,2013Somalia,0,5,5,0,0,0,10,0,0,0,7,0,0,7,17
22242,Somalia,2013,2013Somalia,0,5,6,7,0,0,18,0,7,0,5,0,0,12,30
22243,Somalia,2013,2013Somalia,0,6,0,0,0,0,6,0,0,0,6,0,0,6,12
22244,Somalia,2013,2013Somalia,0,6,16,38,0,0,60,0,8,17,70,12,0,107,167
22245,Somalia,2013,2013Somalia,0,6,17,172,10,0,205,0,11,19,317,7,0,354,559
22246,Somalia,2013,2013Somalia,0,9,14,31,5,0,59,5,15,12,28,0,0,60,119
22247,Somalia,2013,2013Somalia,5,0,0,0,0,0,5,0,0,0,0,0,0,0,5
22248,Somalia,2013,2013Somalia,5,0,0,15,0,0,20,5,0,5,109,0,0,119,139
22249,Somalia,2013,2013Somalia,5,5,6,31,0,0,47,0,6,5,24,0,0,35,82
22250,Somalia,2013,2013Somalia,5,10,11,20,0,309,355,0,15,0,74,0,309,398,753
22251,Somalia,2013,2013Somalia,6,27,11,96,0,0,140,5,28,28,93,0,0,154,294
22252,Somalia,2013,2013Somalia,6,30,31,111,0,0,178,7,29,28,214,0,0,278,456
22253,Somalia,2013,2013Somalia,9,0,0,13,0,0,22,6,5,0,16,0,0,27,49
22254,Somalia,2013,2013Somalia,9,0,0,19,0,0,28,6,0,5,33,0,0,44,72
22255,Somalia,2013,2013Somalia,11,13,11,54,5,0,94,9,15,25,115,5,0,169,3225
22256,Somalia,2013,2013Somalia,12,0,0,23,0,0,35,0,5,0,48,0,0,53,88
22257,Somalia,2013,2013Somalia,13,54,58,170,10,0,305,8,44,62,310,0,0,424,729
22258,Somalia,2013,2013Somalia,17,37,37,165,5,0,261,12,40,29,144,0,0,225,486
22259,Somalia,2013,2013Somalia,24,69,127,383,23,0,626,28,77,100,164,12,0,381,1007
22260,Somalia,2013,2013Somalia,25,99,78,291,13,0,506,27,97,72,786,28,0,1010,2216
22261,Somalia,2013,2013Somalia,38,44,34,80,5,0,201,41,47,26,129,6,0,249,450
22262,Somalia,2013,2013Somalia,52,47,48,306,25,0,478,42,56,62,280,12,0,452,930
22263,Somalia,2013,2013Somalia,61,166,188,686,15,0,1116,80,169,207,571,10,0,1037,2153
22264,Somalia,2013,2013Somalia,128,214,310,2466,112,0,3230,146,232,268,2397,43,0,3086,6316
22265,Somalia,2013,2013Somalia,145,202,161,831,55,0,1394,132,196,167,1570,53,0,2118,3512
22266,Somalia,2013,2013Somalia,161,207,173,530,42,0,1113,154,230,221,353,65,0,1023,2136
22267,Somalia,2013,2013Somalia,199,185,128,662,52,352,1578,202,217,149,1491,30,434,2523,4101
22268,Somalia,2013,2013Somalia,279,378,196,575,25,0,1453,297,391,235,647,31,0,1601,3054
22269,Somalia,2013,2013Somalia,840,1392,2217,1619,91,0,6159,817,1451,2576,2035,106,0,6985,13144
22270,Somalia,2013,2013Somalia,1052,1723,1234,5148,203,0,9360,1077,1724,1085,5692,231,0,9809,19169
22271,Somalia,2013,2013Somalia,4544,7800,11177,74550,1116,0,99187,3992,6974,8224,110694,1435,0,131319,230506
22272,Somalia,2013,2013Somalia,24378,39649,16195,45188,2729,23,128162,24286,40491,18048,27089,2726,23,112663,240825
22273,Somalia,2013,2013Somalia,37747,61857,31833,104195,7254,0,242886,39125,65490,36868,84286,6649,0,232418,475304
22274,Somalia,2014,2014Somalia,0,0,0,0,0,0,0,0,0,0,0,0,0,0,83902
22275,Somalia,2014,2014Somalia,0,0,0,0,0,0,0,0,0,0,0,0,5,5,5
22276,Somalia,2014,2014Somalia,0,0,0,0,0,0,0,0,0,0,5,0,0,5,25
22277,Somalia,2014,2014Somalia,0,0,0,0,0,0,0,0,0,0,6,0,0,6,6
22278,Somalia,2014,2014Somalia,0,0,0,0,0,0,0,0,0,0,7,0,0,7,7
22279,Somalia,2014,2014Somalia,0,0,0,0,0,0,0,0,0,0,9,0,0,9,18
22280,Somalia,2014,2014Somalia,0,0,0,0,0,0,0,0,0,0,11,0,0,11,11
22281,Somalia,2014,2014Somalia,0,0,0,0,0,0,0,0,0,0,13,0,0,13,13
22282,Somalia,2014,2014Somalia,0,0,0,0,0,0,0,0,0,5,7,0,0,12,24
22283,Somalia,2014,2014Somalia,0,0,0,0,0,0,0,0,5,0,0,0,0,5,5
22284,Somalia,2014,2014Somalia,0,0,0,0,0,0,0,5,0,0,0,0,0,5,5
22285,Somalia,2014,2014Somalia,0,0,0,0,0,17,17,0,0,0,0,0,16,16,33
22286,Somalia,2014,2014Somalia,0,0,0,0,0,649,649,0,0,0,0,0,1247,1247,1896
22287,Somalia,2014,2014Somalia,0,0,0,0,0,6849,6849,0,0,0,0,0,33284,33284,40133
22288,Somalia,2014,2014Somalia,0,0,0,5,0,0,5,0,0,0,0,0,0,0,15
22289,Somalia,2014,2014Somalia,0,0,0,5,0,0,5,0,0,0,26,0,0,26,31
22290,Somalia,2014,2014Somalia,0,0,0,7,0,0,7,0,0,0,14,0,0,14,21
22291,Somalia,2014,2014Somalia,0,0,0,7,0,0,7,0,5,0,8,0,0,13,20
22292,Somalia,2014,2014Somalia,0,0,0,12,0,0,12,0,0,0,9,0,0,9,21
22293,Somalia,2014,2014Somalia,0,0,0,13,0,0,13,0,0,6,22,0,0,28,41
22294,Somalia,2014,2014Somalia,0,0,5,5,0,0,10,0,0,0,9,0,0,9,19
22295,Somalia,2014,2014Somalia,0,0,5,6,0,0,11,0,0,0,10,0,0,10,21
22296,Somalia,2014,2014Somalia,0,0,5,18,0,0,23,0,5,0,17,0,0,22,45
22297,Somalia,2014,2014Somalia,0,0,8,0,0,0,8,0,0,0,0,0,0,0,8
22298,Somalia,2014,2014Somalia,0,5,0,0,0,0,5,0,0,5,15,0,0,20,25
22299,Somalia,2014,2014Somalia,0,5,5,5,0,0,15,0,5,5,13,0,0,23,38
22300,Somalia,2014,2014Somalia,0,6,0,0,0,0,6,0,0,0,0,0,0,0,6
22301,Somalia,2014,2014Somalia,0,6,6,6,0,0,18,0,8,0,5,0,0,13,31
22302,Somalia,2014,2014Somalia,0,6,10,41,0,0,57,0,6,21,71,9,0,107,164
22303,Somalia,2014,2014Somalia,0,18,14,80,0,0,112,11,14,31,154,0,0,210,322
22304,Somalia,2014,2014Somalia,5,0,0,8,0,0,13,0,0,6,62,0,0,68,81
22305,Somalia,2014,2014Somalia,5,0,0,8,0,0,13,5,0,0,24,0,0,29,42
22306,Somalia,2014,2014Somalia,5,5,0,9,0,0,19,7,5,0,14,0,0,26,45
22307,Somalia,2014,2014Somalia,5,8,18,38,0,0,69,5,11,0,96,0,0,112,181
22308,Somalia,2014,2014Somalia,5,20,22,107,0,0,154,0,14,27,217,0,0,258,412
22309,Somalia,2014,2014Somalia,6,7,13,47,0,0,73,5,8,11,53,0,0,77,150
22310,Somalia,2014,2014Somalia,7,9,6,34,6,0,62,6,6,9,101,5,0,127,2821
22311,Somalia,2014,2014Somalia,8,0,5,19,0,0,32,5,0,5,30,0,0,40,72
22312,Somalia,2014,2014Somalia,10,5,5,49,0,0,69,7,6,0,38,0,0,51,120
22313,Somalia,2014,2014Somalia,10,46,50,171,6,0,283,10,40,52,269,0,0,371,654
22314,Somalia,2014,2014Somalia,12,0,0,24,0,0,36,0,5,0,48,0,0,53,89
22315,Somalia,2014,2014Somalia,14,111,212,47,6,0,390,18,105,86,31,0,0,240,630
22316,Somalia,2014,2014Somalia,17,209,159,410,90,0,885,16,168,164,963,118,0,1429,2314
22317,Somalia,2014,2014Somalia,19,40,43,211,6,0,319,24,37,26,192,0,0,279,598
22318,Somalia,2014,2014Somalia,33,38,22,71,0,0,164,33,37,20,114,6,0,210,374
22319,Somalia,2014,2014Somalia,46,45,32,286,23,0,432,38,53,50,268,9,0,418,850
22320,Somalia,2014,2014Somalia,70,161,190,803,15,0,1239,95,177,218,643,17,0,1150,2389
22321,Somalia,2014,2014Somalia,139,250,2305,206,111,0,3011,141,246,2100,200,35,0,2722,5733
22322,Somalia,2014,2014Somalia,185,233,170,1007,58,0,1653,177,226,212,1886,51,0,2552,4205
22323,Somalia,2014,2014Somalia,208,214,141,713,57,459,1792,202,245,180,1321,30,509,2487,4279
22324,Somalia,2014,2014Somalia,242,341,179,518,26,0,1306,276,335,225,583,33,0,1452,2758
22325,Somalia,2014,2014Somalia,795,1245,1110,4599,142,0,7891,825,1284,1198,5715,97,0,9119,17010
22326,Somalia,2014,2014Somalia,860,1666,1160,5678,244,0,9608,878,1708,1092,6147,287,0,10112,19720
22327,Somalia,2014,2014Somalia,5506,14370,11012,64447,2856,0,98191,6324,14464,11942,110765,2518,0,146013,244204
22328,Somalia,2014,2014Somalia,22103,41252,18358,45087,2737,0,129537,22169,41799,19993,28803,2796,0,115560,245097
22329,Somalia,2014,2014Somalia,32283,52760,30648,91570,6891,0,214152,33645,56431,35471,78593,6399,0,210539,424691
22330,Somalia,2015,2015Somalia,0,0,0,0,0,0,0,0,0,0,0,0,0,0,125136
22331,Somalia,2015,2015Somalia,0,0,0,0,0,0,0,0,0,0,0,0,9,9,611
22332,Somalia,2015,2015Somalia,0,0,0,0,0,0,0,0,0,0,5,0,0,5,25
22333,Somalia,2015,2015Somalia,0,0,0,0,0,0,0,0,0,0,7,0,0,7,7
22334,Somalia,2015,2015Somalia,0,0,0,0,0,0,0,0,0,0,9,0,0,9,9
22335,Somalia,2015,2015Somalia,0,0,0,0,0,0,0,0,0,0,11,0,0,11,22
22336,Somalia,2015,2015Somalia,0,0,0,0,0,0,0,0,0,0,12,0,0,12,12
22337,Somalia,2015,2015Somalia,0,0,0,0,0,0,0,0,0,0,13,0,0,13,13
22338,Somalia,2015,2015Somalia,0,0,0,0,0,0,0,0,0,5,0,0,0,5,5
22339,Somalia,2015,2015Somalia,0,0,0,0,0,0,0,0,0,5,7,0,0,12,12
22340,Somalia,2015,2015Somalia,0,0,0,0,0,0,0,0,0,5,10,0,0,15,15
22341,Somalia,2015,2015Somalia,0,0,0,0,0,0,0,0,0,5,40,0,0,45,45
22342,Somalia,2015,2015Somalia,0,0,0,0,0,19,19,0,0,0,0,0,19,19,38
22343,Somalia,2015,2015Somalia,0,0,0,0,0,29,29,0,0,0,0,0,86,86,115
22344,Somalia,2015,2015Somalia,0,0,0,0,0,290,290,0,0,0,0,0,358,358,648
22345,Somalia,2015,2015Somalia,0,0,0,0,0,683,683,0,0,0,0,0,1324,1324,2007
22346,Somalia,2015,2015Somalia,0,0,0,5,0,0,5,0,0,0,0,0,0,0,5
22347,Somalia,2015,2015Somalia,0,0,0,7,0,0,7,0,0,5,8,0,0,13,20
22348,Somalia,2015,2015Somalia,0,0,0,10,0,0,10,0,0,0,6,0,0,6,16
22349,Somalia,2015,2015Somalia,0,0,0,10,0,0,10,5,0,0,8,0,0,13,23
22350,Somalia,2015,2015Somalia,0,0,0,12,0,0,12,0,0,0,9,0,0,9,21
22351,Somalia,2015,2015Somalia,0,0,5,0,0,0,5,0,0,0,5,0,0,5,10
22352,Somalia,2015,2015Somalia,0,0,5,5,0,0,10,0,0,0,8,0,0,8,18
22353,Somalia,2015,2015Somalia,0,0,6,0,0,0,6,0,0,0,16,0,0,16,22
22354,Somalia,2015,2015Somalia,0,0,8,0,0,0,8,0,0,0,0,0,0,0,8
22355,Somalia,2015,2015Somalia,0,5,5,5,0,0,15,0,0,9,24,0,0,33,48
22356,Somalia,2015,2015Somalia,0,5,7,36,0,0,48,0,0,5,104,7,0,116,164
22357,Somalia,2015,2015Somalia,0,6,0,0,0,0,6,0,0,0,0,0,0,0,6
22358,Somalia,2015,2015Somalia,0,6,6,7,0,0,19,0,9,0,6,0,0,15,34
22359,Somalia,2015,2015Somalia,0,7,6,163,7,0,183,0,7,9,297,5,0,318,501
22360,Somalia,2015,2015Somalia,5,0,0,9,0,0,14,0,0,0,29,0,0,29,43
22361,Somalia,2015,2015Somalia,5,5,0,0,0,0,10,0,0,5,37,0,0,42,52
22362,Somalia,2015,2015Somalia,5,9,7,0,0,0,21,5,7,21,5,0,0,38,59
22363,Somalia,2015,2015Somalia,5,9,21,105,0,0,140,7,16,15,197,0,0,235,375
22364,Somalia,2015,2015Somalia,5,27,25,33,20,0,110,30,39,25,66,16,0,176,286
22365,Somalia,2015,2015Somalia,6,7,13,47,0,0,73,5,8,11,53,0,0,77,150
22366,Somalia,2015,2015Somalia,6,42,32,119,6,0,205,10,27,44,179,0,0,260,465
22367,Somalia,2015,2015Somalia,7,0,6,22,0,0,35,7,0,5,34,0,0,46,81
22368,Somalia,2015,2015Somalia,7,5,0,11,0,0,23,7,6,5,16,0,0,34,57
22369,Somalia,2015,2015Somalia,8,32,60,192,13,0,305,14,30,42,91,8,0,185,490
22370,Somalia,2015,2015Somalia,10,10,6,21,7,0,54,0,15,6,72,0,0,93,147
22371,Somalia,2015,2015Somalia,12,18,23,110,0,0,163,16,26,21,222,0,0,285,448
22372,Somalia,2015,2015Somalia,13,7,0,46,0,0,66,5,7,0,39,0,0,51,117
22373,Somalia,2015,2015Somalia,18,37,39,211,5,0,310,30,34,27,200,0,0,291,601
22374,Somalia,2015,2015Somalia,19,195,174,433,92,0,913,10,161,167,1027,125,0,1490,2403
22375,Somalia,2015,2015Somalia,20,10,0,44,0,0,74,0,22,5,107,0,0,134,208
22376,Somalia,2015,2015Somalia,27,29,25,61,0,0,142,33,34,22,94,5,0,188,330
22377,Somalia,2015,2015Somalia,47,49,38,280,26,0,440,35,53,40,255,12,0,395,835
22378,Somalia,2015,2015Somalia,81,163,171,773,15,0,1203,91,198,204,651,17,0,1161,2364
22379,Somalia,2015,2015Somalia,121,185,213,1814,89,0,2422,138,169,211,1524,27,0,2069,4491
22380,Somalia,2015,2015Somalia,180,220,146,702,53,0,1301,192,236,169,1277,28,0,1902,4334
22381,Somalia,2015,2015Somalia,215,250,170,1187,62,0,1884,216,245,212,2245,58,0,2976,4860
22382,Somalia,2015,2015Somalia,216,297,166,469,19,0,1167,246,291,215,535,31,0,1318,2485
22383,Somalia,2015,2015Somalia,761,1946,2141,7764,306,0,12918,1399,2028,2177,8963,235,0,14802,27720
22384,Somalia,2015,2015Somalia,912,1288,886,3110,205,0,6401,916,1316,922,2539,229,0,5922,12323
22385,Somalia,2015,2015Somalia,5133,15074,12163,66235,2693,0,101298,5419,15142,12589,116184,2583,0,151917,253215
22386,Somalia,2015,2015Somalia,19354,41270,22072,48774,2913,2468,136851,19758,41345,23678,29588,2982,2467,119818,256669
22387,Somalia,2015,2015Somalia,30765,50633,32720,89306,7057,0,210481,32032,53869,36927,78115,6496,0,207439,417920
22388,Somalia,2016,2016Somalia,0,0,0,0,0,0,0,0,0,0,0,0,0,0,82975
22389,Somalia,2016,2016Somalia,0,0,0,0,0,0,0,0,0,0,0,0,7,7,7
22390,Somalia,2016,2016Somalia,0,0,0,0,0,0,0,0,0,0,5,0,0,5,30
22391,Somalia,2016,2016Somalia,0,0,0,0,0,0,0,0,0,0,8,0,0,8,8
22392,Somalia,2016,2016Somalia,0,0,0,0,0,0,0,0,0,0,9,0,0,9,18
22393,Somalia,2016,2016Somalia,0,0,0,0,0,0,0,0,0,0,11,0,0,11,11
22394,Somalia,2016,2016Somalia,0,0,0,0,0,0,0,0,0,0,13,0,0,13,13
22395,Somalia,2016,2016Somalia,0,0,0,0,0,0,0,0,0,0,17,0,0,17,17
22396,Somalia,2016,2016Somalia,0,0,0,0,0,0,0,0,0,5,0,0,0,5,5
22397,Somalia,2016,2016Somalia,0,0,0,0,0,0,0,0,0,5,41,0,0,46,46
22398,Somalia,2016,2016Somalia,0,0,0,0,0,20,20,0,0,0,0,0,24,24,44
22399,Somalia,2016,2016Somalia,0,0,0,0,0,45,45,0,0,0,0,0,88,88,133
22400,Somalia,2016,2016Somalia,0,0,0,0,0,502,502,0,0,0,0,0,778,778,1280
22401,Somalia,2016,2016Somalia,0,0,0,0,0,785,785,0,0,0,0,0,1739,1739,2524
22402,Somalia,2016,2016Somalia,0,0,0,0,0,5602,5602,0,0,0,0,0,23093,23093,28695
22403,Somalia,2016,2016Somalia,0,0,0,5,0,0,5,0,0,0,0,0,0,0,5
22404,Somalia,2016,2016Somalia,0,0,0,5,0,0,5,0,0,0,16,0,0,16,21
22405,Somalia,2016,2016Somalia,0,0,0,6,0,0,6,0,0,0,11,0,0,11,17
22406,Somalia,2016,2016Somalia,0,0,0,6,0,0,6,5,0,0,8,0,0,13,19
22407,Somalia,2016,2016Somalia,0,0,0,9,0,0,9,0,0,5,17,0,0,22,31
22408,Somalia,2016,2016Somalia,0,0,0,10,0,0,10,0,0,0,6,0,0,6,16
22409,Somalia,2016,2016Somalia,0,0,6,0,0,0,6,0,0,0,18,0,0,18,24
22410,Somalia,2016,2016Somalia,0,0,6,5,0,0,11,0,0,6,0,0,0,6,17
22411,Somalia,2016,2016Somalia,0,0,8,0,0,0,8,0,0,0,0,0,0,0,8
22412,Somalia,2016,2016Somalia,0,5,0,0,0,0,5,0,0,0,0,0,0,0,5
22413,Somalia,2016,2016Somalia,0,5,0,6,0,0,11,0,0,0,5,5,0,10,21
22414,Somalia,2016,2016Somalia,0,5,6,38,0,0,49,0,5,11,87,12,0,115,164
22415,Somalia,2016,2016Somalia,0,6,0,9,0,0,15,0,0,8,25,0,0,33,48
22416,Somalia,2016,2016Somalia,0,6,6,7,0,0,19,0,9,0,6,0,0,15,34
22417,Somalia,2016,2016Somalia,0,6,7,11,0,0,24,5,0,6,20,0,0,31,55
22418,Somalia,2016,2016Somalia,0,7,5,158,6,0,176,0,8,6,280,5,5,304,480
22419,Somalia,2016,2016Somalia,0,7,14,54,5,0,80,0,6,16,112,0,0,134,214
22420,Somalia,2016,2016Somalia,0,9,0,0,0,0,9,0,0,0,41,5,0,46,55
22421,Somalia,2016,2016Somalia,0,15,19,61,0,0,95,0,17,11,240,5,0,273,2775
22422,Somalia,2016,2016Somalia,0,17,53,79,8,0,157,5,28,28,93,7,0,161,421
22423,Somalia,2016,2016Somalia,5,0,0,5,0,0,10,0,0,0,17,0,0,17,27
22424,Somalia,2016,2016Somalia,5,12,15,30,0,0,62,6,16,19,81,0,0,122,184
22425,Somalia,2016,2016Somalia,6,0,5,8,0,0,19,7,6,5,15,0,0,33,52
22426,Somalia,2016,2016Somalia,6,7,13,47,0,0,73,5,8,11,53,0,0,77,150
22427,Somalia,2016,2016Somalia,9,7,5,44,0,0,65,8,0,0,29,0,0,37,102
22428,Somalia,2016,2016Somalia,9,23,47,174,15,0,268,12,27,38,87,5,0,169,437
22429,Somalia,2016,2016Somalia,12,40,29,180,9,0,270,16,33,56,179,0,0,284,554
22430,Somalia,2016,2016Somalia,14,5,5,53,0,0,77,8,7,7,57,0,0,79,156
22431,Somalia,2016,2016Somalia,16,12,19,140,0,0,187,21,28,24,288,0,0,361,548
22432,Somalia,2016,2016Somalia,16,40,40,230,6,0,332,31,35,37,191,0,0,294,626
22433,Somalia,2016,2016Somalia,21,19,0,30,0,0,70,8,10,0,57,0,0,75,145
22434,Somalia,2016,2016Somalia,22,191,176,471,94,0,954,15,154,180,1157,135,0,1641,2595
22435,Somalia,2016,2016Somalia,24,25,20,60,0,0,129,26,27,20,93,5,0,171,300
22436,Somalia,2016,2016Somalia,67,153,157,762,27,0,1166,73,189,174,620,17,0,1073,2239
22437,Somalia,2016,2016Somalia,91,17,22,171,5,0,306,129,26,24,237,7,0,423,729
22438,Somalia,2016,2016Somalia,130,136,195,1335,64,0,1860,145,152,196,1012,19,0,1524,3384
22439,Somalia,2016,2016Somalia,175,208,128,685,49,589,1834,190,220,226,1314,24,632,2606,4440
22440,Somalia,2016,2016Somalia,186,275,161,418,15,0,1055,217,268,209,470,25,0,1189,2244
22441,Somalia,2016,2016Somalia,382,325,190,1988,75,0,2960,370,307,245,3922,75,0,4919,7879
22442,Somalia,2016,2016Somalia,943,2187,2437,8830,383,0,14780,999,2242,2573,9813,282,0,15909,30689
22443,Somalia,2016,2016Somalia,971,1334,916,3272,218,0,6711,958,1346,1004,2759,243,0,6310,13021
22444,Somalia,2016,2016Somalia,1968,14182,12661,70251,3482,0,102544,2025,15160,12076,119889,3427,0,152577,255121
22445,Somalia,2016,2016Somalia,17494,39575,22305,46557,2826,0,128757,17843,39461,23754,29195,3004,0,113257,242014
22446,Somalia,2016,2016Somalia,24975,39253,25845,70100,5263,0,165436,26171,41651,28928,57369,4893,0,159012,324448
22447,Somalia,2017,2017Somalia,0,0,0,0,0,0,0,0,0,0,0,0,0,0,86208
22448,Somalia,2017,2017Somalia,0,0,0,0,0,0,0,0,0,0,0,0,7,7,7
22449,Somalia,2017,2017Somalia,0,0,0,0,0,0,0,0,0,0,0,0,288,288,288
22450,Somalia,2017,2017Somalia,0,0,0,0,0,0,0,0,0,0,5,0,0,5,20
22451,Somalia,2017,2017Somalia,0,0,0,0,0,0,0,0,0,0,7,0,0,7,7
22452,Somalia,2017,2017Somalia,0,0,0,0,0,0,0,0,0,0,9,0,0,9,27
22453,Somalia,2017,2017Somalia,0,0,0,0,0,0,0,0,0,0,10,0,0,10,10
22454,Somalia,2017,2017Somalia,0,0,0,0,0,0,0,0,0,0,11,0,0,11,11
22455,Somalia,2017,2017Somalia,0,0,0,0,0,0,0,0,0,0,25,0,0,25,25
22456,Somalia,2017,2017Somalia,0,0,0,0,0,0,0,0,0,5,0,0,0,5,5
22457,Somalia,2017,2017Somalia,0,0,0,0,0,45,45,0,0,0,0,0,87,87,132
22458,Somalia,2017,2017Somalia,0,0,0,0,0,921,921,0,0,0,0,0,2043,2043,2964
22459,Somalia,2017,2017Somalia,0,0,0,0,0,5483,5483,0,0,0,0,0,21494,21494,26977
22460,Somalia,2017,2017Somalia,0,0,0,0,8,0,8,0,0,0,0,0,0,0,8
22461,Somalia,2017,2017Somalia,0,0,0,0,10,0,10,0,0,0,0,6,0,6,16
22462,Somalia,2017,2017Somalia,0,0,0,5,0,0,5,0,0,0,0,0,0,0,5
22463,Somalia,2017,2017Somalia,0,0,0,5,0,0,5,0,0,0,6,8,0,14,19
22464,Somalia,2017,2017Somalia,0,0,0,6,0,0,6,0,0,0,16,0,0,16,22
22465,Somalia,2017,2017Somalia,0,0,0,6,0,0,6,5,0,0,8,0,0,13,19
22466,Somalia,2017,2017Somalia,0,0,0,7,0,0,7,0,0,0,14,0,0,14,21
22467,Somalia,2017,2017Somalia,0,0,0,7,0,0,7,7,0,0,0,0,0,7,14
22468,Somalia,2017,2017Somalia,0,0,0,8,0,0,8,0,0,0,16,0,0,16,24
22469,Somalia,2017,2017Somalia,0,0,0,9,0,0,9,0,0,0,34,0,0,34,43
22470,Somalia,2017,2017Somalia,0,0,5,0,0,0,5,0,0,0,0,0,0,0,5
22471,Somalia,2017,2017Somalia,0,0,5,6,0,0,11,0,0,0,6,0,0,6,17
22472,Somalia,2017,2017Somalia,0,0,6,0,0,0,6,0,0,0,0,0,0,0,6
22473,Somalia,2017,2017Somalia,0,5,0,0,0,0,5,0,0,0,0,0,0,0,5
22474,Somalia,2017,2017Somalia,0,5,0,5,0,0,10,0,5,0,58,0,0,63,73
22475,Somalia,2017,2017Somalia,0,5,0,6,0,0,11,0,0,0,7,5,0,12,23
22476,Somalia,2017,2017Somalia,0,5,5,160,6,0,176,0,5,6,282,6,0,299,480
22477,Somalia,2017,2017Somalia,0,6,0,9,0,0,15,0,0,8,25,0,0,33,48
22478,Somalia,2017,2017Somalia,0,6,0,34,0,0,40,0,0,12,83,8,0,103,143
22479,Somalia,2017,2017Somalia,0,14,19,78,8,0,119,5,16,16,63,8,0,108,227
22480,Somalia,2017,2017Somalia,5,5,0,7,0,0,17,6,5,5,13,0,0,29,46
22481,Somalia,2017,2017Somalia,5,5,5,34,0,0,49,5,0,5,32,0,0,42,91
22482,Somalia,2017,2017Somalia,5,11,14,66,0,0,96,6,7,12,111,0,0,136,232
22483,Somalia,2017,2017Somalia,6,7,13,47,0,0,73,5,8,11,53,0,0,77,150
22484,Somalia,2017,2017Somalia,7,6,6,11,0,0,30,0,5,5,22,0,0,32,62
22485,Somalia,2017,2017Somalia,7,23,18,29,0,0,77,5,42,61,18,5,0,131,208
22486,Somalia,2017,2017Somalia,11,21,44,160,16,0,252,11,24,32,75,10,0,152,404
22487,Somalia,2017,2017Somalia,14,18,10,30,0,0,72,7,10,0,70,0,0,87,159
22488,Somalia,2017,2017Somalia,14,39,48,230,6,0,337,34,31,47,196,0,0,308,645
22489,Somalia,2017,2017Somalia,17,51,41,218,8,0,335,19,37,54,219,0,0,329,664
22490,Somalia,2017,2017Somalia,18,10,7,79,5,0,119,17,10,5,72,0,0,104,223
22491,Somalia,2017,2017Somalia,23,26,23,62,0,0,134,30,21,27,97,5,0,180,314
22492,Somalia,2017,2017Somalia,40,69,40,290,19,0,458,39,49,46,211,13,0,358,816
22493,Somalia,2017,2017Somalia,51,31,40,258,0,0,380,51,36,60,449,0,0,596,976
22494,Somalia,2017,2017Somalia,54,143,160,763,40,0,1160,52,188,171,631,17,0,1059,2219
22495,Somalia,2017,2017Somalia,68,190,162,335,79,0,834,72,166,155,837,110,0,1340,2174
22496,Somalia,2017,2017Somalia,138,140,217,1284,54,0,1833,171,172,184,874,18,0,1419,3252
22497,Somalia,2017,2017Somalia,167,197,129,690,49,656,1888,181,206,253,1390,25,631,2686,4574
22498,Somalia,2017,2017Somalia,184,264,179,432,15,0,1074,227,281,205,470,29,0,1212,2286
22499,Somalia,2017,2017Somalia,1005,1290,969,3295,224,0,6783,969,1347,1043,2706,260,0,6325,13108
22500,Somalia,2017,2017Somalia,1159,12526,11388,73720,3935,0,102728,1244,13508,11104,123391,3919,0,153166,255894
22501,Somalia,2017,2017Somalia,1177,2078,2028,6843,291,0,12417,1269,2117,2099,6882,227,0,12594,25011
22502,Somalia,2017,2017Somalia,1307,545,437,5175,129,0,7593,1416,561,743,9077,118,0,11915,19508
22503,Somalia,2017,2017Somalia,16611,40909,26687,47539,2894,0,134640,16919,40957,27265,30756,3242,0,119139,253779
22504,Somalia,2017,2017Somalia,20134,31706,24178,62651,4969,0,143638,21221,32971,26594,52593,4675,0,138054,281692
22505,Somalia,2018,2018Somalia,0,0,0,0,0,0,0,0,0,0,0,0,0,0,107094
22506,Somalia,2018,2018Somalia,0,0,0,0,0,0,0,0,0,0,5,0,0,5,25
22507,Somalia,2018,2018Somalia,0,0,0,0,0,0,0,0,0,0,8,0,0,8,8
22508,Somalia,2018,2018Somalia,0,0,0,0,0,0,0,0,0,0,10,0,0,10,10
22509,Somalia,2018,2018Somalia,0,0,0,0,0,0,0,0,0,0,11,0,0,11,11
22510,Somalia,2018,2018Somalia,0,0,0,0,0,0,0,0,0,0,12,0,0,12,12
22511,Somalia,2018,2018Somalia,0,0,0,0,0,0,0,0,0,0,29,0,0,29,29
22512,Somalia,2018,2018Somalia,0,0,0,0,0,0,0,0,0,5,0,0,0,5,5
22513,Somalia,2018,2018Somalia,0,0,0,0,0,0,0,0,6,0,0,0,0,6,6
22514,Somalia,2018,2018Somalia,0,0,0,0,0,7,7,0,0,0,0,0,15,15,22
22515,Somalia,2018,2018Somalia,0,0,0,0,0,1151,1151,0,0,0,0,0,2489,2489,3640
22516,Somalia,2018,2018Somalia,0,0,0,5,0,0,5,0,0,0,0,0,0,0,5
22517,Somalia,2018,2018Somalia,0,0,0,5,0,0,5,0,5,0,8,0,0,13,18
22518,Somalia,2018,2018Somalia,0,0,0,8,0,0,8,0,0,0,0,0,0,0,8
22519,Somalia,2018,2018Somalia,0,0,0,10,0,0,10,0,0,0,6,0,0,6,16
22520,Somalia,2018,2018Somalia,0,0,0,10,0,0,10,5,0,0,14,0,0,19,29
22521,Somalia,2018,2018Somalia,0,0,0,14,0,0,14,0,0,0,7,0,0,7,21
22522,Somalia,2018,2018Somalia,0,0,0,14,0,0,14,0,0,5,7,0,0,12,26
22523,Somalia,2018,2018Somalia,0,0,0,25,0,0,25,0,0,5,22,0,0,27,52
22524,Somalia,2018,2018Somalia,0,0,0,25,0,0,25,5,0,0,30,0,0,35,60
22525,Somalia,2018,2018Somalia,0,0,5,5,0,0,10,0,0,0,8,5,0,13,23
22526,Somalia,2018,2018Somalia,0,0,5,36,0,0,41,0,0,10,94,16,0,120,161
22527,Somalia,2018,2018Somalia,0,0,6,0,0,0,6,0,0,0,0,0,0,0,6
22528,Somalia,2018,2018Somalia,0,0,7,0,0,0,7,0,7,0,0,0,0,7,14
22529,Somalia,2018,2018Somalia,0,5,0,0,0,0,5,0,0,0,0,0,0,0,5
22530,Somalia,2018,2018Somalia,0,5,6,70,5,0,86,0,5,5,103,6,0,119,205
22531,Somalia,2018,2018Somalia,0,7,0,6,0,0,13,5,0,0,73,0,0,78,91
22532,Somalia,2018,2018Somalia,0,7,0,9,0,0,16,0,0,9,25,0,0,34,50
22533,Somalia,2018,2018Somalia,0,12,12,57,0,0,81,5,7,9,79,0,0,100,181
22534,Somalia,2018,2018Somalia,5,5,0,11,0,0,21,6,5,5,13,0,0,29,50
22535,Somalia,2018,2018Somalia,5,6,6,14,0,0,31,0,5,5,22,0,0,32,63
22536,Somalia,2018,2018Somalia,5,9,16,81,9,0,120,0,15,20,63,10,0,108,228
22537,Somalia,2018,2018Somalia,6,7,13,47,0,0,73,5,8,11,53,0,0,77,150
22538,Somalia,2018,2018Somalia,8,15,32,157,17,0,229,10,21,28,78,5,0,142,371
22539,Somalia,2018,2018Somalia,15,41,41,241,5,0,343,33,35,45,224,0,0,337,680
22540,Somalia,2018,2018Somalia,17,22,5,29,0,0,73,7,18,5,58,0,0,88,161
22541,Somalia,2018,2018Somalia,21,37,45,209,8,0,320,19,33,43,193,0,0,288,608
22542,Somalia,2018,2018Somalia,22,13,9,83,5,0,132,15,9,5,69,0,0,98,230
22543,Somalia,2018,2018Somalia,24,24,21,60,0,0,129,24,29,22,94,5,0,174,303
22544,Somalia,2018,2018Somalia,24,39,22,87,0,0,172,23,33,17,182,5,0,260,432
22545,Somalia,2018,2018Somalia,46,141,145,785,40,0,1157,50,162,166,667,18,0,1063,2220
22546,Somalia,2018,2018Somalia,49,88,67,374,21,0,599,45,63,57,264,17,0,446,1045
22547,Somalia,2018,2018Somalia,65,55,52,321,0,0,493,73,58,47,463,5,0,646,1139
22548,Somalia,2018,2018Somalia,90,226,186,502,82,0,1086,88,197,182,1220,118,0,1805,2891
22549,Somalia,2018,2018Somalia,135,188,204,870,27,0,1424,138,242,203,1122,31,0,1736,3245
22550,Somalia,2018,2018Somalia,135,223,219,416,17,0,1010,152,275,215,470,26,0,1138,2148
22551,Somalia,2018,2018Somalia,152,162,106,680,44,715,1859,179,172,218,1415,29,723,2736,4595
22552,Somalia,2018,2018Somalia,161,175,205,1429,55,0,2025,187,211,218,925,22,0,1563,3588
22553,Somalia,2018,2018Somalia,943,1269,997,3160,221,0,6590,944,1327,1017,2534,248,0,6070,12660
22554,Somalia,2018,2018Somalia,954,1566,1414,5254,185,0,9373,1026,1548,1535,5161,121,0,9391,18764
22555,Somalia,2018,2018Somalia,1807,742,529,6310,146,0,9534,1885,803,733,10481,145,0,14047,23581
22556,Somalia,2018,2018Somalia,2388,10228,10239,71221,4089,0,98165,2433,10759,9950,123536,4112,0,150790,248955
22557,Somalia,2018,2018Somalia,15073,38142,29177,50965,3100,0,136457,15422,38108,29756,33991,3465,0,120742,257199
22558,Somalia,2018,2018Somalia,17361,29926,21022,57362,4412,0,130083,18147,30968,22806,46298,4196,0,122415,252498
22559,Somalia,2019,2019Somalia,0,0,0,0,0,0,0,0,0,0,0,0,0,0,102380
22560,Somalia,2019,2019Somalia,0,0,0,0,0,0,0,0,0,0,5,0,0,5,20
22561,Somalia,2019,2019Somalia,0,0,0,0,0,0,0,0,0,0,7,0,0,7,7
22562,Somalia,2019,2019Somalia,0,0,0,0,0,0,0,0,0,0,8,0,0,8,8
22563,Somalia,2019,2019Somalia,0,0,0,0,0,0,0,0,0,0,10,0,0,10,10
22564,Somalia,2019,2019Somalia,0,0,0,0,0,0,0,0,0,0,11,0,0,11,11
22565,Somalia,2019,2019Somalia,0,0,0,0,0,0,0,0,0,0,14,0,0,14,14
22566,Somalia,2019,2019Somalia,0,0,0,0,0,0,0,0,0,0,19,0,0,19,19
22567,Somalia,2019,2019Somalia,0,0,0,0,0,0,0,0,0,0,31,0,0,31,31
22568,Somalia,2019,2019Somalia,0,0,0,0,0,0,0,0,0,11,8,0,0,19,19
22569,Somalia,2019,2019Somalia,0,0,0,0,0,0,0,0,6,0,0,0,0,6,6
22570,Somalia,2019,2019Somalia,0,0,0,0,0,31,31,0,0,0,0,0,54,54,85
22571,Somalia,2019,2019Somalia,0,0,0,0,0,1473,1473,0,0,0,0,0,3062,3062,4535
22572,Somalia,2019,2019Somalia,0,0,0,5,0,0,5,0,0,0,0,0,0,0,30
22573,Somalia,2019,2019Somalia,0,0,0,5,0,0,5,0,0,0,9,0,0,9,14
22574,Somalia,2019,2019Somalia,0,0,0,8,0,0,8,0,0,10,0,0,0,10,18
22575,Somalia,2019,2019Somalia,0,0,0,9,0,0,9,0,0,0,0,0,0,0,9
22576,Somalia,2019,2019Somalia,0,0,0,9,0,0,9,0,0,0,7,0,0,7,16
22577,Somalia,2019,2019Somalia,0,0,0,9,0,0,9,0,0,0,17,0,0,17,26
22578,Somalia,2019,2019Somalia,0,0,0,12,0,0,12,0,0,0,6,0,0,6,18
22579,Somalia,2019,2019Somalia,0,0,0,52,0,0,52,5,0,0,42,0,0,47,99
22580,Somalia,2019,2019Somalia,0,0,5,5,0,0,10,0,0,0,8,5,0,13,23
22581,Somalia,2019,2019Somalia,0,0,5,6,0,0,11,0,6,0,11,0,0,17,28
22582,Somalia,2019,2019Somalia,0,0,5,23,0,0,28,0,0,6,44,13,0,63,91
22583,Somalia,2019,2019Somalia,0,0,6,0,0,0,6,0,0,0,0,0,0,0,6
22584,Somalia,2019,2019Somalia,0,0,7,0,0,0,7,0,0,0,9,0,0,9,16
22585,Somalia,2019,2019Somalia,0,5,7,77,5,0,94,0,0,12,118,7,0,137,231
22586,Somalia,2019,2019Somalia,0,11,10,59,0,0,80,5,8,9,79,0,0,101,181
22587,Somalia,2019,2019Somalia,0,11,15,81,8,0,115,0,12,21,59,11,0,103,218
22588,Somalia,2019,2019Somalia,5,0,0,5,0,0,10,0,0,0,12,0,0,12,22
22589,Somalia,2019,2019Somalia,5,0,0,29,0,0,34,9,0,0,35,0,0,44,78
22590,Somalia,2019,2019Somalia,5,5,0,5,0,0,15,6,0,0,78,0,0,84,99
22591,Somalia,2019,2019Somalia,5,5,0,10,0,0,20,5,7,5,13,0,0,30,50
22592,Somalia,2019,2019Somalia,5,8,8,15,0,0,36,6,10,8,18,0,0,42,78
22593,Somalia,2019,2019Somalia,6,7,13,47,0,0,73,5,8,20,53,0,0,86,159
22594,Somalia,2019,2019Somalia,7,6,0,14,0,0,27,0,5,7,24,0,0,36,63
22595,Somalia,2019,2019Somalia,7,19,31,136,16,0,209,12,15,36,69,5,0,137,346
22596,Somalia,2019,2019Somalia,8,0,0,68,0,0,76,6,5,5,71,0,0,87,163
22597,Somalia,2019,2019Somalia,8,19,0,34,0,0,61,6,13,5,63,0,0,87,148
22598,Somalia,2019,2019Somalia,10,5,5,35,0,0,55,11,0,5,35,0,0,51,106
22599,Somalia,2019,2019Somalia,13,17,11,73,5,0,119,13,7,5,56,0,0,81,200
22600,Somalia,2019,2019Somalia,16,28,23,60,0,0,127,17,31,23,95,6,0,172,299
22601,Somalia,2019,2019Somalia,19,38,23,76,5,0,161,13,36,24,199,5,0,277,438
22602,Somalia,2019,2019Somalia,22,33,43,176,6,0,280,21,30,39,163,0,0,253,533
22603,Somalia,2019,2019Somalia,25,33,40,238,5,0,341,34,34,44,207,0,0,319,660
22604,Somalia,2019,2019Somalia,64,57,40,320,0,0,481,98,49,48,439,5,0,639,1120
22605,Somalia,2019,2019Somalia,71,127,100,549,33,0,880,71,100,79,387,23,0,660,1540
22606,Somalia,2019,2019Somalia,89,257,187,626,85,0,1244,92,206,211,1499,127,0,2135,3379
22607,Somalia,2019,2019Somalia,171,170,91,712,40,0,1184,185,164,193,1451,31,0,2024,4762
22608,Somalia,2019,2019Somalia,173,198,241,1572,75,0,2259,196,212,249,1035,22,0,1714,3973
22609,Somalia,2019,2019Somalia,888,1344,1053,3349,242,0,6876,922,1386,1054,2771,268,0,6401,13277
22610,Somalia,2019,2019Somalia,1258,2128,2105,9319,283,0,15093,1324,2135,2243,12108,170,0,17980,33073
22611,Somalia,2019,2019Somalia,2225,981,541,7048,155,0,10950,2254,1063,597,11010,141,0,15065,26015
22612,Somalia,2019,2019Somalia,2843,9580,10419,72310,4614,0,99766,2935,9972,10152,125372,4702,0,153133,252899
22613,Somalia,2019,2019Somalia,18749,30375,21557,56916,4757,0,132354,19716,31384,23191,46560,4561,0,125412,257766
22614,Somalia,2019,2019Somalia,19243,23095,19909,36707,1741,0,100695,19593,23475,21399,24892,2127,0,91486,192181
22615,Somalia,2020,2020Somalia,0,0,0,0,0,0,0,0,0,0,0,0,0,0,64570
22616,Somalia,2020,2020Somalia,0,0,0,0,0,0,0,0,0,0,0,0,5,5,5
22617,Somalia,2020,2020Somalia,0,0,0,0,0,0,0,0,0,0,0,5,0,5,5
22618,Somalia,2020,2020Somalia,0,0,0,0,0,0,0,0,0,0,5,0,0,5,20
22619,Somalia,2020,2020Somalia,0,0,0,0,0,0,0,0,0,0,7,0,0,7,7
22620,Somalia,2020,2020Somalia,0,0,0,0,0,0,0,0,0,0,8,0,0,8,8
22621,Somalia,2020,2020Somalia,0,0,0,0,0,0,0,0,0,0,11,0,0,11,22
22622,Somalia,2020,2020Somalia,0,0,0,0,0,0,0,0,0,0,13,0,0,13,13
22623,Somalia,2020,2020Somalia,0,0,0,0,0,0,0,0,0,0,14,0,0,14,14
22624,Somalia,2020,2020Somalia,0,0,0,0,0,0,0,0,6,0,0,0,0,6,6
22625,Somalia,2020,2020Somalia,0,0,0,0,0,19,19,0,0,0,0,0,28,28,47
22626,Somalia,2020,2020Somalia,0,0,0,0,0,26,26,0,0,0,0,0,55,55,81
22627,Somalia,2020,2020Somalia,0,0,0,0,0,30,30,16,0,0,100,0,22,138,2039
22628,Somalia,2020,2020Somalia,0,0,0,0,0,104,104,0,0,0,0,0,510,510,614
22629,Somalia,2020,2020Somalia,0,0,0,0,0,1118,1118,0,0,0,0,0,1198,1198,2316
22630,Somalia,2020,2020Somalia,0,0,0,5,0,0,5,0,0,0,0,0,0,0,5
22631,Somalia,2020,2020Somalia,0,0,0,5,0,0,5,0,0,0,6,0,0,6,11
22632,Somalia,2020,2020Somalia,0,0,0,5,0,0,5,0,0,0,17,0,0,17,29
22633,Somalia,2020,2020Somalia,0,0,0,5,0,0,5,0,0,8,22,0,0,30,35
22634,Somalia,2020,2020Somalia,0,0,0,6,0,0,6,0,0,0,0,0,0,0,26
22635,Somalia,2020,2020Somalia,0,0,0,8,0,0,8,0,0,0,0,0,0,0,8
22636,Somalia,2020,2020Somalia,0,0,0,8,0,0,8,0,0,0,14,0,0,14,22
22637,Somalia,2020,2020Somalia,0,0,0,9,0,0,9,0,0,0,7,0,0,7,16
22638,Somalia,2020,2020Somalia,0,0,0,10,0,0,10,0,0,10,12,0,0,22,32
22639,Somalia,2020,2020Somalia,0,0,0,12,0,0,12,0,0,0,6,0,0,6,18
22640,Somalia,2020,2020Somalia,0,0,0,28,0,0,28,5,0,0,29,5,0,39,67
22641,Somalia,2020,2020Somalia,0,0,5,7,0,0,12,0,6,0,11,0,0,17,29
22642,Somalia,2020,2020Somalia,0,0,6,0,0,0,6,0,0,0,0,0,0,0,6
22643,Somalia,2020,2020Somalia,0,0,7,0,0,0,7,0,0,0,7,0,0,7,14
22644,Somalia,2020,2020Somalia,0,5,0,11,0,0,16,0,0,0,19,0,0,19,35
22645,Somalia,2020,2020Somalia,0,5,5,5,0,0,15,7,0,0,79,0,0,86,101
22646,Somalia,2020,2020Somalia,0,6,6,62,0,0,74,6,5,7,55,0,0,73,147
22647,Somalia,2020,2020Somalia,0,7,17,80,11,0,115,0,10,19,62,11,0,102,217
22648,Somalia,2020,2020Somalia,0,8,5,10,0,0,23,6,9,0,16,0,0,31,54
22649,Somalia,2020,2020Somalia,0,8,12,54,0,0,74,0,10,10,83,0,0,103,177
22650,Somalia,2020,2020Somalia,5,0,0,6,0,0,11,0,0,0,8,0,0,8,19
22651,Somalia,2020,2020Somalia,5,0,10,92,5,0,112,0,0,11,142,10,0,163,275
22652,Somalia,2020,2020Somalia,5,9,0,16,0,0,30,0,5,6,27,0,0,38,68
22653,Somalia,2020,2020Somalia,5,20,28,139,21,0,213,5,25,30,71,10,0,141,354
22654,Somalia,2020,2020Somalia,5,22,7,31,0,0,65,5,5,5,71,5,0,91,156
22655,Somalia,2020,2020Somalia,5,24,17,62,0,0,108,5,16,18,160,5,0,204,312
22656,Somalia,2020,2020Somalia,6,0,0,32,0,0,38,5,5,0,34,0,0,44,82
22657,Somalia,2020,2020Somalia,6,7,13,52,0,0,78,5,8,16,53,0,0,82,160
22658,Somalia,2020,2020Somalia,6,8,8,15,0,0,37,7,10,8,18,0,0,43,80
22659,Somalia,2020,2020Somalia,7,0,5,46,0,0,58,12,0,7,63,0,0,82,140
22660,Somalia,2020,2020Somalia,12,5,5,39,0,0,61,14,0,9,36,0,0,59,120
22661,Somalia,2020,2020Somalia,13,17,12,77,0,0,119,15,13,6,55,0,0,89,208
22662,Somalia,2020,2020Somalia,18,26,24,65,0,0,133,17,32,23,90,12,0,174,307
22663,Somalia,2020,2020Somalia,21,31,38,170,7,0,267,19,25,39,164,0,0,247,514
22664,Somalia,2020,2020Somalia,27,29,42,235,8,0,341,30,33,44,217,0,0,324,665
22665,Somalia,2020,2020Somalia,59,67,28,319,5,0,478,101,57,46,437,0,0,641,1119
22666,Somalia,2020,2020Somalia,71,249,204,648,87,0,1259,83,198,210,1523,141,0,2155,3414
22667,Somalia,2020,2020Somalia,72,150,110,669,36,0,1037,64,120,104,438,23,0,749,1786
22668,Somalia,2020,2020Somalia,158,810,404,3642,45,0,5059,186,837,490,16286,196,0,17995,23054
22669,Somalia,2020,2020Somalia,161,145,84,683,53,0,1126,172,160,157,1351,40,0,1880,4662
22670,Somalia,2020,2020Somalia,162,235,270,1824,86,0,2577,184,252,276,1261,30,0,2003,4580
22671,Somalia,2020,2020Somalia,762,1352,1083,3544,270,0,7011,791,1367,1098,3001,290,0,6547,13558
22672,Somalia,2020,2020Somalia,1251,2335,2252,10693,373,0,16904,1316,2329,2363,14415,209,0,20632,37536
22673,Somalia,2020,2020Somalia,1442,4854,6033,45155,3149,0,60633,1467,4931,6025,75085,3014,0,90522,151155
22674,Somalia,2020,2020Somalia,2409,1342,600,7506,182,0,12039,2510,1432,596,11303,158,0,15999,28061
22675,Somalia,2020,2020Somalia,17881,25509,23097,30023,2516,0,99026,17683,25202,21726,38167,1999,0,104777,203803
22676,Somalia,2020,2020Somalia,17941,31002,22925,58979,5143,0,135990,18855,32167,24489,48925,4926,0,129362,265352
22677,Somalia,2021,2021Somalia,0,0,0,0,0,0,0,0,0,0,0,0,0,0,66493
22678,Somalia,2021,2021Somalia,0,0,0,0,0,0,0,0,0,0,0,5,0,5,5
22679,Somalia,2021,2021Somalia,0,0,0,0,0,0,0,0,0,0,5,0,0,5,50
22680,Somalia,2021,2021Somalia,0,0,0,0,0,0,0,0,0,0,7,0,0,7,7
22681,Somalia,2021,2021Somalia,0,0,0,0,0,0,0,0,0,0,8,0,0,8,8
22682,Somalia,2021,2021Somalia,0,0,0,0,0,0,0,0,0,0,9,0,0,9,9
22683,Somalia,2021,2021Somalia,0,0,0,0,0,0,0,0,0,0,11,0,0,11,22
22684,Somalia,2021,2021Somalia,0,0,0,0,0,0,0,0,0,0,13,0,0,13,13
22685,Somalia,2021,2021Somalia,0,0,0,0,0,0,0,0,0,0,21,0,0,21,30
22686,Somalia,2021,2021Somalia,0,0,0,0,0,0,0,0,6,0,0,0,0,6,6
22687,Somalia,2021,2021Somalia,0,0,0,0,0,8,8,0,0,0,0,0,8,8,16
22688,Somalia,2021,2021Somalia,0,0,0,0,0,25,25,0,0,0,0,0,58,58,83
22689,Somalia,2021,2021Somalia,0,0,0,5,0,0,5,0,0,0,0,0,0,0,5
22690,Somalia,2021,2021Somalia,0,0,0,5,0,0,5,0,0,0,6,0,0,6,11
22691,Somalia,2021,2021Somalia,0,0,0,8,0,0,8,0,0,0,0,0,0,0,8
22692,Somalia,2021,2021Somalia,0,0,0,8,0,0,8,0,0,0,13,0,0,13,21
22693,Somalia,2021,2021Somalia,0,0,0,9,0,0,9,0,0,0,7,0,0,7,16
22694,Somalia,2021,2021Somalia,0,0,0,13,0,0,13,0,0,0,6,0,0,6,19
22695,Somalia,2021,2021Somalia,0,0,0,17,0,0,17,7,0,0,19,0,0,26,43
22696,Somalia,2021,2021Somalia,0,0,0,18,0,0,18,0,0,0,0,6,0,6,24
22697,Somalia,2021,2021Somalia,0,0,0,29,0,31,60,15,0,5,169,0,22,211,1498
22698,Somalia,2021,2021Somalia,0,0,5,7,0,0,12,0,6,0,11,0,0,17,29
22699,Somalia,2021,2021Somalia,0,0,6,0,0,0,6,0,0,0,0,0,0,0,6
22700,Somalia,2021,2021Somalia,0,0,7,0,0,0,7,0,0,0,8,0,0,8,15
22701,Somalia,2021,2021Somalia,0,6,0,9,0,0,15,5,0,0,16,0,0,21,36
22702,Somalia,2021,2021Somalia,0,6,12,55,0,0,73,0,10,8,85,0,0,103,176
22703,Somalia,2021,2021Somalia,0,7,7,16,0,0,30,0,9,0,28,0,0,37,67
22704,Somalia,2021,2021Somalia,5,0,0,5,0,0,10,7,0,0,90,0,0,97,107
22705,Somalia,2021,2021Somalia,5,0,0,6,0,0,11,0,0,6,5,0,0,11,22
22706,Somalia,2021,2021Somalia,5,0,0,31,0,0,36,9,0,0,28,0,0,37,73
22707,Somalia,2021,2021Somalia,5,5,13,73,11,0,107,0,7,18,62,8,0,95,202
22708,Somalia,2021,2021Somalia,5,8,5,13,0,0,31,5,13,0,17,0,0,35,66
22709,Somalia,2021,2021Somalia,5,17,8,35,0,0,65,5,11,5,74,0,0,95,160
22710,Somalia,2021,2021Somalia,5,19,25,144,17,5,215,5,24,27,74,0,0,130,345
22711,Somalia,2021,2021Somalia,5,21,30,68,0,0,124,5,20,13,187,5,0,230,354
22712,Somalia,2021,2021Somalia,6,7,14,52,0,0,79,5,8,12,58,0,0,83,162
22713,Somalia,2021,2021Somalia,7,0,0,5,0,0,12,5,0,9,0,0,0,14,26
22714,Somalia,2021,2021Somalia,7,5,10,167,5,0,194,8,0,13,269,9,0,299,493
22715,Somalia,2021,2021Somalia,8,0,0,0,0,0,8,0,0,0,5,0,0,5,13
22716,Somalia,2021,2021Somalia,9,14,27,109,0,0,159,12,19,21,59,0,0,111,270
22717,Somalia,2021,2021Somalia,10,19,10,73,0,0,112,13,13,8,50,0,0,84,196
22718,Somalia,2021,2021Somalia,14,7,0,38,0,0,59,13,0,7,32,0,0,52,111
22719,Somalia,2021,2021Somalia,19,25,35,166,7,0,252,20,24,29,172,0,0,245,497
22720,Somalia,2021,2021Somalia,24,26,22,68,0,0,140,13,34,25,92,10,0,174,314
22721,Somalia,2021,2021Somalia,27,23,36,219,7,0,312,20,35,36,193,5,0,289,601
22722,Somalia,2021,2021Somalia,30,732,466,3685,56,0,4969,34,784,478,15996,268,0,17560,22529
22723,Somalia,2021,2021Somalia,65,178,142,833,40,0,1258,66,143,147,528,26,0,910,2168
22724,Somalia,2021,2021Somalia,70,68,27,321,5,0,491,106,69,35,445,0,0,655,1146
22725,Somalia,2021,2021Somalia,73,250,202,694,90,0,1309,68,219,210,1591,143,0,2231,3540
22726,Somalia,2021,2021Somalia,133,133,101,631,53,0,1051,150,151,159,1189,41,0,1690,4459
22727,Somalia,2021,2021Somalia,171,244,226,1898,87,0,2626,202,275,248,1319,28,0,2072,4698
22728,Somalia,2021,2021Somalia,752,1419,1064,3787,291,0,7313,805,1373,1097,3273,317,0,6865,14178
22729,Somalia,2021,2021Somalia,1118,2468,2451,12229,421,0,18687,1085,2559,2439,17194,238,0,23515,42202
22730,Somalia,2021,2021Somalia,1364,3213,4014,24655,2087,0,35333,1401,3287,3976,29475,1778,0,39917,75250
22731,Somalia,2021,2021Somalia,2465,1923,693,8042,194,5,13322,2456,2005,669,11587,168,0,16885,30283
22732,Somalia,2021,2021Somalia,18798,26540,23404,45290,2416,0,116448,19640,26930,24504,32697,2799,0,106570,223018
22733,Somalia,2021,2021Somalia,21774,30933,23318,61916,5444,0,143385,22881,32174,24802,52069,5168,0,137094,280479
22734,South Sudan,2012,2012South Sudan,0,0,0,0,0,0,0,0,0,0,0,0,0,0,160
22735,South Sudan,2012,2012South Sudan,0,0,0,6,0,0,6,0,0,0,0,0,0,0,6
22736,South Sudan,2012,2012South Sudan,0,0,5,0,0,0,5,0,0,9,11,0,0,20,25
22737,South Sudan,2012,2012South Sudan,0,0,6,0,0,0,6,0,8,0,0,0,0,8,14
22738,South Sudan,2012,2012South Sudan,0,18,23,65,0,0,106,6,0,24,42,0,0,72,178
22739,South Sudan,2012,2012South Sudan,870,1668,1344,1607,159,0,5648,952,1733,1596,1139,67,0,5487,11135
22740,South Sudan,2012,2012South Sudan,1103,1839,1496,3716,251,0,8405,1190,1920,1742,3468,49,0,8369,16774
22741,South Sudan,2012,2012South Sudan,4227,5002,2870,9020,487,0,21606,4193,5285,3190,4305,136,0,17109,58715
22742,South Sudan,2013,2013South Sudan,0,0,0,0,0,0,0,0,0,0,0,0,0,0,164
22743,South Sudan,2013,2013South Sudan,0,0,0,0,0,0,0,0,0,0,5,0,0,5,5
22744,South Sudan,2013,2013South Sudan,0,0,0,0,0,0,0,0,0,0,7,0,0,7,7
22745,South Sudan,2013,2013South Sudan,0,0,0,0,0,0,0,0,0,7,9,0,0,16,16
22746,South Sudan,2013,2013South Sudan,0,0,6,11,0,0,17,0,9,0,5,0,0,14,31
22747,South Sudan,2013,2013South Sudan,12,30,30,98,0,0,170,16,23,22,68,0,0,129,299
22748,South Sudan,2013,2013South Sudan,1427,2500,1581,3818,193,0,9519,1474,2200,1561,5115,61,0,10411,19930
22749,South Sudan,2013,2013South Sudan,1600,2839,2105,4777,391,0,11712,1653,3125,2454,3397,169,0,10798,22510
22750,South Sudan,2013,2013South Sudan,4899,6353,3771,10723,568,11967,38281,4871,6662,4310,5264,150,11968,33225,71506
22751,South Sudan,2014,2014South Sudan,0,0,0,0,0,0,0,0,0,0,0,0,0,0,209
22752,South Sudan,2014,2014South Sudan,0,0,0,0,0,0,0,0,0,0,9,0,0,9,9
22753,South Sudan,2014,2014South Sudan,0,0,0,0,0,0,0,0,0,5,10,0,0,15,15
22754,South Sudan,2014,2014South Sudan,0,0,0,0,0,0,0,0,6,0,0,0,0,6,6
22755,South Sudan,2014,2014South Sudan,0,0,0,5,0,0,5,0,0,0,6,0,0,6,11
22756,South Sudan,2014,2014South Sudan,5,8,26,5,0,0,44,0,14,13,8,0,0,35,79
22757,South Sudan,2014,2014South Sudan,7,0,0,5,0,0,12,0,0,0,12,0,0,12,24
22758,South Sudan,2014,2014South Sudan,24,42,162,68,0,0,296,34,47,117,48,0,0,246,542
22759,South Sudan,2014,2014South Sudan,169,250,113,439,36,0,1007,128,215,91,303,46,0,783,1790
22760,South Sudan,2014,2014South Sudan,6444,10965,7253,16930,1038,0,42630,6851,12809,11345,15232,359,0,46596,89226
22761,South Sudan,2014,2014South Sudan,9359,14285,8874,22867,1889,2291,59565,9236,14007,9570,19029,1742,2302,55886,115451
22762,South Sudan,2014,2014South Sudan,12736,21469,14080,31698,2884,0,82867,13542,22325,15597,21528,1194,0,74186,157053
22763,South Sudan,2014,2014South Sudan,20252,32445,15634,47583,2737,22977,141628,20571,33251,17637,20442,927,17335,110163,251791
22764,South Sudan,2015,2015South Sudan,0,0,0,0,0,0,0,0,0,0,0,0,0,0,252
22765,South Sudan,2015,2015South Sudan,0,0,0,0,0,0,0,0,0,0,0,0,5,5,5
22766,South Sudan,2015,2015South Sudan,0,0,0,0,0,0,0,0,0,0,5,0,0,5,15
22767,South Sudan,2015,2015South Sudan,0,0,0,0,0,0,0,0,0,5,0,0,0,5,5
22768,South Sudan,2015,2015South Sudan,0,0,0,0,0,0,0,0,0,5,5,0,0,10,10
22769,South Sudan,2015,2015South Sudan,0,0,0,0,0,0,0,0,6,0,0,0,0,6,6
22770,South Sudan,2015,2015South Sudan,0,5,0,17,0,0,22,0,0,8,19,0,0,27,49
22771,South Sudan,2015,2015South Sudan,0,7,0,9,0,0,16,0,5,0,19,0,0,24,40
22772,South Sudan,2015,2015South Sudan,0,7,5,28,0,0,40,0,13,7,19,0,0,39,79
22773,South Sudan,2015,2015South Sudan,5,0,0,0,0,0,5,0,0,0,12,0,0,12,17
22774,South Sudan,2015,2015South Sudan,6,0,0,0,0,0,6,0,0,0,13,0,0,13,19
22775,South Sudan,2015,2015South Sudan,83,184,165,476,14,0,922,97,213,179,270,5,0,764,1686
22776,South Sudan,2015,2015South Sudan,645,697,320,1365,90,0,3117,577,653,288,859,103,0,2480,5597
22777,South Sudan,2015,2015South Sudan,6166,11845,8259,17355,1086,0,44711,6380,13726,12537,17946,371,0,50960,95671
22778,South Sudan,2015,2015South Sudan,10596,13246,11481,16533,1729,0,53585,10372,12984,9191,10249,1124,0,43920,194404
22779,South Sudan,2015,2015South Sudan,14993,27120,18268,40719,3746,0,104846,15869,28705,20351,28058,1530,0,94513,199359
22780,South Sudan,2015,2015South Sudan,27762,37202,17301,53965,3059,17605,156894,28413,38462,20294,22587,1026,13832,124614,281508
22781,South Sudan,2016,2016South Sudan,0,0,0,0,0,0,0,0,0,0,0,0,0,0,275
22782,South Sudan,2016,2016South Sudan,0,0,0,0,0,0,0,0,0,0,0,0,8,8,8
22783,South Sudan,2016,2016South Sudan,0,0,0,0,0,0,0,0,0,0,5,0,0,5,10
22784,South Sudan,2016,2016South Sudan,0,0,0,0,0,0,0,0,0,0,8,0,0,8,8
22785,South Sudan,2016,2016South Sudan,0,0,0,0,0,0,0,0,0,5,0,0,0,5,5
22786,South Sudan,2016,2016South Sudan,0,0,0,0,0,0,0,5,0,0,0,0,0,5,5
22787,South Sudan,2016,2016South Sudan,0,0,5,0,0,0,5,0,6,0,0,0,0,6,11
22788,South Sudan,2016,2016South Sudan,0,6,0,15,0,0,21,0,0,9,20,0,0,29,50
22789,South Sudan,2016,2016South Sudan,0,15,0,32,0,0,47,0,11,13,27,0,0,51,98
22790,South Sudan,2016,2016South Sudan,5,0,0,0,0,0,5,0,0,0,5,0,0,5,10
22791,South Sudan,2016,2016South Sudan,6,0,0,0,0,0,6,0,0,0,15,0,0,15,21
22792,South Sudan,2016,2016South Sudan,126,308,229,717,28,0,1408,138,308,244,428,6,0,1124,2532
22793,South Sudan,2016,2016South Sudan,457,586,708,746,79,0,2576,539,605,575,566,51,0,2336,4912
22794,South Sudan,2016,2016South Sudan,7002,11274,7633,14687,726,0,41322,7270,13278,12508,12547,216,0,45819,87141
22795,South Sudan,2016,2016South Sudan,8034,9116,4827,12946,905,0,35828,7751,9267,4700,8531,595,0,30844,66672
22796,South Sudan,2016,2016South Sudan,9826,13921,8704,17980,1821,0,52252,9959,13819,7627,9536,677,0,41618,297168
22797,South Sudan,2016,2016South Sudan,30520,45893,23698,66713,3746,17608,188178,30945,47636,27061,29771,1348,13835,150596,338774
22798,South Sudan,2016,2016South Sudan,39475,58936,40240,82979,8324,133700,363654,40481,60716,43305,55514,3108,72229,275353,639007
22799,South Sudan,2017,2017South Sudan,0,0,0,0,0,0,0,0,0,0,0,0,0,0,302
22800,South Sudan,2017,2017South Sudan,0,0,0,0,0,0,0,0,0,0,5,0,0,5,10
22801,South Sudan,2017,2017South Sudan,0,0,0,0,0,0,0,0,0,0,6,0,0,6,12
22802,South Sudan,2017,2017South Sudan,0,0,0,0,0,0,0,0,0,0,7,0,0,7,7
22803,South Sudan,2017,2017South Sudan,0,0,0,0,0,0,0,0,0,0,8,0,0,8,8
22804,South Sudan,2017,2017South Sudan,0,0,0,0,0,0,0,0,0,0,9,0,0,9,9
22805,South Sudan,2017,2017South Sudan,0,0,0,0,0,0,0,0,0,5,0,0,0,5,5
22806,South Sudan,2017,2017South Sudan,0,0,0,0,0,5,5,0,0,0,0,0,22,22,27
22807,South Sudan,2017,2017South Sudan,0,0,5,0,0,0,5,0,7,0,0,0,0,7,12
22808,South Sudan,2017,2017South Sudan,0,5,0,0,0,0,5,0,0,0,7,0,0,7,12
22809,South Sudan,2017,2017South Sudan,0,5,0,11,0,0,16,0,0,6,17,0,0,23,39
22810,South Sudan,2017,2017South Sudan,0,8,0,9,0,0,17,0,9,0,33,0,0,42,59
22811,South Sudan,2017,2017South Sudan,5,5,12,35,0,0,57,0,10,12,31,0,0,53,110
22812,South Sudan,2017,2017South Sudan,223,222,74,513,39,0,1071,231,205,87,430,25,0,978,2049
22813,South Sudan,2017,2017South Sudan,319,549,455,1473,55,0,2851,326,588,406,1063,13,0,2396,5247
22814,South Sudan,2017,2017South Sudan,8573,13969,9712,19689,924,0,52867,8930,16222,15033,18141,317,0,58643,111510
22815,South Sudan,2017,2017South Sudan,9904,11999,6294,17427,1306,0,46930,9692,12180,6483,12782,903,0,42040,88970
22816,South Sudan,2017,2017South Sudan,22863,31089,18309,50198,5913,0,128372,23689,31154,18332,34870,4202,0,112247,772715
22817,South Sudan,2017,2017South Sudan,38906,54851,28449,85288,4911,19272,231677,38669,58820,32902,42058,2012,15235,189696,421373
22818,South Sudan,2017,2017South Sudan,80923,138572,90037,188567,17556,33328,548983,81738,143426,96725,140763,7833,17944,488429,1037412
22819,South Sudan,2018,2018South Sudan,0,0,0,0,0,0,0,0,0,0,0,0,0,0,474
22820,South Sudan,2018,2018South Sudan,0,0,0,0,0,0,0,0,0,0,5,0,0,5,15
22821,South Sudan,2018,2018South Sudan,0,0,0,0,0,0,0,0,0,0,6,0,0,6,6
22822,South Sudan,2018,2018South Sudan,0,0,0,0,0,0,0,0,0,0,8,0,0,8,24
22823,South Sudan,2018,2018South Sudan,0,0,0,0,0,0,0,0,0,5,0,0,0,5,5
22824,South Sudan,2018,2018South Sudan,0,0,0,0,0,0,0,0,5,0,0,0,0,5,5
22825,South Sudan,2018,2018South Sudan,0,0,0,0,0,0,0,5,0,0,6,0,0,11,11
22826,South Sudan,2018,2018South Sudan,0,0,0,0,0,5,5,0,0,0,0,0,35,35,40
22827,South Sudan,2018,2018South Sudan,0,0,0,5,0,0,5,0,0,0,5,0,0,5,10
22828,South Sudan,2018,2018South Sudan,0,0,0,7,0,0,7,0,6,0,0,0,0,6,13
22829,South Sudan,2018,2018South Sudan,0,0,0,52,0,0,52,0,0,0,107,0,0,107,159
22830,South Sudan,2018,2018South Sudan,0,0,5,0,0,0,5,0,6,0,0,0,0,6,11
22831,South Sudan,2018,2018South Sudan,0,5,0,0,0,0,5,0,0,0,0,0,0,0,5
22832,South Sudan,2018,2018South Sudan,0,5,0,0,0,0,5,0,0,0,8,0,0,8,13
22833,South Sudan,2018,2018South Sudan,0,5,0,10,0,0,15,0,0,7,20,0,0,27,42
22834,South Sudan,2018,2018South Sudan,0,7,0,0,0,0,7,0,0,0,0,0,0,0,7
22835,South Sudan,2018,2018South Sudan,0,9,0,8,0,0,17,6,5,0,48,0,0,59,76
22836,South Sudan,2018,2018South Sudan,0,15,0,39,0,0,54,0,5,17,30,0,0,52,106
22837,South Sudan,2018,2018South Sudan,206,342,83,627,48,0,1306,215,318,119,583,32,0,1267,2573
22838,South Sudan,2018,2018South Sudan,440,765,621,2195,82,0,4103,491,815,583,1720,25,0,3634,7737
22839,South Sudan,2018,2018South Sudan,7976,14205,10154,21032,998,0,54365,8296,16473,15316,20381,371,0,60837,115202
22840,South Sudan,2018,2018South Sudan,10400,12938,6783,18856,1458,0,50435,10112,13043,6993,14114,1007,0,45269,95704
22841,South Sudan,2018,2018South Sudan,36673,56878,29054,80864,5443,19919,228831,37998,58114,35248,43584,2214,15881,193039,422135
22842,South Sudan,2018,2018South Sudan,68684,111471,63094,183918,20682,0,447849,70894,111010,64473,141449,16405,0,404231,852080
22843,South Sudan,2018,2018South Sudan,74700,108303,71249,146452,15920,0,416624,74305,111976,77215,101928,6800,0,372224,788848
22844,South Sudan,2019,2019South Sudan,0,0,0,0,0,0,0,0,0,0,0,0,0,0,545
22845,South Sudan,2019,2019South Sudan,0,0,0,0,0,0,0,0,0,0,5,0,0,5,10
22846,South Sudan,2019,2019South Sudan,0,0,0,0,0,0,0,0,0,0,6,0,0,6,6
22847,South Sudan,2019,2019South Sudan,0,0,0,0,0,0,0,0,0,0,7,0,0,7,7
22848,South Sudan,2019,2019South Sudan,0,0,0,0,0,0,0,0,0,0,8,0,0,8,21
22849,South Sudan,2019,2019South Sudan,0,0,0,0,0,0,0,0,0,0,9,0,0,9,9
22850,South Sudan,2019,2019South Sudan,0,0,0,0,0,11,11,0,0,0,0,0,72,72,83
22851,South Sudan,2019,2019South Sudan,0,0,0,5,0,0,5,0,0,0,8,0,0,8,13
22852,South Sudan,2019,2019South Sudan,0,0,0,88,0,0,88,0,0,0,204,0,0,204,292
22853,South Sudan,2019,2019South Sudan,0,0,5,0,0,0,5,0,0,6,0,0,0,6,11
22854,South Sudan,2019,2019South Sudan,0,0,7,5,0,0,12,0,0,5,15,0,0,20,32
22855,South Sudan,2019,2019South Sudan,0,5,0,0,0,0,5,0,0,0,0,0,0,0,5
22856,South Sudan,2019,2019South Sudan,0,5,0,0,0,0,5,0,0,0,8,0,0,8,13
22857,South Sudan,2019,2019South Sudan,0,14,0,25,0,0,39,0,5,10,21,5,0,41,80
22858,South Sudan,2019,2019South Sudan,5,0,0,0,0,0,5,0,0,0,0,0,0,0,5
22859,South Sudan,2019,2019South Sudan,5,0,0,0,0,0,5,0,5,0,0,0,0,5,10
22860,South Sudan,2019,2019South Sudan,5,5,0,12,0,0,22,6,6,0,52,0,0,64,86
22861,South Sudan,2019,2019South Sudan,226,300,80,530,44,0,1180,261,87,80,585,42,0,1055,2235
22862,South Sudan,2019,2019South Sudan,850,1399,1063,4189,157,0,7658,914,1442,1020,3756,42,0,7174,14832
22863,South Sudan,2019,2019South Sudan,7699,14446,10928,23170,1202,0,57445,7971,16372,15896,23312,414,0,63965,121410
22864,South Sudan,2019,2019South Sudan,9990,12074,6284,17660,1366,0,47374,9621,12310,6211,12308,893,0,41343,88717
22865,South Sudan,2019,2019South Sudan,39187,45539,24867,66932,4307,0,180832,40364,46989,30809,33253,1767,0,153182,334014
22866,South Sudan,2019,2019South Sudan,52803,97079,64237,184346,20292,0,418757,54178,97384,63107,158189,19302,0,392160,810917
22867,South Sudan,2019,2019South Sudan,76191,115918,78961,164079,17090,0,452239,76135,119624,86720,119245,7489,0,409213,861452
22868,South Sudan,2020,2020South Sudan,0,0,0,0,0,0,0,0,0,0,0,0,0,0,568
22869,South Sudan,2020,2020South Sudan,0,0,0,0,0,0,0,0,0,0,0,0,5,5,5
22870,South Sudan,2020,2020South Sudan,0,0,0,0,0,0,0,0,0,0,5,0,0,5,20
22871,South Sudan,2020,2020South Sudan,0,0,0,0,0,0,0,0,0,0,6,0,0,6,6
22872,South Sudan,2020,2020South Sudan,0,0,0,0,0,0,0,0,0,0,7,0,0,7,14
22873,South Sudan,2020,2020South Sudan,0,0,0,0,0,0,0,0,0,0,8,0,0,8,16
22874,South Sudan,2020,2020South Sudan,0,0,0,0,0,0,0,0,0,0,9,0,0,9,9
22875,South Sudan,2020,2020South Sudan,0,0,0,0,0,0,0,0,5,0,0,0,0,5,5
22876,South Sudan,2020,2020South Sudan,0,0,0,5,0,0,5,0,0,0,11,0,0,11,16
22877,South Sudan,2020,2020South Sudan,0,0,0,8,0,0,8,0,0,0,0,0,0,0,8
22878,South Sudan,2020,2020South Sudan,0,0,0,8,0,0,8,0,0,0,17,0,0,17,25
22879,South Sudan,2020,2020South Sudan,0,0,5,0,0,0,5,0,0,6,0,0,0,6,11
22880,South Sudan,2020,2020South Sudan,0,5,0,0,0,0,5,0,0,0,8,0,0,8,13
22881,South Sudan,2020,2020South Sudan,0,5,0,0,0,0,5,0,0,0,9,0,0,9,19
22882,South Sudan,2020,2020South Sudan,0,5,0,0,0,0,5,0,5,0,0,0,0,5,10
22883,South Sudan,2020,2020South Sudan,0,5,8,5,0,0,18,0,6,5,8,0,0,19,37
22884,South Sudan,2020,2020South Sudan,0,9,5,25,0,0,39,0,0,13,24,5,0,42,81
22885,South Sudan,2020,2020South Sudan,5,6,0,11,0,0,22,0,6,8,65,0,0,79,101
22886,South Sudan,2020,2020South Sudan,6,0,0,0,0,0,6,0,0,0,0,0,0,0,6
22887,South Sudan,2020,2020South Sudan,178,223,90,304,40,0,835,185,248,76,412,46,0,967,1802
22888,South Sudan,2020,2020South Sudan,874,1711,1341,5256,177,0,9359,948,1786,1220,4821,45,0,8820,18179
22889,South Sudan,2020,2020South Sudan,5642,7275,3621,11369,1128,0,29035,5452,7377,3627,8475,789,0,25720,54755
22890,South Sudan,2020,2020South Sudan,6747,14843,11405,24139,1223,0,58357,7076,16579,16377,25116,407,0,65555,123912
22891,South Sudan,2020,2020South Sudan,33498,54840,28846,74342,5421,0,196947,34808,55930,34527,40582,2236,0,168083,365030
22892,South Sudan,2020,2020South Sudan,45542,94435,60541,167960,18728,0,387206,46969,95400,59550,131716,15844,0,349479,736685
22893,South Sudan,2020,2020South Sudan,65303,121117,84323,176484,17808,0,465035,65467,123888,92749,132440,7873,0,422417,887452
22894,South Sudan,2021,2021South Sudan,0,0,0,0,0,0,0,0,0,0,0,0,0,0,686
22895,South Sudan,2021,2021South Sudan,0,0,0,0,0,0,0,0,0,0,5,0,0,5,25
22896,South Sudan,2021,2021South Sudan,0,0,0,0,0,0,0,0,0,0,7,0,0,7,21
22897,South Sudan,2021,2021South Sudan,0,0,0,0,0,0,0,0,0,0,8,0,0,8,16
22898,South Sudan,2021,2021South Sudan,0,0,0,0,0,0,0,0,0,0,9,0,0,9,9
22899,South Sudan,2021,2021South Sudan,0,0,0,0,0,0,0,0,0,5,0,0,0,5,5
22900,South Sudan,2021,2021South Sudan,0,0,0,0,0,0,0,0,5,0,0,0,0,5,5
22901,South Sudan,2021,2021South Sudan,0,0,0,0,0,0,0,0,6,0,0,0,0,6,6
22902,South Sudan,2021,2021South Sudan,0,0,0,5,0,0,5,0,0,0,19,0,0,19,24
22903,South Sudan,2021,2021South Sudan,0,0,0,5,0,0,5,0,0,6,0,0,0,6,11
22904,South Sudan,2021,2021South Sudan,0,0,0,8,0,0,8,0,0,5,15,0,0,20,28
22905,South Sudan,2021,2021South Sudan,0,5,0,0,0,0,5,0,0,0,0,0,0,0,5
22906,South Sudan,2021,2021South Sudan,0,5,0,0,0,0,5,0,0,0,6,0,0,6,11
22907,South Sudan,2021,2021South Sudan,0,5,0,0,0,0,5,0,0,0,8,0,0,8,53
22908,South Sudan,2021,2021South Sudan,0,8,7,22,0,0,37,0,13,6,13,5,0,37,74
22909,South Sudan,2021,2021South Sudan,0,11,0,14,0,0,25,0,8,7,78,0,0,93,249
22910,South Sudan,2021,2021South Sudan,5,0,7,5,0,0,17,5,0,7,9,0,0,21,38
22911,South Sudan,2021,2021South Sudan,7,0,0,0,0,0,7,0,0,0,6,0,0,6,19
22912,South Sudan,2021,2021South Sudan,137,275,109,447,41,0,1009,126,256,128,324,51,0,885,1894
22913,South Sudan,2021,2021South Sudan,920,1739,1330,5395,170,0,9554,1025,1789,1288,4967,50,0,9119,18673
22914,South Sudan,2021,2021South Sudan,5258,7646,3979,11772,1158,0,29813,5056,7708,4075,8870,819,0,26528,56341
22915,South Sudan,2021,2021South Sudan,7892,15450,12295,26528,1327,0,63492,8396,17125,17682,28106,454,0,71763,135255
22916,South Sudan,2021,2021South Sudan,31899,57422,33248,79991,5811,0,208371,33357,58326,38279,46027,2390,0,178379,386750
22917,South Sudan,2021,2021South Sudan,41042,99627,67098,186770,21090,0,415627,41821,100868,66954,158304,20060,0,388007,803634
22918,South Sudan,2021,2021South Sudan,68047,129477,89944,195068,18907,0,501443,67982,131251,98676,151083,8492,0,457484,958927
22919,Sri Lanka,2001,2001Sri Lanka,0,0,0,0,0,0,0,0,0,0,0,0,0,0,97027
22920,Sri Lanka,2001,2001Sri Lanka,0,0,0,0,0,0,0,0,0,0,0,0,12,12,12
22921,Sri Lanka,2001,2001Sri Lanka,0,0,0,0,0,0,0,0,0,0,5,0,0,5,10
22922,Sri Lanka,2001,2001Sri Lanka,0,0,0,0,0,0,0,0,0,0,9,0,0,9,9
22923,Sri Lanka,2001,2001Sri Lanka,0,0,0,0,0,0,0,0,0,0,26,0,0,26,26
22924,Sri Lanka,2001,2001Sri Lanka,0,0,0,0,0,0,0,0,8,0,0,0,0,8,8
22925,Sri Lanka,2001,2001Sri Lanka,0,0,0,0,0,4289,4289,0,0,0,0,0,5110,5110,9399
22926,Sri Lanka,2001,2001Sri Lanka,0,0,0,0,0,5897,5897,0,0,0,0,0,9877,9877,15774
22927,Sri Lanka,2001,2001Sri Lanka,0,0,0,5,0,0,5,0,0,0,0,0,0,0,10
22928,Sri Lanka,2001,2001Sri Lanka,0,0,0,8,0,0,8,6,0,0,11,0,0,17,25
22929,Sri Lanka,2001,2001Sri Lanka,0,5,0,0,0,0,5,0,0,0,6,0,0,6,11
22930,Sri Lanka,2001,2001Sri Lanka,0,6,0,5,0,0,11,0,0,6,7,0,0,13,24
22931,Sri Lanka,2001,2001Sri Lanka,0,7,0,0,0,0,7,0,5,0,5,0,0,10,17
22932,Sri Lanka,2001,2001Sri Lanka,5,0,0,0,0,0,5,0,0,0,0,0,0,0,5
22933,Sri Lanka,2001,2001Sri Lanka,5,5,0,14,5,0,29,0,5,0,23,0,0,28,57
22934,Sri Lanka,2002,2002Sri Lanka,0,0,0,0,0,0,0,0,0,0,0,0,0,0,47558
22935,Sri Lanka,2002,2002Sri Lanka,0,0,0,0,0,0,0,0,0,0,5,0,0,5,10
22936,Sri Lanka,2002,2002Sri Lanka,0,0,0,0,0,0,0,0,0,0,9,0,0,9,18
22937,Sri Lanka,2002,2002Sri Lanka,0,0,0,0,0,0,0,0,0,0,13,0,0,13,13
22938,Sri Lanka,2002,2002Sri Lanka,0,0,0,0,0,0,0,0,0,0,18,0,0,18,18
22939,Sri Lanka,2002,2002Sri Lanka,0,0,0,0,0,0,0,0,7,0,0,0,0,7,7
22940,Sri Lanka,2002,2002Sri Lanka,0,0,0,0,0,470,470,0,0,0,0,0,701,701,5807
22941,Sri Lanka,2002,2002Sri Lanka,0,0,0,0,0,5963,5963,0,0,0,0,0,9975,9975,15938
22942,Sri Lanka,2002,2002Sri Lanka,0,0,0,0,0,31884,31884,0,0,0,0,0,31883,31883,63767
22943,Sri Lanka,2002,2002Sri Lanka,0,0,0,5,0,0,5,0,9,0,0,0,0,9,46
22944,Sri Lanka,2002,2002Sri Lanka,0,0,0,7,0,0,7,0,0,0,0,0,0,0,7
22945,Sri Lanka,2002,2002Sri Lanka,0,0,9,0,0,0,9,0,0,0,8,0,0,8,17
22946,Sri Lanka,2002,2002Sri Lanka,0,5,0,0,0,0,5,0,0,0,0,0,0,0,10
22947,Sri Lanka,2002,2002Sri Lanka,0,5,0,6,0,0,11,0,5,0,8,0,0,13,24
22948,Sri Lanka,2003,2003Sri Lanka,0,0,0,0,0,0,0,0,0,0,0,0,0,0,103152
22949,Sri Lanka,2003,2003Sri Lanka,0,0,0,0,0,0,0,0,0,0,5,0,0,5,5
22950,Sri Lanka,2003,2003Sri Lanka,0,0,0,0,0,0,0,0,0,0,6,0,0,6,6
22951,Sri Lanka,2003,2003Sri Lanka,0,0,0,0,0,0,0,0,0,0,9,0,0,9,18
22952,Sri Lanka,2003,2003Sri Lanka,0,0,0,0,0,0,0,0,7,0,0,0,0,7,7
22953,Sri Lanka,2003,2003Sri Lanka,0,0,0,0,0,210,210,0,0,0,0,0,317,317,3679
22954,Sri Lanka,2003,2003Sri Lanka,0,0,0,0,0,5664,5664,0,0,0,0,0,9398,9398,15062
22955,Sri Lanka,2003,2003Sri Lanka,0,0,0,5,0,0,5,0,0,0,0,0,0,0,5
22956,Sri Lanka,2003,2003Sri Lanka,0,0,0,6,0,0,6,0,0,0,0,0,0,0,6
22957,Sri Lanka,2003,2003Sri Lanka,0,0,0,10,0,0,10,0,5,0,9,0,0,14,24
22958,Sri Lanka,2003,2003Sri Lanka,0,0,9,0,0,0,9,0,0,0,8,0,0,8,17
22959,Sri Lanka,2003,2003Sri Lanka,0,5,0,6,0,0,11,0,5,0,8,0,0,13,24
22960,Sri Lanka,2004,2004Sri Lanka,0,0,0,0,0,0,0,0,0,0,0,0,0,0,110908
22961,Sri Lanka,2004,2004Sri Lanka,0,0,0,0,0,0,0,0,0,0,5,0,0,5,20
22962,Sri Lanka,2004,2004Sri Lanka,0,0,0,0,0,0,0,0,0,0,6,0,0,6,6
22963,Sri Lanka,2004,2004Sri Lanka,0,0,0,0,0,0,0,0,0,0,9,0,0,9,9
22964,Sri Lanka,2004,2004Sri Lanka,0,0,0,0,0,0,0,0,6,0,0,0,0,6,6
22965,Sri Lanka,2004,2004Sri Lanka,0,0,0,5,0,0,5,0,0,0,0,0,0,0,5
22966,Sri Lanka,2004,2004Sri Lanka,0,0,0,5,0,0,5,0,0,5,10,0,0,15,20
22967,Sri Lanka,2004,2004Sri Lanka,0,0,9,0,0,0,9,0,0,0,9,0,0,9,18
22968,Sri Lanka,2004,2004Sri Lanka,0,5,0,0,0,0,5,0,0,0,32,0,0,32,37
22969,Sri Lanka,2004,2004Sri Lanka,0,5,0,6,0,0,11,0,5,0,8,0,0,13,24
22970,Sri Lanka,2004,2004Sri Lanka,5,0,0,0,0,0,5,0,0,0,0,0,0,0,45
22971,Sri Lanka,2004,2004Sri Lanka,147,157,134,638,135,206,1417,159,166,143,692,57,318,1535,2952
22972,Sri Lanka,2005,2005Sri Lanka,0,0,0,0,0,0,0,0,0,0,0,0,0,0,89754
22973,Sri Lanka,2005,2005Sri Lanka,0,0,0,0,0,0,0,0,0,0,5,0,0,5,10
22974,Sri Lanka,2005,2005Sri Lanka,0,0,0,0,0,0,0,0,6,0,0,0,0,6,6
22975,Sri Lanka,2005,2005Sri Lanka,0,0,0,0,0,5,5,0,0,0,0,0,0,0,5
22976,Sri Lanka,2005,2005Sri Lanka,0,0,0,0,0,5745,5745,0,0,0,0,0,9857,9857,15602
22977,Sri Lanka,2005,2005Sri Lanka,0,0,0,5,0,0,5,0,0,0,7,0,0,7,12
22978,Sri Lanka,2005,2005Sri Lanka,0,0,0,5,0,0,5,0,0,0,19,0,0,19,24
22979,Sri Lanka,2005,2005Sri Lanka,0,0,0,5,0,0,5,0,0,0,25,0,0,25,30
22980,Sri Lanka,2005,2005Sri Lanka,0,0,0,8,0,0,8,0,0,0,0,0,0,0,8
22981,Sri Lanka,2005,2005Sri Lanka,0,0,0,9,0,0,9,0,0,0,0,0,0,0,9
22982,Sri Lanka,2005,2005Sri Lanka,0,0,9,0,0,0,9,0,0,0,9,0,0,9,18
22983,Sri Lanka,2005,2005Sri Lanka,0,5,0,0,0,0,5,0,0,0,32,0,0,32,37
22984,Sri Lanka,2005,2005Sri Lanka,109,134,115,560,134,217,1269,112,149,128,577,50,332,1348,2617
22985,Sri Lanka,2006,2006Sri Lanka,0,0,0,0,0,0,0,0,0,0,0,0,0,0,29088
22986,Sri Lanka,2006,2006Sri Lanka,0,0,0,0,0,0,0,0,0,0,0,0,5,5,5
22987,Sri Lanka,2006,2006Sri Lanka,0,0,0,0,0,0,0,0,0,0,0,0,8,8,8
22988,Sri Lanka,2006,2006Sri Lanka,0,0,0,0,0,0,0,0,0,0,5,0,0,5,10
22989,Sri Lanka,2006,2006Sri Lanka,0,0,0,0,0,0,0,0,0,0,9,0,0,9,9
22990,Sri Lanka,2006,2006Sri Lanka,0,0,0,0,0,0,0,0,0,6,0,0,0,6,6
22991,Sri Lanka,2006,2006Sri Lanka,0,0,0,0,0,5,5,0,0,0,0,0,0,0,5
22992,Sri Lanka,2006,2006Sri Lanka,0,0,0,0,0,1125,1125,0,0,0,0,0,1227,1227,2352
22993,Sri Lanka,2006,2006Sri Lanka,0,0,0,0,0,5734,5734,0,0,0,0,0,9935,9935,15669
22994,Sri Lanka,2006,2006Sri Lanka,0,0,0,0,0,33947,33947,0,0,0,0,0,35662,35662,69609
22995,Sri Lanka,2006,2006Sri Lanka,0,0,0,6,0,0,6,0,0,0,7,0,0,7,13
22996,Sri Lanka,2006,2006Sri Lanka,0,0,0,6,0,0,6,0,0,5,31,0,0,36,42
22997,Sri Lanka,2006,2006Sri Lanka,0,0,5,0,0,0,5,0,0,0,32,0,0,32,37
22998,Sri Lanka,2006,2006Sri Lanka,0,0,9,0,0,0,9,0,0,0,9,0,0,9,18
22999,Sri Lanka,2006,2006Sri Lanka,0,8,0,0,0,0,8,0,0,0,8,0,0,8,16
23000,Sri Lanka,2006,2006Sri Lanka,0,8,0,10,0,0,18,0,0,5,38,0,0,43,61
23001,Sri Lanka,2007,2007Sri Lanka,0,0,0,0,0,0,0,0,0,0,0,0,0,0,42542
23002,Sri Lanka,2007,2007Sri Lanka,0,0,0,0,0,0,0,0,0,0,0,0,5,5,5
23003,Sri Lanka,2007,2007Sri Lanka,0,0,0,0,0,0,0,0,0,0,5,0,0,5,20
23004,Sri Lanka,2007,2007Sri Lanka,0,0,0,0,0,0,0,0,0,0,7,0,0,7,7
23005,Sri Lanka,2007,2007Sri Lanka,0,0,0,0,0,0,0,0,0,0,9,0,0,9,9
23006,Sri Lanka,2007,2007Sri Lanka,0,0,0,0,0,0,0,0,0,5,73,0,0,78,78
23007,Sri Lanka,2007,2007Sri Lanka,0,0,0,0,0,0,0,0,0,6,0,0,0,6,6
23008,Sri Lanka,2007,2007Sri Lanka,0,0,0,0,0,5,5,0,0,0,0,0,15,15,20
23009,Sri Lanka,2007,2007Sri Lanka,0,0,0,0,0,5977,5977,0,0,0,0,0,10628,10628,16605
23010,Sri Lanka,2007,2007Sri Lanka,0,0,0,0,0,35845,35845,0,0,0,0,0,37089,37089,72934
23011,Sri Lanka,2007,2007Sri Lanka,0,0,0,6,0,0,6,0,0,0,7,0,0,7,13
23012,Sri Lanka,2007,2007Sri Lanka,0,0,5,0,0,0,5,0,0,0,32,0,0,32,37
23013,Sri Lanka,2007,2007Sri Lanka,0,0,9,0,0,0,9,0,0,0,9,0,0,9,18
23014,Sri Lanka,2007,2007Sri Lanka,0,7,0,0,0,0,7,0,0,5,7,0,0,12,19
23015,Sri Lanka,2007,2007Sri Lanka,6,8,8,31,0,0,53,8,5,8,99,0,0,120,173
23016,Sri Lanka,2007,2007Sri Lanka,12,9,11,48,0,0,80,13,9,6,175,0,0,203,283
23017,Sri Lanka,2007,2007Sri Lanka,64,120,59,424,143,243,1053,48,158,68,417,49,383,1123,2176
23018,Sri Lanka,2008,2008Sri Lanka,0,0,0,0,0,0,0,0,0,0,0,0,0,0,42013
23019,Sri Lanka,2008,2008Sri Lanka,0,0,0,0,0,0,0,0,0,0,5,0,0,5,25
23020,Sri Lanka,2008,2008Sri Lanka,0,0,0,0,0,0,0,0,0,0,6,0,0,6,6
23021,Sri Lanka,2008,2008Sri Lanka,0,0,0,0,0,0,0,0,0,0,7,0,0,7,7
23022,Sri Lanka,2008,2008Sri Lanka,0,0,0,0,0,0,0,0,0,0,8,0,0,8,16
23023,Sri Lanka,2008,2008Sri Lanka,0,0,0,0,0,0,0,0,0,0,9,0,0,9,9
23024,Sri Lanka,2008,2008Sri Lanka,0,0,0,0,0,0,0,0,0,0,79,0,0,79,79
23025,Sri Lanka,2008,2008Sri Lanka,0,0,0,0,0,18,18,0,0,0,0,0,69,69,87
23026,Sri Lanka,2008,2008Sri Lanka,0,0,0,0,0,6411,6411,0,0,0,0,0,11691,11691,18102
23027,Sri Lanka,2008,2008Sri Lanka,0,0,0,0,0,35901,35901,0,0,0,0,0,37385,37385,73286
23028,Sri Lanka,2008,2008Sri Lanka,0,0,0,6,0,0,6,0,0,0,7,0,0,7,13
23029,Sri Lanka,2008,2008Sri Lanka,0,0,9,0,0,0,9,0,0,0,8,0,0,8,17
23030,Sri Lanka,2008,2008Sri Lanka,0,5,0,0,0,0,5,0,0,0,0,0,0,0,5
23031,Sri Lanka,2008,2008Sri Lanka,5,0,0,5,0,0,10,5,0,0,14,0,0,19,29
23032,Sri Lanka,2008,2008Sri Lanka,11,19,13,64,0,0,107,13,13,10,209,0,0,245,352
23033,Sri Lanka,2008,2008Sri Lanka,27,28,27,171,8,0,261,33,30,23,880,5,0,971,1232
23034,Sri Lanka,2008,2008Sri Lanka,49,109,58,437,145,312,1110,47,140,70,578,49,470,1354,2464
23035,Sri Lanka,2009,2009Sri Lanka,0,0,0,0,0,0,0,0,0,0,0,0,0,0,54753
23036,Sri Lanka,2009,2009Sri Lanka,0,0,0,0,0,0,0,0,0,0,5,0,0,5,35
23037,Sri Lanka,2009,2009Sri Lanka,0,0,0,0,0,0,0,0,0,0,8,0,0,8,8
23038,Sri Lanka,2009,2009Sri Lanka,0,0,0,0,0,0,0,0,0,0,11,0,0,11,11
23039,Sri Lanka,2009,2009Sri Lanka,0,0,0,0,0,41,41,0,0,0,0,0,119,119,160
23040,Sri Lanka,2009,2009Sri Lanka,0,0,0,0,0,35634,35634,0,0,0,0,0,37249,37249,72883
23041,Sri Lanka,2009,2009Sri Lanka,0,0,0,6,0,0,6,0,0,0,10,0,0,10,16
23042,Sri Lanka,2009,2009Sri Lanka,0,0,0,6,0,0,6,0,0,0,17,0,0,17,23
23043,Sri Lanka,2009,2009Sri Lanka,0,0,0,8,0,0,8,0,0,7,106,0,0,113,121
23044,Sri Lanka,2009,2009Sri Lanka,0,0,0,12,0,0,12,0,0,0,17,0,0,17,29
23045,Sri Lanka,2009,2009Sri Lanka,0,0,5,0,0,0,5,0,0,0,0,0,0,0,5
23046,Sri Lanka,2009,2009Sri Lanka,0,5,0,0,0,0,5,0,0,0,0,0,0,0,5
23047,Sri Lanka,2009,2009Sri Lanka,0,6,0,0,0,0,6,0,0,0,13,0,0,13,19
23048,Sri Lanka,2009,2009Sri Lanka,0,9,0,0,0,0,9,0,0,8,0,0,0,8,17
23049,Sri Lanka,2009,2009Sri Lanka,15,25,13,84,0,0,137,17,22,19,215,0,0,273,410
23050,Sri Lanka,2009,2009Sri Lanka,44,292,316,3267,474,0,4393,51,317,338,6483,666,0,7855,12248
23051,Sri Lanka,2009,2009Sri Lanka,47,59,33,302,15,0,456,43,43,35,1544,11,0,1676,2132
23052,Sri Lanka,2009,2009Sri Lanka,52,91,61,465,157,367,1193,49,117,76,793,60,548,1643,2836
23053,Sri Lanka,2010,2010Sri Lanka,0,0,0,0,0,0,0,0,0,0,0,0,0,0,30629
23054,Sri Lanka,2010,2010Sri Lanka,0,0,0,0,0,0,0,0,0,0,0,0,7,7,7
23055,Sri Lanka,2010,2010Sri Lanka,0,0,0,0,0,0,0,0,0,0,5,0,0,5,20
23056,Sri Lanka,2010,2010Sri Lanka,0,0,0,0,0,0,0,0,0,0,7,0,0,7,7
23057,Sri Lanka,2010,2010Sri Lanka,0,0,0,0,0,0,0,0,0,0,8,0,0,8,16
23058,Sri Lanka,2010,2010Sri Lanka,0,0,0,0,0,5,5,0,0,0,0,0,6,6,11
23059,Sri Lanka,2010,2010Sri Lanka,0,0,0,0,0,54,54,0,0,0,0,0,158,158,212
23060,Sri Lanka,2010,2010Sri Lanka,0,0,0,0,0,7531,7531,0,0,0,0,0,14302,14302,21833
23061,Sri Lanka,2010,2010Sri Lanka,0,0,0,0,0,34358,34358,0,0,0,0,0,35640,35640,69998
23062,Sri Lanka,2010,2010Sri Lanka,0,0,0,5,0,0,5,0,0,0,36,0,0,36,41
23063,Sri Lanka,2010,2010Sri Lanka,0,0,0,6,0,0,6,0,0,0,9,0,0,9,15
23064,Sri Lanka,2010,2010Sri Lanka,0,0,0,6,0,0,6,0,0,0,10,0,0,10,16
23065,Sri Lanka,2010,2010Sri Lanka,0,0,9,0,0,0,9,0,5,0,16,0,0,21,30
23066,Sri Lanka,2010,2010Sri Lanka,0,6,0,5,0,0,11,0,0,7,9,0,0,16,27
23067,Sri Lanka,2010,2010Sri Lanka,0,10,5,18,0,0,33,10,5,0,185,0,0,200,233
23068,Sri Lanka,2010,2010Sri Lanka,5,0,0,0,0,0,5,0,0,0,0,0,0,0,10
23069,Sri Lanka,2010,2010Sri Lanka,17,19,11,79,0,0,126,18,17,16,173,0,0,224,350
23070,Sri Lanka,2010,2010Sri Lanka,46,249,287,3150,518,0,4250,52,254,316,6419,766,0,7807,12057
23071,Sri Lanka,2010,2010Sri Lanka,48,85,72,468,167,430,1270,52,104,96,1029,70,654,2005,3275
23072,Sri Lanka,2010,2010Sri Lanka,57,70,36,346,18,0,527,50,56,36,1591,17,0,1750,2277
23073,Sri Lanka,2011,2011Sri Lanka,0,0,0,0,0,0,0,0,0,0,0,0,0,0,12411
23074,Sri Lanka,2011,2011Sri Lanka,0,0,0,0,0,0,0,0,0,0,5,0,0,5,15
23075,Sri Lanka,2011,2011Sri Lanka,0,0,0,0,0,0,0,0,0,0,7,0,0,7,7
23076,Sri Lanka,2011,2011Sri Lanka,0,0,0,0,0,0,0,0,0,0,8,0,0,8,24
23077,Sri Lanka,2011,2011Sri Lanka,0,0,0,0,0,0,0,0,0,0,9,0,0,9,34
23078,Sri Lanka,2011,2011Sri Lanka,0,0,0,0,0,7,7,0,0,0,0,0,13,13,20
23079,Sri Lanka,2011,2011Sri Lanka,0,0,0,0,0,78,78,0,0,0,0,0,186,186,264
23080,Sri Lanka,2011,2011Sri Lanka,0,0,0,0,0,7724,7724,0,0,0,0,0,14995,14995,22719
23081,Sri Lanka,2011,2011Sri Lanka,0,0,0,0,0,33549,33549,0,0,0,0,0,34603,34603,68152
23082,Sri Lanka,2011,2011Sri Lanka,0,0,0,5,0,0,5,0,0,0,36,0,0,36,61
23083,Sri Lanka,2011,2011Sri Lanka,0,0,0,6,0,0,6,0,0,0,9,0,0,9,15
23084,Sri Lanka,2011,2011Sri Lanka,0,0,0,6,0,0,6,0,0,0,10,0,0,10,16
23085,Sri Lanka,2011,2011Sri Lanka,0,0,5,0,0,0,5,0,0,0,15,0,0,15,20
23086,Sri Lanka,2011,2011Sri Lanka,0,5,0,0,0,0,5,0,0,0,0,0,0,0,5
23087,Sri Lanka,2011,2011Sri Lanka,0,11,5,25,0,0,41,0,13,0,165,0,0,178,219
23088,Sri Lanka,2011,2011Sri Lanka,5,0,0,0,0,0,5,0,0,0,0,0,0,0,5
23089,Sri Lanka,2011,2011Sri Lanka,9,0,0,7,0,0,16,5,0,0,11,0,0,16,32
23090,Sri Lanka,2011,2011Sri Lanka,12,19,5,65,0,0,101,11,18,12,124,0,0,165,266
23091,Sri Lanka,2011,2011Sri Lanka,17,51,37,237,62,0,404,26,48,40,553,35,0,702,15174
23092,Sri Lanka,2011,2011Sri Lanka,38,219,274,2935,576,0,4042,44,233,300,6253,852,0,7682,11724
23093,Sri Lanka,2011,2011Sri Lanka,47,68,54,415,163,454,1201,48,84,83,984,63,662,1924,3125
23094,Sri Lanka,2011,2011Sri Lanka,51,80,38,362,23,0,554,48,71,33,1565,18,0,1735,2294
23095,Sri Lanka,2012,2012Sri Lanka,0,0,0,0,0,0,0,0,0,0,0,0,0,0,10773
23096,Sri Lanka,2012,2012Sri Lanka,0,0,0,0,0,0,0,0,0,0,0,0,8,8,8
23097,Sri Lanka,2012,2012Sri Lanka,0,0,0,0,0,0,0,0,0,0,5,0,0,5,30
23098,Sri Lanka,2012,2012Sri Lanka,0,0,0,0,0,0,0,0,0,0,7,0,0,7,24
23099,Sri Lanka,2012,2012Sri Lanka,0,0,0,0,0,0,0,0,0,0,8,0,0,8,8
23100,Sri Lanka,2012,2012Sri Lanka,0,0,0,0,0,0,0,0,0,0,9,0,0,9,43
23101,Sri Lanka,2012,2012Sri Lanka,0,0,0,0,0,5,5,0,0,0,0,0,9,9,14
23102,Sri Lanka,2012,2012Sri Lanka,0,0,0,0,0,10,10,0,0,0,0,0,19,19,29
23103,Sri Lanka,2012,2012Sri Lanka,0,0,0,0,0,90,90,0,0,0,0,0,212,212,302
23104,Sri Lanka,2012,2012Sri Lanka,0,0,0,0,0,7897,7897,0,0,0,0,0,15328,15328,23225
23105,Sri Lanka,2012,2012Sri Lanka,0,0,0,0,0,33206,33206,0,0,0,0,0,33959,33959,67165
23106,Sri Lanka,2012,2012Sri Lanka,0,0,0,5,0,0,5,0,0,0,6,0,0,6,11
23107,Sri Lanka,2012,2012Sri Lanka,0,0,0,5,0,0,5,0,0,0,14,0,0,14,19
23108,Sri Lanka,2012,2012Sri Lanka,0,0,0,6,0,0,6,0,0,0,9,0,0,9,30
23109,Sri Lanka,2012,2012Sri Lanka,0,0,0,9,0,0,9,0,0,0,30,0,0,30,39
23110,Sri Lanka,2012,2012Sri Lanka,0,5,0,0,0,0,5,0,0,0,0,0,0,0,5
23111,Sri Lanka,2012,2012Sri Lanka,0,11,6,52,10,0,79,7,8,10,267,0,0,292,13705
23112,Sri Lanka,2012,2012Sri Lanka,5,0,0,0,0,0,5,0,0,0,0,0,0,0,5
23113,Sri Lanka,2012,2012Sri Lanka,6,0,0,7,0,0,13,5,0,0,11,0,0,16,29
23114,Sri Lanka,2012,2012Sri Lanka,6,0,30,5,0,0,41,5,0,168,5,0,0,178,219
23115,Sri Lanka,2012,2012Sri Lanka,13,13,5,56,0,0,87,8,24,11,95,0,0,138,225
23116,Sri Lanka,2012,2012Sri Lanka,41,73,57,396,163,505,1235,52,76,80,900,59,715,1882,3117
23117,Sri Lanka,2012,2012Sri Lanka,44,204,280,2843,639,0,4010,51,221,313,6133,944,0,7662,11672
23118,Sri Lanka,2012,2012Sri Lanka,51,76,46,352,24,0,549,46,77,34,1296,16,0,1469,2023
23119,Sri Lanka,2013,2013Sri Lanka,0,0,0,0,0,0,0,0,0,0,0,0,0,0,11358
23120,Sri Lanka,2013,2013Sri Lanka,0,0,0,0,0,0,0,0,0,0,5,0,0,5,20
23121,Sri Lanka,2013,2013Sri Lanka,0,0,0,0,0,0,0,0,0,0,6,0,0,6,6
23122,Sri Lanka,2013,2013Sri Lanka,0,0,0,0,0,0,0,0,0,0,7,0,0,7,7
23123,Sri Lanka,2013,2013Sri Lanka,0,0,0,0,0,0,0,0,0,0,8,0,0,8,8
23124,Sri Lanka,2013,2013Sri Lanka,0,0,0,0,0,0,0,0,0,0,13,0,0,13,13
23125,Sri Lanka,2013,2013Sri Lanka,0,0,0,0,0,10,10,0,0,0,0,0,26,26,36
23126,Sri Lanka,2013,2013Sri Lanka,0,0,0,0,0,90,90,0,0,0,0,0,212,212,313
23127,Sri Lanka,2013,2013Sri Lanka,0,0,0,0,0,7923,7923,0,0,0,0,0,15839,15839,23762
23128,Sri Lanka,2013,2013Sri Lanka,0,0,0,0,0,32772,32772,0,0,0,0,0,32902,32902,65674
23129,Sri Lanka,2013,2013Sri Lanka,0,0,0,5,0,0,5,0,0,0,6,0,0,6,11
23130,Sri Lanka,2013,2013Sri Lanka,0,0,0,5,0,0,5,0,0,0,10,0,0,10,15
23131,Sri Lanka,2013,2013Sri Lanka,0,0,0,5,0,0,5,0,0,0,14,0,0,14,19
23132,Sri Lanka,2013,2013Sri Lanka,0,0,0,6,0,0,6,0,0,0,9,0,0,9,15
23133,Sri Lanka,2013,2013Sri Lanka,0,0,0,6,0,0,6,0,0,0,10,0,0,10,16
23134,Sri Lanka,2013,2013Sri Lanka,0,0,0,8,0,0,8,0,0,0,12,14,0,26,34
23135,Sri Lanka,2013,2013Sri Lanka,0,0,0,10,0,0,10,0,0,0,11,0,0,11,21
23136,Sri Lanka,2013,2013Sri Lanka,0,5,0,0,0,0,5,0,0,0,0,0,0,0,5
23137,Sri Lanka,2013,2013Sri Lanka,0,6,0,6,0,0,12,0,5,0,13,0,0,18,30
23138,Sri Lanka,2013,2013Sri Lanka,5,24,0,33,0,0,62,0,12,17,195,0,0,224,286
23139,Sri Lanka,2013,2013Sri Lanka,8,23,16,104,5,0,156,8,19,22,228,5,0,282,12326
23140,Sri Lanka,2013,2013Sri Lanka,9,9,0,30,0,0,48,7,20,9,63,0,0,99,147
23141,Sri Lanka,2013,2013Sri Lanka,35,114,90,626,204,0,1069,37,124,125,2573,149,0,3008,4077
23142,Sri Lanka,2013,2013Sri Lanka,44,71,51,401,154,529,1250,53,68,76,798,55,765,1815,3065
23143,Sri Lanka,2013,2013Sri Lanka,46,75,46,332,27,0,526,42,71,27,1124,20,0,1284,1810
23144,Sri Lanka,2014,2014Sri Lanka,0,0,0,0,0,0,0,0,0,0,0,0,0,0,12158
23145,Sri Lanka,2014,2014Sri Lanka,0,0,0,0,0,0,0,0,0,0,5,0,0,5,10
23146,Sri Lanka,2014,2014Sri Lanka,0,0,0,0,0,0,0,0,0,0,7,0,0,7,7
23147,Sri Lanka,2014,2014Sri Lanka,0,0,0,0,0,0,0,0,0,0,17,0,0,17,17
23148,Sri Lanka,2014,2014Sri Lanka,0,0,0,0,0,0,0,0,0,5,0,0,0,5,5
23149,Sri Lanka,2014,2014Sri Lanka,0,0,0,0,0,6,6,0,0,0,0,0,9,9,15
23150,Sri Lanka,2014,2014Sri Lanka,0,0,0,0,0,13,13,0,0,0,0,0,30,30,43
23151,Sri Lanka,2014,2014Sri Lanka,0,0,0,0,0,7920,7920,0,0,0,0,0,16046,16046,23966
23152,Sri Lanka,2014,2014Sri Lanka,0,0,0,0,0,32459,32459,0,0,0,0,0,32598,32598,65057
23153,Sri Lanka,2014,2014Sri Lanka,0,0,0,5,0,0,5,0,0,0,0,0,0,0,5
23154,Sri Lanka,2014,2014Sri Lanka,0,0,0,5,0,0,5,0,0,0,8,0,0,8,13
23155,Sri Lanka,2014,2014Sri Lanka,0,0,0,5,0,0,5,0,0,0,9,0,0,9,14
23156,Sri Lanka,2014,2014Sri Lanka,0,0,0,5,0,0,5,0,0,0,10,0,0,10,15
23157,Sri Lanka,2014,2014Sri Lanka,0,0,0,5,0,0,5,0,0,0,11,0,0,11,16
23158,Sri Lanka,2014,2014Sri Lanka,0,0,0,5,0,0,5,0,0,0,14,0,0,14,19
23159,Sri Lanka,2014,2014Sri Lanka,0,0,0,8,0,0,8,0,0,0,10,0,0,10,18
23160,Sri Lanka,2014,2014Sri Lanka,0,0,0,8,0,0,8,0,0,0,12,14,0,26,34
23161,Sri Lanka,2014,2014Sri Lanka,0,5,0,0,0,0,5,0,0,0,0,0,0,0,5
23162,Sri Lanka,2014,2014Sri Lanka,0,5,0,5,0,0,10,0,5,0,11,0,0,16,26
23163,Sri Lanka,2014,2014Sri Lanka,0,8,0,0,0,0,8,0,0,0,0,0,0,0,8
23164,Sri Lanka,2014,2014Sri Lanka,0,9,0,35,5,0,49,0,0,6,169,5,0,180,10745
23165,Sri Lanka,2014,2014Sri Lanka,8,8,5,35,0,0,56,7,18,12,66,0,0,103,159
23166,Sri Lanka,2014,2014Sri Lanka,16,13,7,52,0,0,88,7,14,24,139,0,0,184,272
23167,Sri Lanka,2014,2014Sri Lanka,36,98,76,641,203,0,1054,45,111,96,2581,159,0,2992,4046
23168,Sri Lanka,2014,2014Sri Lanka,43,63,39,301,26,0,472,44,56,20,979,16,0,1115,1587
23169,Sri Lanka,2014,2014Sri Lanka,44,69,42,399,144,688,1386,45,60,78,752,51,1359,2345,3731
23170,Sri Lanka,2015,2015Sri Lanka,0,0,0,0,0,0,0,0,0,0,0,0,0,0,21443
23171,Sri Lanka,2015,2015Sri Lanka,0,0,0,0,0,0,0,0,0,0,0,0,9,9,9
23172,Sri Lanka,2015,2015Sri Lanka,0,0,0,0,0,0,0,0,0,0,0,0,17,17,17
23173,Sri Lanka,2015,2015Sri Lanka,0,0,0,0,0,0,0,0,0,0,5,0,0,5,10
23174,Sri Lanka,2015,2015Sri Lanka,0,0,0,0,0,0,0,0,5,0,8,0,0,13,13
23175,Sri Lanka,2015,2015Sri Lanka,0,0,0,0,0,143,143,0,0,0,0,0,244,244,387
23176,Sri Lanka,2015,2015Sri Lanka,0,0,0,0,0,8004,8004,0,0,0,0,0,16216,16216,24220
23177,Sri Lanka,2015,2015Sri Lanka,0,0,0,0,0,32209,32209,0,0,0,0,0,31999,31999,64208
23178,Sri Lanka,2015,2015Sri Lanka,0,0,0,5,0,0,5,0,0,0,0,0,0,0,5
23179,Sri Lanka,2015,2015Sri Lanka,0,0,0,5,0,0,5,0,0,0,9,0,0,9,28
23180,Sri Lanka,2015,2015Sri Lanka,0,0,0,5,0,0,5,0,0,0,13,0,0,13,18
23181,Sri Lanka,2015,2015Sri Lanka,0,0,0,6,0,0,6,0,0,0,31,0,0,31,37
23182,Sri Lanka,2015,2015Sri Lanka,0,0,0,7,0,0,7,0,0,6,9,0,0,15,22
23183,Sri Lanka,2015,2015Sri Lanka,0,0,0,8,0,0,8,0,0,0,12,0,0,12,20
23184,Sri Lanka,2015,2015Sri Lanka,0,5,0,0,0,0,5,0,0,0,0,0,0,0,5
23185,Sri Lanka,2015,2015Sri Lanka,0,5,0,0,0,0,5,0,0,0,11,0,0,11,16
23186,Sri Lanka,2015,2015Sri Lanka,0,5,0,5,0,0,10,0,5,0,11,0,0,16,26
23187,Sri Lanka,2015,2015Sri Lanka,0,8,0,0,0,0,8,0,0,0,0,0,0,0,8
23188,Sri Lanka,2015,2015Sri Lanka,5,0,0,0,0,0,5,0,0,0,0,0,0,0,10
23189,Sri Lanka,2015,2015Sri Lanka,5,14,0,37,0,0,56,8,15,8,65,0,0,96,152
23190,Sri Lanka,2015,2015Sri Lanka,14,18,13,73,0,0,118,8,20,13,160,0,0,201,319
23191,Sri Lanka,2015,2015Sri Lanka,28,77,64,626,210,0,1005,36,85,83,2537,174,0,2915,3920
23192,Sri Lanka,2015,2015Sri Lanka,35,51,37,291,28,0,442,37,58,21,967,20,0,1103,1545
23193,Sri Lanka,2015,2015Sri Lanka,40,60,42,378,148,579,1247,42,57,72,599,53,536,1359,4989
23194,Sri Lanka,2016,2016Sri Lanka,0,0,0,0,0,0,0,0,0,0,0,0,0,0,13830
23195,Sri Lanka,2016,2016Sri Lanka,0,0,0,0,0,0,0,0,0,0,0,0,5,5,5
23196,Sri Lanka,2016,2016Sri Lanka,0,0,0,0,0,0,0,0,0,0,0,0,8,8,8
23197,Sri Lanka,2016,2016Sri Lanka,0,0,0,0,0,0,0,0,0,0,5,0,0,5,10
23198,Sri Lanka,2016,2016Sri Lanka,0,0,0,0,0,0,0,0,0,0,8,0,0,8,8
23199,Sri Lanka,2016,2016Sri Lanka,0,0,0,0,0,0,0,5,0,0,0,0,0,5,5
23200,Sri Lanka,2016,2016Sri Lanka,0,0,0,0,0,149,149,0,0,0,0,0,245,245,394
23201,Sri Lanka,2016,2016Sri Lanka,0,0,0,0,0,7955,7955,0,0,0,0,0,16371,16371,24326
23202,Sri Lanka,2016,2016Sri Lanka,0,0,0,0,0,31538,31538,0,0,0,0,0,31624,31624,63162
23203,Sri Lanka,2016,2016Sri Lanka,0,0,0,5,0,0,5,0,0,0,0,0,0,0,5
23204,Sri Lanka,2016,2016Sri Lanka,0,0,0,5,0,0,5,0,0,0,5,0,0,5,10
23205,Sri Lanka,2016,2016Sri Lanka,0,0,0,5,0,0,5,0,0,0,7,0,0,7,12
23206,Sri Lanka,2016,2016Sri Lanka,0,0,0,5,0,0,5,0,0,0,13,0,0,13,18
23207,Sri Lanka,2016,2016Sri Lanka,0,0,0,5,0,0,5,0,0,0,14,0,0,14,19
23208,Sri Lanka,2016,2016Sri Lanka,0,0,0,5,0,0,5,0,0,0,15,0,0,15,20
23209,Sri Lanka,2016,2016Sri Lanka,0,0,0,7,0,0,7,0,0,0,16,14,0,30,37
23210,Sri Lanka,2016,2016Sri Lanka,0,0,0,7,0,0,7,0,5,0,10,0,0,15,22
23211,Sri Lanka,2016,2016Sri Lanka,0,0,6,5,0,0,11,0,0,0,14,0,0,14,25
23212,Sri Lanka,2016,2016Sri Lanka,0,7,0,0,0,0,7,0,0,0,0,0,0,0,7
23213,Sri Lanka,2016,2016Sri Lanka,0,8,0,0,0,0,8,0,0,0,0,0,0,0,8
23214,Sri Lanka,2016,2016Sri Lanka,5,0,0,0,0,0,5,0,0,0,0,0,0,0,5
23215,Sri Lanka,2016,2016Sri Lanka,5,6,10,42,5,0,68,0,13,7,95,0,0,115,4648
23216,Sri Lanka,2016,2016Sri Lanka,5,9,5,37,0,0,56,7,16,10,49,0,0,82,138
23217,Sri Lanka,2016,2016Sri Lanka,19,12,22,73,0,0,126,18,26,21,152,0,0,217,343
23218,Sri Lanka,2016,2016Sri Lanka,33,56,50,633,211,0,983,36,74,68,2485,183,0,2846,3829
23219,Sri Lanka,2016,2016Sri Lanka,45,68,37,378,141,1498,2167,50,56,64,656,54,2411,3291,5458
23220,Sri Lanka,2016,2016Sri Lanka,194,48,30,273,0,0,545,187,47,53,283,5,0,575,1120
23221,Sri Lanka,2017,2017Sri Lanka,0,0,0,0,0,0,0,0,0,0,0,0,0,0,18505
23222,Sri Lanka,2017,2017Sri Lanka,0,0,0,0,0,0,0,0,0,0,0,0,8,8,8
23223,Sri Lanka,2017,2017Sri Lanka,0,0,0,0,0,0,0,0,0,0,5,0,0,5,10
23224,Sri Lanka,2017,2017Sri Lanka,0,0,0,0,0,0,0,0,0,0,8,0,0,8,8
23225,Sri Lanka,2017,2017Sri Lanka,0,0,0,0,0,0,0,0,0,0,9,0,0,9,9
23226,Sri Lanka,2017,2017Sri Lanka,0,0,0,0,0,7900,7900,0,0,0,0,0,16210,16210,24110
23227,Sri Lanka,2017,2017Sri Lanka,0,0,0,0,0,31023,31023,0,0,0,0,0,30819,30819,61842
23228,Sri Lanka,2017,2017Sri Lanka,0,0,0,5,0,0,5,0,0,0,0,0,0,0,5
23229,Sri Lanka,2017,2017Sri Lanka,0,0,0,5,0,0,5,0,0,0,10,0,0,10,15
23230,Sri Lanka,2017,2017Sri Lanka,0,0,0,5,0,0,5,0,0,0,10,5,0,15,20
23231,Sri Lanka,2017,2017Sri Lanka,0,0,0,6,0,0,6,0,0,0,23,8,0,31,37
23232,Sri Lanka,2017,2017Sri Lanka,0,0,0,7,0,0,7,0,0,0,13,0,0,13,20
23233,Sri Lanka,2017,2017Sri Lanka,0,0,0,7,0,0,7,0,0,5,8,0,0,13,20
23234,Sri Lanka,2017,2017Sri Lanka,0,0,5,0,0,0,5,0,0,0,9,0,0,9,14
23235,Sri Lanka,2017,2017Sri Lanka,0,0,9,0,0,0,9,0,0,0,12,0,0,12,21
23236,Sri Lanka,2017,2017Sri Lanka,0,7,0,0,0,0,7,0,0,0,0,0,0,0,7
23237,Sri Lanka,2017,2017Sri Lanka,0,8,0,0,0,0,8,0,0,0,0,0,0,0,8
23238,Sri Lanka,2017,2017Sri Lanka,5,0,0,0,0,0,5,0,0,0,0,0,0,0,10
23239,Sri Lanka,2017,2017Sri Lanka,5,9,7,41,0,0,62,7,17,17,53,0,0,94,156
23240,Sri Lanka,2017,2017Sri Lanka,23,27,18,96,0,0,164,18,31,13,163,0,0,225,389
23241,Sri Lanka,2017,2017Sri Lanka,25,44,28,218,21,0,336,28,47,23,525,15,0,638,974
23242,Sri Lanka,2017,2017Sri Lanka,37,57,45,672,226,0,1037,42,68,63,2445,208,0,2826,3863
23243,Sri Lanka,2017,2017Sri Lanka,45,62,42,357,137,2553,3196,36,54,57,581,50,1607,2385,5581
23244,Sri Lanka,2018,2018Sri Lanka,0,0,0,0,0,0,0,0,0,0,0,0,0,0,75156
23245,Sri Lanka,2018,2018Sri Lanka,0,0,0,0,0,0,0,0,0,0,5,0,0,5,18
23246,Sri Lanka,2018,2018Sri Lanka,0,0,0,0,0,0,0,0,0,0,8,0,0,8,8
23247,Sri Lanka,2018,2018Sri Lanka,0,0,0,0,0,0,0,0,0,0,9,0,0,9,9
23248,Sri Lanka,2018,2018Sri Lanka,0,0,0,0,0,0,0,5,0,0,0,0,0,5,5
23249,Sri Lanka,2018,2018Sri Lanka,0,0,0,0,0,9,9,0,0,0,0,0,12,12,21
23250,Sri Lanka,2018,2018Sri Lanka,0,0,0,0,0,1726,1726,0,0,0,0,0,2657,2657,5744
23251,Sri Lanka,2018,2018Sri Lanka,0,0,0,0,0,7833,7833,0,0,0,0,0,16085,16085,23918
23252,Sri Lanka,2018,2018Sri Lanka,0,0,0,5,0,0,5,0,0,0,10,0,0,10,15
23253,Sri Lanka,2018,2018Sri Lanka,0,0,0,5,0,0,5,0,0,0,11,5,0,16,21
23254,Sri Lanka,2018,2018Sri Lanka,0,0,0,6,0,0,6,0,0,0,20,10,0,30,36
23255,Sri Lanka,2018,2018Sri Lanka,0,0,0,7,0,0,7,0,0,0,0,0,0,0,7
23256,Sri Lanka,2018,2018Sri Lanka,0,0,0,7,0,0,7,0,0,0,13,0,0,13,20
23257,Sri Lanka,2018,2018Sri Lanka,0,0,0,7,0,0,7,0,0,5,8,0,0,13,20
23258,Sri Lanka,2018,2018Sri Lanka,0,0,7,0,0,0,7,0,0,0,0,0,0,0,7
23259,Sri Lanka,2018,2018Sri Lanka,0,0,8,0,0,0,8,0,0,0,0,0,0,0,8
23260,Sri Lanka,2018,2018Sri Lanka,5,0,0,0,0,0,5,0,0,0,0,0,0,0,10
23261,Sri Lanka,2018,2018Sri Lanka,5,7,6,36,0,0,54,5,15,18,45,0,0,83,137
23262,Sri Lanka,2018,2018Sri Lanka,5,21,19,121,5,0,171,6,24,22,187,5,0,244,3624
23263,Sri Lanka,2018,2018Sri Lanka,24,32,17,103,5,0,181,25,24,23,156,0,0,228,409
23264,Sri Lanka,2018,2018Sri Lanka,25,43,25,209,20,0,322,30,41,25,509,15,0,620,942
23265,Sri Lanka,2018,2018Sri Lanka,35,56,45,671,238,0,1045,41,75,57,2368,234,0,2775,3820
23266,Sri Lanka,2019,2019Sri Lanka,0,0,0,0,0,0,0,0,0,0,0,0,0,0,15940
23267,Sri Lanka,2019,2019Sri Lanka,0,0,0,0,0,0,0,0,0,0,0,0,7,7,7
23268,Sri Lanka,2019,2019Sri Lanka,0,0,0,0,0,0,0,0,0,0,5,0,0,5,5
23269,Sri Lanka,2019,2019Sri Lanka,0,0,0,0,0,0,0,0,0,0,8,0,0,8,8
23270,Sri Lanka,2019,2019Sri Lanka,0,0,0,0,0,0,0,0,0,0,9,0,0,9,9
23271,Sri Lanka,2019,2019Sri Lanka,0,0,0,0,0,0,0,0,0,0,10,0,0,10,10
23272,Sri Lanka,2019,2019Sri Lanka,0,0,0,0,0,7813,7813,0,0,0,0,0,16008,16008,23821
23273,Sri Lanka,2019,2019Sri Lanka,0,0,0,0,0,30012,30012,0,0,0,0,0,29416,29416,59428
23274,Sri Lanka,2019,2019Sri Lanka,0,0,0,5,0,0,5,0,0,0,11,5,0,16,21
23275,Sri Lanka,2019,2019Sri Lanka,0,0,0,5,0,0,5,0,0,0,12,0,0,12,17
23276,Sri Lanka,2019,2019Sri Lanka,0,0,0,6,0,0,6,0,0,0,18,12,0,30,36
23277,Sri Lanka,2019,2019Sri Lanka,0,0,0,7,0,0,7,0,0,0,13,0,0,13,20
23278,Sri Lanka,2019,2019Sri Lanka,0,0,0,7,0,0,7,0,0,5,8,0,0,13,20
23279,Sri Lanka,2019,2019Sri Lanka,0,0,0,8,0,0,8,0,0,0,0,0,0,0,8
23280,Sri Lanka,2019,2019Sri Lanka,0,5,0,0,0,0,5,0,0,0,0,0,0,0,10
23281,Sri Lanka,2019,2019Sri Lanka,0,6,5,10,0,0,21,0,0,8,44,0,0,52,73
23282,Sri Lanka,2019,2019Sri Lanka,0,10,7,35,0,0,52,5,8,23,43,0,0,79,131
23283,Sri Lanka,2019,2019Sri Lanka,5,0,0,0,0,0,5,0,0,0,0,0,0,0,5
23284,Sri Lanka,2019,2019Sri Lanka,23,34,12,106,5,0,180,18,27,24,148,0,0,217,397
23285,Sri Lanka,2019,2019Sri Lanka,23,43,26,196,21,0,309,27,36,28,441,16,0,548,857
23286,Sri Lanka,2019,2019Sri Lanka,30,61,42,656,243,0,1032,48,71,53,2233,262,0,2667,3699
23287,Sri Lanka,2019,2019Sri Lanka,34,62,39,342,134,0,611,27,47,53,510,54,0,691,5819
23288,Sri Lanka,2020,2020Sri Lanka,0,0,0,0,0,0,0,0,0,0,0,0,0,0,35760
23289,Sri Lanka,2020,2020Sri Lanka,0,0,0,0,0,0,0,0,0,0,0,0,7,7,7
23290,Sri Lanka,2020,2020Sri Lanka,0,0,0,0,0,0,0,0,0,0,5,0,0,5,5
23291,Sri Lanka,2020,2020Sri Lanka,0,0,0,0,0,0,0,0,0,0,8,0,0,8,8
23292,Sri Lanka,2020,2020Sri Lanka,0,0,0,0,0,0,0,0,0,0,9,0,0,9,9
23293,Sri Lanka,2020,2020Sri Lanka,0,0,0,0,0,0,0,0,0,0,10,0,0,10,10
23294,Sri Lanka,2020,2020Sri Lanka,0,0,0,0,0,0,0,0,5,0,0,0,0,5,5
23295,Sri Lanka,2020,2020Sri Lanka,0,0,0,0,0,0,0,9,0,0,0,0,0,9,9
23296,Sri Lanka,2020,2020Sri Lanka,0,0,0,0,0,5,5,0,0,0,0,0,0,0,5
23297,Sri Lanka,2020,2020Sri Lanka,0,0,0,0,0,5,5,0,0,0,0,0,6,6,11
23298,Sri Lanka,2020,2020Sri Lanka,0,0,0,0,0,8,8,0,0,0,0,0,0,0,8
23299,Sri Lanka,2020,2020Sri Lanka,0,0,0,0,0,124,124,0,0,0,0,0,180,180,304
23300,Sri Lanka,2020,2020Sri Lanka,0,0,0,0,0,29899,29899,0,0,0,0,0,28944,28944,93259
23301,Sri Lanka,2020,2020Sri Lanka,0,0,0,5,0,0,5,0,0,0,13,0,0,13,18
23302,Sri Lanka,2020,2020Sri Lanka,0,0,0,5,0,0,5,0,5,0,0,0,0,5,10
23303,Sri Lanka,2020,2020Sri Lanka,0,0,0,6,0,0,6,0,0,0,15,0,0,15,21
23304,Sri Lanka,2020,2020Sri Lanka,0,0,0,6,0,0,6,0,0,0,18,12,0,30,36
23305,Sri Lanka,2020,2020Sri Lanka,0,0,0,7,0,0,7,0,0,0,0,0,0,0,7
23306,Sri Lanka,2020,2020Sri Lanka,0,0,0,7,0,0,7,0,0,5,7,0,0,12,19
23307,Sri Lanka,2020,2020Sri Lanka,0,0,0,20,0,39,59,8,0,0,162,0,47,217,2065
23308,Sri Lanka,2020,2020Sri Lanka,0,5,0,0,0,0,5,0,0,0,0,0,0,0,10
23309,Sri Lanka,2020,2020Sri Lanka,0,6,8,20,0,0,34,0,7,8,53,0,0,68,102
23310,Sri Lanka,2020,2020Sri Lanka,0,8,7,35,0,0,50,5,7,19,38,0,0,69,119
23311,Sri Lanka,2020,2020Sri Lanka,5,0,0,0,0,0,5,0,0,0,0,0,0,0,5
23312,Sri Lanka,2020,2020Sri Lanka,5,0,0,0,0,0,5,0,0,0,16,0,0,16,21
23313,Sri Lanka,2020,2020Sri Lanka,19,40,23,189,20,0,291,21,42,27,396,17,0,503,794
23314,Sri Lanka,2020,2020Sri Lanka,21,33,20,101,5,0,180,15,33,21,146,0,0,215,395
23315,Sri Lanka,2020,2020Sri Lanka,29,68,45,631,241,0,1014,48,78,52,2138,296,0,2612,3626
23316,Sri Lanka,2020,2020Sri Lanka,35,59,47,331,132,0,604,27,44,52,496,63,0,682,6016
23317,Sri Lanka,2021,2021Sri Lanka,0,0,0,0,0,0,0,0,0,0,0,0,0,0,44959
23318,Sri Lanka,2021,2021Sri Lanka,0,0,0,0,0,0,0,0,0,0,0,0,7,7,7
23319,Sri Lanka,2021,2021Sri Lanka,0,0,0,0,0,0,0,0,0,0,0,0,8,8,8
23320,Sri Lanka,2021,2021Sri Lanka,0,0,0,0,0,0,0,0,0,0,6,0,0,6,6
23321,Sri Lanka,2021,2021Sri Lanka,0,0,0,0,0,0,0,0,0,0,7,0,0,7,7
23322,Sri Lanka,2021,2021Sri Lanka,0,0,0,0,0,0,0,0,0,0,9,0,0,9,9
23323,Sri Lanka,2021,2021Sri Lanka,0,0,0,0,0,30092,30092,0,0,0,0,0,28556,28556,92431
23324,Sri Lanka,2021,2021Sri Lanka,0,0,0,5,0,0,5,0,0,0,5,0,0,5,10
23325,Sri Lanka,2021,2021Sri Lanka,0,0,0,5,0,0,5,0,0,0,13,0,0,13,18
23326,Sri Lanka,2021,2021Sri Lanka,0,0,0,5,0,0,5,0,0,0,15,0,0,15,20
23327,Sri Lanka,2021,2021Sri Lanka,0,0,0,5,0,0,5,5,0,0,0,0,0,5,10
23328,Sri Lanka,2021,2021Sri Lanka,0,0,0,6,0,0,6,0,0,0,18,12,0,30,36
23329,Sri Lanka,2021,2021Sri Lanka,0,0,0,6,0,0,6,0,6,0,6,0,0,12,18
23330,Sri Lanka,2021,2021Sri Lanka,0,0,0,7,0,0,7,0,0,5,7,0,0,12,19
23331,Sri Lanka,2021,2021Sri Lanka,0,0,0,8,0,0,8,0,0,0,17,0,0,17,25
23332,Sri Lanka,2021,2021Sri Lanka,0,0,0,9,0,0,9,0,0,0,0,0,0,0,9
23333,Sri Lanka,2021,2021Sri Lanka,0,0,5,0,0,0,5,0,0,0,0,0,0,0,5
23334,Sri Lanka,2021,2021Sri Lanka,0,0,5,5,0,0,10,0,0,5,5,0,0,10,20
23335,Sri Lanka,2021,2021Sri Lanka,0,5,0,0,0,0,5,0,0,0,0,0,0,0,5
23336,Sri Lanka,2021,2021Sri Lanka,0,7,7,29,0,0,43,0,7,17,39,0,0,63,106
23337,Sri Lanka,2021,2021Sri Lanka,5,0,6,12,0,0,23,0,5,5,44,0,0,54,77
23338,Sri Lanka,2021,2021Sri Lanka,5,13,11,90,19,39,177,10,15,15,665,7,47,759,2455
23339,Sri Lanka,2021,2021Sri Lanka,17,39,28,191,22,0,297,17,43,25,393,20,0,498,795
23340,Sri Lanka,2021,2021Sri Lanka,21,29,25,106,5,0,186,14,37,23,147,0,0,221,407
23341,Sri Lanka,2021,2021Sri Lanka,29,72,49,618,253,0,1021,45,85,53,2059,328,0,2570,3591
23342,Sri Lanka,2021,2021Sri Lanka,33,48,50,312,112,0,555,24,40,47,472,60,0,643,6059
23343,Stateless,2001,2001Stateless,0,0,0,0,0,0,0,0,0,0,0,0,0,0,6077
23344,Stateless,2001,2001Stateless,0,0,0,0,0,0,0,0,0,0,5,0,0,5,10
23345,Stateless,2001,2001Stateless,0,0,0,0,0,0,0,0,0,0,21,0,0,21,21
23346,Stateless,2001,2001Stateless,0,0,0,0,0,21,21,0,0,0,0,0,32,32,60
23347,Stateless,2001,2001Stateless,0,0,0,0,0,250,250,0,0,0,0,0,488,488,738
23348,Stateless,2001,2001Stateless,0,0,0,0,90,0,90,0,0,0,0,40,0,40,130
23349,Stateless,2001,2001Stateless,0,0,0,5,0,0,5,0,8,0,0,0,0,8,13
23350,Stateless,2001,2001Stateless,0,8,7,32,5,0,52,8,6,6,36,0,0,56,108
23351,Stateless,2002,2002Stateless,0,0,0,0,0,0,0,0,0,0,0,0,0,0,14287
23352,Stateless,2002,2002Stateless,0,0,0,0,0,0,0,0,0,0,5,0,0,5,10
23353,Stateless,2002,2002Stateless,0,0,0,0,0,0,0,0,0,0,21,0,0,21,21
23354,Stateless,2002,2002Stateless,0,0,0,0,0,0,0,0,0,5,0,0,0,5,5
23355,Stateless,2002,2002Stateless,0,0,0,0,90,0,90,0,0,0,0,40,0,40,130
23356,Stateless,2002,2002Stateless,0,0,0,8,0,0,8,0,0,9,0,0,0,9,17
23357,Stateless,2002,2002Stateless,0,5,0,0,0,0,5,0,0,0,0,0,0,0,5
23358,Stateless,2003,2003Stateless,0,0,0,0,0,0,0,0,0,0,0,0,0,0,12971
23359,Stateless,2003,2003Stateless,0,0,0,0,0,0,0,0,0,0,5,0,0,5,20
23360,Stateless,2003,2003Stateless,0,0,0,0,0,0,0,0,0,0,21,0,0,21,21
23361,Stateless,2003,2003Stateless,0,0,0,0,0,225,225,0,0,0,0,0,483,483,708
23362,Stateless,2003,2003Stateless,0,0,0,0,90,0,90,0,0,0,0,35,0,35,125
23363,Stateless,2003,2003Stateless,0,0,0,8,0,0,8,0,0,0,9,0,0,9,17
23364,Stateless,2003,2003Stateless,0,5,0,0,0,0,5,0,0,0,0,0,0,0,5
23365,Stateless,2004,2004Stateless,0,0,0,0,0,0,0,0,0,0,0,0,0,0,13670
23366,Stateless,2004,2004Stateless,0,0,0,0,0,0,0,0,0,0,5,0,0,5,15
23367,Stateless,2004,2004Stateless,0,0,0,0,0,0,0,0,0,0,7,0,0,7,7
23368,Stateless,2004,2004Stateless,0,0,0,0,0,0,0,0,7,0,0,0,0,7,7
23369,Stateless,2004,2004Stateless,0,0,7,0,0,0,7,0,0,5,0,0,0,5,12
23370,Stateless,2004,2004Stateless,0,5,5,12,0,0,22,0,0,5,11,0,0,16,38
23371,Stateless,2004,2004Stateless,0,7,6,17,0,16,46,5,6,5,31,0,41,88,134
23372,Stateless,2005,2005Stateless,0,0,0,0,0,0,0,0,0,0,0,0,0,0,12016
23373,Stateless,2005,2005Stateless,0,0,0,0,0,0,0,0,0,0,5,0,0,5,10
23374,Stateless,2005,2005Stateless,0,0,0,0,0,0,0,0,0,0,6,0,0,6,6
23375,Stateless,2005,2005Stateless,0,0,0,0,0,0,0,0,0,0,7,0,0,7,7
23376,Stateless,2005,2005Stateless,0,0,0,0,0,0,0,0,0,0,8,0,0,8,8
23377,Stateless,2005,2005Stateless,0,0,0,5,0,16,21,0,0,0,6,0,41,47,174
23378,Stateless,2005,2005Stateless,0,0,8,7,0,0,15,0,8,0,8,0,0,16,31
23379,Stateless,2005,2005Stateless,0,5,5,5,0,0,15,0,0,8,5,0,0,13,28
23380,Stateless,2006,2006Stateless,0,0,0,0,0,0,0,0,0,0,0,0,0,0,11096
23381,Stateless,2006,2006Stateless,0,0,0,0,0,0,0,0,0,0,5,0,0,5,15
23382,Stateless,2006,2006Stateless,0,0,0,0,0,0,0,0,0,0,7,0,0,7,7
23383,Stateless,2006,2006Stateless,0,0,0,0,0,0,0,0,0,0,8,0,0,8,8
23384,Stateless,2006,2006Stateless,0,0,0,0,0,12,12,0,0,0,0,0,39,39,51
23385,Stateless,2006,2006Stateless,0,0,5,0,0,0,5,0,0,0,0,0,0,0,5
23386,Stateless,2006,2006Stateless,0,0,8,10,0,0,18,0,0,9,9,0,0,18,36
23387,Stateless,2006,2006Stateless,0,0,8,10,0,0,18,0,9,0,10,0,0,19,37
23388,Stateless,2007,2007Stateless,0,0,0,0,0,0,0,0,0,0,0,0,0,0,12961
23389,Stateless,2007,2007Stateless,0,0,0,0,0,0,0,0,0,0,5,0,0,5,10
23390,Stateless,2007,2007Stateless,0,0,0,0,0,0,0,0,0,0,7,0,0,7,7
23391,Stateless,2007,2007Stateless,0,0,0,0,0,5,5,0,0,0,0,0,11,11,16
23392,Stateless,2007,2007Stateless,0,0,0,8,0,0,8,0,6,0,8,0,0,14,22
23393,Stateless,2007,2007Stateless,0,0,5,8,0,0,13,0,0,8,8,0,0,16,29
23394,Stateless,2007,2007Stateless,0,5,0,0,0,0,5,0,0,0,5,0,0,5,10
23395,Stateless,2007,2007Stateless,0,6,6,16,0,9,37,0,6,6,26,0,34,72,109
23396,Stateless,2008,2008Stateless,0,0,0,0,0,0,0,0,0,0,0,0,0,0,13966
23397,Stateless,2008,2008Stateless,0,0,0,0,0,0,0,0,0,0,5,0,0,5,15
23398,Stateless,2008,2008Stateless,0,0,0,0,0,0,0,0,0,0,9,0,0,9,9
23399,Stateless,2008,2008Stateless,0,0,0,7,0,0,7,0,0,0,9,0,0,9,16
23400,Stateless,2008,2008Stateless,0,0,5,0,0,0,5,0,0,0,0,0,0,0,5
23401,Stateless,2008,2008Stateless,0,0,8,14,0,0,22,0,9,0,11,0,0,20,42
23402,Stateless,2008,2008Stateless,5,0,0,11,0,0,16,0,0,5,14,0,0,19,35
23403,Stateless,2008,2008Stateless,7,7,0,18,0,0,32,5,5,5,33,0,0,48,80
23404,Stateless,2009,2009Stateless,0,0,0,0,0,0,0,0,0,0,0,0,0,0,10604
23405,Stateless,2009,2009Stateless,0,0,0,0,0,0,0,0,0,0,5,0,0,5,25
23406,Stateless,2009,2009Stateless,0,0,0,7,0,0,7,0,0,0,0,0,0,0,7
23407,Stateless,2009,2009Stateless,0,0,0,8,0,0,8,0,0,0,12,0,0,12,20
23408,Stateless,2009,2009Stateless,0,0,0,16,0,0,16,0,0,6,15,0,0,21,37
23409,Stateless,2009,2009Stateless,0,5,7,24,0,0,36,0,7,7,19,0,0,33,69
23410,Stateless,2009,2009Stateless,0,8,0,0,0,0,8,0,0,0,0,0,0,0,8
23411,Stateless,2009,2009Stateless,49,177,254,1331,254,0,2065,59,198,261,2207,307,0,3032,5097
23412,Stateless,2010,2010Stateless,0,0,0,0,0,0,0,0,0,0,0,0,0,0,11551
23413,Stateless,2010,2010Stateless,0,0,0,0,0,0,0,0,0,0,0,0,5,5,5
23414,Stateless,2010,2010Stateless,0,0,0,0,0,0,0,0,0,0,5,0,0,5,15
23415,Stateless,2010,2010Stateless,0,0,0,0,0,8,8,0,0,0,0,0,10,10,18
23416,Stateless,2010,2010Stateless,0,0,0,0,0,38,38,0,0,0,0,0,66,66,104
23417,Stateless,2010,2010Stateless,0,0,0,5,0,0,5,0,0,0,0,0,0,0,5
23418,Stateless,2010,2010Stateless,0,0,0,6,0,0,6,0,0,0,0,0,0,0,6
23419,Stateless,2010,2010Stateless,0,0,0,24,0,0,24,0,5,5,12,0,0,22,46
23420,Stateless,2010,2010Stateless,0,0,5,23,0,0,28,0,6,9,18,0,0,33,61
23421,Stateless,2010,2010Stateless,61,152,236,1347,259,0,2055,74,164,257,2236,317,0,3048,5103
23422,Stateless,2011,2011Stateless,0,0,0,0,0,0,0,0,0,0,0,0,0,0,11205
23423,Stateless,2011,2011Stateless,0,0,0,0,0,0,0,0,0,0,0,0,9,9,9
23424,Stateless,2011,2011Stateless,0,0,0,0,0,0,0,0,0,0,5,0,0,5,15
23425,Stateless,2011,2011Stateless,0,0,0,0,0,42,42,0,0,0,6,0,71,77,119
23426,Stateless,2011,2011Stateless,0,0,0,5,0,0,5,0,0,0,0,0,0,0,10
23427,Stateless,2011,2011Stateless,0,0,0,13,0,0,13,0,7,0,0,0,0,7,20
23428,Stateless,2011,2011Stateless,0,5,0,15,0,0,20,0,0,0,20,0,0,20,40
23429,Stateless,2011,2011Stateless,5,0,0,0,0,0,5,0,0,0,0,0,0,0,5
23430,Stateless,2011,2011Stateless,5,10,13,71,13,0,112,8,11,13,104,13,0,149,1737
23431,Stateless,2011,2011Stateless,55,136,241,1329,282,0,2043,49,182,227,2174,335,0,2967,5010
23432,Stateless,2012,2012Stateless,0,0,0,0,0,0,0,0,0,0,0,0,0,0,13909
23433,Stateless,2012,2012Stateless,0,0,0,0,0,0,0,0,0,0,0,0,8,8,8
23434,Stateless,2012,2012Stateless,0,0,0,0,0,0,0,0,0,0,0,5,0,5,5
23435,Stateless,2012,2012Stateless,0,0,0,0,0,0,0,0,0,0,5,0,0,5,10
23436,Stateless,2012,2012Stateless,0,0,0,0,0,0,0,0,0,0,7,0,0,7,14
23437,Stateless,2012,2012Stateless,0,0,0,0,0,8,8,0,0,0,0,0,15,15,23
23438,Stateless,2012,2012Stateless,0,0,0,0,0,36,36,0,0,0,5,0,66,71,107
23439,Stateless,2012,2012Stateless,0,0,0,0,0,59,59,0,0,0,0,0,91,91,150
23440,Stateless,2012,2012Stateless,0,0,0,5,0,0,5,0,0,0,0,0,0,0,5
23441,Stateless,2012,2012Stateless,0,0,0,9,0,0,9,0,0,0,12,0,0,12,21
23442,Stateless,2012,2012Stateless,0,0,5,0,0,0,5,0,8,5,0,0,0,13,18
23443,Stateless,2012,2012Stateless,0,5,0,15,0,0,20,0,0,0,19,0,0,19,39
23444,Stateless,2012,2012Stateless,56,152,245,1426,308,0,2187,64,193,236,2309,370,0,3172,5359
23445,Stateless,2013,2013Stateless,0,0,0,0,0,0,0,0,0,0,0,0,0,0,17341
23446,Stateless,2013,2013Stateless,0,0,0,0,0,0,0,0,0,0,0,0,8,8,8
23447,Stateless,2013,2013Stateless,0,0,0,0,0,0,0,0,0,0,0,5,0,5,5
23448,Stateless,2013,2013Stateless,0,0,0,0,0,0,0,0,0,0,5,0,0,5,5
23449,Stateless,2013,2013Stateless,0,0,0,0,0,0,0,0,0,0,8,0,0,8,8
23450,Stateless,2013,2013Stateless,0,0,0,0,0,0,0,0,0,0,10,0,0,10,10
23451,Stateless,2013,2013Stateless,0,0,0,0,0,0,0,0,6,9,0,0,0,15,15
23452,Stateless,2013,2013Stateless,0,0,0,0,0,55,55,0,0,0,7,0,80,87,142
23453,Stateless,2013,2013Stateless,0,0,0,8,0,0,8,0,0,0,0,0,0,0,8
23454,Stateless,2013,2013Stateless,0,0,0,8,0,0,8,0,7,0,0,0,0,7,1708
23455,Stateless,2013,2013Stateless,0,0,0,13,0,0,13,0,0,0,15,0,0,15,28
23456,Stateless,2013,2013Stateless,21,36,29,217,37,0,340,28,38,41,402,71,0,580,920
23457,Stateless,2014,2014Stateless,0,0,0,0,0,0,0,0,0,0,0,0,0,0,24596
23458,Stateless,2014,2014Stateless,0,0,0,0,0,0,0,0,0,0,0,0,8,8,8
23459,Stateless,2014,2014Stateless,0,0,0,0,0,0,0,0,0,0,5,0,0,5,5
23460,Stateless,2014,2014Stateless,0,0,0,0,0,0,0,0,0,0,8,0,0,8,8
23461,Stateless,2014,2014Stateless,0,0,0,0,0,0,0,0,0,0,10,0,0,10,10
23462,Stateless,2014,2014Stateless,0,0,0,5,0,0,5,0,0,0,5,0,0,5,10
23463,Stateless,2014,2014Stateless,0,0,0,8,0,0,8,0,0,5,11,0,0,16,1583
23464,Stateless,2014,2014Stateless,0,0,0,12,0,0,12,0,0,0,0,0,0,0,12
23465,Stateless,2014,2014Stateless,0,0,5,7,0,0,12,0,5,0,38,0,0,43,55
23466,Stateless,2014,2014Stateless,6,0,8,18,0,0,32,0,13,0,16,0,0,29,61
23467,Stateless,2014,2014Stateless,49,79,59,349,49,0,585,46,97,75,677,79,0,974,1559
23468,Stateless,2015,2015Stateless,0,0,0,0,0,0,0,0,0,0,0,0,0,0,33903
23469,Stateless,2015,2015Stateless,0,0,0,0,0,0,0,0,0,0,5,0,0,5,5
23470,Stateless,2015,2015Stateless,0,0,0,0,0,0,0,0,0,0,6,0,0,6,6
23471,Stateless,2015,2015Stateless,0,0,0,0,0,0,0,0,0,0,7,0,0,7,7
23472,Stateless,2015,2015Stateless,0,0,0,0,0,5,5,0,0,0,0,0,11,11,16
23473,Stateless,2015,2015Stateless,0,0,0,0,0,16,16,0,0,0,0,0,37,37,53
23474,Stateless,2015,2015Stateless,0,0,0,5,0,0,5,0,0,0,5,0,0,5,10
23475,Stateless,2015,2015Stateless,0,0,0,9,0,5,14,0,0,0,0,15,0,15,400
23476,Stateless,2015,2015Stateless,0,0,0,12,0,0,12,0,0,0,0,0,0,0,12
23477,Stateless,2015,2015Stateless,0,5,0,0,0,0,5,0,0,0,0,0,0,0,5
23478,Stateless,2015,2015Stateless,5,0,0,9,0,0,14,0,7,0,37,5,0,49,63
23479,Stateless,2015,2015Stateless,84,151,110,580,64,0,989,89,168,124,1459,106,0,1946,2935
23480,Stateless,2016,2016Stateless,0,0,0,0,0,0,0,0,0,0,0,0,0,0,41308
23481,Stateless,2016,2016Stateless,0,0,0,0,0,0,0,0,0,0,6,0,0,6,6
23482,Stateless,2016,2016Stateless,0,0,0,0,0,0,0,0,0,0,7,0,0,7,7
23483,Stateless,2016,2016Stateless,0,0,0,0,0,16,16,0,0,0,0,0,30,30,46
23484,Stateless,2016,2016Stateless,0,0,0,0,0,16,16,0,0,0,0,0,35,35,51
23485,Stateless,2016,2016Stateless,0,0,0,5,0,0,5,0,0,0,0,0,0,0,5
23486,Stateless,2016,2016Stateless,0,0,0,5,0,0,5,0,0,0,8,0,0,8,13
23487,Stateless,2016,2016Stateless,0,0,0,6,0,0,6,0,0,0,5,0,0,5,11
23488,Stateless,2016,2016Stateless,0,0,5,6,0,128,139,0,0,0,16,0,277,293,432
23489,Stateless,2016,2016Stateless,0,9,0,18,0,0,27,0,9,0,44,5,0,58,85
23490,Stateless,2016,2016Stateless,7,0,0,27,5,0,39,0,0,9,32,8,0,49,163
23491,Stateless,2016,2016Stateless,14,12,13,17,0,0,56,0,0,5,20,0,0,25,81
23492,Stateless,2016,2016Stateless,176,330,209,1319,82,0,2116,206,411,343,3257,146,0,4363,6479
23493,Stateless,2017,2017Stateless,0,0,0,0,0,0,0,0,0,0,0,0,0,0,43855
23494,Stateless,2017,2017Stateless,0,0,0,0,0,0,0,0,0,0,0,5,0,5,5
23495,Stateless,2017,2017Stateless,0,0,0,0,0,0,0,0,0,0,6,0,0,6,6
23496,Stateless,2017,2017Stateless,0,0,0,0,0,0,0,0,0,0,7,0,0,7,7
23497,Stateless,2017,2017Stateless,0,0,0,0,0,16,16,0,0,0,0,0,35,35,51
23498,Stateless,2017,2017Stateless,0,0,0,5,0,0,5,0,0,0,0,0,0,0,5
23499,Stateless,2017,2017Stateless,0,0,0,6,0,0,6,0,0,0,5,0,0,5,11
23500,Stateless,2017,2017Stateless,0,0,0,11,0,334,345,0,0,0,19,0,155,174,519
23501,Stateless,2017,2017Stateless,0,6,7,23,0,0,36,0,6,6,60,5,0,77,113
23502,Stateless,2017,2017Stateless,15,21,20,58,0,0,114,15,25,17,35,0,0,92,206
23503,Stateless,2017,2017Stateless,292,465,308,1815,111,0,2991,257,593,447,4097,189,0,5583,8574
23504,Stateless,2018,2018Stateless,0,0,0,0,0,0,0,0,0,0,0,0,0,0,45182
23505,Stateless,2018,2018Stateless,0,0,0,0,0,0,0,0,0,0,5,0,0,5,5
23506,Stateless,2018,2018Stateless,0,0,0,0,0,0,0,0,0,0,7,0,0,7,7
23507,Stateless,2018,2018Stateless,0,0,0,0,0,0,0,5,0,0,0,0,0,5,5
23508,Stateless,2018,2018Stateless,0,0,0,5,0,0,5,0,0,0,0,0,0,0,5
23509,Stateless,2018,2018Stateless,0,0,0,13,0,162,175,0,5,0,20,0,353,378,553
23510,Stateless,2018,2018Stateless,0,5,0,0,0,0,5,0,0,0,6,0,0,6,11
23511,Stateless,2018,2018Stateless,0,7,8,25,0,0,40,5,5,6,60,6,0,82,122
23512,Stateless,2018,2018Stateless,13,23,23,61,0,0,120,10,13,18,47,0,0,88,208
23513,Stateless,2018,2018Stateless,20,32,25,117,13,0,207,16,34,24,119,17,0,210,417
23514,Stateless,2018,2018Stateless,295,514,364,2006,129,0,3308,301,642,487,4302,210,0,5942,9250
23515,Stateless,2019,2019Stateless,0,0,0,0,0,0,0,0,0,0,0,0,0,0,41439
23516,Stateless,2019,2019Stateless,0,0,0,0,0,0,0,0,0,0,0,5,0,5,5
23517,Stateless,2019,2019Stateless,0,0,0,0,0,0,0,0,0,0,5,0,0,5,10
23518,Stateless,2019,2019Stateless,0,0,0,0,0,0,0,0,0,0,7,0,0,7,7
23519,Stateless,2019,2019Stateless,0,0,0,0,0,0,0,0,0,0,9,0,0,9,9
23520,Stateless,2019,2019Stateless,0,0,0,0,0,14,14,0,0,0,0,0,31,31,45
23521,Stateless,2019,2019Stateless,0,0,0,12,0,0,12,0,0,5,16,0,0,21,600
23522,Stateless,2019,2019Stateless,0,0,5,19,0,0,24,6,0,5,49,5,0,65,89
23523,Stateless,2019,2019Stateless,5,5,0,5,0,0,15,0,8,0,20,0,0,28,43
23524,Stateless,2019,2019Stateless,315,589,471,2217,148,0,3740,345,714,567,4409,238,0,6273,10013
23525,Stateless,2019,2019Stateless,1531,1564,865,3721,139,0,7820,1563,1746,1016,4191,188,0,8704,16524
23526,Stateless,2020,2020Stateless,0,0,0,0,0,0,0,0,0,0,0,0,0,0,41528
23527,Stateless,2020,2020Stateless,0,0,0,0,0,0,0,0,0,0,5,0,0,5,10
23528,Stateless,2020,2020Stateless,0,0,0,0,0,0,0,0,0,0,7,0,0,7,7
23529,Stateless,2020,2020Stateless,0,0,0,0,0,16,16,0,0,0,0,0,31,31,47
23530,Stateless,2020,2020Stateless,0,0,0,0,0,16,16,0,0,0,0,0,53,53,69
23531,Stateless,2020,2020Stateless,0,0,0,0,0,47,47,0,0,0,0,0,64,64,111
23532,Stateless,2020,2020Stateless,0,0,0,0,0,48,48,0,0,0,31,0,40,71,179
23533,Stateless,2020,2020Stateless,0,0,0,0,0,83,83,0,0,0,0,0,221,221,304
23534,Stateless,2020,2020Stateless,0,0,0,5,0,0,5,0,0,0,0,0,0,0,5
23535,Stateless,2020,2020Stateless,0,0,0,11,0,0,11,0,0,5,17,0,0,22,646
23536,Stateless,2020,2020Stateless,0,7,0,23,0,0,30,5,0,5,47,5,0,62,92
23537,Stateless,2020,2020Stateless,5,7,5,9,0,0,26,5,5,5,25,0,0,40,66
23538,Stateless,2020,2020Stateless,344,668,554,2346,157,5,4074,343,726,652,4587,274,5,6587,10661
23539,Stateless,2021,2021Stateless,0,0,0,0,0,0,0,0,0,0,0,0,0,0,43226
23540,Stateless,2021,2021Stateless,0,0,0,0,0,0,0,0,0,0,0,5,0,5,5
23541,Stateless,2021,2021Stateless,0,0,0,0,0,0,0,0,0,0,5,0,0,5,5
23542,Stateless,2021,2021Stateless,0,0,0,0,0,0,0,0,0,0,7,0,0,7,7
23543,Stateless,2021,2021Stateless,0,0,0,0,0,0,0,0,0,0,11,0,0,11,11
23544,Stateless,2021,2021Stateless,0,0,0,0,0,12,12,0,0,0,0,0,35,35,47
23545,Stateless,2021,2021Stateless,0,0,0,0,0,34,34,0,0,0,0,0,41,41,75
23546,Stateless,2021,2021Stateless,0,0,5,9,0,0,14,0,0,5,15,0,0,20,671
23547,Stateless,2021,2021Stateless,0,9,6,28,0,0,43,5,6,7,61,5,0,84,127
23548,Stateless,2021,2021Stateless,5,11,0,8,0,0,24,5,5,5,20,0,0,35,59
23549,Stateless,2021,2021Stateless,5,15,7,36,8,48,119,5,9,5,94,6,40,159,400
23550,Stateless,2021,2021Stateless,361,723,657,2641,178,0,4560,350,786,778,5113,314,0,7341,11901
23551,Sudan,2001,2001Sudan,0,0,0,0,0,0,0,0,0,0,0,0,0,0,44113
23552,Sudan,2001,2001Sudan,0,0,0,0,0,0,0,0,0,0,0,0,14,14,14
23553,Sudan,2001,2001Sudan,0,0,0,0,0,0,0,0,0,0,5,0,0,5,15
23554,Sudan,2001,2001Sudan,0,0,0,0,0,0,0,0,0,0,6,0,0,6,12
23555,Sudan,2001,2001Sudan,0,0,0,0,0,0,0,0,0,0,10,0,0,10,10
23556,Sudan,2001,2001Sudan,0,0,0,0,0,0,0,0,0,0,16,0,0,16,16
23557,Sudan,2001,2001Sudan,0,0,0,0,0,0,0,0,0,0,19,0,0,19,19
23558,Sudan,2001,2001Sudan,0,0,0,0,0,0,0,0,5,0,63,0,0,68,68
23559,Sudan,2001,2001Sudan,0,0,0,0,0,75,75,0,0,0,0,0,208,208,283
23560,Sudan,2001,2001Sudan,0,0,0,0,0,76,76,0,0,0,0,0,109,109,185
23561,Sudan,2001,2001Sudan,0,0,0,5,0,0,5,0,5,0,22,0,0,27,32
23562,Sudan,2001,2001Sudan,0,0,0,9,0,0,9,0,0,0,58,0,0,58,67
23563,Sudan,2001,2001Sudan,0,0,5,0,0,0,5,0,0,0,0,0,0,0,10
23564,Sudan,2001,2001Sudan,0,0,5,5,0,0,10,0,0,5,82,0,0,87,97
23565,Sudan,2001,2001Sudan,0,5,0,0,0,0,5,0,0,0,0,0,0,0,5
23566,Sudan,2001,2001Sudan,0,5,0,0,0,0,5,0,0,0,11,0,0,11,16
23567,Sudan,2001,2001Sudan,0,5,0,0,0,0,5,0,0,5,0,0,0,5,10
23568,Sudan,2001,2001Sudan,0,6,6,29,0,0,41,7,7,0,17,0,0,31,72
23569,Sudan,2001,2001Sudan,0,7,6,18,0,0,31,0,7,6,32,0,0,45,76
23570,Sudan,2001,2001Sudan,0,8,0,0,0,0,8,0,0,0,0,0,0,0,16
23571,Sudan,2001,2001Sudan,5,5,5,27,0,0,42,6,6,6,48,0,0,66,108
23572,Sudan,2001,2001Sudan,8,8,6,12,0,0,34,0,17,14,55,0,0,86,120
23573,Sudan,2001,2001Sudan,20,16,14,95,5,0,150,21,11,10,314,15,0,371,521
23574,Sudan,2001,2001Sudan,59,17,15,92,8,0,191,88,28,24,188,10,0,338,529
23575,Sudan,2001,2001Sudan,302,331,283,1035,38,0,1989,338,393,336,1571,32,0,2670,4659
23576,Sudan,2001,2001Sudan,3000,4146,3553,7712,490,0,18901,3363,5165,4425,8260,480,0,21693,75009
23577,Sudan,2001,2001Sudan,3360,2887,2476,7174,0,0,15897,3586,3809,3266,9787,0,0,20448,36345
23578,Sudan,2001,2001Sudan,5668,4982,4272,11062,597,0,26581,6494,8505,7289,20450,485,0,43223,69804
23579,Sudan,2001,2001Sudan,8477,5617,4808,14801,371,0,34074,8759,7659,6557,16283,341,0,39599,80934
23580,Sudan,2001,2001Sudan,10946,16262,13941,32779,1588,0,75516,12164,19179,16449,31787,1671,0,81250,176766
23581,Sudan,2002,2002Sudan,0,0,0,0,0,0,0,0,0,0,0,0,0,0,36763
23582,Sudan,2002,2002Sudan,0,0,0,0,0,0,0,0,0,0,5,0,0,5,20
23583,Sudan,2002,2002Sudan,0,0,0,0,0,0,0,0,0,0,7,0,0,7,7
23584,Sudan,2002,2002Sudan,0,0,0,0,0,0,0,0,0,0,10,0,0,10,10
23585,Sudan,2002,2002Sudan,0,0,0,0,0,0,0,0,0,5,5,0,0,10,10
23586,Sudan,2002,2002Sudan,0,0,0,0,0,0,0,0,0,6,0,0,0,6,6
23587,Sudan,2002,2002Sudan,0,0,0,0,0,0,0,0,5,0,62,0,0,67,67
23588,Sudan,2002,2002Sudan,0,0,0,0,0,52,52,0,0,0,0,0,66,66,188
23589,Sudan,2002,2002Sudan,0,0,0,0,0,75,75,0,0,0,0,0,217,217,292
23590,Sudan,2002,2002Sudan,0,0,0,5,0,0,5,0,0,0,5,0,0,5,10
23591,Sudan,2002,2002Sudan,0,0,0,5,0,0,5,0,0,0,12,0,0,12,17
23592,Sudan,2002,2002Sudan,0,0,0,5,0,0,5,0,5,0,37,0,0,42,47
23593,Sudan,2002,2002Sudan,0,0,0,5,0,0,5,0,27,23,97,0,0,147,152
23594,Sudan,2002,2002Sudan,0,0,0,8,0,0,8,0,0,0,0,0,0,0,8
23595,Sudan,2002,2002Sudan,0,0,0,9,0,0,9,0,0,0,78,0,0,78,87
23596,Sudan,2002,2002Sudan,0,0,0,10,0,0,10,0,0,0,10,0,0,10,47
23597,Sudan,2002,2002Sudan,0,0,5,0,0,0,5,5,0,0,6,0,0,11,23
23598,Sudan,2002,2002Sudan,0,0,5,5,0,0,10,0,0,5,90,0,0,95,105
23599,Sudan,2002,2002Sudan,0,5,0,0,0,0,5,0,0,0,0,0,0,0,5
23600,Sudan,2002,2002Sudan,0,5,6,30,0,0,41,0,7,7,25,0,0,39,80
23601,Sudan,2002,2002Sudan,0,8,0,0,0,0,8,0,0,8,13,0,0,21,29
23602,Sudan,2002,2002Sudan,0,9,7,17,5,0,38,0,0,8,24,5,0,37,75
23603,Sudan,2002,2002Sudan,12,6,6,28,5,0,57,8,5,5,58,0,0,76,133
23604,Sudan,2002,2002Sudan,33,18,15,129,5,0,200,37,18,16,345,5,0,421,621
23605,Sudan,2002,2002Sudan,52,33,28,98,5,0,216,80,43,36,239,8,0,406,622
23606,Sudan,2002,2002Sudan,477,473,405,1702,42,0,3099,548,556,476,2910,40,0,4530,7629
23607,Sudan,2002,2002Sudan,1015,1431,1228,2563,0,0,6237,953,1213,1040,3280,6,0,6492,12729
23608,Sudan,2002,2002Sudan,3182,4161,3565,7802,499,0,19209,3554,5172,4433,8416,481,0,22056,75781
23609,Sudan,2002,2002Sudan,3495,2982,2557,7371,0,0,16405,3724,3895,3340,9953,58,0,20970,37375
23610,Sudan,2002,2002Sudan,4541,3964,3397,9878,536,0,22316,5172,6564,5626,17676,425,0,35463,57779
23611,Sudan,2002,2002Sudan,10267,6165,5288,16016,392,0,38128,10697,8253,7082,17451,390,0,43873,89952
23612,Sudan,2002,2002Sudan,16094,19468,16685,38056,2061,0,92364,15351,22469,19255,37102,1653,0,95830,188194
23613,Sudan,2003,2003Sudan,0,0,0,0,0,0,0,0,0,0,0,0,0,0,41346
23614,Sudan,2003,2003Sudan,0,0,0,0,0,0,0,0,0,0,5,0,0,5,50
23615,Sudan,2003,2003Sudan,0,0,0,0,0,0,0,0,0,0,7,0,0,7,7
23616,Sudan,2003,2003Sudan,0,0,0,0,0,0,0,0,0,7,0,0,0,7,7
23617,Sudan,2003,2003Sudan,0,0,0,0,0,0,0,0,6,0,29,0,0,35,35
23618,Sudan,2003,2003Sudan,0,0,0,0,0,0,0,5,0,0,0,0,0,5,5
23619,Sudan,2003,2003Sudan,0,0,0,0,0,49,49,0,0,0,0,0,66,66,185
23620,Sudan,2003,2003Sudan,0,0,0,0,0,85,85,0,0,0,0,0,251,251,336
23621,Sudan,2003,2003Sudan,0,0,0,0,0,62700,62700,0,0,0,0,0,47300,47300,110000
23622,Sudan,2003,2003Sudan,0,0,0,5,0,0,5,0,0,0,0,0,0,0,5
23623,Sudan,2003,2003Sudan,0,0,0,5,0,0,5,0,0,0,5,0,0,5,10
23624,Sudan,2003,2003Sudan,0,0,0,5,0,0,5,0,0,0,63,0,0,63,68
23625,Sudan,2003,2003Sudan,0,0,0,5,0,0,5,0,5,0,12,0,0,17,22
23626,Sudan,2003,2003Sudan,0,0,0,5,0,0,5,0,5,0,39,0,0,44,49
23627,Sudan,2003,2003Sudan,0,0,0,5,0,0,5,0,27,23,96,0,0,146,177
23628,Sudan,2003,2003Sudan,0,0,0,8,0,0,8,0,0,0,0,0,0,0,8
23629,Sudan,2003,2003Sudan,0,0,0,11,0,0,11,0,0,0,44,0,0,44,55
23630,Sudan,2003,2003Sudan,0,0,5,9,0,0,14,0,6,10,93,0,0,109,123
23631,Sudan,2003,2003Sudan,0,5,0,0,0,0,5,0,0,0,33,0,0,33,38
23632,Sudan,2003,2003Sudan,0,5,0,0,0,0,5,0,0,5,0,0,0,5,10
23633,Sudan,2003,2003Sudan,0,7,6,13,5,0,31,0,0,8,19,5,0,32,63
23634,Sudan,2003,2003Sudan,0,15,13,56,0,0,84,25,10,9,63,0,0,107,191
23635,Sudan,2003,2003Sudan,5,0,0,0,0,0,5,0,0,0,0,0,0,0,5
23636,Sudan,2003,2003Sudan,12,6,0,30,0,0,48,5,5,6,38,0,0,54,102
23637,Sudan,2003,2003Sudan,40,37,31,80,5,0,193,47,50,42,286,6,0,431,624
23638,Sudan,2003,2003Sudan,46,22,18,140,5,0,231,52,23,19,285,5,0,384,615
23639,Sudan,2003,2003Sudan,765,746,640,2914,63,0,5128,916,868,744,6455,67,0,9050,14178
23640,Sudan,2003,2003Sudan,951,839,715,2701,211,0,5417,880,979,832,2517,237,0,5445,45060
23641,Sudan,2003,2003Sudan,3471,2871,2461,7249,0,0,16052,3710,3801,3260,9656,0,0,20427,36479
23642,Sudan,2003,2003Sudan,3667,4911,4210,11315,473,0,24576,4166,7486,6416,20217,336,0,38621,63197
23643,Sudan,2003,2003Sudan,11377,7191,6156,17092,487,0,42303,11784,9494,8144,18664,437,0,48523,94899
23644,Sudan,2003,2003Sudan,15442,17807,15264,35566,1925,0,86004,16669,21020,18008,35062,1518,0,92277,198281
23645,Sudan,2004,2004Sudan,0,0,0,0,0,0,0,0,0,0,0,0,0,0,51350
23646,Sudan,2004,2004Sudan,0,0,0,0,0,0,0,0,0,0,5,0,0,5,30
23647,Sudan,2004,2004Sudan,0,0,0,0,0,0,0,0,0,0,8,0,0,8,8
23648,Sudan,2004,2004Sudan,0,0,0,0,0,0,0,0,0,0,9,0,0,9,14
23649,Sudan,2004,2004Sudan,0,0,0,0,0,0,0,0,0,5,5,0,0,10,10
23650,Sudan,2004,2004Sudan,0,0,0,0,0,0,0,5,0,0,0,0,0,5,5
23651,Sudan,2004,2004Sudan,0,0,0,5,0,0,5,0,0,0,0,0,0,0,5
23652,Sudan,2004,2004Sudan,0,0,0,5,0,0,5,0,0,0,5,0,0,5,48
23653,Sudan,2004,2004Sudan,0,0,0,5,0,0,5,0,0,0,6,0,0,6,11
23654,Sudan,2004,2004Sudan,0,0,0,5,0,0,5,0,0,0,64,0,0,64,69
23655,Sudan,2004,2004Sudan,0,0,0,6,0,0,6,0,0,0,29,0,0,29,35
23656,Sudan,2004,2004Sudan,0,0,0,6,0,0,6,0,5,0,40,0,0,45,51
23657,Sudan,2004,2004Sudan,0,0,0,6,0,0,6,5,0,0,14,0,0,19,25
23658,Sudan,2004,2004Sudan,0,0,0,7,0,0,7,0,0,0,0,0,0,0,7
23659,Sudan,2004,2004Sudan,0,5,0,0,0,0,5,0,0,5,5,0,0,10,15
23660,Sudan,2004,2004Sudan,0,5,0,0,0,0,5,0,0,6,0,0,0,6,11
23661,Sudan,2004,2004Sudan,5,0,0,0,0,0,5,0,0,0,7,0,0,7,12
23662,Sudan,2004,2004Sudan,6,6,5,10,0,0,27,5,8,7,9,0,0,29,56
23663,Sudan,2004,2004Sudan,8,0,0,15,0,51,74,9,0,0,18,5,63,95,169
23664,Sudan,2004,2004Sudan,10,10,8,52,0,0,80,13,9,7,57,0,0,86,166
23665,Sudan,2004,2004Sudan,12,6,6,9,0,0,33,0,24,26,118,0,0,168,201
23666,Sudan,2004,2004Sudan,13,0,6,20,0,0,39,10,5,6,44,0,0,65,104
23667,Sudan,2004,2004Sudan,24,11,9,71,0,0,115,19,10,9,158,0,0,196,311
23668,Sudan,2004,2004Sudan,36,53,45,91,5,0,230,53,61,53,306,11,0,484,714
23669,Sudan,2004,2004Sudan,898,787,675,2945,57,0,5362,1107,946,810,6633,46,0,9542,14904
23670,Sudan,2004,2004Sudan,1102,936,810,2872,204,0,5924,1032,1115,959,2660,265,0,6031,45226
23671,Sudan,2004,2004Sudan,1398,1674,1436,4940,199,0,9647,1412,1718,1473,4995,225,0,9823,19470
23672,Sudan,2004,2004Sudan,4413,5279,4527,12102,521,0,26842,4949,8121,6961,20272,411,0,40714,67556
23673,Sudan,2004,2004Sudan,11847,7157,6128,16609,563,0,42304,12345,9433,8095,17795,479,0,48147,90451
23674,Sudan,2004,2004Sudan,18671,19120,16395,38093,1915,0,94194,19971,22603,19373,36516,1511,0,99974,214673
23675,Sudan,2004,2004Sudan,23450,22547,19324,44532,5379,0,115232,21555,20270,17375,21951,3586,0,84737,224924
23676,Sudan,2005,2005Sudan,0,0,0,0,0,0,0,0,0,0,0,0,0,0,53028
23677,Sudan,2005,2005Sudan,0,0,0,0,0,0,0,0,0,0,5,0,0,5,20
23678,Sudan,2005,2005Sudan,0,0,0,0,0,0,0,0,0,0,6,0,0,6,6
23679,Sudan,2005,2005Sudan,0,0,0,0,0,0,0,0,0,0,7,0,0,7,21
23680,Sudan,2005,2005Sudan,0,0,0,0,0,0,0,0,0,0,8,0,0,8,58
23681,Sudan,2005,2005Sudan,0,0,0,0,0,0,0,0,0,0,9,0,0,9,17
23682,Sudan,2005,2005Sudan,0,0,0,0,0,0,0,0,5,0,0,0,0,5,5
23683,Sudan,2005,2005Sudan,0,0,0,0,0,0,0,0,5,0,6,0,0,11,11
23684,Sudan,2005,2005Sudan,0,0,0,0,0,0,0,0,5,0,16,0,0,21,29
23685,Sudan,2005,2005Sudan,0,0,0,0,0,0,0,0,6,0,0,0,0,6,6
23686,Sudan,2005,2005Sudan,0,0,0,0,0,0,0,0,7,0,29,0,0,36,36
23687,Sudan,2005,2005Sudan,0,0,0,0,0,5,5,0,0,0,0,0,0,0,5
23688,Sudan,2005,2005Sudan,0,0,0,0,0,141,141,0,0,0,0,0,489,489,630
23689,Sudan,2005,2005Sudan,0,0,0,5,0,0,5,0,0,0,8,0,0,8,13
23690,Sudan,2005,2005Sudan,0,0,0,5,0,0,5,0,5,0,57,0,0,62,67
23691,Sudan,2005,2005Sudan,0,0,0,6,0,0,6,0,5,0,40,0,0,45,51
23692,Sudan,2005,2005Sudan,0,0,0,7,0,0,7,0,0,0,0,0,0,0,7
23693,Sudan,2005,2005Sudan,0,0,5,0,0,0,5,0,0,0,8,0,0,8,13
23694,Sudan,2005,2005Sudan,0,0,5,0,0,0,5,0,0,0,12,0,0,12,17
23695,Sudan,2005,2005Sudan,0,0,6,8,0,0,14,0,0,6,8,0,0,14,28
23696,Sudan,2005,2005Sudan,0,6,5,17,0,0,28,0,7,7,22,0,0,36,64
23697,Sudan,2005,2005Sudan,5,0,0,11,0,53,69,8,0,0,21,0,62,91,160
23698,Sudan,2005,2005Sudan,5,6,0,12,0,0,23,5,0,5,105,0,0,115,138
23699,Sudan,2005,2005Sudan,8,11,10,55,0,0,84,9,11,10,63,0,0,93,177
23700,Sudan,2005,2005Sudan,10,5,0,21,0,0,36,7,5,0,71,0,0,83,119
23701,Sudan,2005,2005Sudan,13,0,6,20,0,0,39,10,5,6,113,0,0,134,173
23702,Sudan,2005,2005Sudan,21,12,10,40,0,0,83,15,11,9,461,0,0,496,579
23703,Sudan,2005,2005Sudan,47,58,50,87,5,0,247,70,59,50,307,15,0,501,748
23704,Sudan,2005,2005Sudan,753,856,739,2845,518,0,5711,926,952,819,2787,528,0,6012,11723
23705,Sudan,2005,2005Sudan,849,682,585,2701,58,0,4875,1067,828,709,5922,45,0,8571,13446
23706,Sudan,2005,2005Sudan,1435,1696,1454,5014,199,0,9798,1447,1753,1503,5234,225,0,10162,19960
23707,Sudan,2005,2005Sudan,4775,6095,5224,14053,640,0,30787,5184,9193,7880,23128,474,0,45859,76646
23708,Sudan,2005,2005Sudan,8626,6369,5461,16160,477,0,37093,9039,7635,6553,13265,0,342,36834,73927
23709,Sudan,2005,2005Sudan,14426,17434,14942,35062,2709,22055,106628,14838,19527,16738,31541,1530,22055,106229,212857
23710,Sudan,2005,2005Sudan,21397,23563,20200,46485,4354,0,115999,20795,21182,18155,23009,3126,0,86267,228836
23711,Sudan,2006,2006Sudan,0,0,0,0,0,0,0,0,0,0,0,0,0,0,67920
23712,Sudan,2006,2006Sudan,0,0,0,0,0,0,0,0,0,0,5,0,0,5,29
23713,Sudan,2006,2006Sudan,0,0,0,0,0,0,0,0,0,0,7,0,0,7,14
23714,Sudan,2006,2006Sudan,0,0,0,0,0,0,0,0,0,0,8,0,0,8,8
23715,Sudan,2006,2006Sudan,0,0,0,0,0,0,0,0,0,0,9,0,0,9,9
23716,Sudan,2006,2006Sudan,0,0,0,0,0,0,0,0,0,0,12,0,0,12,12
23717,Sudan,2006,2006Sudan,0,0,0,0,0,0,0,0,0,5,0,0,0,5,5
23718,Sudan,2006,2006Sudan,0,0,0,0,0,0,0,0,0,5,18,0,0,23,23
23719,Sudan,2006,2006Sudan,0,0,0,0,0,0,0,0,0,7,7,0,0,14,14
23720,Sudan,2006,2006Sudan,0,0,0,0,0,0,0,0,5,0,0,0,0,5,5
23721,Sudan,2006,2006Sudan,0,0,0,0,0,0,0,0,6,0,0,0,0,6,6
23722,Sudan,2006,2006Sudan,0,0,0,0,0,5,5,0,0,0,0,0,0,0,5
23723,Sudan,2006,2006Sudan,0,0,0,0,0,5,5,0,0,0,0,0,59,59,64
23724,Sudan,2006,2006Sudan,0,0,0,0,0,7,7,0,0,0,0,0,20,20,27
23725,Sudan,2006,2006Sudan,0,0,0,0,0,14,14,0,0,0,0,0,35,35,49
23726,Sudan,2006,2006Sudan,0,0,0,0,0,70,70,0,0,0,0,0,95,95,165
23727,Sudan,2006,2006Sudan,0,0,0,0,0,156,156,0,0,0,0,0,643,643,799
23728,Sudan,2006,2006Sudan,0,0,0,5,0,0,5,0,0,0,5,0,0,5,10
23729,Sudan,2006,2006Sudan,0,0,0,5,0,0,5,0,0,0,10,0,0,10,15
23730,Sudan,2006,2006Sudan,0,0,0,5,0,0,5,0,0,5,0,0,0,5,10
23731,Sudan,2006,2006Sudan,0,0,0,7,0,0,7,0,0,0,6,5,0,11,18
23732,Sudan,2006,2006Sudan,0,0,5,0,0,0,5,0,0,0,8,0,0,8,13
23733,Sudan,2006,2006Sudan,0,5,0,5,0,0,10,0,5,0,47,0,0,52,62
23734,Sudan,2006,2006Sudan,0,6,7,9,0,0,22,0,0,5,10,0,0,15,37
23735,Sudan,2006,2006Sudan,5,0,0,0,0,0,5,0,0,0,8,0,0,8,13
23736,Sudan,2006,2006Sudan,6,5,5,17,0,0,33,5,7,6,27,0,0,45,78
23737,Sudan,2006,2006Sudan,6,6,0,13,0,0,25,5,5,0,31,0,0,41,66
23738,Sudan,2006,2006Sudan,7,7,0,10,0,0,24,5,9,0,100,0,0,114,138
23739,Sudan,2006,2006Sudan,11,19,7,66,0,0,103,13,19,6,86,0,0,124,227
23740,Sudan,2006,2006Sudan,13,0,6,30,0,0,49,5,6,6,115,0,0,132,181
23741,Sudan,2006,2006Sudan,23,16,5,38,0,0,82,13,9,11,485,0,0,518,600
23742,Sudan,2006,2006Sudan,48,61,46,87,5,0,247,76,81,28,305,15,0,505,752
23743,Sudan,2006,2006Sudan,486,626,434,1937,71,0,3554,484,675,455,2621,111,0,4346,7900
23744,Sudan,2006,2006Sudan,594,810,462,2587,71,0,4524,670,1011,576,5320,56,0,7633,12157
23745,Sudan,2006,2006Sudan,616,722,0,1290,339,0,2967,498,723,0,1562,431,0,3214,6181
23746,Sudan,2006,2006Sudan,4283,6681,4356,13756,678,0,29754,4635,8132,7711,22285,487,0,43250,73004
23747,Sudan,2006,2006Sudan,6877,8082,3547,14715,438,0,33659,7227,8447,4928,12417,302,0,33321,66980
23748,Sudan,2006,2006Sudan,14522,18944,13597,35812,2801,0,85676,14875,19451,17061,32877,1625,0,85889,215675
23749,Sudan,2006,2006Sudan,20532,33527,15992,51494,4667,0,126212,20739,31145,14721,25341,3367,0,95313,233025
23750,Sudan,2007,2007Sudan,0,0,0,0,0,0,0,0,0,0,0,0,0,0,261171
23751,Sudan,2007,2007Sudan,0,0,0,0,0,0,0,0,0,0,5,0,0,5,20
23752,Sudan,2007,2007Sudan,0,0,0,0,0,0,0,0,0,0,6,0,0,6,6
23753,Sudan,2007,2007Sudan,0,0,0,0,0,0,0,0,0,0,7,0,0,7,7
23754,Sudan,2007,2007Sudan,0,0,0,0,0,0,0,0,0,0,8,0,0,8,24
23755,Sudan,2007,2007Sudan,0,0,0,0,0,0,0,0,0,0,10,0,0,10,10
23756,Sudan,2007,2007Sudan,0,0,0,0,0,0,0,0,0,0,15,0,0,15,15
23757,Sudan,2007,2007Sudan,0,0,0,0,0,0,0,0,0,5,0,0,0,5,5
23758,Sudan,2007,2007Sudan,0,0,0,0,0,0,0,0,0,6,0,0,0,6,6
23759,Sudan,2007,2007Sudan,0,0,0,0,0,5,5,0,0,0,0,0,56,56,61
23760,Sudan,2007,2007Sudan,0,0,0,0,0,11,11,0,0,0,0,0,28,28,39
23761,Sudan,2007,2007Sudan,0,0,0,0,0,169,169,0,0,0,0,0,825,825,994
23762,Sudan,2007,2007Sudan,0,0,0,5,0,0,5,0,0,0,0,0,0,0,5
23763,Sudan,2007,2007Sudan,0,0,0,5,0,0,5,0,5,0,17,0,0,22,27
23764,Sudan,2007,2007Sudan,0,0,0,7,0,0,7,0,0,0,6,5,0,11,18
23765,Sudan,2007,2007Sudan,0,0,0,7,0,0,7,0,0,5,18,0,0,23,30
23766,Sudan,2007,2007Sudan,0,0,0,29,0,0,29,0,0,0,269,0,0,269,565
23767,Sudan,2007,2007Sudan,0,0,5,0,0,0,5,0,0,0,7,0,0,7,12
23768,Sudan,2007,2007Sudan,0,0,5,0,0,0,5,0,0,0,8,0,0,8,13
23769,Sudan,2007,2007Sudan,0,0,5,8,0,46,59,9,0,0,28,0,53,90,149
23770,Sudan,2007,2007Sudan,0,5,0,0,0,0,5,0,0,0,24,0,0,24,29
23771,Sudan,2007,2007Sudan,0,5,0,5,0,0,10,0,0,5,8,0,0,13,23
23772,Sudan,2007,2007Sudan,0,5,0,7,0,0,12,0,6,0,52,0,0,58,70
23773,Sudan,2007,2007Sudan,0,5,0,21,0,0,26,5,7,6,37,0,0,55,81
23774,Sudan,2007,2007Sudan,0,11,0,5,0,0,16,0,0,5,10,0,0,15,31
23775,Sudan,2007,2007Sudan,0,11,6,49,0,0,66,9,21,6,68,0,0,104,170
23776,Sudan,2007,2007Sudan,6,0,0,0,0,0,6,0,0,0,8,0,0,8,14
23777,Sudan,2007,2007Sudan,7,7,0,10,0,0,24,5,9,0,99,0,0,113,137
23778,Sudan,2007,2007Sudan,8,7,0,15,0,0,30,9,7,0,48,0,0,64,94
23779,Sudan,2007,2007Sudan,9,0,5,0,0,0,14,0,7,0,19,0,0,26,40
23780,Sudan,2007,2007Sudan,12,17,12,28,0,0,69,10,15,14,73,0,0,112,181
23781,Sudan,2007,2007Sudan,13,0,6,30,0,0,49,5,6,6,106,0,0,123,172
23782,Sudan,2007,2007Sudan,25,16,5,36,0,0,82,17,7,11,478,0,0,513,595
23783,Sudan,2007,2007Sudan,47,57,45,85,5,0,239,74,80,25,296,15,0,490,729
23784,Sudan,2007,2007Sudan,384,298,260,770,50,0,1762,408,304,254,1351,91,0,2408,4170
23785,Sudan,2007,2007Sudan,457,674,399,2267,68,0,3865,522,870,487,4692,63,0,6634,10499
23786,Sudan,2007,2007Sudan,2490,4106,2771,9150,395,0,18912,2572,4765,4420,14349,243,0,26349,45261
23787,Sudan,2007,2007Sudan,3626,1318,5542,8109,224,0,18819,3917,2021,5813,4818,105,0,16674,35493
23788,Sudan,2007,2007Sudan,10874,17270,12597,34469,2620,0,77830,11212,17688,14736,34097,1500,0,79233,162063
23789,Sudan,2008,2008Sudan,0,0,0,0,0,0,0,0,0,0,0,0,0,0,17646
23790,Sudan,2008,2008Sudan,0,0,0,0,0,0,0,0,0,0,5,0,0,5,4341
23791,Sudan,2008,2008Sudan,0,0,0,0,0,0,0,0,0,0,6,0,0,6,6
23792,Sudan,2008,2008Sudan,0,0,0,0,0,0,0,0,0,0,8,0,0,8,16
23793,Sudan,2008,2008Sudan,0,0,0,0,0,0,0,0,0,0,10,0,0,10,10
23794,Sudan,2008,2008Sudan,0,0,0,0,0,0,0,0,0,0,11,0,0,11,11
23795,Sudan,2008,2008Sudan,0,0,0,0,0,0,0,0,0,0,16,0,0,16,16
23796,Sudan,2008,2008Sudan,0,0,0,0,0,0,0,0,0,5,5,0,0,10,10
23797,Sudan,2008,2008Sudan,0,0,0,0,0,0,0,0,0,6,0,0,0,6,6
23798,Sudan,2008,2008Sudan,0,0,0,0,0,0,0,0,0,7,0,0,0,7,7
23799,Sudan,2008,2008Sudan,0,0,0,0,0,0,0,0,6,0,0,0,0,6,6
23800,Sudan,2008,2008Sudan,0,0,0,0,0,11,11,0,0,0,0,0,36,36,47
23801,Sudan,2008,2008Sudan,0,0,0,0,0,180,180,0,0,0,0,0,971,971,1151
23802,Sudan,2008,2008Sudan,0,0,0,5,0,0,5,0,0,0,0,0,0,0,5
23803,Sudan,2008,2008Sudan,0,0,0,5,0,0,5,0,0,0,5,0,0,5,10
23804,Sudan,2008,2008Sudan,0,0,0,5,0,0,5,0,0,0,6,0,0,6,11
23805,Sudan,2008,2008Sudan,0,0,0,5,0,0,5,0,0,0,9,0,0,9,14
23806,Sudan,2008,2008Sudan,0,0,0,5,0,0,5,0,0,0,16,0,0,16,21
23807,Sudan,2008,2008Sudan,0,0,0,5,0,0,5,0,0,0,38,0,0,38,43
23808,Sudan,2008,2008Sudan,0,0,0,5,0,0,5,5,0,5,49,0,0,59,64
23809,Sudan,2008,2008Sudan,0,0,0,7,0,0,7,0,0,5,18,0,0,23,30
23810,Sudan,2008,2008Sudan,0,0,0,9,0,0,9,0,0,0,8,0,0,8,17
23811,Sudan,2008,2008Sudan,0,0,0,13,0,0,13,0,0,0,17,0,0,17,30
23812,Sudan,2008,2008Sudan,0,0,5,7,0,45,57,7,5,0,30,0,55,97,154
23813,Sudan,2008,2008Sudan,0,6,0,29,0,0,35,0,8,10,36,0,0,54,89
23814,Sudan,2008,2008Sudan,0,6,6,8,0,0,20,0,0,6,13,0,0,19,39
23815,Sudan,2008,2008Sudan,0,8,0,7,0,0,15,0,9,0,18,0,0,27,42
23816,Sudan,2008,2008Sudan,5,0,0,0,0,0,5,0,0,0,0,0,0,0,5
23817,Sudan,2008,2008Sudan,5,6,0,8,0,0,19,0,5,0,20,0,0,25,44
23818,Sudan,2008,2008Sudan,5,6,5,12,0,0,28,6,7,7,344,0,0,364,392
23819,Sudan,2008,2008Sudan,5,8,0,10,0,0,23,5,7,5,71,0,0,88,111
23820,Sudan,2008,2008Sudan,5,9,0,7,0,0,21,0,8,0,58,0,0,66,87
23821,Sudan,2008,2008Sudan,8,8,0,16,0,0,32,7,6,0,56,0,0,69,101
23822,Sudan,2008,2008Sudan,10,21,8,75,0,0,114,20,34,13,111,0,0,178,292
23823,Sudan,2008,2008Sudan,13,0,6,30,0,0,49,5,6,6,122,0,0,139,188
23824,Sudan,2008,2008Sudan,16,30,32,72,0,0,150,14,34,34,134,6,0,222,372
23825,Sudan,2008,2008Sudan,403,731,399,2206,66,0,3805,416,926,493,4447,59,0,6341,10146
23826,Sudan,2008,2008Sudan,477,395,209,805,50,0,1936,484,426,218,1256,91,0,2475,4411
23827,Sudan,2008,2008Sudan,1585,2441,1795,5636,197,0,11654,1635,2736,2637,9735,99,0,16842,28496
23828,Sudan,2008,2008Sudan,2302,3457,1718,6130,161,0,13768,2527,3449,2052,4054,63,0,12145,25913
23829,Sudan,2008,2008Sudan,4141,6781,4573,12862,861,0,29218,4338,7015,5252,10542,518,0,27665,56883
23830,Sudan,2008,2008Sudan,22761,33943,17308,52848,5115,0,131975,22892,32205,16073,26729,3461,0,101360,267966
23831,Sudan,2009,2009Sudan,0,0,0,0,0,0,0,0,0,0,0,0,0,0,20891
23832,Sudan,2009,2009Sudan,0,0,0,0,0,0,0,0,0,0,5,0,0,5,15
23833,Sudan,2009,2009Sudan,0,0,0,0,0,0,0,0,0,0,8,0,0,8,24
23834,Sudan,2009,2009Sudan,0,0,0,0,0,0,0,0,0,0,9,0,0,9,9
23835,Sudan,2009,2009Sudan,0,0,0,0,0,0,0,0,0,0,10,0,0,10,10
23836,Sudan,2009,2009Sudan,0,0,0,0,0,0,0,0,0,0,14,0,0,14,14
23837,Sudan,2009,2009Sudan,0,0,0,0,0,0,0,0,0,6,0,0,0,6,12
23838,Sudan,2009,2009Sudan,0,0,0,0,0,8,8,0,0,0,0,0,40,40,48
23839,Sudan,2009,2009Sudan,0,0,0,0,0,41,41,0,0,0,0,0,94,94,135
23840,Sudan,2009,2009Sudan,0,0,0,5,0,0,5,0,0,0,0,0,0,0,5
23841,Sudan,2009,2009Sudan,0,0,0,5,0,0,5,0,0,0,6,0,0,6,11
23842,Sudan,2009,2009Sudan,0,0,0,7,0,0,7,0,0,0,8,0,0,8,15
23843,Sudan,2009,2009Sudan,0,0,0,8,0,0,8,0,0,5,21,0,0,26,34
23844,Sudan,2009,2009Sudan,0,0,0,11,0,0,11,0,0,0,16,0,0,16,27
23845,Sudan,2009,2009Sudan,0,0,0,13,0,0,13,0,0,0,18,0,0,18,31
23846,Sudan,2009,2009Sudan,0,0,5,0,0,0,5,0,0,0,0,0,0,0,5
23847,Sudan,2009,2009Sudan,0,0,5,0,0,0,5,0,6,0,19,0,0,25,30
23848,Sudan,2009,2009Sudan,0,0,5,9,0,36,50,7,7,0,28,0,52,94,144
23849,Sudan,2009,2009Sudan,0,0,7,0,0,0,7,0,0,10,42,0,0,52,59
23850,Sudan,2009,2009Sudan,0,0,9,22,0,0,31,0,8,8,31,0,0,47,78
23851,Sudan,2009,2009Sudan,0,12,0,8,0,0,20,0,0,5,13,0,0,18,38
23852,Sudan,2009,2009Sudan,5,0,0,5,0,0,10,0,5,0,26,0,0,31,41
23853,Sudan,2009,2009Sudan,5,0,0,11,0,0,16,0,9,0,83,0,0,92,108
23854,Sudan,2009,2009Sudan,5,5,0,13,0,0,23,5,5,0,54,0,0,64,87
23855,Sudan,2009,2009Sudan,5,6,5,13,0,0,29,5,17,5,61,0,0,88,117
23856,Sudan,2009,2009Sudan,5,7,0,6,0,0,18,6,0,0,59,5,0,70,88
23857,Sudan,2009,2009Sudan,6,0,0,0,0,0,6,0,0,0,9,0,0,9,15
23858,Sudan,2009,2009Sudan,12,5,5,14,0,0,36,10,0,8,207,0,0,225,261
23859,Sudan,2009,2009Sudan,12,17,13,93,16,0,151,7,21,9,331,27,0,395,546
23860,Sudan,2009,2009Sudan,13,0,6,30,0,0,49,5,6,6,112,0,0,129,178
23861,Sudan,2009,2009Sudan,16,26,14,77,0,0,133,11,45,19,103,5,0,183,316
23862,Sudan,2009,2009Sudan,17,22,8,35,0,0,82,10,10,8,76,5,0,109,191
23863,Sudan,2009,2009Sudan,30,56,86,195,5,0,372,19,75,71,361,21,0,547,919
23864,Sudan,2009,2009Sudan,166,182,179,559,88,0,1174,175,218,197,602,143,0,1335,2509
23865,Sudan,2009,2009Sudan,348,671,417,2230,84,0,3750,366,827,524,4283,68,0,6068,9818
23866,Sudan,2009,2009Sudan,477,395,213,830,50,0,1965,484,426,241,1281,91,0,2523,4488
23867,Sudan,2009,2009Sudan,1281,1865,1453,4266,163,0,9028,1322,2041,1927,5922,75,0,11287,20315
23868,Sudan,2009,2009Sudan,1646,2487,1772,4520,298,0,10723,1706,2600,1898,3746,163,0,10113,20836
23869,Sudan,2009,2009Sudan,2602,3017,1664,5416,158,0,12857,2743,2963,1882,3018,53,0,10659,23516
23870,Sudan,2009,2009Sudan,23022,32920,17378,54911,5652,0,133883,23121,31342,15615,26999,3616,0,100693,262194
23871,Sudan,2010,2010Sudan,0,0,0,0,0,0,0,0,0,0,0,0,0,0,21155
23872,Sudan,2010,2010Sudan,0,0,0,0,0,0,0,0,0,0,5,0,0,5,20
23873,Sudan,2010,2010Sudan,0,0,0,0,0,0,0,0,0,0,6,0,0,6,12
23874,Sudan,2010,2010Sudan,0,0,0,0,0,0,0,0,0,0,8,0,0,8,16
23875,Sudan,2010,2010Sudan,0,0,0,0,0,0,0,0,0,0,14,0,0,14,14
23876,Sudan,2010,2010Sudan,0,0,0,0,0,0,0,0,0,0,18,0,0,18,18
23877,Sudan,2010,2010Sudan,0,0,0,0,0,0,0,0,0,6,0,0,0,6,6
23878,Sudan,2010,2010Sudan,0,0,0,0,0,0,0,0,0,9,0,0,0,9,9
23879,Sudan,2010,2010Sudan,0,0,0,0,0,5,5,0,0,0,0,0,0,0,5
23880,Sudan,2010,2010Sudan,0,0,0,0,0,5,5,0,0,0,0,0,11,11,16
23881,Sudan,2010,2010Sudan,0,0,0,0,0,6,6,0,0,0,0,0,50,50,56
23882,Sudan,2010,2010Sudan,0,0,0,0,0,19,19,0,0,0,0,0,44,44,63
23883,Sudan,2010,2010Sudan,0,0,0,0,0,53,53,0,0,0,0,0,106,106,159
23884,Sudan,2010,2010Sudan,0,0,0,0,0,215,215,0,0,0,0,0,1382,1382,1597
23885,Sudan,2010,2010Sudan,0,0,0,5,0,0,5,0,0,0,0,0,0,0,5
23886,Sudan,2010,2010Sudan,0,0,0,5,0,0,5,0,0,0,6,0,0,6,11
23887,Sudan,2010,2010Sudan,0,0,0,5,0,0,5,0,0,5,23,0,0,28,33
23888,Sudan,2010,2010Sudan,0,0,0,6,0,0,6,0,0,5,28,0,0,33,39
23889,Sudan,2010,2010Sudan,0,0,6,11,0,32,49,5,7,5,38,0,50,105,154
23890,Sudan,2010,2010Sudan,0,0,7,0,0,0,7,0,0,0,7,0,0,7,14
23891,Sudan,2010,2010Sudan,0,8,0,9,0,0,17,0,7,0,34,0,0,41,58
23892,Sudan,2010,2010Sudan,0,11,0,6,0,0,17,0,5,0,62,0,0,67,84
23893,Sudan,2010,2010Sudan,0,12,0,8,0,0,20,0,0,5,13,0,0,18,38
23894,Sudan,2010,2010Sudan,0,13,10,20,5,0,48,0,7,5,22,0,0,34,82
23895,Sudan,2010,2010Sudan,5,10,8,10,0,0,33,13,8,0,79,0,0,100,133
23896,Sudan,2010,2010Sudan,6,0,0,0,0,0,6,0,0,0,9,0,0,9,15
23897,Sudan,2010,2010Sudan,6,0,5,0,0,0,11,0,5,0,13,0,0,18,29
23898,Sudan,2010,2010Sudan,7,17,13,89,17,0,143,5,17,12,323,31,0,388,531
23899,Sudan,2010,2010Sudan,10,0,0,13,0,0,23,7,6,0,94,0,0,107,130
23900,Sudan,2010,2010Sudan,13,7,5,8,0,0,33,6,0,8,138,0,0,152,185
23901,Sudan,2010,2010Sudan,14,0,6,29,0,0,49,7,6,6,86,0,0,105,154
23902,Sudan,2010,2010Sudan,19,35,12,49,0,0,115,29,23,9,130,12,0,203,318
23903,Sudan,2010,2010Sudan,23,47,72,189,5,0,336,19,63,62,333,21,0,498,834
23904,Sudan,2010,2010Sudan,24,10,8,16,0,0,58,25,21,6,63,0,0,115,173
23905,Sudan,2010,2010Sudan,45,56,19,115,0,0,235,50,72,25,152,0,5,304,539
23906,Sudan,2010,2010Sudan,159,177,194,556,87,0,1173,172,207,205,607,141,0,1332,2505
23907,Sudan,2010,2010Sudan,346,682,480,2282,94,0,3884,338,830,576,4332,75,0,6151,10035
23908,Sudan,2010,2010Sudan,517,395,287,830,50,0,2079,553,416,271,1205,91,0,2536,4615
23909,Sudan,2010,2010Sudan,1349,2222,1643,4302,312,0,9828,1375,2302,1783,3929,165,0,9554,19382
23910,Sudan,2010,2010Sudan,1352,1933,1620,4126,190,0,9221,1451,2217,2114,5453,72,0,11307,20528
23911,Sudan,2010,2010Sudan,2768,3192,1877,5645,203,0,13685,2872,3201,2001,3411,68,0,11553,25238
23912,Sudan,2010,2010Sudan,23446,32694,23804,63794,6522,0,150260,23614,31286,22341,32240,4323,0,113804,278257
23913,Sudan,2011,2011Sudan,0,0,0,0,0,0,0,0,0,0,0,0,0,0,20984
23914,Sudan,2011,2011Sudan,0,0,0,0,0,0,0,0,0,0,5,0,0,5,30
23915,Sudan,2011,2011Sudan,0,0,0,0,0,0,0,0,0,0,6,0,0,6,6
23916,Sudan,2011,2011Sudan,0,0,0,0,0,0,0,0,0,0,7,0,0,7,7
23917,Sudan,2011,2011Sudan,0,0,0,0,0,0,0,0,0,0,8,0,0,8,8
23918,Sudan,2011,2011Sudan,0,0,0,0,0,0,0,0,0,0,9,0,0,9,9
23919,Sudan,2011,2011Sudan,0,0,0,0,0,0,0,0,0,0,12,0,0,12,24
23920,Sudan,2011,2011Sudan,0,0,0,0,0,0,0,0,0,0,14,0,0,14,14
23921,Sudan,2011,2011Sudan,0,0,0,0,0,0,0,0,0,0,19,0,0,19,19
23922,Sudan,2011,2011Sudan,0,0,0,0,0,0,0,0,0,7,0,0,0,7,7
23923,Sudan,2011,2011Sudan,0,0,0,0,0,0,0,0,5,0,0,0,0,5,5
23924,Sudan,2011,2011Sudan,0,0,0,0,0,5,5,0,0,0,0,0,9,9,14
23925,Sudan,2011,2011Sudan,0,0,0,0,0,20,20,0,0,0,0,0,45,45,65
23926,Sudan,2011,2011Sudan,0,0,0,0,0,248,248,0,0,0,0,0,1658,1658,1906
23927,Sudan,2011,2011Sudan,0,0,0,5,0,0,5,0,0,0,0,0,0,0,5
23928,Sudan,2011,2011Sudan,0,0,0,6,0,0,6,0,0,5,29,0,0,34,40
23929,Sudan,2011,2011Sudan,0,0,0,7,0,0,7,0,0,5,18,0,0,23,30
23930,Sudan,2011,2011Sudan,0,0,5,13,0,28,46,5,11,5,35,0,48,104,150
23931,Sudan,2011,2011Sudan,0,0,7,0,0,0,7,0,0,0,7,0,0,7,14
23932,Sudan,2011,2011Sudan,0,6,0,5,0,0,11,0,5,0,36,0,0,41,52
23933,Sudan,2011,2011Sudan,0,9,0,15,0,0,24,0,8,9,15,5,0,37,61
23934,Sudan,2011,2011Sudan,0,12,0,8,0,0,20,0,0,5,13,0,0,18,38
23935,Sudan,2011,2011Sudan,5,0,0,0,0,0,5,0,0,0,0,0,0,0,5
23936,Sudan,2011,2011Sudan,5,5,0,0,0,0,10,0,5,0,13,0,0,18,28
23937,Sudan,2011,2011Sudan,5,5,0,13,0,0,23,5,6,0,36,0,0,47,70
23938,Sudan,2011,2011Sudan,5,15,11,82,16,0,129,5,12,15,317,31,0,380,509
23939,Sudan,2011,2011Sudan,6,0,0,0,0,0,6,0,0,0,0,0,0,0,6
23940,Sudan,2011,2011Sudan,6,14,7,43,5,0,75,11,12,12,94,5,0,134,1238
23941,Sudan,2011,2011Sudan,7,7,6,10,0,0,30,5,5,48,103,0,0,161,191
23942,Sudan,2011,2011Sudan,9,14,5,10,0,0,38,13,7,0,97,0,0,117,155
23943,Sudan,2011,2011Sudan,9,18,19,18,8,0,72,11,20,15,50,5,0,101,173
23944,Sudan,2011,2011Sudan,12,0,6,27,0,0,45,12,0,6,86,0,0,104,149
23945,Sudan,2011,2011Sudan,19,45,71,187,5,0,327,19,62,62,325,23,0,491,818
23946,Sudan,2011,2011Sudan,21,0,0,19,0,0,40,0,16,0,101,0,0,117,157
23947,Sudan,2011,2011Sudan,21,19,15,63,0,0,118,23,29,37,604,6,0,699,817
23948,Sudan,2011,2011Sudan,31,56,10,52,0,0,149,39,44,13,161,6,0,263,412
23949,Sudan,2011,2011Sudan,40,63,28,114,0,0,245,49,83,21,159,5,0,317,562
23950,Sudan,2011,2011Sudan,159,182,188,557,87,0,1173,172,214,196,607,142,0,1331,2504
23951,Sudan,2011,2011Sudan,309,175,214,372,28,0,1098,357,176,169,272,48,0,1022,2120
23952,Sudan,2011,2011Sudan,311,690,517,2399,95,0,4012,344,815,611,4460,82,0,6312,10324
23953,Sudan,2011,2011Sudan,989,1522,1528,3760,154,0,7953,1049,1678,1726,5105,57,0,9615,17568
23954,Sudan,2011,2011Sudan,1209,2140,1605,4006,319,0,9279,1262,2154,1896,3523,154,0,8989,18268
23955,Sudan,2011,2011Sudan,4930,5100,2990,9459,486,0,22965,5032,5214,3300,8411,364,0,22321,45286
23956,Sudan,2011,2011Sudan,5955,8949,6536,12643,611,0,34694,7286,11733,8025,14438,669,0,42151,76845
23957,Sudan,2011,2011Sudan,25621,36749,24257,65279,6618,0,158524,25722,35345,22901,34376,4443,0,122787,298311
23958,Sudan,2012,2012Sudan,0,0,0,0,0,0,0,0,0,0,0,0,0,0,22581
23959,Sudan,2012,2012Sudan,0,0,0,0,0,0,0,0,0,0,0,0,21,21,21
23960,Sudan,2012,2012Sudan,0,0,0,0,0,0,0,0,0,0,5,0,0,5,44
23961,Sudan,2012,2012Sudan,0,0,0,0,0,0,0,0,0,0,6,0,0,6,27
23962,Sudan,2012,2012Sudan,0,0,0,0,0,0,0,0,0,0,7,0,0,7,7
23963,Sudan,2012,2012Sudan,0,0,0,0,0,0,0,0,0,0,8,0,0,8,16
23964,Sudan,2012,2012Sudan,0,0,0,0,0,0,0,0,0,0,9,0,0,9,9
23965,Sudan,2012,2012Sudan,0,0,0,0,0,0,0,0,0,0,30,0,0,30,30
23966,Sudan,2012,2012Sudan,0,0,0,0,0,0,0,0,0,7,0,0,0,7,14
23967,Sudan,2012,2012Sudan,0,0,0,0,0,0,0,0,5,0,0,0,0,5,5
23968,Sudan,2012,2012Sudan,0,0,0,0,0,5,5,0,0,0,0,0,9,9,14
23969,Sudan,2012,2012Sudan,0,0,0,0,0,6,6,0,0,0,0,0,47,47,53
23970,Sudan,2012,2012Sudan,0,0,0,0,0,22,22,0,0,0,0,0,42,42,64
23971,Sudan,2012,2012Sudan,0,0,0,0,0,283,283,0,0,0,0,0,1897,1897,2180
23972,Sudan,2012,2012Sudan,0,0,0,5,0,0,5,0,0,0,0,0,0,0,5
23973,Sudan,2012,2012Sudan,0,0,0,7,0,0,7,0,0,5,30,0,0,35,42
23974,Sudan,2012,2012Sudan,0,0,0,9,0,0,9,0,0,7,16,0,0,23,32
23975,Sudan,2012,2012Sudan,0,0,6,0,0,0,6,0,0,0,9,0,0,9,15
23976,Sudan,2012,2012Sudan,0,5,0,0,0,0,5,0,0,0,0,0,0,0,5
23977,Sudan,2012,2012Sudan,0,5,0,18,0,0,23,0,0,9,109,5,0,123,146
23978,Sudan,2012,2012Sudan,0,5,5,10,0,0,20,5,5,7,14,5,0,36,56
23979,Sudan,2012,2012Sudan,0,6,5,5,0,0,16,0,7,0,42,0,0,49,65
23980,Sudan,2012,2012Sudan,0,7,0,9,0,0,16,0,7,0,39,0,0,46,62
23981,Sudan,2012,2012Sudan,0,12,0,6,0,0,18,0,0,5,8,0,0,13,31
23982,Sudan,2012,2012Sudan,5,0,0,0,0,0,5,0,0,0,0,0,0,0,10
23983,Sudan,2012,2012Sudan,5,0,0,5,0,39,49,0,9,0,21,0,76,106,155
23984,Sudan,2012,2012Sudan,5,5,0,0,0,0,10,0,0,0,18,0,0,18,28
23985,Sudan,2012,2012Sudan,5,7,11,11,0,0,34,5,14,0,113,0,0,132,166
23986,Sudan,2012,2012Sudan,6,0,0,0,0,0,6,0,0,0,0,0,0,0,6
23987,Sudan,2012,2012Sudan,6,5,0,12,0,0,23,6,6,0,43,0,0,55,78
23988,Sudan,2012,2012Sudan,6,9,8,9,0,0,32,5,6,49,110,0,0,170,202
23989,Sudan,2012,2012Sudan,6,13,7,42,0,0,68,23,19,11,296,10,0,359,427
23990,Sudan,2012,2012Sudan,7,0,0,10,0,0,17,0,0,8,22,0,0,30,1100
23991,Sudan,2012,2012Sudan,7,16,16,84,21,0,144,5,19,17,358,32,0,431,575
23992,Sudan,2012,2012Sudan,12,40,94,104,5,0,255,10,48,112,196,14,0,380,635
23993,Sudan,2012,2012Sudan,25,38,18,57,0,0,138,34,40,12,182,6,0,274,412
23994,Sudan,2012,2012Sudan,35,71,37,126,0,0,269,49,75,35,160,10,0,329,598
23995,Sudan,2012,2012Sudan,38,0,0,14,0,0,52,10,12,0,105,0,0,127,179
23996,Sudan,2012,2012Sudan,105,147,136,416,7,0,811,145,186,218,1792,5,0,2346,3157
23997,Sudan,2012,2012Sudan,159,182,188,557,87,0,1173,171,216,196,607,142,0,1332,2505
23998,Sudan,2012,2012Sudan,232,279,162,419,36,0,1128,240,316,133,304,53,0,1046,2174
23999,Sudan,2012,2012Sudan,344,804,638,2693,107,0,4586,367,910,1417,4750,94,0,7538,12124
24000,Sudan,2012,2012Sudan,527,918,755,1734,115,0,4049,484,994,1005,1328,50,0,3861,7910
24001,Sudan,2012,2012Sudan,2923,3095,1451,5509,454,0,13432,3081,3128,1723,5323,488,0,13743,27175
24002,Sudan,2012,2012Sudan,17833,23294,11677,36613,2444,0,91861,18784,22905,11352,29226,2706,0,84973,176834
24003,Sudan,2012,2012Sudan,24978,32030,27976,71698,6756,0,163438,25161,31467,26710,39521,4750,0,127609,306960
24004,Sudan,2013,2013Sudan,0,0,0,0,0,0,0,0,0,0,0,0,0,0,26612
24005,Sudan,2013,2013Sudan,0,0,0,0,0,0,0,0,0,0,5,0,0,5,44
24006,Sudan,2013,2013Sudan,0,0,0,0,0,0,0,0,0,0,6,0,0,6,18
24007,Sudan,2013,2013Sudan,0,0,0,0,0,0,0,0,0,0,7,0,0,7,21
24008,Sudan,2013,2013Sudan,0,0,0,0,0,0,0,0,0,0,9,0,0,9,9
24009,Sudan,2013,2013Sudan,0,0,0,0,0,0,0,0,0,0,14,0,0,14,14
24010,Sudan,2013,2013Sudan,0,0,0,0,0,0,0,0,0,0,47,0,0,47,47
24011,Sudan,2013,2013Sudan,0,0,0,0,0,0,0,0,0,7,0,0,0,7,7
24012,Sudan,2013,2013Sudan,0,0,0,0,0,0,0,0,7,0,0,0,0,7,7
24013,Sudan,2013,2013Sudan,0,0,0,0,0,5,5,0,0,0,0,0,9,9,14
24014,Sudan,2013,2013Sudan,0,0,0,0,0,25,25,0,0,0,0,0,40,40,129
24015,Sudan,2013,2013Sudan,0,0,0,0,0,355,355,0,0,0,0,0,2075,2075,2430
24016,Sudan,2013,2013Sudan,0,0,0,5,0,0,5,0,0,0,0,0,0,0,10
24017,Sudan,2013,2013Sudan,0,0,0,7,0,0,7,0,0,5,34,0,0,39,46
24018,Sudan,2013,2013Sudan,0,0,0,9,0,0,9,0,6,0,16,0,0,22,31
24019,Sudan,2013,2013Sudan,0,5,0,0,0,0,5,0,0,0,0,0,0,0,5
24020,Sudan,2013,2013Sudan,0,5,0,9,0,0,14,0,5,6,14,0,0,25,905
24021,Sudan,2013,2013Sudan,0,5,0,9,0,0,14,0,6,0,37,0,0,43,57
24022,Sudan,2013,2013Sudan,0,5,5,14,0,31,55,5,11,7,40,0,49,112,167
24023,Sudan,2013,2013Sudan,0,6,5,9,0,0,20,5,5,7,17,5,0,39,59
24024,Sudan,2013,2013Sudan,0,7,5,5,0,0,17,0,5,0,40,0,0,45,62
24025,Sudan,2013,2013Sudan,0,7,5,28,0,0,40,19,13,5,65,0,0,102,142
24026,Sudan,2013,2013Sudan,0,8,0,0,0,0,8,7,5,0,27,0,0,39,47
24027,Sudan,2013,2013Sudan,0,9,0,14,0,0,23,0,6,6,50,0,0,62,85
24028,Sudan,2013,2013Sudan,0,9,5,20,0,0,34,0,7,7,138,0,0,152,186
24029,Sudan,2013,2013Sudan,0,10,0,0,0,0,10,0,0,0,20,0,0,20,30
24030,Sudan,2013,2013Sudan,0,12,0,6,0,0,18,0,0,5,8,0,0,13,31
24031,Sudan,2013,2013Sudan,0,37,42,182,6,0,267,7,40,45,269,23,0,384,651
24032,Sudan,2013,2013Sudan,5,0,0,0,0,0,5,0,0,0,0,0,0,0,5
24033,Sudan,2013,2013Sudan,5,0,0,0,0,0,5,0,0,0,9,0,0,9,14
24034,Sudan,2013,2013Sudan,5,8,5,40,10,0,68,5,0,7,203,13,0,228,296
24035,Sudan,2013,2013Sudan,5,20,6,15,0,0,46,7,16,7,101,0,0,131,177
24036,Sudan,2013,2013Sudan,19,15,9,23,0,0,66,15,14,7,154,0,0,190,256
24037,Sudan,2013,2013Sudan,27,7,0,18,0,0,52,5,14,0,103,0,0,122,174
24038,Sudan,2013,2013Sudan,36,74,31,97,0,0,238,22,80,37,163,8,0,310,548
24039,Sudan,2013,2013Sudan,40,39,18,58,0,0,155,36,52,13,213,5,0,319,474
24040,Sudan,2013,2013Sudan,65,112,107,115,45,0,444,76,111,155,234,48,0,624,1068
24041,Sudan,2013,2013Sudan,165,176,156,553,5,0,1055,182,189,183,2293,5,0,2852,3907
24042,Sudan,2013,2013Sudan,185,181,185,562,89,0,1202,191,216,199,615,141,0,1362,2564
24043,Sudan,2013,2013Sudan,485,957,732,2981,109,0,5264,475,1030,966,5072,120,0,7663,12927
24044,Sudan,2013,2013Sudan,3847,3858,1905,6256,548,0,16414,3932,3883,2064,6680,609,0,17168,33582
24045,Sudan,2013,2013Sudan,24059,25811,13288,40459,2615,0,106232,25230,25405,13711,34686,2866,0,101898,208130
24046,Sudan,2013,2013Sudan,29973,41409,33491,75585,7184,0,187642,30124,40144,29847,41581,4896,0,146592,352948
24047,Sudan,2014,2014Sudan,0,0,0,0,0,0,0,0,0,0,0,0,0,0,19069
24048,Sudan,2014,2014Sudan,0,0,0,0,0,0,0,0,0,0,5,0,0,5,10
24049,Sudan,2014,2014Sudan,0,0,0,0,0,0,0,0,0,0,6,0,0,6,12
24050,Sudan,2014,2014Sudan,0,0,0,0,0,0,0,0,0,0,8,0,0,8,32
24051,Sudan,2014,2014Sudan,0,0,0,0,0,0,0,0,0,0,49,0,0,49,49
24052,Sudan,2014,2014Sudan,0,0,0,0,0,0,0,0,7,0,0,0,0,7,7
24053,Sudan,2014,2014Sudan,0,0,0,0,0,5,5,0,0,0,0,0,9,9,14
24054,Sudan,2014,2014Sudan,0,0,0,0,0,19,19,0,0,0,0,0,164,164,183
24055,Sudan,2014,2014Sudan,0,0,0,0,0,411,411,0,0,0,0,0,2335,2335,2746
24056,Sudan,2014,2014Sudan,0,0,0,5,0,0,5,0,0,0,0,0,0,0,15
24057,Sudan,2014,2014Sudan,0,0,0,5,0,0,5,0,0,0,6,0,0,6,11
24058,Sudan,2014,2014Sudan,0,0,0,6,0,0,6,0,0,5,107,0,0,112,118
24059,Sudan,2014,2014Sudan,0,0,0,9,0,0,9,0,0,6,16,0,0,22,31
24060,Sudan,2014,2014Sudan,0,5,0,0,0,0,5,0,0,0,0,0,0,0,5
24061,Sudan,2014,2014Sudan,0,5,0,18,0,0,23,0,0,10,10,5,0,25,48
24062,Sudan,2014,2014Sudan,0,6,0,5,0,0,11,6,6,0,26,0,0,38,49
24063,Sudan,2014,2014Sudan,0,6,6,10,0,0,22,5,5,7,20,5,0,42,64
24064,Sudan,2014,2014Sudan,0,6,7,13,0,44,70,0,13,8,47,0,62,130,200
24065,Sudan,2014,2014Sudan,0,7,0,0,0,0,7,0,0,0,11,0,0,11,18
24066,Sudan,2014,2014Sudan,0,7,0,24,0,0,31,5,5,5,38,0,0,53,84
24067,Sudan,2014,2014Sudan,0,8,0,0,0,0,8,0,0,0,0,0,0,0,16
24068,Sudan,2014,2014Sudan,0,9,0,13,0,0,22,5,8,0,26,0,0,39,671
24069,Sudan,2014,2014Sudan,0,9,5,10,0,0,24,5,5,0,52,0,0,62,86
24070,Sudan,2014,2014Sudan,0,9,6,21,0,0,36,14,14,12,157,0,0,197,233
24071,Sudan,2014,2014Sudan,0,12,0,0,0,0,12,0,5,6,12,0,0,23,35
24072,Sudan,2014,2014Sudan,0,12,0,6,0,0,18,0,0,5,8,0,0,13,31
24073,Sudan,2014,2014Sudan,5,0,0,0,0,0,5,0,0,0,0,0,0,0,5
24074,Sudan,2014,2014Sudan,5,0,0,0,0,0,5,0,0,0,9,0,0,9,28
24075,Sudan,2014,2014Sudan,5,7,0,13,0,0,25,0,5,7,43,0,0,55,80
24076,Sudan,2014,2014Sudan,5,32,41,198,6,0,282,5,39,30,275,27,0,376,658
24077,Sudan,2014,2014Sudan,7,13,5,44,11,0,80,5,5,5,217,18,0,250,330
24078,Sudan,2014,2014Sudan,11,13,0,10,0,0,34,8,16,5,36,0,0,65,99
24079,Sudan,2014,2014Sudan,22,12,5,30,0,0,69,7,18,5,119,0,0,149,218
24080,Sudan,2014,2014Sudan,24,22,6,35,0,0,87,14,19,10,227,0,0,270,357
24081,Sudan,2014,2014Sudan,38,138,110,14,0,0,300,29,129,165,30,0,0,353,653
24082,Sudan,2014,2014Sudan,59,73,30,118,5,0,285,69,69,37,536,17,0,728,1013
24083,Sudan,2014,2014Sudan,86,156,92,324,5,0,663,75,141,147,770,6,0,1139,1802
24084,Sudan,2014,2014Sudan,105,143,120,445,5,0,818,130,178,201,2049,5,0,2563,3381
24085,Sudan,2014,2014Sudan,174,272,103,408,41,0,998,216,296,119,226,25,0,882,1880
24086,Sudan,2014,2014Sudan,535,756,3063,996,119,0,5469,585,862,4614,1065,135,0,7261,12730
24087,Sudan,2014,2014Sudan,3158,4300,2054,7081,596,0,17189,3336,4458,2533,7266,665,0,18258,35447
24088,Sudan,2014,2014Sudan,24645,28158,15196,43466,2807,0,114272,26090,28010,16036,38240,3079,0,111455,225727
24089,Sudan,2014,2014Sudan,30884,41413,32622,82017,7839,0,194775,30944,40670,30641,46118,5414,0,153787,357711
24090,Sudan,2015,2015Sudan,0,0,0,0,0,0,0,0,0,0,0,0,0,0,19384
24091,Sudan,2015,2015Sudan,0,0,0,0,0,0,0,0,0,0,0,0,5,5,5
24092,Sudan,2015,2015Sudan,0,0,0,0,0,0,0,0,0,0,0,5,0,5,5
24093,Sudan,2015,2015Sudan,0,0,0,0,0,0,0,0,0,0,5,0,0,5,20
24094,Sudan,2015,2015Sudan,0,0,0,0,0,0,0,0,0,0,6,0,0,6,6
24095,Sudan,2015,2015Sudan,0,0,0,0,0,0,0,0,0,0,7,0,0,7,14
24096,Sudan,2015,2015Sudan,0,0,0,0,0,0,0,0,0,0,8,0,0,8,8
24097,Sudan,2015,2015Sudan,0,0,0,0,0,0,0,0,0,0,9,0,0,9,9
24098,Sudan,2015,2015Sudan,0,0,0,0,0,0,0,0,0,0,20,0,0,20,20
24099,Sudan,2015,2015Sudan,0,0,0,0,0,0,0,0,0,0,65,0,0,65,65
24100,Sudan,2015,2015Sudan,0,0,0,0,0,0,0,0,0,8,0,0,0,8,8
24101,Sudan,2015,2015Sudan,0,0,0,0,0,0,0,0,0,9,0,0,0,9,9
24102,Sudan,2015,2015Sudan,0,0,0,0,0,0,0,0,9,0,0,0,0,9,9
24103,Sudan,2015,2015Sudan,0,0,0,0,0,0,0,5,0,0,0,0,0,5,5
24104,Sudan,2015,2015Sudan,0,0,0,0,0,8,8,0,0,0,0,0,54,54,62
24105,Sudan,2015,2015Sudan,0,0,0,0,0,33,33,0,0,0,0,0,90,90,123
24106,Sudan,2015,2015Sudan,0,0,0,0,0,523,523,0,0,0,0,0,3623,3623,4146
24107,Sudan,2015,2015Sudan,0,0,0,5,0,0,5,0,0,0,0,0,0,0,5
24108,Sudan,2015,2015Sudan,0,0,0,5,0,0,5,0,0,0,6,0,0,6,11
24109,Sudan,2015,2015Sudan,0,0,0,6,0,0,6,10,0,0,155,0,0,165,171
24110,Sudan,2015,2015Sudan,0,0,0,11,0,0,11,0,0,0,47,0,0,47,58
24111,Sudan,2015,2015Sudan,0,0,0,18,0,0,18,8,0,0,25,0,0,33,51
24112,Sudan,2015,2015Sudan,0,0,5,0,0,0,5,0,0,0,0,0,0,0,5
24113,Sudan,2015,2015Sudan,0,0,5,0,0,0,5,0,0,0,5,0,0,5,10
24114,Sudan,2015,2015Sudan,0,5,5,9,0,0,19,5,0,15,27,5,0,52,71
24115,Sudan,2015,2015Sudan,0,5,9,16,0,0,30,0,6,5,45,0,0,56,205
24116,Sudan,2015,2015Sudan,0,6,0,0,0,0,6,0,0,0,0,0,0,0,6
24117,Sudan,2015,2015Sudan,0,6,0,5,0,0,11,6,6,0,25,0,0,37,48
24118,Sudan,2015,2015Sudan,0,7,0,0,0,0,7,0,0,0,11,0,0,11,18
24119,Sudan,2015,2015Sudan,0,7,5,0,0,0,12,0,12,0,13,0,0,25,37
24120,Sudan,2015,2015Sudan,0,8,24,16,0,0,48,14,7,0,71,5,0,97,145
24121,Sudan,2015,2015Sudan,0,9,0,0,0,0,9,0,5,0,10,0,0,15,24
24122,Sudan,2015,2015Sudan,0,9,5,29,0,0,43,0,5,6,147,0,0,158,201
24123,Sudan,2015,2015Sudan,5,0,0,0,0,0,5,0,0,0,0,0,0,0,10
24124,Sudan,2015,2015Sudan,5,0,0,0,0,0,5,0,0,0,6,0,0,6,11
24125,Sudan,2015,2015Sudan,5,0,0,8,0,0,13,0,7,0,34,0,0,41,54
24126,Sudan,2015,2015Sudan,5,6,0,0,0,0,11,0,8,0,9,0,0,17,28
24127,Sudan,2015,2015Sudan,5,24,31,189,6,0,255,5,28,34,276,26,0,369,624
24128,Sudan,2015,2015Sudan,8,13,5,56,11,0,93,9,9,16,314,16,0,364,457
24129,Sudan,2015,2015Sudan,14,22,13,35,0,0,84,14,24,16,124,0,0,178,262
24130,Sudan,2015,2015Sudan,15,17,21,39,0,0,92,19,14,34,115,5,0,187,279
24131,Sudan,2015,2015Sudan,35,86,72,120,0,0,313,35,91,56,186,18,0,386,699
24132,Sudan,2015,2015Sudan,55,20,9,46,0,0,130,33,28,12,443,0,0,516,646
24133,Sudan,2015,2015Sudan,90,162,109,370,6,0,737,77,157,147,868,6,0,1255,1992
24134,Sudan,2015,2015Sudan,101,151,118,450,5,0,825,128,199,206,2054,7,0,2594,3419
24135,Sudan,2015,2015Sudan,105,121,47,264,10,0,547,126,137,71,908,26,0,1268,1815
24136,Sudan,2015,2015Sudan,214,271,110,405,30,0,1030,286,288,128,229,26,0,957,1987
24137,Sudan,2015,2015Sudan,609,1143,743,2589,76,0,5160,688,1209,847,3310,82,0,6136,11296
24138,Sudan,2015,2015Sudan,4032,4377,2112,7183,594,0,18298,4209,4554,2660,7390,674,0,19487,37785
24139,Sudan,2015,2015Sudan,20446,39012,27679,75945,7988,0,171070,20558,38696,25166,39170,5090,0,128680,299750
24140,Sudan,2015,2015Sudan,25488,31313,16019,47297,2879,0,122996,26994,31648,16860,39493,3011,0,118006,241002
24141,Sudan,2016,2016Sudan,0,0,0,0,0,0,0,0,0,0,0,0,0,0,20164
24142,Sudan,2016,2016Sudan,0,0,0,0,0,0,0,0,0,0,0,5,0,5,5
24143,Sudan,2016,2016Sudan,0,0,0,0,0,0,0,0,0,0,5,0,0,5,25
24144,Sudan,2016,2016Sudan,0,0,0,0,0,0,0,0,0,0,6,0,0,6,6
24145,Sudan,2016,2016Sudan,0,0,0,0,0,0,0,0,0,0,8,0,0,8,8
24146,Sudan,2016,2016Sudan,0,0,0,0,0,0,0,0,0,0,9,0,0,9,18
24147,Sudan,2016,2016Sudan,0,0,0,0,0,0,0,0,0,8,0,0,0,8,8
24148,Sudan,2016,2016Sudan,0,0,0,0,0,7,7,0,0,0,0,0,54,54,61
24149,Sudan,2016,2016Sudan,0,0,0,0,0,16,16,0,0,0,0,0,99,99,115
24150,Sudan,2016,2016Sudan,0,0,0,0,0,37,37,0,0,0,0,0,137,137,174
24151,Sudan,2016,2016Sudan,0,0,0,0,0,709,709,0,0,0,0,0,6340,6340,7049
24152,Sudan,2016,2016Sudan,0,0,0,5,0,0,5,0,0,0,0,0,0,0,10
24153,Sudan,2016,2016Sudan,0,0,0,5,0,0,5,0,5,0,0,0,0,5,10
24154,Sudan,2016,2016Sudan,0,0,0,6,0,0,6,0,0,0,46,10,0,56,62
24155,Sudan,2016,2016Sudan,0,0,0,6,0,0,6,0,0,0,72,0,0,72,78
24156,Sudan,2016,2016Sudan,0,0,0,12,0,0,12,0,0,0,53,0,0,53,65
24157,Sudan,2016,2016Sudan,0,0,0,16,5,0,21,0,0,5,28,5,0,38,465
24158,Sudan,2016,2016Sudan,0,5,0,0,0,0,5,0,0,0,0,0,0,0,5
24159,Sudan,2016,2016Sudan,0,5,0,0,0,0,5,0,0,0,7,0,0,7,12
24160,Sudan,2016,2016Sudan,0,5,0,0,0,0,5,0,0,0,8,0,0,8,13
24161,Sudan,2016,2016Sudan,0,5,0,0,0,0,5,0,0,0,9,0,0,9,14
24162,Sudan,2016,2016Sudan,0,5,0,0,0,0,5,5,0,0,0,0,0,5,10
24163,Sudan,2016,2016Sudan,0,5,0,5,0,0,10,0,5,0,17,0,0,22,32
24164,Sudan,2016,2016Sudan,0,6,6,24,0,0,36,0,0,9,133,5,0,147,183
24165,Sudan,2016,2016Sudan,0,6,7,26,0,0,39,0,7,16,30,13,0,66,105
24166,Sudan,2016,2016Sudan,0,7,0,5,0,0,12,5,5,0,25,0,0,35,47
24167,Sudan,2016,2016Sudan,0,7,5,0,0,0,12,7,0,0,18,0,0,25,37
24168,Sudan,2016,2016Sudan,0,7,7,16,0,53,83,0,13,11,63,0,77,164,247
24169,Sudan,2016,2016Sudan,0,9,0,0,0,0,9,0,5,0,9,0,0,14,23
24170,Sudan,2016,2016Sudan,5,0,0,0,0,0,5,0,0,0,0,0,0,0,5
24171,Sudan,2016,2016Sudan,5,0,0,0,0,0,5,0,0,0,6,0,0,6,11
24172,Sudan,2016,2016Sudan,6,9,0,9,0,0,24,0,7,5,32,0,0,44,68
24173,Sudan,2016,2016Sudan,6,12,0,5,0,0,23,5,10,5,24,0,0,44,67
24174,Sudan,2016,2016Sudan,6,21,29,186,7,0,249,5,23,36,280,33,0,377,626
24175,Sudan,2016,2016Sudan,8,0,0,0,0,0,8,0,0,0,0,0,0,0,8
24176,Sudan,2016,2016Sudan,8,0,5,9,0,0,22,9,0,0,25,0,0,34,56
24177,Sudan,2016,2016Sudan,9,5,0,9,0,0,23,26,0,0,147,0,0,173,196
24178,Sudan,2016,2016Sudan,18,17,21,39,0,0,95,10,30,5,129,0,0,174,269
24179,Sudan,2016,2016Sudan,21,24,8,23,0,0,76,9,20,17,23,5,0,74,150
24180,Sudan,2016,2016Sudan,21,28,11,83,11,0,154,16,20,26,458,19,0,539,693
24181,Sudan,2016,2016Sudan,26,14,6,31,0,0,77,20,20,23,148,0,0,211,288
24182,Sudan,2016,2016Sudan,35,92,73,129,0,0,329,36,78,85,181,33,0,413,742
24183,Sudan,2016,2016Sudan,57,21,13,62,0,0,153,42,31,14,455,0,0,542,695
24184,Sudan,2016,2016Sudan,112,176,141,427,15,0,871,131,245,246,1364,6,0,1992,2863
24185,Sudan,2016,2016Sudan,161,145,54,343,12,0,715,183,152,68,1071,33,0,1507,2222
24186,Sudan,2016,2016Sudan,170,228,141,454,5,0,998,167,211,178,979,12,0,1547,2545
24187,Sudan,2016,2016Sudan,250,277,115,420,30,0,1092,330,305,128,233,26,0,1022,2114
24188,Sudan,2016,2016Sudan,815,1381,959,3175,95,0,6425,867,1424,1045,3977,110,0,7423,13848
24189,Sudan,2016,2016Sudan,4148,4481,2501,7496,632,0,19258,4398,4654,3099,7773,714,0,20638,39896
24190,Sudan,2016,2016Sudan,24754,32577,17426,48180,3015,0,125952,25743,33167,17284,36268,3096,0,115558,241510
24191,Sudan,2016,2016Sudan,26353,38699,27752,76068,7962,0,176834,26870,38318,25258,40090,5098,0,135634,312468
24192,Sudan,2017,2017Sudan,0,0,0,0,0,0,0,0,0,0,0,0,0,0,20491
24193,Sudan,2017,2017Sudan,0,0,0,0,0,0,0,0,0,0,0,0,313,313,313
24194,Sudan,2017,2017Sudan,0,0,0,0,0,0,0,0,0,0,5,0,0,5,35
24195,Sudan,2017,2017Sudan,0,0,0,0,0,0,0,0,0,0,6,0,0,6,6
24196,Sudan,2017,2017Sudan,0,0,0,0,0,0,0,0,0,0,8,0,0,8,8
24197,Sudan,2017,2017Sudan,0,0,0,0,0,0,0,0,0,0,9,0,0,9,27
24198,Sudan,2017,2017Sudan,0,0,0,0,0,0,0,0,0,0,12,0,0,12,12
24199,Sudan,2017,2017Sudan,0,0,0,0,0,0,0,0,0,8,0,0,0,8,8
24200,Sudan,2017,2017Sudan,0,0,0,0,0,0,0,6,0,0,0,0,0,6,6
24201,Sudan,2017,2017Sudan,0,0,0,0,0,7,7,0,0,0,0,0,53,53,60
24202,Sudan,2017,2017Sudan,0,0,0,0,0,16,16,0,0,0,0,0,96,96,112
24203,Sudan,2017,2017Sudan,0,0,0,0,0,918,918,0,0,0,0,0,10419,10419,11337
24204,Sudan,2017,2017Sudan,0,0,0,5,0,0,5,0,0,0,0,0,0,0,86
24205,Sudan,2017,2017Sudan,0,0,0,5,0,0,5,0,0,0,10,0,0,10,15
24206,Sudan,2017,2017Sudan,0,0,0,5,0,0,5,0,5,0,16,0,0,21,26
24207,Sudan,2017,2017Sudan,0,0,0,6,0,0,6,0,0,0,83,0,0,83,89
24208,Sudan,2017,2017Sudan,0,0,0,8,0,0,8,0,0,0,42,14,0,56,64
24209,Sudan,2017,2017Sudan,0,0,5,0,0,0,5,0,0,0,0,0,0,0,5
24210,Sudan,2017,2017Sudan,0,0,6,0,0,0,6,0,5,0,15,0,0,20,26
24211,Sudan,2017,2017Sudan,0,5,0,0,0,0,5,0,0,0,0,0,0,0,5
24212,Sudan,2017,2017Sudan,0,5,0,0,0,0,5,0,0,0,7,0,0,7,12
24213,Sudan,2017,2017Sudan,0,5,0,0,0,0,5,0,0,0,9,0,0,9,14
24214,Sudan,2017,2017Sudan,0,5,7,27,0,0,39,0,0,8,136,5,0,149,188
24215,Sudan,2017,2017Sudan,0,5,9,37,0,0,51,0,7,9,41,16,0,73,124
24216,Sudan,2017,2017Sudan,0,6,0,0,0,0,6,0,0,0,0,0,0,0,6
24217,Sudan,2017,2017Sudan,0,7,0,0,0,0,7,0,0,0,5,0,0,5,12
24218,Sudan,2017,2017Sudan,0,7,0,0,0,0,7,0,0,7,10,0,0,17,24
24219,Sudan,2017,2017Sudan,0,7,0,5,0,0,12,5,5,0,26,0,0,36,48
24220,Sudan,2017,2017Sudan,0,7,5,13,0,95,120,0,10,12,77,0,58,157,277
24221,Sudan,2017,2017Sudan,0,9,0,16,0,0,25,10,7,0,37,0,0,54,79
24222,Sudan,2017,2017Sudan,5,14,0,5,0,0,24,0,14,8,21,0,0,43,67
24223,Sudan,2017,2017Sudan,5,30,23,44,0,0,102,25,17,5,125,0,0,172,274
24224,Sudan,2017,2017Sudan,6,0,0,14,0,0,20,0,5,8,35,0,0,48,68
24225,Sudan,2017,2017Sudan,9,5,0,30,0,0,44,25,5,0,192,0,0,222,266
24226,Sudan,2017,2017Sudan,12,19,27,220,9,0,287,12,30,47,215,38,0,342,629
24227,Sudan,2017,2017Sudan,16,23,14,23,0,0,76,9,18,18,25,5,0,75,151
24228,Sudan,2017,2017Sudan,20,19,5,32,0,0,76,16,27,12,168,0,0,223,299
24229,Sudan,2017,2017Sudan,33,96,82,133,0,0,344,39,75,87,182,35,0,418,762
24230,Sudan,2017,2017Sudan,38,44,29,112,10,0,233,32,69,31,124,13,0,269,502
24231,Sudan,2017,2017Sudan,68,78,33,213,13,0,405,58,69,57,1360,25,0,1569,1974
24232,Sudan,2017,2017Sudan,70,23,12,64,0,0,169,62,25,13,431,5,0,536,705
24233,Sudan,2017,2017Sudan,108,169,143,478,9,0,907,127,226,229,1426,7,0,2015,2922
24234,Sudan,2017,2017Sudan,127,196,125,409,5,0,862,125,174,143,1030,21,0,1493,2355
24235,Sudan,2017,2017Sudan,192,150,84,450,12,0,888,230,164,91,1155,39,0,1679,2567
24236,Sudan,2017,2017Sudan,1076,1689,1156,4098,106,0,8125,1089,1773,1239,4940,132,0,9173,17298
24237,Sudan,2017,2017Sudan,4600,4993,2838,7918,689,0,21038,4804,5250,3598,8401,801,0,22854,43892
24238,Sudan,2017,2017Sudan,25228,33216,63180,52875,8101,0,182600,25683,31466,35795,43488,5295,0,141727,324327
24239,Sudan,2017,2017Sudan,25240,34305,20923,53375,3396,0,137239,26429,34884,20642,39324,3465,0,124744,261983
24240,Sudan,2018,2018Sudan,0,0,0,0,0,0,0,0,0,0,0,0,0,0,21707
24241,Sudan,2018,2018Sudan,0,0,0,0,0,0,0,0,0,0,0,8,0,8,8
24242,Sudan,2018,2018Sudan,0,0,0,0,0,0,0,0,0,0,5,0,0,5,20
24243,Sudan,2018,2018Sudan,0,0,0,0,0,0,0,0,0,0,6,0,0,6,12
24244,Sudan,2018,2018Sudan,0,0,0,0,0,0,0,0,0,0,9,0,0,9,18
24245,Sudan,2018,2018Sudan,0,0,0,0,0,0,0,0,0,0,10,0,0,10,10
24246,Sudan,2018,2018Sudan,0,0,0,0,0,0,0,0,0,5,0,0,0,5,5
24247,Sudan,2018,2018Sudan,0,0,0,0,0,0,0,5,0,0,14,0,0,19,19
24248,Sudan,2018,2018Sudan,0,0,0,0,0,0,0,7,0,0,0,0,0,7,7
24249,Sudan,2018,2018Sudan,0,0,0,0,0,1223,1223,0,0,0,0,0,13477,13477,14700
24250,Sudan,2018,2018Sudan,0,0,0,5,0,0,5,0,0,0,11,0,0,11,16
24251,Sudan,2018,2018Sudan,0,0,0,5,0,0,5,0,0,0,14,0,0,14,19
24252,Sudan,2018,2018Sudan,0,0,0,5,0,0,5,0,0,0,73,0,0,73,78
24253,Sudan,2018,2018Sudan,0,0,9,21,0,0,30,7,6,5,54,0,0,72,102
24254,Sudan,2018,2018Sudan,0,5,0,0,0,0,5,0,0,0,0,0,0,0,10
24255,Sudan,2018,2018Sudan,0,5,0,0,0,0,5,0,0,0,6,0,0,6,11
24256,Sudan,2018,2018Sudan,0,5,0,0,0,0,5,0,0,0,7,0,0,7,12
24257,Sudan,2018,2018Sudan,0,5,0,5,0,0,10,0,0,0,16,0,0,16,26
24258,Sudan,2018,2018Sudan,0,5,5,7,0,0,17,0,0,5,48,15,0,68,85
24259,Sudan,2018,2018Sudan,0,5,7,20,0,0,32,0,0,8,114,5,0,127,159
24260,Sudan,2018,2018Sudan,0,5,8,30,5,0,48,0,7,7,37,20,0,71,119
24261,Sudan,2018,2018Sudan,0,6,0,0,0,0,6,0,0,0,0,0,0,0,6
24262,Sudan,2018,2018Sudan,0,7,0,0,0,0,7,0,0,8,11,0,0,19,26
24263,Sudan,2018,2018Sudan,0,7,0,0,0,0,7,0,5,0,18,0,0,23,30
24264,Sudan,2018,2018Sudan,0,7,0,5,0,0,12,5,5,0,27,0,0,37,49
24265,Sudan,2018,2018Sudan,0,8,0,0,0,0,8,0,0,0,0,0,0,0,8
24266,Sudan,2018,2018Sudan,0,8,6,18,0,64,96,5,8,5,87,0,96,201,297
24267,Sudan,2018,2018Sudan,0,15,5,5,0,0,25,0,11,9,25,0,0,45,70
24268,Sudan,2018,2018Sudan,0,31,19,46,0,0,96,20,22,5,123,0,0,170,266
24269,Sudan,2018,2018Sudan,5,6,5,21,0,0,37,5,14,0,38,0,0,57,94
24270,Sudan,2018,2018Sudan,15,20,16,18,0,0,69,5,14,26,38,0,0,83,152
24271,Sudan,2018,2018Sudan,20,20,0,55,0,0,95,48,10,5,242,0,0,305,400
24272,Sudan,2018,2018Sudan,29,29,7,42,0,0,107,30,29,17,230,0,0,306,413
24273,Sudan,2018,2018Sudan,31,51,45,280,14,0,421,46,49,64,322,54,0,535,956
24274,Sudan,2018,2018Sudan,38,80,93,141,0,0,352,38,72,80,181,46,0,417,769
24275,Sudan,2018,2018Sudan,41,49,21,120,10,0,241,32,71,31,129,14,0,277,518
24276,Sudan,2018,2018Sudan,45,82,44,198,5,0,374,61,84,55,250,10,0,460,1173
24277,Sudan,2018,2018Sudan,59,27,16,59,0,0,161,66,22,13,396,10,0,507,668
24278,Sudan,2018,2018Sudan,86,84,33,253,14,0,470,75,83,74,1699,35,0,1966,2436
24279,Sudan,2018,2018Sudan,128,228,194,560,9,0,1119,154,311,301,1575,8,0,2349,3582
24280,Sudan,2018,2018Sudan,217,170,79,502,19,0,987,225,207,98,1216,55,0,1801,2788
24281,Sudan,2018,2018Sudan,218,305,217,524,45,0,1309,239,309,232,687,26,0,1493,2802
24282,Sudan,2018,2018Sudan,1185,1847,1361,4713,134,0,9240,1232,1974,1450,5466,178,0,10300,19540
24283,Sudan,2018,2018Sudan,4244,5253,3049,8077,672,0,21295,4318,5542,3584,8460,804,0,22708,44003
24284,Sudan,2018,2018Sudan,25618,40773,28811,84358,8490,0,188050,26240,40254,27012,49411,5707,0,148624,336674
24285,Sudan,2018,2018Sudan,26883,35842,21997,54539,3324,0,142585,28143,36792,21075,38025,3304,0,127339,269924
24286,Sudan,2019,2019Sudan,0,0,0,0,0,0,0,0,0,0,0,0,0,0,24906
24287,Sudan,2019,2019Sudan,0,0,0,0,0,0,0,0,0,0,0,8,0,8,8
24288,Sudan,2019,2019Sudan,0,0,0,0,0,0,0,0,0,0,5,0,0,5,30
24289,Sudan,2019,2019Sudan,0,0,0,0,0,0,0,0,0,0,6,0,0,6,12
24290,Sudan,2019,2019Sudan,0,0,0,0,0,0,0,0,0,0,8,0,0,8,16
24291,Sudan,2019,2019Sudan,0,0,0,0,0,0,0,0,0,0,9,0,0,9,9
24292,Sudan,2019,2019Sudan,0,0,0,0,0,0,0,0,0,0,11,0,0,11,11
24293,Sudan,2019,2019Sudan,0,0,0,0,0,0,0,0,0,0,13,0,0,13,13
24294,Sudan,2019,2019Sudan,0,0,0,0,0,0,0,0,0,0,55,0,0,55,55
24295,Sudan,2019,2019Sudan,0,0,0,0,0,0,0,0,0,5,0,0,0,5,5
24296,Sudan,2019,2019Sudan,0,0,0,0,0,0,0,0,0,5,5,0,0,10,10
24297,Sudan,2019,2019Sudan,0,0,0,0,0,0,0,0,7,0,0,0,0,7,7
24298,Sudan,2019,2019Sudan,0,0,0,0,0,0,0,0,9,5,6,0,0,20,20
24299,Sudan,2019,2019Sudan,0,0,0,0,0,5,5,0,0,0,0,0,23,23,28
24300,Sudan,2019,2019Sudan,0,0,0,0,0,1756,1756,0,0,0,0,0,16717,16717,18473
24301,Sudan,2019,2019Sudan,0,0,0,5,0,0,5,0,0,0,13,0,0,13,18
24302,Sudan,2019,2019Sudan,0,0,0,5,0,0,5,0,0,0,64,0,0,64,69
24303,Sudan,2019,2019Sudan,0,0,0,5,0,0,5,0,0,5,6,0,0,11,16
24304,Sudan,2019,2019Sudan,0,0,0,11,0,0,11,0,0,5,35,0,0,40,51
24305,Sudan,2019,2019Sudan,0,0,5,0,0,0,5,0,0,0,0,0,0,0,5
24306,Sudan,2019,2019Sudan,0,0,5,0,0,0,5,0,5,0,0,0,0,5,10
24307,Sudan,2019,2019Sudan,0,0,6,0,0,0,6,0,0,0,0,0,0,0,6
24308,Sudan,2019,2019Sudan,0,5,0,0,0,0,5,0,0,0,0,0,0,0,5
24309,Sudan,2019,2019Sudan,0,5,0,12,0,0,17,0,0,5,39,27,0,71,88
24310,Sudan,2019,2019Sudan,0,5,8,18,0,0,31,0,8,7,91,5,0,111,326
24311,Sudan,2019,2019Sudan,0,5,8,27,0,0,40,0,0,8,154,0,0,162,202
24312,Sudan,2019,2019Sudan,0,5,9,31,5,0,50,0,7,7,35,20,0,69,119
24313,Sudan,2019,2019Sudan,0,6,0,0,0,0,6,0,0,0,0,0,0,0,6
24314,Sudan,2019,2019Sudan,0,7,0,5,0,0,12,0,9,0,26,0,0,35,47
24315,Sudan,2019,2019Sudan,0,7,6,0,0,0,13,0,9,0,6,0,0,15,28
24316,Sudan,2019,2019Sudan,0,8,0,0,0,0,8,0,0,0,12,5,0,17,25
24317,Sudan,2019,2019Sudan,0,11,6,23,0,0,40,7,14,0,37,0,0,58,98
24318,Sudan,2019,2019Sudan,6,19,6,5,0,0,36,8,20,7,28,0,0,63,99
24319,Sudan,2019,2019Sudan,10,6,8,31,5,0,60,13,7,5,73,0,0,98,158
24320,Sudan,2019,2019Sudan,24,23,0,50,0,0,97,45,10,15,233,0,0,303,400
24321,Sudan,2019,2019Sudan,26,16,14,49,0,0,105,23,22,25,234,0,0,304,409
24322,Sudan,2019,2019Sudan,30,37,10,56,0,0,133,31,36,22,263,0,0,352,485
24323,Sudan,2019,2019Sudan,31,74,95,121,5,0,326,38,59,76,166,53,0,392,718
24324,Sudan,2019,2019Sudan,41,38,34,256,9,0,378,33,66,41,244,35,0,419,797
24325,Sudan,2019,2019Sudan,43,51,24,80,10,0,208,31,61,18,81,6,0,197,405
24326,Sudan,2019,2019Sudan,53,31,16,58,0,0,158,65,26,12,370,10,0,483,641
24327,Sudan,2019,2019Sudan,86,103,41,281,15,0,526,84,95,56,1807,38,0,2080,2606
24328,Sudan,2019,2019Sudan,124,225,204,653,11,0,1217,145,296,307,1592,11,0,2351,3568
24329,Sudan,2019,2019Sudan,145,266,164,502,15,0,1092,147,257,199,901,31,0,1535,2627
24330,Sudan,2019,2019Sudan,229,176,95,557,21,0,1078,275,228,101,1248,66,0,1918,2996
24331,Sudan,2019,2019Sudan,1306,1994,1560,5355,163,0,10378,1299,2109,1720,6099,256,0,11483,21861
24332,Sudan,2019,2019Sudan,4756,4536,2857,7399,506,0,20054,4877,4756,3426,7781,585,0,21425,41479
24333,Sudan,2019,2019Sudan,24765,37396,23703,55379,3413,0,144656,25732,38549,23252,39995,3379,0,130907,275563
24334,Sudan,2019,2019Sudan,28146,38789,27678,86012,7878,0,188503,28894,38607,26104,48154,4984,0,146743,335246
24335,Sudan,2020,2020Sudan,0,0,0,0,0,0,0,0,0,0,0,0,0,0,41240
24336,Sudan,2020,2020Sudan,0,0,0,0,0,0,0,0,0,0,0,0,27,27,27
24337,Sudan,2020,2020Sudan,0,0,0,0,0,0,0,0,0,0,5,0,0,5,20
24338,Sudan,2020,2020Sudan,0,0,0,0,0,0,0,0,0,0,6,0,0,6,6
24339,Sudan,2020,2020Sudan,0,0,0,0,0,0,0,0,0,0,7,0,0,7,7
24340,Sudan,2020,2020Sudan,0,0,0,0,0,0,0,0,0,0,8,0,0,8,24
24341,Sudan,2020,2020Sudan,0,0,0,0,0,0,0,0,0,0,13,0,0,13,13
24342,Sudan,2020,2020Sudan,0,0,0,0,0,0,0,0,0,0,42,0,0,42,42
24343,Sudan,2020,2020Sudan,0,0,0,0,0,0,0,0,0,5,0,0,0,5,5
24344,Sudan,2020,2020Sudan,0,0,0,0,0,0,0,0,0,5,6,0,0,11,22
24345,Sudan,2020,2020Sudan,0,0,0,0,0,0,0,0,7,0,0,0,0,7,7
24346,Sudan,2020,2020Sudan,0,0,0,0,0,0,0,0,9,0,0,0,0,9,9
24347,Sudan,2020,2020Sudan,0,0,0,0,0,0,0,5,0,0,0,0,0,5,5
24348,Sudan,2020,2020Sudan,0,0,0,0,0,0,0,7,0,0,0,0,0,7,7
24349,Sudan,2020,2020Sudan,0,0,0,0,0,5,5,0,0,0,0,0,41,41,46
24350,Sudan,2020,2020Sudan,0,0,0,0,0,8,8,0,0,0,0,0,23,23,31
24351,Sudan,2020,2020Sudan,0,0,0,0,0,10,10,0,0,0,0,0,57,57,67
24352,Sudan,2020,2020Sudan,0,0,0,0,0,56,56,0,0,0,0,0,203,203,259
24353,Sudan,2020,2020Sudan,0,0,0,0,0,202,202,29,33,0,103,9,36,210,1776
24354,Sudan,2020,2020Sudan,0,0,0,5,0,0,5,0,0,0,0,0,0,0,5
24355,Sudan,2020,2020Sudan,0,0,0,5,0,0,5,0,0,0,8,0,0,8,13
24356,Sudan,2020,2020Sudan,0,0,0,5,0,0,5,0,0,0,11,0,0,11,16
24357,Sudan,2020,2020Sudan,0,0,0,5,0,0,5,0,0,0,15,0,0,15,20
24358,Sudan,2020,2020Sudan,0,0,0,5,0,0,5,0,0,0,60,0,0,60,65
24359,Sudan,2020,2020Sudan,0,0,5,0,0,0,5,0,0,0,0,0,0,0,5
24360,Sudan,2020,2020Sudan,0,0,6,0,0,0,6,0,0,0,0,0,0,0,6
24361,Sudan,2020,2020Sudan,0,0,6,5,0,0,11,0,8,0,28,0,0,36,47
24362,Sudan,2020,2020Sudan,0,0,7,14,0,0,21,0,0,5,62,5,0,72,93
24363,Sudan,2020,2020Sudan,0,0,12,0,0,0,12,5,0,6,5,0,0,16,28
24364,Sudan,2020,2020Sudan,0,5,0,0,0,0,5,0,5,0,0,0,0,5,10
24365,Sudan,2020,2020Sudan,0,5,5,11,0,0,21,0,0,5,38,30,0,73,94
24366,Sudan,2020,2020Sudan,0,5,5,18,0,0,28,0,6,8,89,5,0,108,324
24367,Sudan,2020,2020Sudan,0,5,7,33,5,0,50,0,7,5,37,20,0,69,119
24368,Sudan,2020,2020Sudan,0,5,8,25,0,0,38,0,0,8,166,0,0,174,212
24369,Sudan,2020,2020Sudan,0,7,0,0,0,0,7,0,5,0,19,0,0,24,31
24370,Sudan,2020,2020Sudan,0,9,0,6,0,0,15,0,0,9,120,0,0,129,144
24371,Sudan,2020,2020Sudan,5,0,0,0,0,0,5,0,5,0,0,0,0,5,10
24372,Sudan,2020,2020Sudan,5,0,0,6,0,0,11,0,5,0,16,0,0,21,32
24373,Sudan,2020,2020Sudan,5,8,5,24,0,0,42,6,10,6,38,0,0,60,102
24374,Sudan,2020,2020Sudan,5,18,8,5,0,0,36,6,20,9,28,0,0,63,99
24375,Sudan,2020,2020Sudan,7,9,8,34,5,0,63,11,7,7,75,0,0,100,163
24376,Sudan,2020,2020Sudan,29,66,22,72,5,0,194,37,50,22,78,6,0,193,387
24377,Sudan,2020,2020Sudan,29,70,87,140,5,0,331,30,53,74,167,64,0,388,719
24378,Sudan,2020,2020Sudan,31,42,13,63,0,0,149,38,40,26,335,0,0,439,588
24379,Sudan,2020,2020Sudan,35,23,0,50,0,0,108,44,19,5,233,0,0,301,409
24380,Sudan,2020,2020Sudan,46,41,15,64,0,0,166,62,30,9,384,17,0,502,668
24381,Sudan,2020,2020Sudan,48,33,13,96,0,0,190,44,39,35,734,0,0,852,1042
24382,Sudan,2020,2020Sudan,62,84,41,310,12,0,509,58,100,55,256,24,0,493,1002
24383,Sudan,2020,2020Sudan,92,126,55,324,17,0,614,93,114,57,1855,41,0,2160,2774
24384,Sudan,2020,2020Sudan,130,246,250,745,17,0,1388,148,329,370,1750,13,0,2610,3998
24385,Sudan,2020,2020Sudan,132,253,199,539,25,0,1148,158,254,221,973,36,0,1642,2790
24386,Sudan,2020,2020Sudan,294,205,114,639,24,0,1276,311,257,121,1499,98,0,2286,3562
24387,Sudan,2020,2020Sudan,1335,2287,1862,6291,176,0,11951,1288,2406,2013,7336,289,0,13332,25283
24388,Sudan,2020,2020Sudan,4183,4912,3326,8067,548,0,21036,4305,5150,3706,8725,644,0,22530,43566
24389,Sudan,2020,2020Sudan,26437,37753,25533,58870,3684,0,152277,27539,39264,25176,43311,3682,0,138972,291249
24390,Sudan,2020,2020Sudan,33005,40175,28060,92594,9462,0,203296,33842,40100,26832,54613,5852,0,161239,364535
24391,Sudan,2021,2021Sudan,0,0,0,0,0,0,0,0,0,0,0,0,0,0,44599
24392,Sudan,2021,2021Sudan,0,0,0,0,0,0,0,0,0,0,0,0,9,9,9
24393,Sudan,2021,2021Sudan,0,0,0,0,0,0,0,0,0,0,5,0,0,5,30
24394,Sudan,2021,2021Sudan,0,0,0,0,0,0,0,0,0,0,7,0,0,7,7
24395,Sudan,2021,2021Sudan,0,0,0,0,0,0,0,0,0,0,8,0,0,8,8
24396,Sudan,2021,2021Sudan,0,0,0,0,0,0,0,0,0,0,9,0,0,9,9
24397,Sudan,2021,2021Sudan,0,0,0,0,0,0,0,0,0,0,33,0,0,33,33
24398,Sudan,2021,2021Sudan,0,0,0,0,0,0,0,0,0,5,0,0,0,5,5
24399,Sudan,2021,2021Sudan,0,0,0,0,0,0,0,0,0,7,26,0,0,33,33
24400,Sudan,2021,2021Sudan,0,0,0,0,0,0,0,0,0,9,0,0,0,9,9
24401,Sudan,2021,2021Sudan,0,0,0,0,0,0,0,0,7,0,0,0,0,7,7
24402,Sudan,2021,2021Sudan,0,0,0,0,0,0,0,5,0,0,0,0,0,5,5
24403,Sudan,2021,2021Sudan,0,0,0,0,0,0,0,9,0,0,0,0,0,9,9
24404,Sudan,2021,2021Sudan,0,0,0,0,0,5,5,0,0,0,0,0,22,22,27
24405,Sudan,2021,2021Sudan,0,0,0,5,0,0,5,0,0,0,8,0,0,8,13
24406,Sudan,2021,2021Sudan,0,0,0,5,0,0,5,0,0,0,19,0,0,19,24
24407,Sudan,2021,2021Sudan,0,0,0,5,0,0,5,0,0,11,38,0,0,49,54
24408,Sudan,2021,2021Sudan,0,0,0,6,0,0,6,0,0,0,55,0,0,55,61
24409,Sudan,2021,2021Sudan,0,0,0,14,0,0,14,5,0,33,120,0,0,158,172
24410,Sudan,2021,2021Sudan,0,0,5,0,0,0,5,0,0,0,0,0,0,0,10
24411,Sudan,2021,2021Sudan,0,0,5,0,0,0,5,0,5,0,0,0,0,5,10
24412,Sudan,2021,2021Sudan,0,0,5,6,0,0,11,0,0,12,55,0,0,67,78
24413,Sudan,2021,2021Sudan,0,0,5,11,0,0,16,0,0,5,60,5,0,70,86
24414,Sudan,2021,2021Sudan,0,0,6,0,0,0,6,0,0,0,0,0,0,0,6
24415,Sudan,2021,2021Sudan,0,0,6,0,0,0,6,5,0,5,13,0,0,23,29
24416,Sudan,2021,2021Sudan,0,0,6,5,0,0,11,0,8,0,28,0,0,36,47
24417,Sudan,2021,2021Sudan,0,5,0,0,0,0,5,0,0,0,6,0,0,6,11
24418,Sudan,2021,2021Sudan,0,5,0,0,0,0,5,0,0,0,8,0,0,8,13
24419,Sudan,2021,2021Sudan,0,5,0,0,0,0,5,0,0,0,13,0,0,13,18
24420,Sudan,2021,2021Sudan,0,5,5,35,5,0,50,0,5,6,28,20,0,59,109
24421,Sudan,2021,2021Sudan,0,5,7,9,0,0,21,5,0,0,31,35,0,71,92
24422,Sudan,2021,2021Sudan,0,5,12,31,0,0,48,0,5,8,168,0,0,181,229
24423,Sudan,2021,2021Sudan,0,6,8,19,0,0,33,0,5,10,78,5,0,98,525
24424,Sudan,2021,2021Sudan,0,9,0,0,0,0,9,0,0,5,16,0,0,21,30
24425,Sudan,2021,2021Sudan,0,11,20,5,0,0,36,5,16,14,28,0,0,63,99
24426,Sudan,2021,2021Sudan,0,15,5,8,0,0,28,5,10,0,22,0,0,37,65
24427,Sudan,2021,2021Sudan,7,259,222,566,55,0,1109,0,213,192,416,93,0,914,2023
24428,Sudan,2021,2021Sudan,8,10,9,34,5,0,66,11,8,6,86,5,0,116,182
24429,Sudan,2021,2021Sudan,16,54,34,89,5,0,198,14,61,36,78,7,0,196,394
24430,Sudan,2021,2021Sudan,18,30,35,113,5,202,403,56,80,22,246,17,36,457,2185
24431,Sudan,2021,2021Sudan,24,52,90,164,5,0,335,30,58,58,174,71,0,391,726
24432,Sudan,2021,2021Sudan,25,47,12,68,0,0,152,40,41,24,327,0,0,432,584
24433,Sudan,2021,2021Sudan,32,19,5,46,0,0,102,39,21,5,230,0,0,295,397
24434,Sudan,2021,2021Sudan,43,56,9,64,0,0,172,60,41,9,429,17,0,556,728
24435,Sudan,2021,2021Sudan,48,20,5,61,0,0,134,34,20,67,595,0,0,716,850
24436,Sudan,2021,2021Sudan,83,151,64,333,13,0,644,114,130,61,1926,34,0,2265,2909
24437,Sudan,2021,2021Sudan,98,94,72,354,11,0,629,102,119,56,409,21,0,707,1336
24438,Sudan,2021,2021Sudan,135,280,210,586,26,0,1237,152,280,236,1057,41,0,1766,3003
24439,Sudan,2021,2021Sudan,162,256,249,847,18,0,1532,141,333,389,1804,14,0,2681,4213
24440,Sudan,2021,2021Sudan,350,194,126,624,25,0,1319,374,246,131,1533,94,0,2378,3697
24441,Sudan,2021,2021Sudan,1353,2216,1888,6335,188,0,11980,1365,2321,2005,7488,317,0,13496,25476
24442,Sudan,2021,2021Sudan,4392,5480,3418,8298,583,0,22171,4330,5767,3882,9010,683,0,23672,45843
24443,Sudan,2021,2021Sudan,27021,37603,28226,63235,4002,0,160087,28375,39085,27839,48817,3971,0,148087,308174
24444,Sudan,2021,2021Sudan,27806,41038,29211,99310,9944,0,207309,28242,41446,28506,60634,6267,0,165095,375999
24445,Syrian Arab Rep.,2001,2001Syrian Arab Rep.,0,0,0,0,0,0,0,0,0,0,0,0,0,0,4220
24446,Syrian Arab Rep.,2001,2001Syrian Arab Rep.,0,0,0,0,0,0,0,0,0,0,5,0,0,5,15
24447,Syrian Arab Rep.,2001,2001Syrian Arab Rep.,0,0,0,0,0,0,0,0,0,0,44,0,0,44,44
24448,Syrian Arab Rep.,2001,2001Syrian Arab Rep.,0,0,0,0,0,15,15,0,0,0,0,0,32,32,47
24449,Syrian Arab Rep.,2001,2001Syrian Arab Rep.,0,0,0,0,0,49,49,0,0,0,0,0,143,143,192
24450,Syrian Arab Rep.,2001,2001Syrian Arab Rep.,0,0,0,0,0,69,69,0,0,0,0,0,88,88,157
24451,Syrian Arab Rep.,2001,2001Syrian Arab Rep.,0,0,0,5,0,0,5,0,0,0,0,0,0,0,5
24452,Syrian Arab Rep.,2001,2001Syrian Arab Rep.,0,0,0,5,0,0,5,0,0,0,8,0,0,8,13
24453,Syrian Arab Rep.,2001,2001Syrian Arab Rep.,0,0,5,0,0,0,5,0,0,0,6,0,0,6,16
24454,Syrian Arab Rep.,2001,2001Syrian Arab Rep.,0,0,12,0,0,0,12,5,0,0,0,0,0,5,101
24455,Syrian Arab Rep.,2001,2001Syrian Arab Rep.,0,5,5,10,0,0,20,0,6,6,7,0,0,19,39
24456,Syrian Arab Rep.,2001,2001Syrian Arab Rep.,0,6,0,0,0,0,6,0,0,0,0,0,0,0,12
24457,Syrian Arab Rep.,2002,2002Syrian Arab Rep.,0,0,0,0,0,0,0,0,0,0,0,0,0,0,18268
24458,Syrian Arab Rep.,2002,2002Syrian Arab Rep.,0,0,0,0,0,0,0,0,0,0,5,0,0,5,10
24459,Syrian Arab Rep.,2002,2002Syrian Arab Rep.,0,0,0,0,0,0,0,0,0,0,7,0,0,7,7
24460,Syrian Arab Rep.,2002,2002Syrian Arab Rep.,0,0,0,0,0,0,0,0,0,0,45,0,0,45,45
24461,Syrian Arab Rep.,2002,2002Syrian Arab Rep.,0,0,0,0,0,0,0,0,6,0,5,0,0,11,55
24462,Syrian Arab Rep.,2002,2002Syrian Arab Rep.,0,0,0,0,0,48,48,0,0,0,0,0,55,55,180
24463,Syrian Arab Rep.,2002,2002Syrian Arab Rep.,0,0,0,0,0,50,50,0,0,0,0,0,157,157,207
24464,Syrian Arab Rep.,2002,2002Syrian Arab Rep.,0,0,0,5,0,0,5,0,0,0,8,0,0,8,13
24465,Syrian Arab Rep.,2002,2002Syrian Arab Rep.,0,0,5,0,0,0,5,0,0,0,0,0,0,0,5
24466,Syrian Arab Rep.,2002,2002Syrian Arab Rep.,0,0,5,5,0,0,10,0,0,8,0,0,0,8,18
24467,Syrian Arab Rep.,2002,2002Syrian Arab Rep.,13,15,7,12,0,0,47,15,11,9,18,0,0,53,100
24468,Syrian Arab Rep.,2003,2003Syrian Arab Rep.,0,0,0,0,0,0,0,0,0,0,0,0,0,0,19619
24469,Syrian Arab Rep.,2003,2003Syrian Arab Rep.,0,0,0,0,0,0,0,0,0,0,5,0,0,5,10
24470,Syrian Arab Rep.,2003,2003Syrian Arab Rep.,0,0,0,0,0,0,0,0,0,9,0,0,0,9,55
24471,Syrian Arab Rep.,2003,2003Syrian Arab Rep.,0,0,0,0,0,44,44,0,0,0,0,0,53,53,178
24472,Syrian Arab Rep.,2003,2003Syrian Arab Rep.,0,0,0,0,0,44,44,0,0,0,0,0,147,147,191
24473,Syrian Arab Rep.,2003,2003Syrian Arab Rep.,0,0,0,5,0,0,5,0,0,0,8,0,0,8,13
24474,Syrian Arab Rep.,2003,2003Syrian Arab Rep.,0,0,0,5,0,0,5,0,0,0,9,0,0,9,14
24475,Syrian Arab Rep.,2003,2003Syrian Arab Rep.,0,0,5,0,0,0,5,0,0,0,37,0,0,37,42
24476,Syrian Arab Rep.,2003,2003Syrian Arab Rep.,0,5,0,0,0,0,5,0,0,0,0,0,0,0,5
24477,Syrian Arab Rep.,2003,2003Syrian Arab Rep.,0,8,0,0,0,0,8,0,5,0,5,0,0,10,18
24478,Syrian Arab Rep.,2003,2003Syrian Arab Rep.,8,0,0,9,0,0,17,0,5,0,6,0,0,11,28
24479,Syrian Arab Rep.,2003,2003Syrian Arab Rep.,16,42,42,186,21,0,307,22,41,36,192,45,0,336,643
24480,Syrian Arab Rep.,2004,2004Syrian Arab Rep.,0,0,0,0,0,0,0,0,0,0,0,0,0,0,20503
24481,Syrian Arab Rep.,2004,2004Syrian Arab Rep.,0,0,0,0,0,0,0,0,0,0,5,0,0,5,36
24482,Syrian Arab Rep.,2004,2004Syrian Arab Rep.,0,0,5,0,0,0,5,0,0,0,0,0,0,0,5
24483,Syrian Arab Rep.,2004,2004Syrian Arab Rep.,0,0,5,5,0,0,10,0,5,0,11,0,0,16,26
24484,Syrian Arab Rep.,2004,2004Syrian Arab Rep.,0,0,6,0,0,0,6,0,0,0,0,0,0,0,6
24485,Syrian Arab Rep.,2004,2004Syrian Arab Rep.,0,0,6,6,0,0,12,0,0,0,8,11,0,19,50
24486,Syrian Arab Rep.,2004,2004Syrian Arab Rep.,0,5,0,0,0,0,5,0,0,0,35,0,0,35,40
24487,Syrian Arab Rep.,2004,2004Syrian Arab Rep.,0,5,0,13,0,0,18,0,6,0,13,0,0,19,37
24488,Syrian Arab Rep.,2004,2004Syrian Arab Rep.,0,8,0,0,0,0,8,0,0,6,11,0,0,17,25
24489,Syrian Arab Rep.,2004,2004Syrian Arab Rep.,0,8,0,15,0,50,73,5,6,6,28,0,61,106,179
24490,Syrian Arab Rep.,2004,2004Syrian Arab Rep.,7,0,0,9,0,0,16,9,0,0,9,0,0,18,34
24491,Syrian Arab Rep.,2004,2004Syrian Arab Rep.,18,35,35,142,16,0,246,16,32,26,135,34,0,243,489
24492,Syrian Arab Rep.,2005,2005Syrian Arab Rep.,0,0,0,0,0,0,0,0,0,0,0,0,0,0,15015
24493,Syrian Arab Rep.,2005,2005Syrian Arab Rep.,0,0,0,0,0,0,0,0,0,0,5,0,0,5,5
24494,Syrian Arab Rep.,2005,2005Syrian Arab Rep.,0,0,0,0,0,0,0,0,0,0,6,0,0,6,24
24495,Syrian Arab Rep.,2005,2005Syrian Arab Rep.,0,0,0,0,0,0,0,0,0,0,8,0,0,8,8
24496,Syrian Arab Rep.,2005,2005Syrian Arab Rep.,0,0,0,0,0,13,13,0,0,0,0,0,29,29,42
24497,Syrian Arab Rep.,2005,2005Syrian Arab Rep.,0,0,0,0,0,48,48,0,0,0,0,0,165,165,213
24498,Syrian Arab Rep.,2005,2005Syrian Arab Rep.,0,0,0,5,0,0,5,0,0,0,0,0,0,0,5
24499,Syrian Arab Rep.,2005,2005Syrian Arab Rep.,0,0,0,16,5,0,21,0,0,0,13,6,0,19,40
24500,Syrian Arab Rep.,2005,2005Syrian Arab Rep.,0,0,5,0,0,0,5,0,0,0,0,0,0,0,5
24501,Syrian Arab Rep.,2005,2005Syrian Arab Rep.,0,0,5,5,0,0,10,0,5,0,10,0,0,15,25
24502,Syrian Arab Rep.,2005,2005Syrian Arab Rep.,0,0,7,0,0,0,7,0,0,0,0,0,0,0,7
24503,Syrian Arab Rep.,2005,2005Syrian Arab Rep.,0,5,0,0,0,0,5,0,0,0,34,0,0,34,39
24504,Syrian Arab Rep.,2005,2005Syrian Arab Rep.,0,5,0,0,0,0,5,0,0,7,0,0,0,7,12
24505,Syrian Arab Rep.,2005,2005Syrian Arab Rep.,6,0,0,10,0,0,16,8,0,0,10,0,0,18,34
24506,Syrian Arab Rep.,2005,2005Syrian Arab Rep.,8,6,6,35,0,50,105,9,17,14,85,0,64,189,294
24507,Syrian Arab Rep.,2005,2005Syrian Arab Rep.,20,50,48,185,17,0,320,32,41,35,161,38,0,307,627
24508,Syrian Arab Rep.,2006,2006Syrian Arab Rep.,0,0,0,0,0,0,0,0,0,0,0,0,0,0,10647
24509,Syrian Arab Rep.,2006,2006Syrian Arab Rep.,0,0,0,0,0,0,0,0,0,0,0,0,5,5,5
24510,Syrian Arab Rep.,2006,2006Syrian Arab Rep.,0,0,0,0,0,0,0,0,0,0,0,0,37,37,37
24511,Syrian Arab Rep.,2006,2006Syrian Arab Rep.,0,0,0,0,0,0,0,0,0,0,5,0,0,5,48
24512,Syrian Arab Rep.,2006,2006Syrian Arab Rep.,0,0,0,0,0,0,0,0,0,0,17,0,0,17,17
24513,Syrian Arab Rep.,2006,2006Syrian Arab Rep.,0,0,0,0,0,16,16,0,0,0,0,0,34,34,50
24514,Syrian Arab Rep.,2006,2006Syrian Arab Rep.,0,0,0,0,0,28,28,0,0,0,0,0,72,72,100
24515,Syrian Arab Rep.,2006,2006Syrian Arab Rep.,0,0,0,0,0,46,46,0,0,0,0,0,170,170,216
24516,Syrian Arab Rep.,2006,2006Syrian Arab Rep.,0,0,0,0,0,139,139,0,0,0,0,0,249,249,388
24517,Syrian Arab Rep.,2006,2006Syrian Arab Rep.,0,0,5,0,0,0,5,0,0,0,0,0,0,0,5
24518,Syrian Arab Rep.,2006,2006Syrian Arab Rep.,0,0,5,5,0,0,10,0,5,0,10,0,0,15,25
24519,Syrian Arab Rep.,2006,2006Syrian Arab Rep.,0,0,7,0,0,0,7,0,0,0,0,0,0,0,7
24520,Syrian Arab Rep.,2006,2006Syrian Arab Rep.,0,6,0,0,0,0,6,0,0,0,0,0,0,0,6
24521,Syrian Arab Rep.,2006,2006Syrian Arab Rep.,0,7,0,9,0,0,16,0,9,0,12,5,0,26,42
24522,Syrian Arab Rep.,2006,2006Syrian Arab Rep.,5,0,7,17,0,0,29,7,6,8,21,0,0,42,71
24523,Syrian Arab Rep.,2006,2006Syrian Arab Rep.,23,65,51,189,19,0,347,26,54,43,159,34,0,316,663
24524,Syrian Arab Rep.,2007,2007Syrian Arab Rep.,0,0,0,0,0,0,0,0,0,0,0,0,0,0,12078
24525,Syrian Arab Rep.,2007,2007Syrian Arab Rep.,0,0,0,0,0,0,0,0,0,0,0,0,36,36,36
24526,Syrian Arab Rep.,2007,2007Syrian Arab Rep.,0,0,0,0,0,0,0,0,0,0,5,0,0,5,25
24527,Syrian Arab Rep.,2007,2007Syrian Arab Rep.,0,0,0,0,0,0,0,0,0,0,11,0,0,11,11
24528,Syrian Arab Rep.,2007,2007Syrian Arab Rep.,0,0,0,0,0,37,37,0,0,0,0,0,77,77,114
24529,Syrian Arab Rep.,2007,2007Syrian Arab Rep.,0,0,0,0,0,45,45,0,0,0,0,0,172,172,217
24530,Syrian Arab Rep.,2007,2007Syrian Arab Rep.,0,0,0,5,0,0,5,0,0,0,0,0,0,0,5
24531,Syrian Arab Rep.,2007,2007Syrian Arab Rep.,0,0,0,5,0,0,5,0,0,0,5,0,0,5,10
24532,Syrian Arab Rep.,2007,2007Syrian Arab Rep.,0,0,0,12,0,0,12,7,0,0,11,0,0,18,30
24533,Syrian Arab Rep.,2007,2007Syrian Arab Rep.,0,0,5,0,0,0,5,0,0,0,0,0,0,0,5
24534,Syrian Arab Rep.,2007,2007Syrian Arab Rep.,0,0,5,6,0,0,11,0,5,5,11,0,0,21,32
24535,Syrian Arab Rep.,2007,2007Syrian Arab Rep.,0,0,7,0,0,0,7,0,0,0,0,0,0,0,7
24536,Syrian Arab Rep.,2007,2007Syrian Arab Rep.,0,6,0,8,0,0,14,0,9,0,13,5,0,27,41
24537,Syrian Arab Rep.,2007,2007Syrian Arab Rep.,0,7,0,11,0,0,18,0,6,0,5,0,0,11,48
24538,Syrian Arab Rep.,2007,2007Syrian Arab Rep.,5,0,0,0,0,0,5,0,0,0,0,0,0,0,5
24539,Syrian Arab Rep.,2007,2007Syrian Arab Rep.,11,17,9,51,0,70,158,13,28,18,125,0,88,272,430
24540,Syrian Arab Rep.,2007,2007Syrian Arab Rep.,19,61,40,176,14,0,310,11,47,41,155,26,0,280,590
24541,Syrian Arab Rep.,2008,2008Syrian Arab Rep.,0,0,0,0,0,0,0,0,0,0,0,0,0,0,13341
24542,Syrian Arab Rep.,2008,2008Syrian Arab Rep.,0,0,0,0,0,0,0,0,0,0,5,0,0,5,15
24543,Syrian Arab Rep.,2008,2008Syrian Arab Rep.,0,0,0,0,0,0,0,0,0,0,9,0,0,9,9
24544,Syrian Arab Rep.,2008,2008Syrian Arab Rep.,0,0,0,0,0,0,0,0,0,0,12,0,0,12,12
24545,Syrian Arab Rep.,2008,2008Syrian Arab Rep.,0,0,0,0,0,0,0,0,0,0,39,0,0,39,39
24546,Syrian Arab Rep.,2008,2008Syrian Arab Rep.,0,0,0,0,0,0,0,0,0,5,0,0,0,5,14
24547,Syrian Arab Rep.,2008,2008Syrian Arab Rep.,0,0,0,0,0,0,0,0,6,0,6,0,0,12,12
24548,Syrian Arab Rep.,2008,2008Syrian Arab Rep.,0,0,0,0,0,42,42,0,0,0,0,0,110,110,152
24549,Syrian Arab Rep.,2008,2008Syrian Arab Rep.,0,0,0,0,0,55,55,0,0,0,0,0,178,178,233
24550,Syrian Arab Rep.,2008,2008Syrian Arab Rep.,0,0,0,5,0,0,5,0,0,0,5,0,0,5,10
24551,Syrian Arab Rep.,2008,2008Syrian Arab Rep.,0,0,0,7,0,0,7,0,0,0,0,0,0,0,14
24552,Syrian Arab Rep.,2008,2008Syrian Arab Rep.,0,0,0,8,0,0,8,7,0,0,6,0,0,13,21
24553,Syrian Arab Rep.,2008,2008Syrian Arab Rep.,0,0,5,5,0,0,10,5,0,6,11,0,0,22,32
24554,Syrian Arab Rep.,2008,2008Syrian Arab Rep.,0,0,6,11,0,0,17,0,0,8,14,5,0,27,44
24555,Syrian Arab Rep.,2008,2008Syrian Arab Rep.,0,5,5,20,0,0,30,0,8,0,21,0,0,29,84
24556,Syrian Arab Rep.,2008,2008Syrian Arab Rep.,0,8,0,0,0,0,8,0,0,6,0,0,0,6,14
24557,Syrian Arab Rep.,2008,2008Syrian Arab Rep.,10,58,50,138,11,0,267,9,41,34,152,31,0,267,534
24558,Syrian Arab Rep.,2008,2008Syrian Arab Rep.,16,34,15,80,0,90,235,24,41,22,184,5,115,391,626
24559,Syrian Arab Rep.,2009,2009Syrian Arab Rep.,0,0,0,0,0,0,0,0,0,0,0,0,0,0,5692
24560,Syrian Arab Rep.,2009,2009Syrian Arab Rep.,0,0,0,0,0,0,0,0,0,0,5,0,0,5,15
24561,Syrian Arab Rep.,2009,2009Syrian Arab Rep.,0,0,0,0,0,0,0,0,0,0,9,0,0,9,9
24562,Syrian Arab Rep.,2009,2009Syrian Arab Rep.,0,0,0,0,0,0,0,0,0,0,10,0,0,10,10
24563,Syrian Arab Rep.,2009,2009Syrian Arab Rep.,0,0,0,0,0,0,0,0,8,0,0,0,0,8,8
24564,Syrian Arab Rep.,2009,2009Syrian Arab Rep.,0,0,0,0,0,50,50,0,0,0,0,0,127,127,177
24565,Syrian Arab Rep.,2009,2009Syrian Arab Rep.,0,0,0,5,0,0,5,0,0,0,5,0,0,5,10
24566,Syrian Arab Rep.,2009,2009Syrian Arab Rep.,0,0,0,7,0,0,7,0,0,0,0,0,0,0,14
24567,Syrian Arab Rep.,2009,2009Syrian Arab Rep.,0,0,0,8,0,0,8,0,6,0,7,0,0,13,21
24568,Syrian Arab Rep.,2009,2009Syrian Arab Rep.,0,0,6,0,0,0,6,0,0,0,36,0,0,36,42
24569,Syrian Arab Rep.,2009,2009Syrian Arab Rep.,0,0,9,0,0,0,9,0,0,0,5,0,0,5,14
24570,Syrian Arab Rep.,2009,2009Syrian Arab Rep.,0,5,0,7,0,0,12,0,5,5,18,0,0,28,40
24571,Syrian Arab Rep.,2009,2009Syrian Arab Rep.,5,0,6,20,0,0,31,0,9,0,20,0,0,29,90
24572,Syrian Arab Rep.,2009,2009Syrian Arab Rep.,14,11,15,27,0,0,67,7,10,15,34,5,0,71,138
24573,Syrian Arab Rep.,2009,2009Syrian Arab Rep.,19,32,16,78,5,110,260,22,46,26,165,5,137,401,661
24574,Syrian Arab Rep.,2009,2009Syrian Arab Rep.,19,35,75,149,13,0,291,29,74,80,238,45,0,466,757
24575,Syrian Arab Rep.,2009,2009Syrian Arab Rep.,218,590,670,2840,283,0,4601,219,671,715,3738,273,0,5616,10217
24576,Syrian Arab Rep.,2010,2010Syrian Arab Rep.,0,0,0,0,0,0,0,0,0,0,0,0,0,0,5973
24577,Syrian Arab Rep.,2010,2010Syrian Arab Rep.,0,0,0,0,0,0,0,0,0,0,5,0,0,5,32
24578,Syrian Arab Rep.,2010,2010Syrian Arab Rep.,0,0,0,0,0,0,0,0,0,0,8,0,0,8,8
24579,Syrian Arab Rep.,2010,2010Syrian Arab Rep.,0,0,0,0,0,0,0,0,0,0,10,0,0,10,10
24580,Syrian Arab Rep.,2010,2010Syrian Arab Rep.,0,0,0,0,0,0,0,0,0,9,0,0,0,9,9
24581,Syrian Arab Rep.,2010,2010Syrian Arab Rep.,0,0,0,0,0,6,6,0,0,0,0,0,36,36,42
24582,Syrian Arab Rep.,2010,2010Syrian Arab Rep.,0,0,0,0,0,61,61,0,0,0,0,0,168,168,229
24583,Syrian Arab Rep.,2010,2010Syrian Arab Rep.,0,0,0,0,0,72,72,0,0,0,0,0,208,208,280
24584,Syrian Arab Rep.,2010,2010Syrian Arab Rep.,0,0,0,7,0,0,7,0,0,0,0,0,0,0,7
24585,Syrian Arab Rep.,2010,2010Syrian Arab Rep.,0,0,0,8,0,0,8,0,0,0,0,0,0,0,8
24586,Syrian Arab Rep.,2010,2010Syrian Arab Rep.,0,0,0,9,0,0,9,0,0,0,0,0,0,0,9
24587,Syrian Arab Rep.,2010,2010Syrian Arab Rep.,0,0,5,0,0,0,5,0,0,0,6,0,0,6,11
24588,Syrian Arab Rep.,2010,2010Syrian Arab Rep.,0,0,5,6,0,0,11,5,0,9,9,0,0,23,34
24589,Syrian Arab Rep.,2010,2010Syrian Arab Rep.,0,0,9,0,0,0,9,0,0,0,5,0,0,5,14
24590,Syrian Arab Rep.,2010,2010Syrian Arab Rep.,0,5,0,0,0,0,5,0,0,0,0,0,0,0,5
24591,Syrian Arab Rep.,2010,2010Syrian Arab Rep.,0,9,6,19,0,0,34,0,0,8,10,0,0,18,52
24592,Syrian Arab Rep.,2010,2010Syrian Arab Rep.,5,0,6,12,0,0,23,0,5,0,12,0,0,17,64
24593,Syrian Arab Rep.,2010,2010Syrian Arab Rep.,8,21,27,41,0,0,97,9,11,21,53,7,0,101,198
24594,Syrian Arab Rep.,2010,2010Syrian Arab Rep.,15,24,17,70,5,0,131,12,19,21,66,5,0,123,254
24595,Syrian Arab Rep.,2010,2010Syrian Arab Rep.,19,34,20,86,0,120,279,28,41,31,149,5,161,415,694
24596,Syrian Arab Rep.,2010,2010Syrian Arab Rep.,220,604,675,2973,305,0,4777,205,639,749,3860,288,0,5741,10518
24597,Syrian Arab Rep.,2011,2011Syrian Arab Rep.,0,0,0,0,0,0,0,0,0,0,0,0,0,0,6619
24598,Syrian Arab Rep.,2011,2011Syrian Arab Rep.,0,0,0,0,0,0,0,0,0,0,5,0,0,5,23
24599,Syrian Arab Rep.,2011,2011Syrian Arab Rep.,0,0,0,0,0,0,0,0,0,0,6,0,0,6,6
24600,Syrian Arab Rep.,2011,2011Syrian Arab Rep.,0,0,0,0,0,0,0,0,0,0,9,0,0,9,18
24601,Syrian Arab Rep.,2011,2011Syrian Arab Rep.,0,0,0,0,0,0,0,0,0,0,11,0,0,11,11
24602,Syrian Arab Rep.,2011,2011Syrian Arab Rep.,0,0,0,0,0,0,0,6,0,0,5,0,0,11,11
24603,Syrian Arab Rep.,2011,2011Syrian Arab Rep.,0,0,0,0,0,96,96,0,0,0,0,0,216,216,312
24604,Syrian Arab Rep.,2011,2011Syrian Arab Rep.,0,0,0,0,0,98,98,0,0,0,0,0,253,253,351
24605,Syrian Arab Rep.,2011,2011Syrian Arab Rep.,0,0,0,5,0,0,5,0,0,0,6,0,0,6,11
24606,Syrian Arab Rep.,2011,2011Syrian Arab Rep.,0,0,0,6,0,0,6,0,0,0,0,0,0,0,6
24607,Syrian Arab Rep.,2011,2011Syrian Arab Rep.,0,0,0,7,0,0,7,0,0,0,0,0,0,0,7
24608,Syrian Arab Rep.,2011,2011Syrian Arab Rep.,0,0,0,8,0,0,8,0,0,0,0,0,0,0,8
24609,Syrian Arab Rep.,2011,2011Syrian Arab Rep.,0,0,7,6,0,0,13,5,5,5,9,0,0,24,37
24610,Syrian Arab Rep.,2011,2011Syrian Arab Rep.,0,0,9,0,0,0,9,0,0,0,5,0,0,5,14
24611,Syrian Arab Rep.,2011,2011Syrian Arab Rep.,0,5,0,0,0,0,5,5,0,0,0,0,0,5,10
24612,Syrian Arab Rep.,2011,2011Syrian Arab Rep.,0,5,0,7,0,0,12,0,11,0,19,0,0,30,42
24613,Syrian Arab Rep.,2011,2011Syrian Arab Rep.,0,9,5,46,10,0,70,5,5,6,73,0,0,89,547
24614,Syrian Arab Rep.,2011,2011Syrian Arab Rep.,5,0,0,0,0,0,5,0,0,0,0,0,0,0,10
24615,Syrian Arab Rep.,2011,2011Syrian Arab Rep.,7,0,0,0,0,0,7,0,0,0,12,0,0,12,19
24616,Syrian Arab Rep.,2011,2011Syrian Arab Rep.,9,19,30,39,0,0,97,9,14,13,54,6,0,96,193
24617,Syrian Arab Rep.,2011,2011Syrian Arab Rep.,11,5,8,25,0,0,49,5,9,6,24,0,0,44,124
24618,Syrian Arab Rep.,2011,2011Syrian Arab Rep.,17,31,24,81,6,0,159,13,24,24,89,14,0,164,323
24619,Syrian Arab Rep.,2011,2011Syrian Arab Rep.,46,48,25,141,0,161,421,49,65,50,271,5,213,653,1074
24620,Syrian Arab Rep.,2011,2011Syrian Arab Rep.,194,555,625,2896,313,0,4583,189,567,696,3810,310,0,5572,10155
24621,Syrian Arab Rep.,2012,2012Syrian Arab Rep.,0,0,0,0,0,0,0,0,0,0,0,0,0,0,16524
24622,Syrian Arab Rep.,2012,2012Syrian Arab Rep.,0,0,0,0,0,0,0,0,0,0,5,0,0,5,29
24623,Syrian Arab Rep.,2012,2012Syrian Arab Rep.,0,0,0,0,0,0,0,0,0,0,6,0,0,6,6
24624,Syrian Arab Rep.,2012,2012Syrian Arab Rep.,0,0,0,0,0,0,0,0,0,0,8,0,0,8,152
24625,Syrian Arab Rep.,2012,2012Syrian Arab Rep.,0,0,0,0,0,0,0,0,0,0,10,0,0,10,10
24626,Syrian Arab Rep.,2012,2012Syrian Arab Rep.,0,0,0,0,0,0,0,0,0,0,12,0,0,12,17
24627,Syrian Arab Rep.,2012,2012Syrian Arab Rep.,0,0,0,0,0,0,0,0,0,5,0,0,0,5,15
24628,Syrian Arab Rep.,2012,2012Syrian Arab Rep.,0,0,0,0,0,11,11,0,0,0,0,0,43,43,54
24629,Syrian Arab Rep.,2012,2012Syrian Arab Rep.,0,0,0,0,0,15,15,0,0,0,0,0,48,48,63
24630,Syrian Arab Rep.,2012,2012Syrian Arab Rep.,0,0,0,0,0,112,112,0,0,0,0,0,243,243,355
24631,Syrian Arab Rep.,2012,2012Syrian Arab Rep.,0,0,0,0,0,179,179,0,0,0,0,0,461,461,640
24632,Syrian Arab Rep.,2012,2012Syrian Arab Rep.,0,0,0,5,0,0,5,0,0,0,6,0,0,6,11
24633,Syrian Arab Rep.,2012,2012Syrian Arab Rep.,0,0,0,5,0,0,5,0,0,0,7,0,0,7,12
24634,Syrian Arab Rep.,2012,2012Syrian Arab Rep.,0,0,0,6,0,0,6,0,0,0,0,0,0,0,6
24635,Syrian Arab Rep.,2012,2012Syrian Arab Rep.,0,0,0,7,0,0,7,0,0,0,0,0,0,0,7
24636,Syrian Arab Rep.,2012,2012Syrian Arab Rep.,0,0,0,7,5,0,12,0,0,0,30,0,0,30,42
24637,Syrian Arab Rep.,2012,2012Syrian Arab Rep.,0,0,0,8,0,0,8,0,0,0,0,0,0,0,8
24638,Syrian Arab Rep.,2012,2012Syrian Arab Rep.,0,0,0,9,5,0,14,5,0,0,21,0,0,26,40
24639,Syrian Arab Rep.,2012,2012Syrian Arab Rep.,0,0,0,12,0,0,12,0,6,5,19,0,0,30,42
24640,Syrian Arab Rep.,2012,2012Syrian Arab Rep.,0,0,5,0,0,0,5,0,0,6,0,0,0,6,11
24641,Syrian Arab Rep.,2012,2012Syrian Arab Rep.,0,0,5,0,0,0,5,0,5,6,0,0,0,11,16
24642,Syrian Arab Rep.,2012,2012Syrian Arab Rep.,0,0,7,0,0,0,7,0,0,0,0,0,0,0,7
24643,Syrian Arab Rep.,2012,2012Syrian Arab Rep.,0,0,9,0,0,0,9,0,0,0,5,0,0,5,14
24644,Syrian Arab Rep.,2012,2012Syrian Arab Rep.,0,5,0,0,0,0,5,0,0,0,0,0,0,0,5
24645,Syrian Arab Rep.,2012,2012Syrian Arab Rep.,0,5,0,7,0,0,12,0,0,5,38,0,0,43,55
24646,Syrian Arab Rep.,2012,2012Syrian Arab Rep.,0,9,0,0,0,0,9,6,0,0,0,0,0,6,15
24647,Syrian Arab Rep.,2012,2012Syrian Arab Rep.,5,0,0,0,0,0,5,0,0,0,0,0,0,0,5
24648,Syrian Arab Rep.,2012,2012Syrian Arab Rep.,5,5,0,40,14,0,64,0,5,5,73,8,0,91,533
24649,Syrian Arab Rep.,2012,2012Syrian Arab Rep.,8,9,5,26,5,0,53,10,11,9,47,6,0,83,136
24650,Syrian Arab Rep.,2012,2012Syrian Arab Rep.,15,0,0,5,0,72191,72211,5,0,0,5,0,78947,78957,248466
24651,Syrian Arab Rep.,2012,2012Syrian Arab Rep.,18,19,16,79,0,430,562,20,38,23,140,5,603,829,1391
24652,Syrian Arab Rep.,2012,2012Syrian Arab Rep.,545,1002,1006,4844,465,0,7862,574,1102,1135,7046,446,0,10303,18165
24653,Syrian Arab Rep.,2012,2012Syrian Arab Rep.,835,1131,791,3336,225,0,6318,886,1134,911,3331,256,0,6518,12836
24654,Syrian Arab Rep.,2012,2012Syrian Arab Rep.,4472,3823,2136,10961,500,0,21892,4609,3997,4177,28486,420,0,41689,63586
24655,Syrian Arab Rep.,2012,2012Syrian Arab Rep.,12678,12238,8057,29618,1852,0,64443,13360,13011,8268,26141,1532,0,62312,126939
24656,Syrian Arab Rep.,2012,2012Syrian Arab Rep.,22189,25344,17828,53392,3454,0,122207,20187,25485,19050,49409,2460,0,116591,238798
24657,Syrian Arab Rep.,2013,2013Syrian Arab Rep.,0,0,0,0,0,0,0,0,0,0,0,0,0,0,43069
24658,Syrian Arab Rep.,2013,2013Syrian Arab Rep.,0,0,0,0,0,0,0,0,0,0,5,0,0,5,20
24659,Syrian Arab Rep.,2013,2013Syrian Arab Rep.,0,0,0,0,0,0,0,0,0,0,7,0,0,7,7
24660,Syrian Arab Rep.,2013,2013Syrian Arab Rep.,0,0,0,0,0,0,0,0,0,0,9,0,0,9,27
24661,Syrian Arab Rep.,2013,2013Syrian Arab Rep.,0,0,0,0,0,8,8,0,0,0,0,0,18,18,26
24662,Syrian Arab Rep.,2013,2013Syrian Arab Rep.,0,0,0,0,0,119,119,0,0,0,0,0,299,299,932
24663,Syrian Arab Rep.,2013,2013Syrian Arab Rep.,0,0,0,0,0,150,150,0,0,0,0,0,321,321,1987
24664,Syrian Arab Rep.,2013,2013Syrian Arab Rep.,0,0,0,0,0,522,522,0,0,0,0,0,952,952,1474
24665,Syrian Arab Rep.,2013,2013Syrian Arab Rep.,0,0,0,5,0,0,5,0,0,0,6,0,0,6,11
24666,Syrian Arab Rep.,2013,2013Syrian Arab Rep.,0,0,0,5,0,0,5,0,5,0,6,0,0,11,16
24667,Syrian Arab Rep.,2013,2013Syrian Arab Rep.,0,0,0,5,0,0,5,0,5,0,8,0,0,13,18
24668,Syrian Arab Rep.,2013,2013Syrian Arab Rep.,0,0,0,5,0,0,5,0,6,0,0,0,0,6,18
24669,Syrian Arab Rep.,2013,2013Syrian Arab Rep.,0,0,0,7,0,0,7,0,0,0,0,0,0,0,14
24670,Syrian Arab Rep.,2013,2013Syrian Arab Rep.,0,0,0,7,0,0,7,0,0,0,6,0,0,6,13
24671,Syrian Arab Rep.,2013,2013Syrian Arab Rep.,0,0,0,7,0,0,7,6,0,0,0,0,0,6,13
24672,Syrian Arab Rep.,2013,2013Syrian Arab Rep.,0,0,0,8,0,0,8,0,0,0,0,0,0,0,8
24673,Syrian Arab Rep.,2013,2013Syrian Arab Rep.,0,0,0,9,0,0,9,0,5,0,8,0,0,13,22
24674,Syrian Arab Rep.,2013,2013Syrian Arab Rep.,0,0,0,14,0,0,14,0,0,0,30,0,0,30,44
24675,Syrian Arab Rep.,2013,2013Syrian Arab Rep.,0,0,5,0,0,0,5,0,0,0,0,0,0,0,5
24676,Syrian Arab Rep.,2013,2013Syrian Arab Rep.,0,0,5,0,0,0,5,0,0,0,8,0,0,8,13
24677,Syrian Arab Rep.,2013,2013Syrian Arab Rep.,0,0,5,0,0,0,5,9,0,0,0,0,0,9,14
24678,Syrian Arab Rep.,2013,2013Syrian Arab Rep.,0,0,5,6,0,0,11,0,0,5,6,0,0,11,11090
24679,Syrian Arab Rep.,2013,2013Syrian Arab Rep.,0,0,7,0,0,0,7,0,0,0,8,0,0,8,15
24680,Syrian Arab Rep.,2013,2013Syrian Arab Rep.,0,0,9,0,0,0,9,0,0,0,5,0,0,5,14
24681,Syrian Arab Rep.,2013,2013Syrian Arab Rep.,0,0,15,0,0,0,15,0,0,0,9,0,0,9,24
24682,Syrian Arab Rep.,2013,2013Syrian Arab Rep.,0,5,0,6,0,0,11,0,0,0,24,0,0,24,35
24683,Syrian Arab Rep.,2013,2013Syrian Arab Rep.,0,5,0,11,0,0,16,0,8,5,25,0,0,38,54
24684,Syrian Arab Rep.,2013,2013Syrian Arab Rep.,0,5,34,48,0,0,87,0,5,6,27,0,0,38,585601
24685,Syrian Arab Rep.,2013,2013Syrian Arab Rep.,0,6,0,0,0,0,6,0,0,0,0,0,0,0,6
24686,Syrian Arab Rep.,2013,2013Syrian Arab Rep.,0,9,0,10,0,0,19,0,9,0,20,0,0,29,48
24687,Syrian Arab Rep.,2013,2013Syrian Arab Rep.,0,11,21,71,6,0,109,0,18,9,192,5,0,224,333
24688,Syrian Arab Rep.,2013,2013Syrian Arab Rep.,5,0,0,0,0,0,5,0,0,0,23,0,0,23,33
24689,Syrian Arab Rep.,2013,2013Syrian Arab Rep.,5,0,0,13,5,0,23,0,5,0,38,5,0,48,71
24690,Syrian Arab Rep.,2013,2013Syrian Arab Rep.,5,5,5,22,0,0,37,8,10,5,41,0,0,64,101
24691,Syrian Arab Rep.,2013,2013Syrian Arab Rep.,5,5,6,42,9,0,67,6,14,9,57,6,0,92,159
24692,Syrian Arab Rep.,2013,2013Syrian Arab Rep.,5,6,0,17,5,0,33,0,9,0,92,5,0,106,139
24693,Syrian Arab Rep.,2013,2013Syrian Arab Rep.,6,6,5,17,0,0,34,5,6,5,34,0,0,50,84
24694,Syrian Arab Rep.,2013,2013Syrian Arab Rep.,6,25,5,21,5,0,62,7,12,8,75,0,0,102,164
24695,Syrian Arab Rep.,2013,2013Syrian Arab Rep.,7,0,0,6,0,0,13,0,0,14,9,0,0,23,36
24696,Syrian Arab Rep.,2013,2013Syrian Arab Rep.,9,23,13,127,67,0,239,10,21,13,141,40,0,225,592
24697,Syrian Arab Rep.,2013,2013Syrian Arab Rep.,18,22,6,44,0,0,90,22,12,38,694,0,0,766,856
24698,Syrian Arab Rep.,2013,2013Syrian Arab Rep.,68,93,52,255,10,306,784,80,125,79,544,11,389,1228,2012
24699,Syrian Arab Rep.,2013,2013Syrian Arab Rep.,829,1212,920,5007,496,0,8464,849,1384,1070,9034,452,0,12789,21253
24700,Syrian Arab Rep.,2013,2013Syrian Arab Rep.,1303,1553,826,3825,160,0,7667,1376,1526,1024,5024,179,0,9129,16796
24701,Syrian Arab Rep.,2013,2013Syrian Arab Rep.,9498,11288,7413,33403,2686,0,64288,9931,12011,8596,34108,2725,0,67371,131659
24702,Syrian Arab Rep.,2013,2013Syrian Arab Rep.,15920,14619,9405,44458,2074,0,86476,16264,15628,14722,77984,1735,0,126333,212809
24703,Syrian Arab Rep.,2013,2013Syrian Arab Rep.,54454,58887,40398,138153,11429,0,303321,55582,61177,42248,114747,8229,0,281983,585304
24704,Syrian Arab Rep.,2013,2013Syrian Arab Rep.,83487,84857,51820,201667,12285,0,434116,88680,90144,51251,177593,9500,0,417168,851284
24705,Syrian Arab Rep.,2014,2014Syrian Arab Rep.,0,0,0,0,0,0,0,0,0,0,0,0,0,0,92947
24706,Syrian Arab Rep.,2014,2014Syrian Arab Rep.,0,0,0,0,0,0,0,0,0,0,5,0,0,5,10
24707,Syrian Arab Rep.,2014,2014Syrian Arab Rep.,0,0,0,0,0,0,0,0,0,0,6,0,0,6,18
24708,Syrian Arab Rep.,2014,2014Syrian Arab Rep.,0,0,0,0,0,0,0,0,0,0,7,0,0,7,478
24709,Syrian Arab Rep.,2014,2014Syrian Arab Rep.,0,0,0,0,0,0,0,0,0,0,8,0,0,8,8
24710,Syrian Arab Rep.,2014,2014Syrian Arab Rep.,0,0,0,0,0,0,0,0,0,0,11,0,0,11,11
24711,Syrian Arab Rep.,2014,2014Syrian Arab Rep.,0,0,0,0,0,0,0,0,0,0,19,0,0,19,19
24712,Syrian Arab Rep.,2014,2014Syrian Arab Rep.,0,0,0,0,0,0,0,0,0,5,0,0,0,5,25
24713,Syrian Arab Rep.,2014,2014Syrian Arab Rep.,0,0,0,0,0,0,0,0,5,0,0,0,0,5,10
24714,Syrian Arab Rep.,2014,2014Syrian Arab Rep.,0,0,0,0,0,0,0,5,0,0,0,0,0,5,10
24715,Syrian Arab Rep.,2014,2014Syrian Arab Rep.,0,0,0,0,0,9,9,0,0,0,0,0,19,19,28
24716,Syrian Arab Rep.,2014,2014Syrian Arab Rep.,0,0,0,0,0,13,13,0,0,0,0,0,28,28,41
24717,Syrian Arab Rep.,2014,2014Syrian Arab Rep.,0,0,0,0,0,28,28,0,0,0,0,0,31,31,59
24718,Syrian Arab Rep.,2014,2014Syrian Arab Rep.,0,0,0,0,0,1134,1134,0,0,0,0,0,1748,1748,2882
24719,Syrian Arab Rep.,2014,2014Syrian Arab Rep.,0,0,0,5,0,0,5,0,0,0,0,0,0,0,5
24720,Syrian Arab Rep.,2014,2014Syrian Arab Rep.,0,0,0,6,0,0,6,0,0,0,0,0,0,0,6
24721,Syrian Arab Rep.,2014,2014Syrian Arab Rep.,0,0,0,6,0,0,6,0,0,0,14,0,0,14,20
24722,Syrian Arab Rep.,2014,2014Syrian Arab Rep.,0,0,0,6,0,0,6,0,5,0,0,0,0,5,11
24723,Syrian Arab Rep.,2014,2014Syrian Arab Rep.,0,0,0,7,0,0,7,0,0,0,0,0,0,0,7
24724,Syrian Arab Rep.,2014,2014Syrian Arab Rep.,0,0,0,7,0,0,7,0,0,0,8,0,0,8,15
24725,Syrian Arab Rep.,2014,2014Syrian Arab Rep.,0,0,0,7,0,0,7,0,6,0,14,0,0,20,27
24726,Syrian Arab Rep.,2014,2014Syrian Arab Rep.,0,0,0,8,0,0,8,0,0,0,6,0,0,6,14
24727,Syrian Arab Rep.,2014,2014Syrian Arab Rep.,0,0,0,8,0,0,8,0,0,0,8,0,0,8,16
24728,Syrian Arab Rep.,2014,2014Syrian Arab Rep.,0,0,0,8,0,0,8,0,0,0,12,0,0,12,20
24729,Syrian Arab Rep.,2014,2014Syrian Arab Rep.,0,0,0,9,0,0,9,0,5,0,8,0,0,13,22
24730,Syrian Arab Rep.,2014,2014Syrian Arab Rep.,0,0,0,14,5,0,19,5,0,0,12,5,0,22,41
24731,Syrian Arab Rep.,2014,2014Syrian Arab Rep.,0,0,5,5,0,0,10,0,0,5,5,0,0,10,14994
24732,Syrian Arab Rep.,2014,2014Syrian Arab Rep.,0,0,5,7,0,0,12,0,0,5,8,0,0,13,25
24733,Syrian Arab Rep.,2014,2014Syrian Arab Rep.,0,0,7,6,0,0,13,0,0,0,5,0,0,5,18
24734,Syrian Arab Rep.,2014,2014Syrian Arab Rep.,0,5,0,7,0,0,12,0,0,6,10,0,0,16,28
24735,Syrian Arab Rep.,2014,2014Syrian Arab Rep.,0,5,0,11,0,0,16,0,0,0,56,0,0,56,72
24736,Syrian Arab Rep.,2014,2014Syrian Arab Rep.,0,5,7,9,0,0,21,0,9,6,20,0,0,35,56
24737,Syrian Arab Rep.,2014,2014Syrian Arab Rep.,0,5,10,0,0,0,15,0,0,0,5,0,0,5,20
24738,Syrian Arab Rep.,2014,2014Syrian Arab Rep.,0,6,0,0,0,0,6,0,0,0,0,0,0,0,6
24739,Syrian Arab Rep.,2014,2014Syrian Arab Rep.,0,6,0,0,0,0,6,0,5,0,5,0,0,10,16
24740,Syrian Arab Rep.,2014,2014Syrian Arab Rep.,0,7,0,0,0,0,7,0,0,0,0,0,0,0,7
24741,Syrian Arab Rep.,2014,2014Syrian Arab Rep.,5,0,0,9,0,0,14,0,0,0,0,0,0,0,14
24742,Syrian Arab Rep.,2014,2014Syrian Arab Rep.,5,5,0,22,0,0,32,6,0,0,44,0,0,50,82
24743,Syrian Arab Rep.,2014,2014Syrian Arab Rep.,5,5,5,8,0,0,23,0,7,5,13,0,0,25,48
24744,Syrian Arab Rep.,2014,2014Syrian Arab Rep.,5,6,5,24,5,0,45,0,9,5,122,5,0,141,186
24745,Syrian Arab Rep.,2014,2014Syrian Arab Rep.,6,6,9,66,10,0,97,8,18,11,89,10,0,136,233
24746,Syrian Arab Rep.,2014,2014Syrian Arab Rep.,7,0,0,0,0,0,7,0,0,0,45,0,0,45,52
24747,Syrian Arab Rep.,2014,2014Syrian Arab Rep.,9,0,0,0,0,0,9,0,5,6,23,0,0,34,43
24748,Syrian Arab Rep.,2014,2014Syrian Arab Rep.,14,8,0,18,0,0,40,12,5,7,439,0,0,463,503
24749,Syrian Arab Rep.,2014,2014Syrian Arab Rep.,17,40,19,199,108,0,383,20,27,27,174,54,0,302,705
24750,Syrian Arab Rep.,2014,2014Syrian Arab Rep.,21,18,18,104,9,0,170,30,39,22,180,6,0,277,447
24751,Syrian Arab Rep.,2014,2014Syrian Arab Rep.,23,43,25,100,5,0,196,21,60,24,137,0,0,242,558
24752,Syrian Arab Rep.,2014,2014Syrian Arab Rep.,24,59,40,250,18,0,391,29,75,58,1158,28,0,1348,1739
24753,Syrian Arab Rep.,2014,2014Syrian Arab Rep.,46,56,34,125,10,0,271,41,57,44,228,6,0,376,647
24754,Syrian Arab Rep.,2014,2014Syrian Arab Rep.,51,66,39,248,16,0,420,79,70,58,634,17,0,858,1278
24755,Syrian Arab Rep.,2014,2014Syrian Arab Rep.,60,72,38,182,10,0,362,58,79,40,249,9,0,435,797
24756,Syrian Arab Rep.,2014,2014Syrian Arab Rep.,183,244,139,491,22,0,1079,188,232,158,588,31,0,1197,2276
24757,Syrian Arab Rep.,2014,2014Syrian Arab Rep.,212,275,155,862,99,586,2189,234,298,222,1281,66,871,2972,5161
24758,Syrian Arab Rep.,2014,2014Syrian Arab Rep.,1164,1828,939,4232,182,0,8345,1169,2134,1183,5609,213,0,10308,18653
24759,Syrian Arab Rep.,2014,2014Syrian Arab Rep.,1600,2311,1517,8624,807,0,14859,1576,2586,1966,19251,756,0,26135,40994
24760,Syrian Arab Rep.,2014,2014Syrian Arab Rep.,8810,7875,35680,12433,2848,0,67646,9284,8566,36846,13205,2834,0,70735,138381
24761,Syrian Arab Rep.,2014,2014Syrian Arab Rep.,18298,18970,13409,47799,2280,0,100756,18864,20062,18088,74509,1917,0,133440,234196
24762,Syrian Arab Rep.,2014,2014Syrian Arab Rep.,22362,23159,16184,50709,4049,0,116463,24319,24471,16963,50305,3975,0,120033,1557899
24763,Syrian Arab Rep.,2014,2014Syrian Arab Rep.,51833,64223,40616,147125,12634,0,316431,54699,67760,43277,131825,9120,0,306681,623112
24764,Syrian Arab Rep.,2014,2014Syrian Arab Rep.,104393,125014,72649,286605,18290,0,606951,107270,130784,72845,215940,13704,0,540543,1147494
24765,Syrian Arab Rep.,2015,2015Syrian Arab Rep.,0,0,0,0,0,0,0,0,0,0,0,0,0,0,2652292
24766,Syrian Arab Rep.,2015,2015Syrian Arab Rep.,0,0,0,0,0,0,0,0,0,0,0,0,18,18,476
24767,Syrian Arab Rep.,2015,2015Syrian Arab Rep.,0,0,0,0,0,0,0,0,0,0,5,0,0,5,20
24768,Syrian Arab Rep.,2015,2015Syrian Arab Rep.,0,0,0,0,0,0,0,0,0,0,6,0,0,6,30
24769,Syrian Arab Rep.,2015,2015Syrian Arab Rep.,0,0,0,0,0,0,0,0,0,0,7,0,0,7,14
24770,Syrian Arab Rep.,2015,2015Syrian Arab Rep.,0,0,0,0,0,0,0,0,0,0,8,0,0,8,8
24771,Syrian Arab Rep.,2015,2015Syrian Arab Rep.,0,0,0,0,0,0,0,0,0,0,9,0,0,9,9
24772,Syrian Arab Rep.,2015,2015Syrian Arab Rep.,0,0,0,0,0,0,0,0,0,0,15,0,0,15,15
24773,Syrian Arab Rep.,2015,2015Syrian Arab Rep.,0,0,0,0,0,0,0,0,0,0,22,0,0,22,22
24774,Syrian Arab Rep.,2015,2015Syrian Arab Rep.,0,0,0,0,0,0,0,0,0,5,12,0,0,17,23
24775,Syrian Arab Rep.,2015,2015Syrian Arab Rep.,0,0,0,0,0,0,0,0,0,5,26,5,0,36,36
24776,Syrian Arab Rep.,2015,2015Syrian Arab Rep.,0,0,0,0,0,0,0,0,0,9,0,0,0,9,9
24777,Syrian Arab Rep.,2015,2015Syrian Arab Rep.,0,0,0,0,0,0,0,0,8,0,6,0,0,14,14
24778,Syrian Arab Rep.,2015,2015Syrian Arab Rep.,0,0,0,0,0,0,0,5,0,0,0,0,0,5,5
24779,Syrian Arab Rep.,2015,2015Syrian Arab Rep.,0,0,0,0,0,59,59,0,0,0,0,0,340,340,399
24780,Syrian Arab Rep.,2015,2015Syrian Arab Rep.,0,0,0,0,0,76,76,0,0,0,0,0,101,101,177
24781,Syrian Arab Rep.,2015,2015Syrian Arab Rep.,0,0,0,0,0,1615,1615,0,0,0,0,0,2624,2624,4239
24782,Syrian Arab Rep.,2015,2015Syrian Arab Rep.,0,0,0,0,0,2110,2110,0,0,0,0,0,3069,3069,5179
24783,Syrian Arab Rep.,2015,2015Syrian Arab Rep.,0,0,0,5,0,0,5,0,0,5,5,0,0,10,15
24784,Syrian Arab Rep.,2015,2015Syrian Arab Rep.,0,0,0,6,0,0,6,0,7,0,0,0,0,7,13
24785,Syrian Arab Rep.,2015,2015Syrian Arab Rep.,0,0,0,7,0,0,7,0,0,0,0,0,0,0,14
24786,Syrian Arab Rep.,2015,2015Syrian Arab Rep.,0,0,0,7,0,0,7,0,0,5,5,0,0,10,17
24787,Syrian Arab Rep.,2015,2015Syrian Arab Rep.,0,0,0,7,0,0,7,0,0,5,11,0,0,16,23
24788,Syrian Arab Rep.,2015,2015Syrian Arab Rep.,0,0,0,7,0,0,7,0,0,5,20,0,0,25,32
24789,Syrian Arab Rep.,2015,2015Syrian Arab Rep.,0,0,0,7,0,0,7,7,0,0,10,0,0,17,24
24790,Syrian Arab Rep.,2015,2015Syrian Arab Rep.,0,0,0,8,0,0,8,0,0,0,6,0,0,6,14
24791,Syrian Arab Rep.,2015,2015Syrian Arab Rep.,0,0,0,9,0,0,9,0,0,0,0,0,0,0,9
24792,Syrian Arab Rep.,2015,2015Syrian Arab Rep.,0,0,0,9,0,0,9,0,0,0,5,0,0,5,14
24793,Syrian Arab Rep.,2015,2015Syrian Arab Rep.,0,0,0,9,0,0,9,0,5,0,9,0,0,14,23
24794,Syrian Arab Rep.,2015,2015Syrian Arab Rep.,0,0,5,0,0,0,5,0,0,0,6,0,0,6,11
24795,Syrian Arab Rep.,2015,2015Syrian Arab Rep.,0,0,5,5,0,0,10,0,5,0,5,0,0,10,20
24796,Syrian Arab Rep.,2015,2015Syrian Arab Rep.,0,0,5,6,0,295,306,0,0,5,6,0,294,305,16611
24797,Syrian Arab Rep.,2015,2015Syrian Arab Rep.,0,0,5,12,0,0,17,0,0,5,14,0,0,19,36
24798,Syrian Arab Rep.,2015,2015Syrian Arab Rep.,0,0,6,0,0,0,6,0,0,0,8,0,0,8,14
24799,Syrian Arab Rep.,2015,2015Syrian Arab Rep.,0,0,7,11,0,0,18,5,8,0,24,0,0,37,55
24800,Syrian Arab Rep.,2015,2015Syrian Arab Rep.,0,0,16,0,0,0,16,0,0,11,20,0,0,31,47
24801,Syrian Arab Rep.,2015,2015Syrian Arab Rep.,0,5,0,0,0,0,5,0,0,0,0,0,0,0,10
24802,Syrian Arab Rep.,2015,2015Syrian Arab Rep.,0,5,0,0,0,0,5,0,0,0,11,0,0,11,16
24803,Syrian Arab Rep.,2015,2015Syrian Arab Rep.,0,5,0,5,0,0,10,0,0,5,15,0,0,20,30
24804,Syrian Arab Rep.,2015,2015Syrian Arab Rep.,0,5,5,12,0,0,22,0,5,0,14,0,0,19,41
24805,Syrian Arab Rep.,2015,2015Syrian Arab Rep.,0,5,5,20,6,0,36,0,5,0,63,5,0,73,109
24806,Syrian Arab Rep.,2015,2015Syrian Arab Rep.,0,5,5,22,5,0,37,0,6,5,29,5,0,45,475
24807,Syrian Arab Rep.,2015,2015Syrian Arab Rep.,0,6,0,0,0,0,6,0,0,0,0,0,0,0,6
24808,Syrian Arab Rep.,2015,2015Syrian Arab Rep.,0,6,0,6,0,0,12,0,0,0,18,0,0,18,30
24809,Syrian Arab Rep.,2015,2015Syrian Arab Rep.,0,136,44,396,31,0,607,0,158,76,1395,35,0,1664,2271
24810,Syrian Arab Rep.,2015,2015Syrian Arab Rep.,5,0,0,6,0,0,11,0,7,0,23,0,0,30,41
24811,Syrian Arab Rep.,2015,2015Syrian Arab Rep.,5,7,5,10,0,0,27,5,8,5,13,0,0,31,58
24812,Syrian Arab Rep.,2015,2015Syrian Arab Rep.,5,7,6,36,0,0,54,5,8,6,24,0,0,43,97
24813,Syrian Arab Rep.,2015,2015Syrian Arab Rep.,5,7,11,82,12,0,117,5,20,16,103,15,0,159,276
24814,Syrian Arab Rep.,2015,2015Syrian Arab Rep.,5,31,0,34,0,0,70,12,16,18,524,0,0,570,646
24815,Syrian Arab Rep.,2015,2015Syrian Arab Rep.,6,7,0,23,0,0,36,0,8,0,51,0,0,59,95
24816,Syrian Arab Rep.,2015,2015Syrian Arab Rep.,8,7,5,33,0,0,53,0,11,6,131,5,0,153,206
24817,Syrian Arab Rep.,2015,2015Syrian Arab Rep.,8,10,0,17,0,0,35,7,10,5,25,0,0,47,82
24818,Syrian Arab Rep.,2015,2015Syrian Arab Rep.,9,0,0,18,0,0,27,0,6,0,105,0,0,111,138
24819,Syrian Arab Rep.,2015,2015Syrian Arab Rep.,9,16,0,0,0,0,25,0,10,8,18,0,0,36,61
24820,Syrian Arab Rep.,2015,2015Syrian Arab Rep.,10,18,16,57,5,0,106,11,14,12,67,5,0,109,215
24821,Syrian Arab Rep.,2015,2015Syrian Arab Rep.,20,20,20,98,12,0,170,27,42,29,196,9,0,303,473
24822,Syrian Arab Rep.,2015,2015Syrian Arab Rep.,28,48,16,115,5,0,212,24,48,23,192,0,0,287,499
24823,Syrian Arab Rep.,2015,2015Syrian Arab Rep.,74,85,54,314,24,0,551,103,89,76,749,23,0,1040,1591
24824,Syrian Arab Rep.,2015,2015Syrian Arab Rep.,185,300,185,705,39,0,1414,194,315,191,854,43,0,1597,3011
24825,Syrian Arab Rep.,2015,2015Syrian Arab Rep.,193,268,126,609,28,0,1224,176,302,158,804,28,0,1468,2692
24826,Syrian Arab Rep.,2015,2015Syrian Arab Rep.,242,260,154,553,32,0,1241,230,276,192,648,32,0,1378,2619
24827,Syrian Arab Rep.,2015,2015Syrian Arab Rep.,294,394,289,1386,178,0,2541,317,443,366,2478,115,0,3719,8695
24828,Syrian Arab Rep.,2015,2015Syrian Arab Rep.,3608,5300,3147,19732,1620,0,33407,3855,6194,5147,65467,1534,0,82197,115604
24829,Syrian Arab Rep.,2015,2015Syrian Arab Rep.,6616,11136,6890,30497,2529,0,57668,7016,11794,7361,31184,2612,0,59967,117635
24830,Syrian Arab Rep.,2015,2015Syrian Arab Rep.,17983,18946,11302,55610,3045,0,106886,18566,19933,13996,82589,2672,0,137756,244642
24831,Syrian Arab Rep.,2015,2015Syrian Arab Rep.,47134,67643,41629,149579,13453,0,319438,49724,71487,43927,133962,9685,0,308785,628223
24832,Syrian Arab Rep.,2015,2015Syrian Arab Rep.,95463,116578,65823,256675,15372,0,549911,99684,122887,67918,210218,12072,0,512779,1062690
24833,Syrian Arab Rep.,2016,2016Syrian Arab Rep.,0,0,0,0,0,0,0,0,0,0,0,0,0,0,3076555
24834,Syrian Arab Rep.,2016,2016Syrian Arab Rep.,0,0,0,0,0,0,0,0,0,0,5,0,0,5,30
24835,Syrian Arab Rep.,2016,2016Syrian Arab Rep.,0,0,0,0,0,0,0,0,0,0,6,0,0,6,6
24836,Syrian Arab Rep.,2016,2016Syrian Arab Rep.,0,0,0,0,0,0,0,0,0,0,7,0,0,7,7
24837,Syrian Arab Rep.,2016,2016Syrian Arab Rep.,0,0,0,0,0,0,0,0,0,0,8,0,0,8,8
24838,Syrian Arab Rep.,2016,2016Syrian Arab Rep.,0,0,0,0,0,0,0,0,0,0,9,0,0,9,9
24839,Syrian Arab Rep.,2016,2016Syrian Arab Rep.,0,0,0,0,0,0,0,0,0,8,0,0,0,8,8
24840,Syrian Arab Rep.,2016,2016Syrian Arab Rep.,0,0,0,0,0,0,0,0,7,0,0,0,0,7,7
24841,Syrian Arab Rep.,2016,2016Syrian Arab Rep.,0,0,0,0,0,8,8,0,0,0,0,0,0,0,8
24842,Syrian Arab Rep.,2016,2016Syrian Arab Rep.,0,0,0,0,0,19,19,0,0,0,0,0,25,25,44
24843,Syrian Arab Rep.,2016,2016Syrian Arab Rep.,0,0,0,0,0,72,72,0,0,0,0,0,374,374,446
24844,Syrian Arab Rep.,2016,2016Syrian Arab Rep.,0,0,0,0,0,267,267,0,0,0,0,0,419,419,686
24845,Syrian Arab Rep.,2016,2016Syrian Arab Rep.,0,0,0,0,0,2926,2926,0,0,0,0,0,6154,6154,9080
24846,Syrian Arab Rep.,2016,2016Syrian Arab Rep.,0,0,0,0,0,3881,3881,0,0,0,0,0,5110,5110,8991
24847,Syrian Arab Rep.,2016,2016Syrian Arab Rep.,0,0,0,5,0,0,5,0,0,0,0,0,0,0,5
24848,Syrian Arab Rep.,2016,2016Syrian Arab Rep.,0,0,0,5,0,0,5,0,0,0,26,0,0,26,31
24849,Syrian Arab Rep.,2016,2016Syrian Arab Rep.,0,0,0,5,0,0,5,0,0,0,46,0,0,46,51
24850,Syrian Arab Rep.,2016,2016Syrian Arab Rep.,0,0,0,5,0,0,5,0,0,8,0,0,0,8,13
24851,Syrian Arab Rep.,2016,2016Syrian Arab Rep.,0,0,0,6,0,0,6,0,0,5,8,0,0,13,747
24852,Syrian Arab Rep.,2016,2016Syrian Arab Rep.,0,0,0,6,0,0,6,0,5,0,6,0,0,11,17
24853,Syrian Arab Rep.,2016,2016Syrian Arab Rep.,0,0,0,7,0,0,7,0,0,0,0,0,0,0,7
24854,Syrian Arab Rep.,2016,2016Syrian Arab Rep.,0,0,0,7,0,0,7,0,0,0,12,0,0,12,19
24855,Syrian Arab Rep.,2016,2016Syrian Arab Rep.,0,0,0,8,0,0,8,0,0,0,0,7,0,7,15
24856,Syrian Arab Rep.,2016,2016Syrian Arab Rep.,0,0,0,9,0,0,9,0,0,0,14,0,0,14,23
24857,Syrian Arab Rep.,2016,2016Syrian Arab Rep.,0,0,5,0,0,0,5,0,0,0,8,0,0,8,13
24858,Syrian Arab Rep.,2016,2016Syrian Arab Rep.,0,0,5,0,0,0,5,0,0,0,25,0,0,25,30
24859,Syrian Arab Rep.,2016,2016Syrian Arab Rep.,0,0,5,5,0,0,10,0,0,0,9,0,0,9,19
24860,Syrian Arab Rep.,2016,2016Syrian Arab Rep.,0,0,8,10,0,0,18,0,5,5,8,0,0,18,50
24861,Syrian Arab Rep.,2016,2016Syrian Arab Rep.,0,5,0,0,0,0,5,0,0,0,0,0,0,0,10
24862,Syrian Arab Rep.,2016,2016Syrian Arab Rep.,0,5,0,0,0,0,5,0,0,0,5,0,0,5,10
24863,Syrian Arab Rep.,2016,2016Syrian Arab Rep.,0,5,0,0,0,0,5,0,0,0,6,0,0,6,11
24864,Syrian Arab Rep.,2016,2016Syrian Arab Rep.,0,5,0,0,0,0,5,5,0,0,5,0,0,10,15
24865,Syrian Arab Rep.,2016,2016Syrian Arab Rep.,0,5,0,0,0,0,5,6,0,0,0,0,0,6,11
24866,Syrian Arab Rep.,2016,2016Syrian Arab Rep.,0,5,0,8,0,0,13,0,0,5,9,0,0,14,14626
24867,Syrian Arab Rep.,2016,2016Syrian Arab Rep.,0,5,0,12,0,0,17,0,0,8,63,0,0,71,88
24868,Syrian Arab Rep.,2016,2016Syrian Arab Rep.,0,5,5,22,5,0,37,0,6,5,31,5,0,47,425
24869,Syrian Arab Rep.,2016,2016Syrian Arab Rep.,0,6,0,0,0,0,6,0,0,0,7,0,0,7,13
24870,Syrian Arab Rep.,2016,2016Syrian Arab Rep.,0,6,0,12,0,0,18,0,7,8,33,0,0,48,66
24871,Syrian Arab Rep.,2016,2016Syrian Arab Rep.,0,6,5,12,0,0,23,5,0,0,11,0,0,16,39
24872,Syrian Arab Rep.,2016,2016Syrian Arab Rep.,0,7,5,16,0,0,28,0,8,9,15,0,0,32,60
24873,Syrian Arab Rep.,2016,2016Syrian Arab Rep.,0,8,0,0,0,0,8,0,0,0,0,0,0,0,8
24874,Syrian Arab Rep.,2016,2016Syrian Arab Rep.,0,14,0,6,0,0,20,0,6,0,51,0,0,57,77
24875,Syrian Arab Rep.,2016,2016Syrian Arab Rep.,0,22,31,6,0,0,59,6,21,27,6,0,0,60,119
24876,Syrian Arab Rep.,2016,2016Syrian Arab Rep.,5,0,0,0,0,0,5,0,0,0,0,0,0,0,5
24877,Syrian Arab Rep.,2016,2016Syrian Arab Rep.,5,0,0,5,0,0,10,0,5,0,5,0,0,10,20
24878,Syrian Arab Rep.,2016,2016Syrian Arab Rep.,5,0,5,14,0,0,24,0,8,0,28,0,0,36,60
24879,Syrian Arab Rep.,2016,2016Syrian Arab Rep.,5,5,0,12,0,0,22,0,5,0,5,0,0,10,32
24880,Syrian Arab Rep.,2016,2016Syrian Arab Rep.,5,13,13,102,13,0,146,6,26,24,137,18,0,211,357
24881,Syrian Arab Rep.,2016,2016Syrian Arab Rep.,5,14,7,28,0,0,54,8,13,5,60,5,0,91,145
24882,Syrian Arab Rep.,2016,2016Syrian Arab Rep.,5,14,8,82,17,0,126,6,10,20,121,21,0,178,2757
24883,Syrian Arab Rep.,2016,2016Syrian Arab Rep.,5,147,52,450,39,0,693,6,166,81,1603,42,0,1898,2591
24884,Syrian Arab Rep.,2016,2016Syrian Arab Rep.,6,10,0,35,0,0,51,0,10,5,52,0,0,67,118
24885,Syrian Arab Rep.,2016,2016Syrian Arab Rep.,6,16,9,47,0,0,78,10,11,9,34,0,0,64,142
24886,Syrian Arab Rep.,2016,2016Syrian Arab Rep.,7,0,0,13,0,0,20,5,6,0,34,0,0,45,65
24887,Syrian Arab Rep.,2016,2016Syrian Arab Rep.,7,11,5,36,0,0,59,5,8,5,136,5,0,159,218
24888,Syrian Arab Rep.,2016,2016Syrian Arab Rep.,8,14,14,50,9,0,95,8,11,5,116,8,0,148,243
24889,Syrian Arab Rep.,2016,2016Syrian Arab Rep.,10,7,6,47,5,0,75,6,13,6,163,5,0,193,268
24890,Syrian Arab Rep.,2016,2016Syrian Arab Rep.,18,39,34,109,8,0,208,15,24,28,133,9,0,209,417
24891,Syrian Arab Rep.,2016,2016Syrian Arab Rep.,23,32,21,115,5,0,196,34,0,30,83,5,45,197,230836
24892,Syrian Arab Rep.,2016,2016Syrian Arab Rep.,30,32,11,128,5,0,206,20,49,45,184,0,0,298,504
24893,Syrian Arab Rep.,2016,2016Syrian Arab Rep.,41,41,11,90,5,0,188,45,29,14,600,0,0,688,876
24894,Syrian Arab Rep.,2016,2016Syrian Arab Rep.,42,25,17,125,0,0,209,43,13,24,164,5,0,249,458
24895,Syrian Arab Rep.,2016,2016Syrian Arab Rep.,86,96,68,356,30,0,636,105,114,76,814,30,0,1139,1775
24896,Syrian Arab Rep.,2016,2016Syrian Arab Rep.,143,322,215,792,48,0,1520,172,326,222,946,63,0,1729,3249
24897,Syrian Arab Rep.,2016,2016Syrian Arab Rep.,253,340,231,686,45,0,1555,248,331,228,837,43,0,1687,3242
24898,Syrian Arab Rep.,2016,2016Syrian Arab Rep.,324,480,326,1455,186,2124,4895,381,520,440,1888,120,2915,6264,11159
24899,Syrian Arab Rep.,2016,2016Syrian Arab Rep.,395,643,370,1599,66,0,3073,420,736,483,2195,90,0,3924,6997
24900,Syrian Arab Rep.,2016,2016Syrian Arab Rep.,6519,11166,6916,29986,2566,0,57153,6834,11713,7544,30127,2642,0,58860,116013
24901,Syrian Arab Rep.,2016,2016Syrian Arab Rep.,16243,20415,10899,69053,3291,0,119901,17579,24354,18724,190995,3569,0,255221,375122
24902,Syrian Arab Rep.,2016,2016Syrian Arab Rep.,48161,69590,43099,154167,14264,0,329281,50969,73578,45226,139704,10078,0,319555,648836
24903,Syrian Arab Rep.,2016,2016Syrian Arab Rep.,86670,117548,65930,241509,14922,0,526579,90768,123198,68497,184608,11853,0,478924,1005503
24904,Syrian Arab Rep.,2017,2017Syrian Arab Rep.,0,0,0,0,0,0,0,0,0,0,0,0,0,0,3724083
24905,Syrian Arab Rep.,2017,2017Syrian Arab Rep.,0,0,0,0,0,0,0,0,0,0,0,0,9,9,9
24906,Syrian Arab Rep.,2017,2017Syrian Arab Rep.,0,0,0,0,0,0,0,0,0,0,5,0,0,5,5
24907,Syrian Arab Rep.,2017,2017Syrian Arab Rep.,0,0,0,0,0,0,0,0,0,0,7,0,0,7,21
24908,Syrian Arab Rep.,2017,2017Syrian Arab Rep.,0,0,0,0,0,0,0,0,0,0,8,0,0,8,8
24909,Syrian Arab Rep.,2017,2017Syrian Arab Rep.,0,0,0,0,0,0,0,0,0,0,9,0,0,9,27
24910,Syrian Arab Rep.,2017,2017Syrian Arab Rep.,0,0,0,0,0,0,0,0,0,5,0,0,0,5,5
24911,Syrian Arab Rep.,2017,2017Syrian Arab Rep.,0,0,0,0,0,0,0,0,0,7,0,0,0,7,7
24912,Syrian Arab Rep.,2017,2017Syrian Arab Rep.,0,0,0,0,0,0,0,0,0,9,0,0,0,9,9
24913,Syrian Arab Rep.,2017,2017Syrian Arab Rep.,0,0,0,0,0,20,20,0,0,0,0,0,25,25,45
24914,Syrian Arab Rep.,2017,2017Syrian Arab Rep.,0,0,0,0,0,85,85,0,0,0,0,0,398,398,483
24915,Syrian Arab Rep.,2017,2017Syrian Arab Rep.,0,0,0,0,0,5578,5578,0,0,0,0,0,6942,6942,12520
24916,Syrian Arab Rep.,2017,2017Syrian Arab Rep.,0,0,0,0,5,0,5,0,0,0,0,0,0,0,5
24917,Syrian Arab Rep.,2017,2017Syrian Arab Rep.,0,0,0,0,6,0,6,0,0,0,0,8,0,8,14
24918,Syrian Arab Rep.,2017,2017Syrian Arab Rep.,0,0,0,0,7,0,7,0,0,0,0,0,0,0,7
24919,Syrian Arab Rep.,2017,2017Syrian Arab Rep.,0,0,0,5,0,0,5,0,0,0,0,0,0,0,5
24920,Syrian Arab Rep.,2017,2017Syrian Arab Rep.,0,0,0,5,0,0,5,0,0,0,10,0,0,10,15
24921,Syrian Arab Rep.,2017,2017Syrian Arab Rep.,0,0,0,5,0,0,5,0,0,0,12,0,0,12,17
24922,Syrian Arab Rep.,2017,2017Syrian Arab Rep.,0,0,0,6,0,0,6,0,0,9,0,0,0,9,15
24923,Syrian Arab Rep.,2017,2017Syrian Arab Rep.,0,0,0,8,0,0,8,0,0,0,0,0,0,0,8
24924,Syrian Arab Rep.,2017,2017Syrian Arab Rep.,0,0,0,8,0,0,8,0,0,0,0,7,0,7,15
24925,Syrian Arab Rep.,2017,2017Syrian Arab Rep.,0,0,0,8,0,0,8,0,5,0,40,0,0,45,53
24926,Syrian Arab Rep.,2017,2017Syrian Arab Rep.,0,0,0,9,5,0,14,0,5,0,20,0,0,25,39
24927,Syrian Arab Rep.,2017,2017Syrian Arab Rep.,0,0,0,10,0,0,10,0,0,5,0,0,0,5,73
24928,Syrian Arab Rep.,2017,2017Syrian Arab Rep.,0,0,0,11,0,0,11,0,0,5,53,5,0,63,74
24929,Syrian Arab Rep.,2017,2017Syrian Arab Rep.,0,0,6,8,0,0,14,0,0,0,15,0,0,15,29
24930,Syrian Arab Rep.,2017,2017Syrian Arab Rep.,0,0,6,11,5,0,22,0,8,0,13,0,0,21,43
24931,Syrian Arab Rep.,2017,2017Syrian Arab Rep.,0,0,6,16,0,0,22,0,0,9,13,0,0,22,44
24932,Syrian Arab Rep.,2017,2017Syrian Arab Rep.,0,0,7,12,0,0,19,0,12,0,38,0,0,50,69
24933,Syrian Arab Rep.,2017,2017Syrian Arab Rep.,0,0,8,0,0,0,8,0,0,0,0,0,0,0,8
24934,Syrian Arab Rep.,2017,2017Syrian Arab Rep.,0,5,0,0,0,0,5,0,0,0,0,0,0,0,5
24935,Syrian Arab Rep.,2017,2017Syrian Arab Rep.,0,5,0,0,0,0,5,0,0,7,0,0,0,7,12
24936,Syrian Arab Rep.,2017,2017Syrian Arab Rep.,0,5,0,5,0,0,10,0,0,0,25,0,0,25,35
24937,Syrian Arab Rep.,2017,2017Syrian Arab Rep.,0,5,0,10,0,0,15,0,0,5,11,0,0,16,14680
24938,Syrian Arab Rep.,2017,2017Syrian Arab Rep.,0,5,5,25,5,0,40,0,11,5,34,6,0,56,445
24939,Syrian Arab Rep.,2017,2017Syrian Arab Rep.,0,6,0,0,0,0,6,0,0,0,9,0,0,9,15
24940,Syrian Arab Rep.,2017,2017Syrian Arab Rep.,0,6,0,5,11,0,22,0,5,0,0,7,0,12,34
24941,Syrian Arab Rep.,2017,2017Syrian Arab Rep.,0,6,0,12,0,0,18,0,0,7,28,0,0,35,53
24942,Syrian Arab Rep.,2017,2017Syrian Arab Rep.,0,7,0,9,0,0,16,0,9,0,14,0,0,23,39
24943,Syrian Arab Rep.,2017,2017Syrian Arab Rep.,0,7,5,16,0,0,28,0,8,9,16,0,0,33,61
24944,Syrian Arab Rep.,2017,2017Syrian Arab Rep.,0,8,0,0,0,0,8,0,0,6,0,0,0,6,14
24945,Syrian Arab Rep.,2017,2017Syrian Arab Rep.,0,9,0,9,0,0,18,0,6,0,15,0,0,21,39
24946,Syrian Arab Rep.,2017,2017Syrian Arab Rep.,0,15,5,33,0,0,53,0,8,8,130,5,0,151,204
24947,Syrian Arab Rep.,2017,2017Syrian Arab Rep.,0,18,11,105,17,0,151,5,27,23,143,21,0,219,370
24948,Syrian Arab Rep.,2017,2017Syrian Arab Rep.,5,5,0,19,0,0,29,5,5,5,105,5,0,125,154
24949,Syrian Arab Rep.,2017,2017Syrian Arab Rep.,5,9,15,31,0,0,60,9,10,17,32,0,0,68,128
24950,Syrian Arab Rep.,2017,2017Syrian Arab Rep.,5,12,5,61,5,0,88,33,16,18,148,7,0,222,2905
24951,Syrian Arab Rep.,2017,2017Syrian Arab Rep.,6,14,15,34,0,0,69,12,13,0,73,5,0,103,172
24952,Syrian Arab Rep.,2017,2017Syrian Arab Rep.,7,0,6,15,0,0,28,7,7,0,45,0,0,59,87
24953,Syrian Arab Rep.,2017,2017Syrian Arab Rep.,8,5,0,8,0,0,21,0,8,0,13,0,0,21,42
24954,Syrian Arab Rep.,2017,2017Syrian Arab Rep.,8,13,5,56,5,0,87,15,17,9,194,5,0,240,327
24955,Syrian Arab Rep.,2017,2017Syrian Arab Rep.,10,17,9,55,0,0,91,6,20,18,80,0,0,124,215
24956,Syrian Arab Rep.,2017,2017Syrian Arab Rep.,10,34,15,78,5,0,142,11,23,17,59,5,0,115,257
24957,Syrian Arab Rep.,2017,2017Syrian Arab Rep.,11,13,5,58,0,0,87,13,11,6,77,0,0,107,194
24958,Syrian Arab Rep.,2017,2017Syrian Arab Rep.,13,17,11,86,12,0,139,12,43,19,145,14,0,233,372
24959,Syrian Arab Rep.,2017,2017Syrian Arab Rep.,25,38,28,121,7,0,219,16,34,26,157,12,0,245,464
24960,Syrian Arab Rep.,2017,2017Syrian Arab Rep.,34,52,37,145,11,0,279,33,43,53,185,10,0,324,603
24961,Syrian Arab Rep.,2017,2017Syrian Arab Rep.,50,49,22,161,13,0,295,48,47,24,296,8,0,423,718
24962,Syrian Arab Rep.,2017,2017Syrian Arab Rep.,50,66,14,133,5,0,268,62,32,36,724,0,0,854,1122
24963,Syrian Arab Rep.,2017,2017Syrian Arab Rep.,88,338,227,838,55,0,1546,114,343,249,958,76,0,1740,3286
24964,Syrian Arab Rep.,2017,2017Syrian Arab Rep.,106,116,80,474,33,0,809,114,161,94,1059,45,0,1473,2282
24965,Syrian Arab Rep.,2017,2017Syrian Arab Rep.,196,299,207,625,39,0,1366,195,320,226,794,52,0,1587,2953
24966,Syrian Arab Rep.,2017,2017Syrian Arab Rep.,373,565,349,1671,201,3802,6961,389,627,484,2221,140,2817,6678,13639
24967,Syrian Arab Rep.,2017,2017Syrian Arab Rep.,595,1063,583,2624,124,0,4989,669,1199,777,3458,148,0,6251,11240
24968,Syrian Arab Rep.,2017,2017Syrian Arab Rep.,6833,12043,7277,32090,3030,0,61273,7202,12614,8417,34054,3128,0,65415,126688
24969,Syrian Arab Rep.,2017,2017Syrian Arab Rep.,19447,20578,11292,59897,3603,0,114817,20575,21512,12763,74367,3023,0,132240,247057
24970,Syrian Arab Rep.,2017,2017Syrian Arab Rep.,24513,28751,15968,93786,4531,0,167549,26338,33486,26552,237748,5001,0,329125,496674
24971,Syrian Arab Rep.,2017,2017Syrian Arab Rep.,50049,70376,43150,152346,14186,0,330107,53115,74180,45278,140351,10000,0,322924,653031
24972,Syrian Arab Rep.,2017,2017Syrian Arab Rep.,82179,120660,67565,235244,14300,0,519948,86038,126718,70516,177641,11266,0,472179,992127
24973,Syrian Arab Rep.,2018,2018Syrian Arab Rep.,0,0,0,0,0,0,0,0,0,0,0,0,0,0,331148
24974,Syrian Arab Rep.,2018,2018Syrian Arab Rep.,0,0,0,0,0,0,0,0,0,0,5,0,0,5,20
24975,Syrian Arab Rep.,2018,2018Syrian Arab Rep.,0,0,0,0,0,0,0,0,0,0,6,0,0,6,6
24976,Syrian Arab Rep.,2018,2018Syrian Arab Rep.,0,0,0,0,0,0,0,0,0,0,8,0,0,8,16
24977,Syrian Arab Rep.,2018,2018Syrian Arab Rep.,0,0,0,0,0,0,0,0,0,0,9,0,0,9,9
24978,Syrian Arab Rep.,2018,2018Syrian Arab Rep.,0,0,0,0,0,0,0,0,0,0,10,0,0,10,10
24979,Syrian Arab Rep.,2018,2018Syrian Arab Rep.,0,0,0,0,0,0,0,0,0,9,0,0,0,9,9
24980,Syrian Arab Rep.,2018,2018Syrian Arab Rep.,0,0,0,0,0,0,0,0,5,0,0,0,0,5,5
24981,Syrian Arab Rep.,2018,2018Syrian Arab Rep.,0,0,0,0,0,0,0,5,0,0,7,0,0,12,12
24982,Syrian Arab Rep.,2018,2018Syrian Arab Rep.,0,0,0,0,0,7194,7194,0,0,0,0,0,8628,8628,15822
24983,Syrian Arab Rep.,2018,2018Syrian Arab Rep.,0,0,0,5,0,0,5,0,0,0,0,0,0,0,10
24984,Syrian Arab Rep.,2018,2018Syrian Arab Rep.,0,0,0,5,0,0,5,0,0,0,7,0,0,7,12
24985,Syrian Arab Rep.,2018,2018Syrian Arab Rep.,0,0,0,5,0,0,5,0,0,0,10,0,0,10,15
24986,Syrian Arab Rep.,2018,2018Syrian Arab Rep.,0,0,0,6,0,0,6,0,0,11,12,0,0,23,29
24987,Syrian Arab Rep.,2018,2018Syrian Arab Rep.,0,0,0,7,0,0,7,0,0,0,0,0,0,0,7
24988,Syrian Arab Rep.,2018,2018Syrian Arab Rep.,0,0,0,8,0,0,8,0,0,0,9,0,0,9,17
24989,Syrian Arab Rep.,2018,2018Syrian Arab Rep.,0,0,5,6,0,0,11,0,0,0,11,0,0,11,22
24990,Syrian Arab Rep.,2018,2018Syrian Arab Rep.,0,0,5,18,0,0,23,5,9,0,40,0,0,54,77
24991,Syrian Arab Rep.,2018,2018Syrian Arab Rep.,0,0,6,0,0,0,6,0,0,0,8,0,0,8,14
24992,Syrian Arab Rep.,2018,2018Syrian Arab Rep.,0,0,6,0,0,0,6,0,0,0,9,0,0,9,15
24993,Syrian Arab Rep.,2018,2018Syrian Arab Rep.,0,0,7,11,5,0,23,0,8,0,13,0,0,21,44
24994,Syrian Arab Rep.,2018,2018Syrian Arab Rep.,0,0,8,0,0,0,8,0,0,6,0,0,0,6,14
24995,Syrian Arab Rep.,2018,2018Syrian Arab Rep.,0,5,0,0,0,0,5,0,0,0,0,0,0,0,5
24996,Syrian Arab Rep.,2018,2018Syrian Arab Rep.,0,5,0,0,0,0,5,0,0,0,5,0,0,5,10
24997,Syrian Arab Rep.,2018,2018Syrian Arab Rep.,0,5,0,0,0,0,5,0,0,0,6,0,0,6,11
24998,Syrian Arab Rep.,2018,2018Syrian Arab Rep.,0,5,0,8,0,0,13,5,0,0,45,0,0,50,102
24999,Syrian Arab Rep.,2018,2018Syrian Arab Rep.,0,5,6,7,0,0,18,0,5,0,67,10,5,87,105
25000,Syrian Arab Rep.,2018,2018Syrian Arab Rep.,0,5,10,20,5,0,40,0,9,6,18,0,0,33,73
25001,Syrian Arab Rep.,2018,2018Syrian Arab Rep.,0,6,0,0,0,0,6,0,0,0,9,0,0,9,15
25002,Syrian Arab Rep.,2018,2018Syrian Arab Rep.,0,6,6,15,0,0,27,0,8,9,17,0,0,34,61
25003,Syrian Arab Rep.,2018,2018Syrian Arab Rep.,0,8,6,0,0,0,14,0,0,0,15,0,0,15,29
25004,Syrian Arab Rep.,2018,2018Syrian Arab Rep.,0,9,0,13,0,0,22,0,5,0,7,0,0,12,34
25005,Syrian Arab Rep.,2018,2018Syrian Arab Rep.,0,9,0,25,0,0,34,5,9,0,168,8,0,190,224
25006,Syrian Arab Rep.,2018,2018Syrian Arab Rep.,0,12,11,34,5,0,62,0,8,7,131,5,0,151,213
25007,Syrian Arab Rep.,2018,2018Syrian Arab Rep.,0,16,13,105,19,0,153,0,27,22,159,24,0,232,385
25008,Syrian Arab Rep.,2018,2018Syrian Arab Rep.,5,5,0,16,0,0,26,0,8,6,17,0,0,31,57
25009,Syrian Arab Rep.,2018,2018Syrian Arab Rep.,5,11,5,44,5,0,70,11,13,8,169,5,0,206,276
25010,Syrian Arab Rep.,2018,2018Syrian Arab Rep.,5,19,23,104,24,0,175,6,31,16,169,31,0,253,428
25011,Syrian Arab Rep.,2018,2018Syrian Arab Rep.,7,7,8,27,5,0,54,7,7,8,27,0,0,49,103
25012,Syrian Arab Rep.,2018,2018Syrian Arab Rep.,7,15,12,44,0,0,78,11,14,12,85,6,0,128,206
25013,Syrian Arab Rep.,2018,2018Syrian Arab Rep.,8,0,6,13,0,0,27,5,9,0,42,0,0,56,83
25014,Syrian Arab Rep.,2018,2018Syrian Arab Rep.,8,11,0,19,0,0,38,5,8,5,36,0,0,54,92
25015,Syrian Arab Rep.,2018,2018Syrian Arab Rep.,10,17,9,55,0,0,91,6,20,18,80,0,0,124,290
25016,Syrian Arab Rep.,2018,2018Syrian Arab Rep.,11,17,5,32,0,0,65,8,10,5,69,0,0,92,157
25017,Syrian Arab Rep.,2018,2018Syrian Arab Rep.,15,35,32,70,0,0,152,27,30,25,164,0,0,246,398
25018,Syrian Arab Rep.,2018,2018Syrian Arab Rep.,18,41,21,57,5,0,142,15,28,22,80,0,0,145,287
25019,Syrian Arab Rep.,2018,2018Syrian Arab Rep.,19,24,16,85,8,0,152,18,23,22,107,10,0,180,332
25020,Syrian Arab Rep.,2018,2018Syrian Arab Rep.,20,21,15,98,13,0,167,14,48,19,158,15,0,254,421
25021,Syrian Arab Rep.,2018,2018Syrian Arab Rep.,22,39,32,182,46,0,321,22,40,45,231,42,0,380,14701
25022,Syrian Arab Rep.,2018,2018Syrian Arab Rep.,35,65,32,140,10,0,282,37,66,36,123,8,0,270,552
25023,Syrian Arab Rep.,2018,2018Syrian Arab Rep.,46,67,26,144,5,0,288,55,50,31,753,0,0,889,1177
25024,Syrian Arab Rep.,2018,2018Syrian Arab Rep.,46,77,65,221,20,0,429,46,83,87,262,20,0,498,927
25025,Syrian Arab Rep.,2018,2018Syrian Arab Rep.,59,357,234,906,58,0,1614,71,376,267,1021,97,0,1832,3446
25026,Syrian Arab Rep.,2018,2018Syrian Arab Rep.,81,82,47,252,19,0,481,72,94,61,405,13,0,645,2126
25027,Syrian Arab Rep.,2018,2018Syrian Arab Rep.,107,126,73,496,31,0,833,105,157,96,1049,52,0,1459,2292
25028,Syrian Arab Rep.,2018,2018Syrian Arab Rep.,202,347,210,868,73,0,1700,222,376,230,961,69,0,1858,3558
25029,Syrian Arab Rep.,2018,2018Syrian Arab Rep.,211,362,254,760,48,0,1635,251,373,233,954,60,0,1871,3506
25030,Syrian Arab Rep.,2018,2018Syrian Arab Rep.,431,648,433,1934,219,3731,7396,438,731,478,2580,163,4779,9169,16565
25031,Syrian Arab Rep.,2018,2018Syrian Arab Rep.,584,1278,719,3178,167,0,5926,673,1430,874,4090,198,0,7265,93502
25032,Syrian Arab Rep.,2018,2018Syrian Arab Rep.,6831,12519,7633,33725,3316,0,64024,7265,12959,8485,36772,3366,0,68847,132871
25033,Syrian Arab Rep.,2018,2018Syrian Arab Rep.,20354,21046,11457,62104,3982,0,118943,21628,21881,12693,73964,3417,0,133583,252526
25034,Syrian Arab Rep.,2018,2018Syrian Arab Rep.,26342,32345,18666,103267,5178,0,185798,28094,36934,26909,248413,5917,0,346267,532065
25035,Syrian Arab Rep.,2018,2018Syrian Arab Rep.,46898,69554,45900,161540,15691,0,339583,49965,74379,48197,152974,11185,0,336700,676283
25036,Syrian Arab Rep.,2018,2018Syrian Arab Rep.,73369,118259,66067,221612,13559,0,492866,77130,123308,69048,171050,10779,0,451315,944181
25037,Syrian Arab Rep.,2018,2018Syrian Arab Rep.,284075,309878,193295,811450,58147,0,1656845,304035,330889,225144,1051441,54012,0,1965521,3622366
25038,Syrian Arab Rep.,2019,2019Syrian Arab Rep.,0,0,0,0,0,0,0,0,0,0,0,0,0,0,353568
25039,Syrian Arab Rep.,2019,2019Syrian Arab Rep.,0,0,0,0,0,0,0,0,0,0,5,0,0,5,15
25040,Syrian Arab Rep.,2019,2019Syrian Arab Rep.,0,0,0,0,0,0,0,0,0,0,6,0,0,6,6
25041,Syrian Arab Rep.,2019,2019Syrian Arab Rep.,0,0,0,0,0,0,0,0,0,0,8,0,0,8,8
25042,Syrian Arab Rep.,2019,2019Syrian Arab Rep.,0,0,0,0,0,0,0,0,0,0,23,0,0,23,23
25043,Syrian Arab Rep.,2019,2019Syrian Arab Rep.,0,0,0,0,0,0,0,0,0,5,0,0,0,5,5
25044,Syrian Arab Rep.,2019,2019Syrian Arab Rep.,0,0,0,0,0,0,0,0,0,5,6,0,0,11,11
25045,Syrian Arab Rep.,2019,2019Syrian Arab Rep.,0,0,0,0,0,0,0,0,6,0,0,0,0,6,6
25046,Syrian Arab Rep.,2019,2019Syrian Arab Rep.,0,0,0,0,0,0,0,0,7,0,0,0,0,7,7
25047,Syrian Arab Rep.,2019,2019Syrian Arab Rep.,0,0,0,0,0,0,0,5,0,0,7,0,0,12,12
25048,Syrian Arab Rep.,2019,2019Syrian Arab Rep.,0,0,0,0,0,71,71,0,0,0,0,0,391,391,462
25049,Syrian Arab Rep.,2019,2019Syrian Arab Rep.,0,0,0,0,0,8347,8347,0,0,0,0,0,9897,9897,18244
25050,Syrian Arab Rep.,2019,2019Syrian Arab Rep.,0,0,0,5,0,0,5,0,0,0,0,0,0,0,127
25051,Syrian Arab Rep.,2019,2019Syrian Arab Rep.,0,0,0,5,0,0,5,0,0,0,8,0,0,8,13
25052,Syrian Arab Rep.,2019,2019Syrian Arab Rep.,0,0,0,6,0,0,6,0,0,5,10,0,0,15,21
25053,Syrian Arab Rep.,2019,2019Syrian Arab Rep.,0,0,0,8,0,0,8,0,0,0,0,0,0,0,8
25054,Syrian Arab Rep.,2019,2019Syrian Arab Rep.,0,0,0,8,0,0,8,0,0,0,9,0,0,9,17
25055,Syrian Arab Rep.,2019,2019Syrian Arab Rep.,0,0,5,6,0,0,11,0,0,0,13,0,0,13,24
25056,Syrian Arab Rep.,2019,2019Syrian Arab Rep.,0,0,7,0,0,0,7,0,0,0,7,0,0,7,14
25057,Syrian Arab Rep.,2019,2019Syrian Arab Rep.,0,0,7,24,0,0,31,0,9,0,46,5,0,60,91
25058,Syrian Arab Rep.,2019,2019Syrian Arab Rep.,0,0,11,12,0,0,23,0,6,0,11,0,0,17,40
25059,Syrian Arab Rep.,2019,2019Syrian Arab Rep.,0,5,0,0,0,0,5,0,0,0,0,0,0,0,5
25060,Syrian Arab Rep.,2019,2019Syrian Arab Rep.,0,5,0,0,0,0,5,0,0,0,5,0,0,5,10
25061,Syrian Arab Rep.,2019,2019Syrian Arab Rep.,0,5,0,0,0,0,5,0,0,0,9,0,0,9,14
25062,Syrian Arab Rep.,2019,2019Syrian Arab Rep.,0,5,5,18,0,0,28,0,6,5,47,0,0,58,86
25063,Syrian Arab Rep.,2019,2019Syrian Arab Rep.,0,5,6,17,0,0,28,0,8,9,16,0,0,33,61
25064,Syrian Arab Rep.,2019,2019Syrian Arab Rep.,0,6,0,0,0,0,6,0,0,0,9,0,0,9,15
25065,Syrian Arab Rep.,2019,2019Syrian Arab Rep.,0,6,6,8,0,0,20,0,6,0,71,18,0,95,115
25066,Syrian Arab Rep.,2019,2019Syrian Arab Rep.,0,7,0,0,0,0,7,0,0,0,13,0,0,13,20
25067,Syrian Arab Rep.,2019,2019Syrian Arab Rep.,0,8,0,0,0,0,8,0,0,5,7,0,0,12,20
25068,Syrian Arab Rep.,2019,2019Syrian Arab Rep.,0,9,0,13,0,0,22,0,5,0,7,0,0,12,34
25069,Syrian Arab Rep.,2019,2019Syrian Arab Rep.,0,10,8,36,5,0,59,0,7,7,132,5,0,151,210
25070,Syrian Arab Rep.,2019,2019Syrian Arab Rep.,0,11,5,30,0,0,46,6,9,5,187,10,0,217,263
25071,Syrian Arab Rep.,2019,2019Syrian Arab Rep.,0,16,12,108,22,0,158,0,27,26,165,25,0,243,401
25072,Syrian Arab Rep.,2019,2019Syrian Arab Rep.,5,6,5,29,5,0,50,8,7,6,141,5,0,167,217
25073,Syrian Arab Rep.,2019,2019Syrian Arab Rep.,5,7,12,27,5,0,56,0,12,10,23,5,0,50,106
25074,Syrian Arab Rep.,2019,2019Syrian Arab Rep.,5,10,0,5,0,0,20,0,8,0,15,0,0,23,43
25075,Syrian Arab Rep.,2019,2019Syrian Arab Rep.,7,0,7,12,0,0,26,5,7,0,32,0,0,44,70
25076,Syrian Arab Rep.,2019,2019Syrian Arab Rep.,7,6,0,9,0,0,22,7,0,0,21,0,0,28,50
25077,Syrian Arab Rep.,2019,2019Syrian Arab Rep.,9,0,0,8,0,0,17,7,0,0,11,0,0,18,35
25078,Syrian Arab Rep.,2019,2019Syrian Arab Rep.,9,12,9,34,5,0,69,7,15,19,42,0,0,83,152
25079,Syrian Arab Rep.,2019,2019Syrian Arab Rep.,9,16,0,29,0,0,54,8,12,7,45,6,0,78,132
25080,Syrian Arab Rep.,2019,2019Syrian Arab Rep.,10,12,19,48,0,0,89,5,18,17,110,6,0,156,245
25081,Syrian Arab Rep.,2019,2019Syrian Arab Rep.,14,19,5,32,0,0,70,8,10,5,74,0,0,97,167
25082,Syrian Arab Rep.,2019,2019Syrian Arab Rep.,16,28,15,103,12,0,174,11,43,28,157,12,0,251,425
25083,Syrian Arab Rep.,2019,2019Syrian Arab Rep.,18,34,24,85,7,0,168,13,34,24,94,0,0,165,333
25084,Syrian Arab Rep.,2019,2019Syrian Arab Rep.,18,45,39,101,5,0,208,30,46,43,200,0,0,319,527
25085,Syrian Arab Rep.,2019,2019Syrian Arab Rep.,20,24,20,86,9,0,159,29,25,18,112,12,0,196,355
25086,Syrian Arab Rep.,2019,2019Syrian Arab Rep.,25,40,32,188,47,0,332,23,41,48,242,44,0,398,14730
25087,Syrian Arab Rep.,2019,2019Syrian Arab Rep.,28,344,270,963,67,0,1672,32,391,274,1075,107,0,1879,3551
25088,Syrian Arab Rep.,2019,2019Syrian Arab Rep.,49,67,44,147,0,0,307,48,81,41,129,6,0,305,612
25089,Syrian Arab Rep.,2019,2019Syrian Arab Rep.,65,127,88,338,37,0,655,64,138,86,406,33,0,727,1382
25090,Syrian Arab Rep.,2019,2019Syrian Arab Rep.,73,85,51,273,20,0,502,51,113,54,443,14,0,675,2882
25091,Syrian Arab Rep.,2019,2019Syrian Arab Rep.,89,122,76,444,34,0,765,83,141,95,941,65,0,1325,2090
25092,Syrian Arab Rep.,2019,2019Syrian Arab Rep.,233,356,241,797,51,0,1678,279,362,242,1059,56,0,1998,3676
25093,Syrian Arab Rep.,2019,2019Syrian Arab Rep.,448,658,335,1431,65,0,2937,525,712,396,3118,69,0,4820,7757
25094,Syrian Arab Rep.,2019,2019Syrian Arab Rep.,451,688,451,2095,241,0,3926,419,797,519,2748,179,0,4662,18755
25095,Syrian Arab Rep.,2019,2019Syrian Arab Rep.,3440,8921,5520,22935,1323,0,42139,3619,10257,6170,29794,1516,0,51356,93495
25096,Syrian Arab Rep.,2019,2019Syrian Arab Rep.,6550,11445,7760,33127,3360,0,62242,7010,11876,8357,36371,3354,0,66968,129210
25097,Syrian Arab Rep.,2019,2019Syrian Arab Rep.,21166,20890,11408,60530,4136,0,118130,22582,21679,13604,66416,3399,0,127680,245810
25098,Syrian Arab Rep.,2019,2019Syrian Arab Rep.,29466,37038,22742,112803,5867,0,207916,31218,41576,29517,255662,6929,0,364902,572818
25099,Syrian Arab Rep.,2019,2019Syrian Arab Rep.,47559,69461,44096,151737,14723,0,327576,50292,73253,46332,146766,10473,0,327116,654692
25100,Syrian Arab Rep.,2019,2019Syrian Arab Rep.,67536,115368,66964,211653,11700,1096,474317,71067,119823,70108,165261,9095,915,436269,910586
25101,Syrian Arab Rep.,2019,2019Syrian Arab Rep.,285668,322983,179668,799852,56910,0,1645081,305587,343537,204763,1024856,52546,0,1931289,3576370
25102,Syrian Arab Rep.,2020,2020Syrian Arab Rep.,0,0,0,0,0,0,0,0,0,0,0,0,0,0,376368
25103,Syrian Arab Rep.,2020,2020Syrian Arab Rep.,0,0,0,0,0,0,0,0,0,0,5,0,0,5,20
25104,Syrian Arab Rep.,2020,2020Syrian Arab Rep.,0,0,0,0,0,0,0,0,0,0,8,0,0,8,16
25105,Syrian Arab Rep.,2020,2020Syrian Arab Rep.,0,0,0,0,0,0,0,0,0,0,12,0,0,12,12
25106,Syrian Arab Rep.,2020,2020Syrian Arab Rep.,0,0,0,0,0,0,0,0,0,5,0,0,0,5,5
25107,Syrian Arab Rep.,2020,2020Syrian Arab Rep.,0,0,0,0,0,0,0,0,0,5,5,0,0,10,10
25108,Syrian Arab Rep.,2020,2020Syrian Arab Rep.,0,0,0,0,0,0,0,0,5,0,11,0,0,16,16
25109,Syrian Arab Rep.,2020,2020Syrian Arab Rep.,0,0,0,0,0,0,0,0,5,0,17,0,0,22,22
25110,Syrian Arab Rep.,2020,2020Syrian Arab Rep.,0,0,0,0,0,0,0,17,0,0,13,0,0,30,131
25111,Syrian Arab Rep.,2020,2020Syrian Arab Rep.,0,0,0,0,0,88,88,0,0,0,0,0,403,403,491
25112,Syrian Arab Rep.,2020,2020Syrian Arab Rep.,0,0,0,0,0,261,261,0,0,0,0,0,662,662,923
25113,Syrian Arab Rep.,2020,2020Syrian Arab Rep.,0,0,0,0,0,301,301,0,0,0,0,0,935,935,1236
25114,Syrian Arab Rep.,2020,2020Syrian Arab Rep.,0,0,0,0,0,921,921,0,0,0,0,0,1148,1148,2069
25115,Syrian Arab Rep.,2020,2020Syrian Arab Rep.,0,0,0,0,0,6895,6895,0,0,0,0,0,10798,10798,17693
25116,Syrian Arab Rep.,2020,2020Syrian Arab Rep.,0,0,0,5,0,0,5,0,0,0,0,0,0,0,10
25117,Syrian Arab Rep.,2020,2020Syrian Arab Rep.,0,0,0,5,0,0,5,0,0,0,18,0,0,18,23
25118,Syrian Arab Rep.,2020,2020Syrian Arab Rep.,0,0,0,7,0,0,7,0,5,0,5,0,0,10,17
25119,Syrian Arab Rep.,2020,2020Syrian Arab Rep.,0,0,0,8,0,0,8,0,0,0,0,0,0,0,8
25120,Syrian Arab Rep.,2020,2020Syrian Arab Rep.,0,0,0,8,0,0,8,0,0,0,9,0,0,9,17
25121,Syrian Arab Rep.,2020,2020Syrian Arab Rep.,0,0,0,9,0,0,9,0,0,0,0,0,0,0,9
25122,Syrian Arab Rep.,2020,2020Syrian Arab Rep.,0,0,0,14,0,0,14,0,0,0,18,0,0,18,32
25123,Syrian Arab Rep.,2020,2020Syrian Arab Rep.,0,0,5,0,0,0,5,0,5,0,12,0,0,17,22
25124,Syrian Arab Rep.,2020,2020Syrian Arab Rep.,0,0,5,6,0,0,11,0,0,0,13,0,0,13,24
25125,Syrian Arab Rep.,2020,2020Syrian Arab Rep.,0,0,5,24,0,0,29,0,8,0,100,5,0,113,142
25126,Syrian Arab Rep.,2020,2020Syrian Arab Rep.,0,0,6,0,0,0,6,0,0,0,0,0,0,0,6
25127,Syrian Arab Rep.,2020,2020Syrian Arab Rep.,0,0,6,11,5,0,22,0,0,5,13,0,0,18,40
25128,Syrian Arab Rep.,2020,2020Syrian Arab Rep.,0,0,6,12,0,0,18,0,0,5,15,0,0,20,38
25129,Syrian Arab Rep.,2020,2020Syrian Arab Rep.,0,0,7,18,0,0,25,0,9,5,39,0,0,53,78
25130,Syrian Arab Rep.,2020,2020Syrian Arab Rep.,0,5,0,0,0,0,5,0,0,0,0,0,0,0,5
25131,Syrian Arab Rep.,2020,2020Syrian Arab Rep.,0,5,0,0,0,0,5,0,0,0,9,0,0,9,14
25132,Syrian Arab Rep.,2020,2020Syrian Arab Rep.,0,5,6,18,0,0,29,0,7,6,21,0,0,34,63
25133,Syrian Arab Rep.,2020,2020Syrian Arab Rep.,0,8,0,0,0,0,8,0,0,5,7,0,0,12,20
25134,Syrian Arab Rep.,2020,2020Syrian Arab Rep.,0,8,0,0,0,0,8,5,0,0,7,0,0,12,20
25135,Syrian Arab Rep.,2020,2020Syrian Arab Rep.,0,8,0,5,0,0,13,0,5,0,16,0,0,21,34
25136,Syrian Arab Rep.,2020,2020Syrian Arab Rep.,0,8,8,27,5,0,48,6,7,7,152,6,0,178,226
25137,Syrian Arab Rep.,2020,2020Syrian Arab Rep.,0,9,0,13,0,0,22,0,5,0,7,0,0,12,34
25138,Syrian Arab Rep.,2020,2020Syrian Arab Rep.,0,10,5,36,5,0,56,0,5,7,117,5,0,134,190
25139,Syrian Arab Rep.,2020,2020Syrian Arab Rep.,0,12,11,110,25,0,158,0,22,26,176,25,0,249,407
25140,Syrian Arab Rep.,2020,2020Syrian Arab Rep.,0,23,0,29,0,0,52,12,7,5,225,7,0,256,308
25141,Syrian Arab Rep.,2020,2020Syrian Arab Rep.,5,5,0,0,0,0,10,0,0,0,30,10,0,40,134
25142,Syrian Arab Rep.,2020,2020Syrian Arab Rep.,5,5,5,5,0,0,20,0,8,0,15,0,0,23,43
25143,Syrian Arab Rep.,2020,2020Syrian Arab Rep.,5,6,0,6,0,0,17,0,0,6,18,0,0,24,41
25144,Syrian Arab Rep.,2020,2020Syrian Arab Rep.,5,8,12,40,5,0,70,5,14,19,26,5,0,69,139
25145,Syrian Arab Rep.,2020,2020Syrian Arab Rep.,7,0,0,11,0,0,18,0,9,0,13,0,0,22,113
25146,Syrian Arab Rep.,2020,2020Syrian Arab Rep.,7,0,6,11,0,0,24,0,6,5,28,0,0,39,63
25147,Syrian Arab Rep.,2020,2020Syrian Arab Rep.,8,0,0,0,0,0,8,0,0,0,8,0,0,8,16
25148,Syrian Arab Rep.,2020,2020Syrian Arab Rep.,9,0,0,7,0,0,16,0,0,6,10,0,0,16,32
25149,Syrian Arab Rep.,2020,2020Syrian Arab Rep.,9,15,23,112,24,0,183,7,32,20,163,32,0,254,437
25150,Syrian Arab Rep.,2020,2020Syrian Arab Rep.,9,19,9,41,5,0,83,5,14,18,53,0,0,90,173
25151,Syrian Arab Rep.,2020,2020Syrian Arab Rep.,10,28,13,98,13,0,162,10,36,30,157,12,0,245,407
25152,Syrian Arab Rep.,2020,2020Syrian Arab Rep.,11,10,5,33,0,0,59,7,12,6,52,6,0,83,142
25153,Syrian Arab Rep.,2020,2020Syrian Arab Rep.,18,38,28,96,11,0,191,13,40,25,108,6,0,192,383
25154,Syrian Arab Rep.,2020,2020Syrian Arab Rep.,20,46,39,101,5,0,211,31,48,43,206,0,0,328,539
25155,Syrian Arab Rep.,2020,2020Syrian Arab Rep.,21,24,7,41,0,0,93,9,20,6,102,0,0,137,230
25156,Syrian Arab Rep.,2020,2020Syrian Arab Rep.,21,24,20,91,10,0,166,25,24,21,119,9,0,198,364
25157,Syrian Arab Rep.,2020,2020Syrian Arab Rep.,23,299,294,1008,78,0,1702,27,347,292,1112,129,0,1907,3609
25158,Syrian Arab Rep.,2020,2020Syrian Arab Rep.,25,40,32,188,47,0,332,23,41,48,242,55,0,409,14741
25159,Syrian Arab Rep.,2020,2020Syrian Arab Rep.,49,110,57,284,24,0,524,35,120,63,470,14,0,702,3126
25160,Syrian Arab Rep.,2020,2020Syrian Arab Rep.,51,84,50,163,5,0,353,47,96,50,162,9,0,364,717
25161,Syrian Arab Rep.,2020,2020Syrian Arab Rep.,55,56,25,129,0,0,265,46,57,50,180,5,0,338,603
25162,Syrian Arab Rep.,2020,2020Syrian Arab Rep.,80,104,82,422,40,0,728,77,133,93,906,65,0,1274,2002
25163,Syrian Arab Rep.,2020,2020Syrian Arab Rep.,93,180,128,500,57,0,958,104,191,116,568,60,0,1039,1997
25164,Syrian Arab Rep.,2020,2020Syrian Arab Rep.,305,402,293,952,60,0,2012,329,449,274,1388,76,0,2516,4528
25165,Syrian Arab Rep.,2020,2020Syrian Arab Rep.,330,585,308,1244,52,0,2519,388,624,342,2685,69,0,4108,6627
25166,Syrian Arab Rep.,2020,2020Syrian Arab Rep.,420,653,469,2116,260,0,3918,400,742,533,2695,200,0,4570,19869
25167,Syrian Arab Rep.,2020,2020Syrian Arab Rep.,2525,9050,5864,23117,1410,0,41966,2505,10519,6552,30310,1646,0,51532,93498
25168,Syrian Arab Rep.,2020,2020Syrian Arab Rep.,5824,11562,8126,33706,3637,0,62855,6154,12001,8819,37174,3574,0,67722,130577
25169,Syrian Arab Rep.,2020,2020Syrian Arab Rep.,18205,21867,11771,59946,4419,0,116208,19380,22680,13270,66922,3703,0,125955,242163
25170,Syrian Arab Rep.,2020,2020Syrian Arab Rep.,31045,40944,26506,119837,6656,5,224993,32859,45092,32469,261284,8089,0,379793,605338
25171,Syrian Arab Rep.,2020,2020Syrian Arab Rep.,43545,69632,46519,156166,15796,0,331658,45975,73519,48798,151631,11209,0,331132,662790
25172,Syrian Arab Rep.,2020,2020Syrian Arab Rep.,60955,106851,68063,201884,12228,0,449981,63832,111032,71132,159659,9664,0,415319,865300
25173,Syrian Arab Rep.,2020,2020Syrian Arab Rep.,257733,332019,205675,822787,58838,0,1677052,262045,361296,243076,1043830,54071,0,1964318,3641370
25174,Syrian Arab Rep.,2021,2021Syrian Arab Rep.,0,0,0,0,0,0,0,0,0,0,0,0,0,0,435474
25175,Syrian Arab Rep.,2021,2021Syrian Arab Rep.,0,0,0,0,0,0,0,0,0,0,0,5,0,5,5
25176,Syrian Arab Rep.,2021,2021Syrian Arab Rep.,0,0,0,0,0,0,0,0,0,0,5,0,0,5,15
25177,Syrian Arab Rep.,2021,2021Syrian Arab Rep.,0,0,0,0,0,0,0,0,0,0,11,0,0,11,11
25178,Syrian Arab Rep.,2021,2021Syrian Arab Rep.,0,0,0,0,0,0,0,0,0,5,0,0,0,5,5
25179,Syrian Arab Rep.,2021,2021Syrian Arab Rep.,0,0,0,0,0,0,0,5,0,0,13,0,0,18,18
25180,Syrian Arab Rep.,2021,2021Syrian Arab Rep.,0,0,0,0,0,115,115,0,0,0,0,0,397,397,512
25181,Syrian Arab Rep.,2021,2021Syrian Arab Rep.,0,0,0,0,0,149,149,0,0,0,0,0,209,209,358
25182,Syrian Arab Rep.,2021,2021Syrian Arab Rep.,0,0,0,5,0,0,5,0,0,0,0,0,0,0,5
25183,Syrian Arab Rep.,2021,2021Syrian Arab Rep.,0,0,0,5,0,0,5,0,0,0,7,0,0,7,12
25184,Syrian Arab Rep.,2021,2021Syrian Arab Rep.,0,0,0,5,0,0,5,0,0,0,8,0,0,8,45
25185,Syrian Arab Rep.,2021,2021Syrian Arab Rep.,0,0,0,5,0,0,5,0,0,0,15,0,0,15,20
25186,Syrian Arab Rep.,2021,2021Syrian Arab Rep.,0,0,0,5,0,0,5,0,5,0,11,0,0,16,84
25187,Syrian Arab Rep.,2021,2021Syrian Arab Rep.,0,0,0,5,0,0,5,0,6,0,16,0,0,22,27
25188,Syrian Arab Rep.,2021,2021Syrian Arab Rep.,0,0,0,5,0,0,5,7,0,0,20,0,0,27,32
25189,Syrian Arab Rep.,2021,2021Syrian Arab Rep.,0,0,0,6,0,0,6,0,0,0,28,0,0,28,34
25190,Syrian Arab Rep.,2021,2021Syrian Arab Rep.,0,0,0,7,0,0,7,0,0,0,7,0,0,7,14
25191,Syrian Arab Rep.,2021,2021Syrian Arab Rep.,0,0,0,7,0,0,7,0,0,0,8,0,0,8,15
25192,Syrian Arab Rep.,2021,2021Syrian Arab Rep.,0,0,0,7,0,0,7,0,5,0,16,0,0,21,28
25193,Syrian Arab Rep.,2021,2021Syrian Arab Rep.,0,0,0,8,0,0,8,0,0,0,0,0,0,0,8
25194,Syrian Arab Rep.,2021,2021Syrian Arab Rep.,0,0,0,8,0,0,8,0,0,0,9,0,0,9,17
25195,Syrian Arab Rep.,2021,2021Syrian Arab Rep.,0,0,0,17,0,0,17,0,0,0,16,0,0,16,33
25196,Syrian Arab Rep.,2021,2021Syrian Arab Rep.,0,0,5,0,0,0,5,0,0,0,0,0,0,0,5
25197,Syrian Arab Rep.,2021,2021Syrian Arab Rep.,0,0,5,5,0,0,10,0,0,5,9,0,0,14,24
25198,Syrian Arab Rep.,2021,2021Syrian Arab Rep.,0,0,5,8,0,0,13,0,0,7,48,0,0,55,68
25199,Syrian Arab Rep.,2021,2021Syrian Arab Rep.,0,0,5,13,0,0,18,0,0,5,15,0,0,20,38
25200,Syrian Arab Rep.,2021,2021Syrian Arab Rep.,0,0,5,30,0,0,35,0,8,5,109,0,0,122,157
25201,Syrian Arab Rep.,2021,2021Syrian Arab Rep.,0,0,6,0,0,0,6,0,0,0,8,0,0,8,14
25202,Syrian Arab Rep.,2021,2021Syrian Arab Rep.,0,0,6,14,0,0,20,0,0,5,11,0,0,16,36
25203,Syrian Arab Rep.,2021,2021Syrian Arab Rep.,0,0,12,23,5,0,40,0,9,9,149,8,0,175,215
25204,Syrian Arab Rep.,2021,2021Syrian Arab Rep.,0,5,0,0,0,0,5,0,0,0,0,0,0,0,5
25205,Syrian Arab Rep.,2021,2021Syrian Arab Rep.,0,5,0,0,0,0,5,0,0,0,9,0,0,9,14
25206,Syrian Arab Rep.,2021,2021Syrian Arab Rep.,0,5,0,15,0,0,20,0,7,7,41,0,0,55,75
25207,Syrian Arab Rep.,2021,2021Syrian Arab Rep.,0,5,5,10,0,0,20,0,8,0,10,0,0,18,38
25208,Syrian Arab Rep.,2021,2021Syrian Arab Rep.,0,5,6,18,0,0,29,0,5,7,25,0,0,37,66
25209,Syrian Arab Rep.,2021,2021Syrian Arab Rep.,0,6,5,32,6,0,49,0,0,9,103,5,0,117,166
25210,Syrian Arab Rep.,2021,2021Syrian Arab Rep.,0,7,0,6,0,0,13,0,5,0,15,0,0,20,33
25211,Syrian Arab Rep.,2021,2021Syrian Arab Rep.,0,7,0,7,5,0,19,0,5,0,6,0,0,11,30
25212,Syrian Arab Rep.,2021,2021Syrian Arab Rep.,0,7,5,47,0,0,59,0,6,5,43,0,0,54,113
25213,Syrian Arab Rep.,2021,2021Syrian Arab Rep.,0,9,0,7,0,0,16,0,7,0,13,0,0,20,36
25214,Syrian Arab Rep.,2021,2021Syrian Arab Rep.,0,9,5,38,13,0,65,22,7,5,66,5,0,105,190
25215,Syrian Arab Rep.,2021,2021Syrian Arab Rep.,0,10,5,10,0,0,25,0,0,8,17,0,0,25,50
25216,Syrian Arab Rep.,2021,2021Syrian Arab Rep.,0,11,0,5,0,0,16,0,0,6,21,0,0,27,43
25217,Syrian Arab Rep.,2021,2021Syrian Arab Rep.,0,11,13,117,27,0,168,0,21,31,188,25,0,265,433
25218,Syrian Arab Rep.,2021,2021Syrian Arab Rep.,5,0,0,0,0,0,5,0,0,0,0,0,0,0,5
25219,Syrian Arab Rep.,2021,2021Syrian Arab Rep.,5,6,0,14,0,0,25,0,5,0,81,19,0,105,130
25220,Syrian Arab Rep.,2021,2021Syrian Arab Rep.,5,6,0,15,0,0,26,5,8,0,30,0,0,43,69
25221,Syrian Arab Rep.,2021,2021Syrian Arab Rep.,5,12,14,42,5,0,78,5,14,13,35,5,0,72,150
25222,Syrian Arab Rep.,2021,2021Syrian Arab Rep.,6,6,0,10,0,0,22,0,6,6,14,0,0,26,48
25223,Syrian Arab Rep.,2021,2021Syrian Arab Rep.,7,34,12,40,0,0,93,6,21,8,96,5,0,136,229
25224,Syrian Arab Rep.,2021,2021Syrian Arab Rep.,8,0,0,0,0,0,8,0,0,0,10,0,0,10,18
25225,Syrian Arab Rep.,2021,2021Syrian Arab Rep.,8,32,19,118,13,0,190,13,39,40,151,16,0,259,449
25226,Syrian Arab Rep.,2021,2021Syrian Arab Rep.,9,12,6,33,0,0,60,8,7,12,55,6,0,88,148
25227,Syrian Arab Rep.,2021,2021Syrian Arab Rep.,9,17,12,48,5,0,91,7,16,24,48,0,0,95,186
25228,Syrian Arab Rep.,2021,2021Syrian Arab Rep.,11,26,5,39,0,0,81,10,18,5,300,8,0,341,422
25229,Syrian Arab Rep.,2021,2021Syrian Arab Rep.,14,14,21,109,30,0,188,12,31,16,166,31,0,256,444
25230,Syrian Arab Rep.,2021,2021Syrian Arab Rep.,14,34,19,90,11,0,168,24,24,19,125,8,0,200,368
25231,Syrian Arab Rep.,2021,2021Syrian Arab Rep.,19,46,39,105,0,5,214,31,48,43,206,0,6,334,548
25232,Syrian Arab Rep.,2021,2021Syrian Arab Rep.,21,125,70,285,19,0,520,20,125,70,475,13,0,703,2832
25233,Syrian Arab Rep.,2021,2021Syrian Arab Rep.,22,40,37,108,10,0,217,18,52,33,111,8,0,222,439
25234,Syrian Arab Rep.,2021,2021Syrian Arab Rep.,25,40,32,188,48,10,343,23,41,48,242,55,9,418,5335
25235,Syrian Arab Rep.,2021,2021Syrian Arab Rep.,28,165,201,708,62,0,1164,33,189,207,816,104,0,1349,2513
25236,Syrian Arab Rep.,2021,2021Syrian Arab Rep.,29,60,31,122,5,0,247,29,64,37,109,6,0,245,492
25237,Syrian Arab Rep.,2021,2021Syrian Arab Rep.,90,76,43,217,5,0,431,80,98,69,303,10,0,560,991
25238,Syrian Arab Rep.,2021,2021Syrian Arab Rep.,96,129,88,459,45,0,817,100,133,97,1045,66,0,1441,2258
25239,Syrian Arab Rep.,2021,2021Syrian Arab Rep.,123,250,150,575,73,0,1171,113,235,153,776,75,0,1352,2523
25240,Syrian Arab Rep.,2021,2021Syrian Arab Rep.,316,447,289,1103,74,0,2229,350,455,306,1642,100,0,2853,5082
25241,Syrian Arab Rep.,2021,2021Syrian Arab Rep.,335,586,312,1247,53,0,2533,397,624,346,2690,69,0,4126,6659
25242,Syrian Arab Rep.,2021,2021Syrian Arab Rep.,344,615,455,1990,266,0,3670,322,691,479,2500,216,0,4208,20146
25243,Syrian Arab Rep.,2021,2021Syrian Arab Rep.,1550,8749,6341,23545,1531,0,41716,1588,10097,6832,31452,1797,0,51766,93482
25244,Syrian Arab Rep.,2021,2021Syrian Arab Rep.,6374,11425,8735,35145,3985,0,65664,6689,11964,9526,39140,3744,0,71063,136727
25245,Syrian Arab Rep.,2021,2021Syrian Arab Rep.,19129,23522,12304,62057,4747,0,121759,20108,24575,13521,70686,3912,0,132802,254561
25246,Syrian Arab Rep.,2021,2021Syrian Arab Rep.,29528,44232,28721,123599,7305,5,233390,31056,48116,34461,263229,8961,5,385828,621740
25247,Syrian Arab Rep.,2021,2021Syrian Arab Rep.,44981,68291,48434,158986,16088,0,336780,47028,72204,50937,154638,11365,0,336172,672952
25248,Syrian Arab Rep.,2021,2021Syrian Arab Rep.,52226,102370,69539,200564,12150,0,436849,54751,106340,72435,160745,9809,0,404080,840929
25249,Syrian Arab Rep.,2021,2021Syrian Arab Rep.,246770,373607,197814,847309,61568,0,1727068,264347,397781,216627,1075220,56326,0,2010301,3737369
25250,Tajikistan,2001,2001Tajikistan,0,0,0,0,0,0,0,0,0,0,0,0,0,0,35288
25251,Tajikistan,2001,2001Tajikistan,0,0,0,0,0,5,5,0,0,0,0,0,7,7,12
25252,Tajikistan,2001,2001Tajikistan,0,0,0,0,0,4998,4998,0,0,0,0,0,7385,7385,12383
25253,Tajikistan,2001,2001Tajikistan,0,0,0,9,5,0,14,0,5,0,0,0,0,5,19
25254,Tajikistan,2001,2001Tajikistan,0,0,10,16,0,0,26,0,0,0,12,0,0,12,38
25255,Tajikistan,2001,2001Tajikistan,1113,627,537,1584,112,0,3973,890,853,730,1790,131,0,4394,8367
25256,Tajikistan,2002,2002Tajikistan,0,0,0,0,0,0,0,0,0,0,0,0,0,0,1416
25257,Tajikistan,2002,2002Tajikistan,0,0,0,0,0,5,5,0,0,0,0,0,8,8,13
25258,Tajikistan,2002,2002Tajikistan,0,0,0,0,0,1391,1391,0,0,0,0,0,2086,2086,3477
25259,Tajikistan,2002,2002Tajikistan,0,0,0,5,8,0,13,5,0,0,0,0,0,5,18
25260,Tajikistan,2002,2002Tajikistan,0,0,10,16,0,0,26,0,0,0,12,0,0,12,38
25261,Tajikistan,2002,2002Tajikistan,463,1088,934,3181,116,0,5782,709,1050,901,3241,589,0,6490,12272
25262,Tajikistan,2002,2002Tajikistan,595,372,320,1922,97,0,3306,632,397,340,2048,105,0,3522,6828
25263,Tajikistan,2002,2002Tajikistan,7618,2396,2051,6985,2118,0,21168,6492,2039,1748,5952,1803,0,18034,39202
25264,Tajikistan,2003,2003Tajikistan,0,0,0,0,0,0,0,0,0,0,0,0,0,0,2600
25265,Tajikistan,2003,2003Tajikistan,0,0,0,0,0,5,5,0,0,0,0,0,8,8,13
25266,Tajikistan,2003,2003Tajikistan,0,0,0,0,0,2247,2247,0,0,0,0,0,2682,2682,4929
25267,Tajikistan,2003,2003Tajikistan,0,0,0,6,7,0,13,0,0,5,0,0,0,5,18
25268,Tajikistan,2003,2003Tajikistan,0,5,0,13,0,0,18,0,0,0,13,0,0,13,31
25269,Tajikistan,2003,2003Tajikistan,458,1076,925,3149,114,0,5722,701,1038,894,3206,581,0,6420,12142
25270,Tajikistan,2003,2003Tajikistan,7618,2396,2051,6985,2118,0,21168,6492,2039,1748,5952,1803,0,18034,39202
25271,Tajikistan,2004,2004Tajikistan,0,0,0,0,0,0,0,0,0,0,0,0,0,0,536
25272,Tajikistan,2004,2004Tajikistan,0,0,0,6,7,0,13,0,5,0,0,0,0,5,18
25273,Tajikistan,2004,2004Tajikistan,0,0,0,9,0,0,9,0,0,0,8,0,0,8,17
25274,Tajikistan,2004,2004Tajikistan,107,195,168,341,43,0,854,123,128,110,159,72,0,592,1446
25275,Tajikistan,2004,2004Tajikistan,259,133,113,993,97,0,1595,303,157,134,1169,114,0,1877,3472
25276,Tajikistan,2004,2004Tajikistan,457,1071,921,3137,109,0,5695,698,1033,889,3191,579,0,6390,12085
25277,Tajikistan,2004,2004Tajikistan,7618,2396,2051,6985,2118,0,21168,6492,2039,1748,5952,1803,0,18034,39202
25278,Tajikistan,2005,2005Tajikistan,0,0,0,0,0,0,0,0,0,0,0,0,0,0,1993
25279,Tajikistan,2005,2005Tajikistan,0,0,0,0,0,11,11,0,0,0,0,0,14,14,25
25280,Tajikistan,2005,2005Tajikistan,0,0,0,9,0,0,9,0,0,0,6,0,0,6,15
25281,Tajikistan,2005,2005Tajikistan,0,0,5,0,0,0,5,0,0,0,0,0,0,0,5
25282,Tajikistan,2005,2005Tajikistan,0,6,0,8,6,0,20,0,0,0,0,0,0,0,20
25283,Tajikistan,2005,2005Tajikistan,126,116,90,707,49,0,1088,143,117,113,805,54,0,1232,2320
25284,Tajikistan,2005,2005Tajikistan,627,982,838,2984,211,0,5642,607,1001,861,2873,189,0,5531,11173
25285,Tajikistan,2005,2005Tajikistan,7618,2396,2051,6985,2118,0,21168,6492,2039,1748,5952,1803,0,18034,39202
25286,Tajikistan,2006,2006Tajikistan,0,0,0,0,0,0,0,0,0,0,0,0,0,0,575
25287,Tajikistan,2006,2006Tajikistan,0,0,0,0,0,12,12,0,0,0,0,0,15,15,27
25288,Tajikistan,2006,2006Tajikistan,0,0,0,5,0,0,5,0,0,0,0,0,0,0,5
25289,Tajikistan,2006,2006Tajikistan,0,0,0,8,0,0,8,0,0,0,6,0,0,6,14
25290,Tajikistan,2006,2006Tajikistan,0,0,5,0,0,0,5,0,0,0,0,0,0,0,5
25291,Tajikistan,2006,2006Tajikistan,0,5,0,10,0,0,15,0,5,0,0,0,0,5,20
25292,Tajikistan,2007,2007Tajikistan,0,0,0,0,0,0,0,0,0,0,0,0,0,0,825
25293,Tajikistan,2007,2007Tajikistan,0,0,0,0,0,8,8,0,0,0,0,0,6,6,14
25294,Tajikistan,2007,2007Tajikistan,0,0,0,0,0,11,11,0,0,0,0,0,13,13,24
25295,Tajikistan,2007,2007Tajikistan,0,0,5,0,0,0,5,0,0,0,0,0,0,0,5
25296,Tajikistan,2007,2007Tajikistan,0,6,0,6,0,0,12,0,7,0,0,0,0,7,19
25297,Tajikistan,2008,2008Tajikistan,0,0,0,0,0,0,0,0,0,0,0,0,0,0,478
25298,Tajikistan,2008,2008Tajikistan,0,0,0,0,0,0,0,0,0,0,5,0,0,5,5
25299,Tajikistan,2008,2008Tajikistan,0,0,0,0,0,11,11,0,0,0,0,0,14,14,25
25300,Tajikistan,2008,2008Tajikistan,0,0,0,5,0,0,5,0,11,0,0,0,0,11,16
25301,Tajikistan,2008,2008Tajikistan,0,0,0,6,0,0,6,0,0,0,6,0,0,6,12
25302,Tajikistan,2008,2008Tajikistan,0,0,5,0,0,0,5,0,0,0,0,0,0,0,5
25303,Tajikistan,2009,2009Tajikistan,0,0,0,0,0,0,0,0,0,0,0,0,0,0,395
25304,Tajikistan,2009,2009Tajikistan,0,0,0,0,0,0,0,0,15,0,0,0,0,15,15
25305,Tajikistan,2009,2009Tajikistan,0,0,0,6,0,0,6,0,0,0,6,0,0,6,12
25306,Tajikistan,2009,2009Tajikistan,0,0,5,0,0,0,5,0,0,0,0,0,0,0,5
25307,Tajikistan,2009,2009Tajikistan,0,11,0,35,19,0,65,5,10,5,37,7,0,64,129
25308,Tajikistan,2010,2010Tajikistan,0,0,0,0,0,0,0,0,0,0,0,0,0,0,380
25309,Tajikistan,2010,2010Tajikistan,0,0,0,0,0,0,0,0,0,0,5,0,0,5,5
25310,Tajikistan,2010,2010Tajikistan,0,0,0,0,0,0,0,0,0,5,0,0,0,5,5
25311,Tajikistan,2010,2010Tajikistan,0,0,0,0,0,0,0,0,15,0,0,0,0,15,15
25312,Tajikistan,2010,2010Tajikistan,0,0,0,0,0,6,6,0,0,0,0,0,6,6,12
25313,Tajikistan,2010,2010Tajikistan,0,0,0,0,0,12,12,0,0,0,0,0,16,16,28
25314,Tajikistan,2010,2010Tajikistan,0,10,6,30,19,0,65,5,9,9,32,8,0,63,128
25315,Tajikistan,2011,2011Tajikistan,0,0,0,0,0,0,0,0,0,0,0,0,0,0,360
25316,Tajikistan,2011,2011Tajikistan,0,0,0,0,0,0,0,0,0,5,0,0,0,5,5
25317,Tajikistan,2011,2011Tajikistan,0,0,0,0,0,0,0,0,0,9,0,0,0,9,9
25318,Tajikistan,2011,2011Tajikistan,0,0,0,0,0,0,0,0,6,7,0,0,0,13,13
25319,Tajikistan,2011,2011Tajikistan,0,0,0,0,0,12,12,0,0,0,0,0,16,16,28
25320,Tajikistan,2011,2011Tajikistan,0,0,0,5,0,0,5,0,0,0,5,0,0,5,43
25321,Tajikistan,2011,2011Tajikistan,0,13,11,30,20,0,74,5,14,11,35,7,0,72,146
25322,Tajikistan,2012,2012Tajikistan,0,0,0,0,0,0,0,0,0,0,0,0,0,0,404
25323,Tajikistan,2012,2012Tajikistan,0,0,0,0,0,0,0,0,0,0,0,0,9,9,9
25324,Tajikistan,2012,2012Tajikistan,0,0,0,0,0,0,0,0,0,9,0,0,0,9,9
25325,Tajikistan,2012,2012Tajikistan,0,0,0,0,0,0,0,0,12,0,0,0,0,12,12
25326,Tajikistan,2012,2012Tajikistan,0,0,0,0,0,6,6,0,0,0,0,0,0,0,6
25327,Tajikistan,2012,2012Tajikistan,0,0,0,0,0,12,12,0,0,0,0,0,16,16,28
25328,Tajikistan,2012,2012Tajikistan,0,0,0,5,0,0,5,0,0,0,0,0,0,0,5
25329,Tajikistan,2012,2012Tajikistan,0,0,0,6,0,0,6,0,0,0,0,0,0,0,50
25330,Tajikistan,2012,2012Tajikistan,5,6,9,25,21,0,66,6,11,12,45,6,0,80,146
25331,Tajikistan,2013,2013Tajikistan,0,0,0,0,0,0,0,0,0,0,0,0,0,0,445
25332,Tajikistan,2013,2013Tajikistan,0,0,0,0,0,0,0,0,0,0,5,0,0,5,54
25333,Tajikistan,2013,2013Tajikistan,0,0,0,0,0,0,0,0,12,0,0,0,0,12,12
25334,Tajikistan,2013,2013Tajikistan,0,0,0,0,0,5,5,0,0,0,0,0,0,0,5
25335,Tajikistan,2013,2013Tajikistan,0,0,0,0,0,12,12,0,0,0,0,0,16,16,28
25336,Tajikistan,2013,2013Tajikistan,0,0,0,0,5,0,5,0,0,0,0,0,0,0,5
25337,Tajikistan,2013,2013Tajikistan,0,0,0,7,0,0,7,0,0,0,5,0,0,5,12
25338,Tajikistan,2013,2013Tajikistan,0,0,5,0,0,0,5,0,0,6,0,0,0,6,11
25339,Tajikistan,2013,2013Tajikistan,0,5,0,0,0,0,5,0,7,0,0,0,0,7,12
25340,Tajikistan,2013,2013Tajikistan,5,7,0,11,5,0,28,0,8,6,31,0,0,45,73
25341,Tajikistan,2014,2014Tajikistan,0,0,0,0,0,0,0,0,0,0,0,0,0,0,482
25342,Tajikistan,2014,2014Tajikistan,0,0,0,0,0,0,0,0,0,0,7,0,0,7,59
25343,Tajikistan,2014,2014Tajikistan,0,0,0,0,0,0,0,0,6,6,0,0,0,12,12
25344,Tajikistan,2014,2014Tajikistan,0,0,0,0,0,5,5,0,0,0,0,0,0,0,5
25345,Tajikistan,2014,2014Tajikistan,0,0,0,0,0,13,13,0,0,0,0,0,18,18,31
25346,Tajikistan,2014,2014Tajikistan,0,0,0,5,0,0,5,0,0,0,0,0,0,0,10
25347,Tajikistan,2014,2014Tajikistan,0,0,5,0,0,0,5,0,6,0,0,0,0,6,11
25348,Tajikistan,2014,2014Tajikistan,0,0,5,0,0,0,5,0,6,6,0,0,0,12,17
25349,Tajikistan,2014,2014Tajikistan,5,6,5,15,5,0,36,5,9,7,38,0,0,59,95
25350,Tajikistan,2015,2015Tajikistan,0,0,0,0,0,0,0,0,0,0,0,0,0,0,561
25351,Tajikistan,2015,2015Tajikistan,0,0,0,0,0,0,0,0,0,6,6,0,0,12,12
25352,Tajikistan,2015,2015Tajikistan,0,0,0,0,0,0,0,0,14,0,0,0,0,14,14
25353,Tajikistan,2015,2015Tajikistan,0,0,0,0,0,5,5,0,0,0,0,0,0,0,5
25354,Tajikistan,2015,2015Tajikistan,0,0,0,0,0,5,5,0,0,0,0,0,9,9,14
25355,Tajikistan,2015,2015Tajikistan,0,0,0,0,0,8,8,0,0,0,0,0,5,5,13
25356,Tajikistan,2015,2015Tajikistan,0,0,0,0,0,14,14,0,0,0,0,0,21,21,35
25357,Tajikistan,2015,2015Tajikistan,0,0,0,5,0,0,5,0,0,0,0,0,0,0,10
25358,Tajikistan,2015,2015Tajikistan,0,0,0,7,0,0,7,0,0,0,5,0,0,5,12
25359,Tajikistan,2015,2015Tajikistan,0,0,5,0,0,0,5,0,0,6,0,0,0,6,11
25360,Tajikistan,2015,2015Tajikistan,0,9,7,18,5,0,39,0,9,6,44,5,0,64,103
25361,Tajikistan,2016,2016Tajikistan,0,0,0,0,0,0,0,0,0,0,0,0,0,0,620
25362,Tajikistan,2016,2016Tajikistan,0,0,0,0,0,0,0,0,0,0,7,0,0,7,37
25363,Tajikistan,2016,2016Tajikistan,0,0,0,0,0,0,0,0,0,0,12,0,0,12,12
25364,Tajikistan,2016,2016Tajikistan,0,0,0,0,0,0,0,0,8,0,0,0,0,8,8
25365,Tajikistan,2016,2016Tajikistan,0,0,0,0,0,5,5,0,0,0,0,0,0,0,5
25366,Tajikistan,2016,2016Tajikistan,0,0,0,0,0,5,5,0,0,0,0,0,5,5,10
25367,Tajikistan,2016,2016Tajikistan,0,0,0,0,0,5,5,0,0,0,0,0,9,9,14
25368,Tajikistan,2016,2016Tajikistan,0,0,0,0,0,20,20,0,0,0,0,0,23,23,43
25369,Tajikistan,2016,2016Tajikistan,0,0,0,5,0,0,5,0,0,0,0,0,0,0,5
25370,Tajikistan,2016,2016Tajikistan,0,0,0,7,0,0,7,0,0,0,0,0,0,0,7
25371,Tajikistan,2016,2016Tajikistan,0,0,0,7,0,0,7,0,0,0,5,0,0,5,12
25372,Tajikistan,2016,2016Tajikistan,0,0,5,0,0,0,5,0,0,6,0,0,0,6,11
25373,Tajikistan,2016,2016Tajikistan,6,13,5,31,6,0,61,5,12,10,55,5,0,87,148
25374,Tajikistan,2017,2017Tajikistan,0,0,0,0,0,0,0,0,0,0,0,0,0,0,742
25375,Tajikistan,2017,2017Tajikistan,0,0,0,0,0,0,0,0,0,0,12,0,0,12,12
25376,Tajikistan,2017,2017Tajikistan,0,0,0,0,0,0,0,0,8,0,0,0,0,8,8
25377,Tajikistan,2017,2017Tajikistan,0,0,0,0,0,5,5,0,0,0,0,0,11,11,16
25378,Tajikistan,2017,2017Tajikistan,0,0,0,0,0,6,6,0,0,0,0,0,5,5,11
25379,Tajikistan,2017,2017Tajikistan,0,0,0,0,0,23,23,0,0,0,0,0,25,25,48
25380,Tajikistan,2017,2017Tajikistan,0,0,0,5,0,0,5,0,0,0,0,0,0,0,5
25381,Tajikistan,2017,2017Tajikistan,0,0,0,6,0,0,6,0,0,0,0,0,0,0,6
25382,Tajikistan,2017,2017Tajikistan,0,0,0,7,0,0,7,0,0,0,0,0,0,0,7
25383,Tajikistan,2017,2017Tajikistan,0,0,0,7,0,0,7,0,0,0,5,0,0,5,12
25384,Tajikistan,2017,2017Tajikistan,0,0,5,0,0,0,5,0,0,7,0,0,0,7,12
25385,Tajikistan,2017,2017Tajikistan,42,49,12,122,8,0,233,35,30,29,155,8,0,257,490
25386,Tajikistan,2018,2018Tajikistan,0,0,0,0,0,0,0,0,0,0,0,0,0,0,856
25387,Tajikistan,2018,2018Tajikistan,0,0,0,0,0,0,0,0,0,0,12,0,0,12,12
25388,Tajikistan,2018,2018Tajikistan,0,0,0,0,0,0,0,0,8,0,0,0,0,8,8
25389,Tajikistan,2018,2018Tajikistan,0,0,0,0,0,9,9,0,0,0,0,0,9,9,18
25390,Tajikistan,2018,2018Tajikistan,0,0,0,0,0,23,23,0,0,0,0,0,25,25,48
25391,Tajikistan,2018,2018Tajikistan,0,0,0,5,0,0,5,0,0,0,0,0,0,0,5
25392,Tajikistan,2018,2018Tajikistan,0,0,0,5,0,0,5,0,0,0,7,0,0,7,12
25393,Tajikistan,2018,2018Tajikistan,0,0,0,6,0,0,6,0,0,0,0,0,0,0,6
25394,Tajikistan,2018,2018Tajikistan,0,0,0,7,0,0,7,0,0,0,0,0,0,0,7
25395,Tajikistan,2018,2018Tajikistan,0,0,5,0,0,0,5,0,0,0,0,0,0,0,5
25396,Tajikistan,2018,2018Tajikistan,0,6,0,6,0,0,12,0,0,5,8,0,0,13,52
25397,Tajikistan,2018,2018Tajikistan,47,65,20,166,10,0,308,55,53,32,210,8,0,358,666
25398,Tajikistan,2019,2019Tajikistan,0,0,0,0,0,0,0,0,0,0,0,0,0,0,999
25399,Tajikistan,2019,2019Tajikistan,0,0,0,0,0,0,0,0,0,0,5,0,0,5,5
25400,Tajikistan,2019,2019Tajikistan,0,0,0,0,0,0,0,0,0,0,12,0,0,12,12
25401,Tajikistan,2019,2019Tajikistan,0,0,0,0,0,5,5,0,0,0,0,0,8,8,13
25402,Tajikistan,2019,2019Tajikistan,0,0,0,0,0,25,25,0,0,0,0,0,31,31,56
25403,Tajikistan,2019,2019Tajikistan,0,0,0,5,0,0,5,0,0,0,7,0,0,7,12
25404,Tajikistan,2019,2019Tajikistan,0,0,0,6,0,0,6,0,0,0,0,0,0,0,6
25405,Tajikistan,2019,2019Tajikistan,0,0,0,8,0,0,8,0,0,0,0,0,0,0,8
25406,Tajikistan,2019,2019Tajikistan,0,0,5,0,0,0,5,0,0,0,0,0,0,0,5
25407,Tajikistan,2019,2019Tajikistan,66,88,27,215,11,0,407,72,81,44,259,8,0,464,871
25408,Tajikistan,2020,2020Tajikistan,0,0,0,0,0,0,0,0,0,0,0,0,0,0,1074
25409,Tajikistan,2020,2020Tajikistan,0,0,0,0,0,0,0,0,0,0,5,0,0,5,5
25410,Tajikistan,2020,2020Tajikistan,0,0,0,0,0,6,6,0,0,0,0,0,5,5,11
25411,Tajikistan,2020,2020Tajikistan,0,0,0,0,0,8,8,0,0,0,0,0,14,14,22
25412,Tajikistan,2020,2020Tajikistan,0,0,0,5,0,0,5,0,0,0,7,0,0,7,12
25413,Tajikistan,2020,2020Tajikistan,0,0,0,6,0,0,6,0,0,0,5,0,0,5,11
25414,Tajikistan,2020,2020Tajikistan,0,0,0,8,0,0,8,0,0,0,0,0,0,0,8
25415,Tajikistan,2020,2020Tajikistan,0,0,5,0,0,0,5,0,0,0,0,0,0,0,5
25416,Tajikistan,2020,2020Tajikistan,0,7,0,0,0,0,7,0,0,0,0,0,0,0,7
25417,Tajikistan,2020,2020Tajikistan,74,111,49,257,11,0,502,78,113,59,303,9,0,562,1064
25418,Tajikistan,2021,2021Tajikistan,0,0,0,0,0,0,0,0,0,0,0,0,0,0,1124
25419,Tajikistan,2021,2021Tajikistan,0,0,0,0,0,0,0,0,0,0,0,0,23,23,23
25420,Tajikistan,2021,2021Tajikistan,0,0,0,0,0,0,0,0,0,0,5,0,0,5,5
25421,Tajikistan,2021,2021Tajikistan,0,0,0,0,0,5,5,0,0,0,0,0,0,0,5
25422,Tajikistan,2021,2021Tajikistan,0,0,0,5,0,0,5,0,0,0,5,0,0,5,10
25423,Tajikistan,2021,2021Tajikistan,0,0,0,5,0,0,5,0,0,0,7,0,0,7,12
25424,Tajikistan,2021,2021Tajikistan,0,0,0,6,0,0,6,0,0,0,0,0,0,0,6
25425,Tajikistan,2021,2021Tajikistan,0,6,0,0,0,0,6,0,0,0,7,0,0,7,42
25426,Tajikistan,2021,2021Tajikistan,0,7,0,0,0,0,7,0,0,0,0,0,0,0,7
25427,Tajikistan,2021,2021Tajikistan,70,120,66,284,12,0,552,75,137,62,340,12,0,626,1178
25428,Tibetan,2001,2001Tibetan,0,0,0,0,0,0,0,0,0,0,0,0,0,0,20721
25429,Tibetan,2002,2002Tibetan,0,0,0,0,0,0,0,0,0,0,0,0,0,0,20631
25430,Tibetan,2003,2003Tibetan,0,0,0,0,0,0,0,0,0,0,0,0,0,0,20038
25431,Tibetan,2004,2004Tibetan,0,0,0,0,0,0,0,0,0,0,0,0,0,0,38
25432,Tibetan,2004,2004Tibetan,0,0,0,0,0,9536,9536,0,0,0,0,0,10464,10464,20000
25433,Tibetan,2005,2005Tibetan,0,0,0,0,0,0,0,0,0,0,0,0,0,0,45
25434,Tibetan,2005,2005Tibetan,0,0,0,0,0,9610,9610,0,0,0,0,0,10543,10543,20153
25435,Tibetan,2006,2006Tibetan,0,0,0,0,0,0,0,0,0,0,0,0,0,0,15
25436,Tibetan,2006,2006Tibetan,0,0,0,0,0,5,5,0,0,0,0,0,11,11,16
25437,Tibetan,2006,2006Tibetan,0,0,0,0,0,9610,9610,0,0,0,0,0,10543,10543,20153
25438,Tibetan,2007,2007Tibetan,0,0,0,0,0,5,5,0,0,0,0,0,12,12,17
25439,Tibetan,2007,2007Tibetan,0,0,0,0,0,9610,9610,0,0,0,0,0,10543,10543,20153
25440,Tibetan,2008,2008Tibetan,0,0,0,0,0,0,0,0,0,0,0,0,0,0,63
25441,Tibetan,2008,2008Tibetan,0,0,0,0,0,5,5,0,0,0,0,0,12,12,17
25442,Tibetan,2008,2008Tibetan,0,0,0,0,0,10000,10000,0,0,0,0,0,10000,10000,20000
25443,Tibetan,2009,2009Tibetan,0,0,0,0,0,0,0,0,0,0,0,0,0,0,65
25444,Tibetan,2009,2009Tibetan,0,0,0,0,0,5,5,0,0,0,0,0,10,10,15
25445,Tibetan,2009,2009Tibetan,0,0,0,0,0,10000,10000,0,0,0,0,0,10000,10000,20000
25446,Tibetan,2010,2010Tibetan,0,0,0,0,0,0,0,0,0,0,0,0,0,0,15065
25447,Tibetan,2010,2010Tibetan,0,0,0,0,0,0,0,0,0,0,0,0,16,16,16
25448,Tibetan,2011,2011Tibetan,0,0,0,0,0,0,0,0,0,0,0,0,0,0,65
25449,Tibetan,2011,2011Tibetan,0,0,0,0,0,7500,7500,0,0,0,0,0,7500,7500,15000
25450,Tibetan,2012,2012Tibetan,0,0,0,0,0,7500,7500,0,0,0,0,0,7500,7500,15000
25451,Tibetan,2013,2013Tibetan,0,0,0,0,0,0,0,0,0,0,0,0,0,0,65
25452,Tibetan,2013,2013Tibetan,0,0,0,0,0,7500,7500,0,0,0,0,0,7500,7500,15000
25453,Tibetan,2014,2014Tibetan,0,0,0,0,0,0,0,0,0,0,0,0,0,0,66
25454,Tibetan,2014,2014Tibetan,0,0,0,0,0,7500,7500,0,0,0,0,0,7500,7500,15000
25455,Tibetan,2015,2015Tibetan,0,0,0,0,0,0,0,0,0,0,0,0,0,0,69
25456,Tibetan,2015,2015Tibetan,0,0,0,7500,0,0,7500,0,0,0,7500,0,0,7500,15000
25457,Tibetan,2016,2016Tibetan,0,0,0,0,0,0,0,0,0,0,0,0,0,0,22
25458,Tibetan,2016,2016Tibetan,0,0,0,0,0,0,0,0,0,0,5,0,0,5,5
25459,Tibetan,2016,2016Tibetan,0,0,0,7003,0,0,7003,0,0,0,6506,0,0,6506,13509
25460,Tibetan,2017,2017Tibetan,0,0,0,0,0,0,0,0,0,0,0,0,0,0,22
25461,Tibetan,2017,2017Tibetan,0,0,0,7003,0,0,7003,0,0,0,6506,0,0,6506,13509
25462,Tibetan,2018,2018Tibetan,0,0,0,0,0,0,0,0,0,0,0,0,0,0,18
25463,Tibetan,2018,2018Tibetan,0,0,0,7003,0,0,7003,0,0,0,6506,0,0,6506,13509
25464,Tibetan,2019,2019Tibetan,0,0,0,0,0,0,0,0,0,0,0,0,0,0,15
25465,Tibetan,2019,2019Tibetan,0,0,0,6520,0,0,6520,0,0,0,6020,0,0,6020,12540
25466,Tibetan,2020,2020Tibetan,0,0,0,0,0,0,0,0,0,0,0,0,0,0,15
25467,Tibetan,2020,2020Tibetan,0,0,0,0,0,0,0,0,0,0,0,0,6,6,6
25468,Tibetan,2020,2020Tibetan,0,0,0,0,0,6897,6897,0,0,0,0,0,5643,5643,12540
25469,Tibetan,2021,2021Tibetan,0,0,0,0,0,0,0,0,0,0,0,0,0,0,53
25470,Tibetan,2021,2021Tibetan,0,0,0,0,0,6897,6897,0,0,0,0,0,5643,5643,12540
25471,Timor-Leste,2001,2001Timor-Leste,0,0,0,0,0,35060,35060,0,0,0,0,0,37982,37982,73042
25472,Timor-Leste,2002,2002Timor-Leste,0,0,0,0,0,0,0,0,0,0,0,0,0,0,28097
25473,Timor-Leste,2003,2003Timor-Leste,0,0,0,0,0,0,0,0,0,0,0,0,0,0,127
25474,Timor-Leste,2004,2004Timor-Leste,0,0,0,0,0,0,0,0,0,0,0,0,0,0,221
25475,Timor-Leste,2005,2005Timor-Leste,0,0,0,0,0,0,0,0,0,0,0,0,0,0,251
25476,Timor-Leste,2006,2006Timor-Leste,0,0,0,0,0,0,0,0,0,0,0,0,0,0,251
25477,Timor-Leste,2007,2007Timor-Leste,0,0,0,0,0,0,0,0,0,0,0,0,0,0,6
25478,Timor-Leste,2008,2008Timor-Leste,0,0,0,0,0,0,0,0,0,0,0,0,0,0,7
25479,Timor-Leste,2009,2009Timor-Leste,0,0,0,0,0,0,0,0,0,0,0,0,0,0,7
25480,Timor-Leste,2010,2010Timor-Leste,0,0,0,0,0,0,0,0,0,0,0,0,0,0,8
25481,Timor-Leste,2011,2011Timor-Leste,0,0,0,0,0,0,0,0,0,0,0,0,0,0,8
25482,Timor-Leste,2012,2012Timor-Leste,0,0,0,0,0,0,0,0,0,0,0,0,0,0,8
25483,Timor-Leste,2013,2013Timor-Leste,0,0,0,0,0,0,0,0,0,0,0,0,0,0,8
25484,Timor-Leste,2014,2014Timor-Leste,0,0,0,0,0,0,0,0,0,0,0,0,0,0,13
25485,Timor-Leste,2015,2015Timor-Leste,0,0,0,0,0,0,0,0,0,0,0,0,0,0,19
25486,Timor-Leste,2016,2016Timor-Leste,0,0,0,0,0,0,0,0,0,0,0,0,0,0,19
25487,Timor-Leste,2017,2017Timor-Leste,0,0,0,0,0,0,0,0,0,0,0,0,0,0,13
25488,Timor-Leste,2018,2018Timor-Leste,0,0,0,0,0,0,0,0,0,0,0,0,0,0,12
25489,Timor-Leste,2019,2019Timor-Leste,0,0,0,0,0,0,0,0,0,0,0,0,0,0,17
25490,Timor-Leste,2020,2020Timor-Leste,0,0,0,0,0,0,0,0,0,0,0,0,0,0,11
25491,Timor-Leste,2021,2021Timor-Leste,0,0,0,0,0,0,0,0,0,0,0,0,0,0,11
25492,Togo,2001,2001Togo,0,0,0,0,0,0,0,0,0,0,0,0,0,0,2057
25493,Togo,2001,2001Togo,0,0,0,0,0,0,0,0,0,0,5,0,0,5,5
25494,Togo,2001,2001Togo,0,0,0,0,0,0,0,0,0,0,7,0,0,7,7
25495,Togo,2001,2001Togo,0,0,0,0,0,18,18,0,0,0,0,0,22,22,40
25496,Togo,2001,2001Togo,0,0,0,0,0,19,19,0,0,0,0,0,15,15,34
25497,Togo,2001,2001Togo,0,0,0,0,0,50,50,0,0,0,0,0,99,99,149
25498,Togo,2001,2001Togo,0,0,8,8,0,0,16,0,9,0,15,0,0,24,40
25499,Togo,2001,2001Togo,48,49,42,195,9,0,343,45,58,50,333,13,0,499,842
25500,Togo,2001,2001Togo,68,82,71,446,7,0,674,62,71,61,314,0,0,508,1182
25501,Togo,2002,2002Togo,0,0,0,0,0,0,0,0,0,0,0,0,0,0,8120
25502,Togo,2002,2002Togo,0,0,0,0,0,0,0,0,0,0,5,0,0,5,5
25503,Togo,2002,2002Togo,0,0,0,0,0,0,0,0,0,0,8,0,0,8,8
25504,Togo,2002,2002Togo,0,0,0,0,0,0,0,0,0,7,0,0,0,7,7
25505,Togo,2002,2002Togo,0,0,0,0,0,7,7,0,0,0,0,0,15,15,38
25506,Togo,2002,2002Togo,0,0,0,0,0,59,59,0,0,0,0,0,127,127,186
25507,Togo,2002,2002Togo,0,0,0,7,0,0,7,0,0,0,6,0,0,6,13
25508,Togo,2002,2002Togo,0,0,6,10,0,0,16,0,0,8,16,0,0,24,40
25509,Togo,2002,2002Togo,38,27,24,78,0,0,167,44,22,19,115,7,0,207,819
25510,Togo,2002,2002Togo,73,80,68,446,7,0,674,67,70,60,334,0,0,531,1205
25511,Togo,2003,2003Togo,0,0,0,0,0,0,0,0,0,0,0,0,0,0,8405
25512,Togo,2003,2003Togo,0,0,0,0,0,0,0,0,0,0,5,0,0,5,5
25513,Togo,2003,2003Togo,0,0,0,0,0,0,0,0,0,0,9,0,0,9,9
25514,Togo,2003,2003Togo,0,0,0,0,0,0,0,0,0,7,0,0,0,7,7
25515,Togo,2003,2003Togo,0,0,0,0,0,0,0,5,0,0,0,0,0,5,5
25516,Togo,2003,2003Togo,0,0,0,0,0,13,13,0,0,0,0,0,34,34,64
25517,Togo,2003,2003Togo,0,0,0,0,0,72,72,0,0,0,0,0,172,172,244
25518,Togo,2003,2003Togo,0,0,0,8,0,0,8,0,5,5,39,0,0,49,57
25519,Togo,2003,2003Togo,0,0,6,5,0,0,11,0,0,0,7,0,0,7,18
25520,Togo,2003,2003Togo,0,0,6,10,0,0,16,0,0,8,16,0,0,24,40
25521,Togo,2003,2003Togo,36,47,41,127,6,0,257,39,44,38,148,8,0,277,534
25522,Togo,2003,2003Togo,78,78,67,453,7,0,683,76,70,60,332,0,0,538,1221
25523,Togo,2004,2004Togo,0,0,0,0,0,0,0,0,0,0,0,0,0,0,8914
25524,Togo,2004,2004Togo,0,0,0,0,0,0,0,0,0,0,5,0,0,5,5
25525,Togo,2004,2004Togo,0,0,0,0,0,0,0,0,0,0,6,0,0,6,6
25526,Togo,2004,2004Togo,0,0,0,0,0,0,0,0,0,5,0,0,0,5,5
25527,Togo,2004,2004Togo,0,0,0,8,0,0,8,0,5,5,41,0,0,51,59
25528,Togo,2004,2004Togo,0,0,6,5,0,0,11,0,0,0,7,0,0,7,18
25529,Togo,2004,2004Togo,0,0,6,10,0,0,16,0,0,8,16,0,0,24,40
25530,Togo,2004,2004Togo,0,5,0,7,0,42,54,0,0,5,5,0,65,75,129
25531,Togo,2004,2004Togo,49,46,40,123,6,0,264,53,41,35,141,8,0,278,542
25532,Togo,2004,2004Togo,75,67,58,432,5,0,637,74,48,41,300,0,0,463,1100
25533,Togo,2005,2005Togo,0,0,0,0,0,0,0,0,0,0,0,0,0,0,9519
25534,Togo,2005,2005Togo,0,0,0,0,0,0,0,0,0,0,5,0,0,5,5
25535,Togo,2005,2005Togo,0,0,0,0,0,0,0,0,0,0,12,0,0,12,12
25536,Togo,2005,2005Togo,0,0,0,0,0,0,0,0,0,5,31,0,0,36,36
25537,Togo,2005,2005Togo,0,0,0,0,0,0,0,0,0,7,0,0,0,7,7
25538,Togo,2005,2005Togo,0,0,0,0,0,114,114,0,0,0,0,0,302,302,416
25539,Togo,2005,2005Togo,0,0,0,6,0,0,6,0,0,0,7,0,0,7,13
25540,Togo,2005,2005Togo,0,0,0,8,0,0,8,0,5,5,41,0,0,51,59
25541,Togo,2005,2005Togo,0,0,6,6,0,0,12,0,0,0,6,0,0,6,18
25542,Togo,2005,2005Togo,0,0,6,7,0,75,88,0,0,5,5,0,128,138,226
25543,Togo,2005,2005Togo,0,5,0,0,0,0,5,0,0,0,8,0,0,8,13
25544,Togo,2005,2005Togo,1125,1103,947,3912,335,0,7422,1159,1094,938,3348,175,0,6714,14136
25545,Togo,2005,2005Togo,1646,1800,1543,6919,438,0,12346,1678,1851,1586,8982,189,0,14286,26632
25546,Togo,2006,2006Togo,0,0,0,0,0,0,0,0,0,0,0,0,0,0,8195
25547,Togo,2006,2006Togo,0,0,0,0,0,0,0,0,0,0,5,0,0,5,5
25548,Togo,2006,2006Togo,0,0,0,0,0,0,0,0,0,0,14,0,0,14,14
25549,Togo,2006,2006Togo,0,0,0,0,0,0,0,0,0,7,0,0,0,7,7
25550,Togo,2006,2006Togo,0,0,0,0,0,18,18,0,0,0,0,0,66,66,84
25551,Togo,2006,2006Togo,0,0,0,0,0,137,137,0,0,0,0,0,353,353,490
25552,Togo,2006,2006Togo,0,0,0,0,0,167,167,0,0,0,0,0,214,214,381
25553,Togo,2006,2006Togo,0,0,0,6,0,0,6,0,0,5,0,0,0,5,11
25554,Togo,2006,2006Togo,0,0,0,7,0,0,7,0,0,0,10,0,0,10,17
25555,Togo,2006,2006Togo,0,0,0,8,0,0,8,5,0,5,42,0,0,52,60
25556,Togo,2006,2006Togo,0,0,0,17,0,0,17,0,0,0,10,0,0,10,27
25557,Togo,2006,2006Togo,0,0,5,5,0,0,10,0,0,0,13,0,0,13,23
25558,Togo,2006,2006Togo,0,0,7,0,0,0,7,0,0,0,0,0,0,0,7
25559,Togo,2006,2006Togo,0,8,0,0,0,0,8,0,5,0,23,0,0,28,36
25560,Togo,2006,2006Togo,541,238,892,2263,61,0,3995,565,262,848,3734,40,0,5449,9444
25561,Togo,2006,2006Togo,773,817,451,2321,180,0,4542,773,812,466,1837,87,0,3975,8517
25562,Togo,2007,2007Togo,0,0,0,0,0,0,0,0,0,0,0,0,0,0,7710
25563,Togo,2007,2007Togo,0,0,0,0,0,0,0,0,0,0,14,0,0,14,14
25564,Togo,2007,2007Togo,0,0,0,0,0,0,0,0,0,7,0,0,0,7,7
25565,Togo,2007,2007Togo,0,0,0,0,0,24,24,0,0,0,0,0,77,77,101
25566,Togo,2007,2007Togo,0,0,0,0,0,156,156,0,0,0,0,0,384,384,540
25567,Togo,2007,2007Togo,0,0,0,6,0,0,6,0,5,0,0,0,0,5,11
25568,Togo,2007,2007Togo,0,0,0,8,0,0,8,0,0,0,9,0,0,9,17
25569,Togo,2007,2007Togo,0,0,0,8,0,0,8,5,0,5,43,0,0,53,61
25570,Togo,2007,2007Togo,0,0,0,13,0,0,13,0,0,0,17,0,0,17,30
25571,Togo,2007,2007Togo,0,0,6,6,0,0,12,0,5,0,31,0,0,36,48
25572,Togo,2007,2007Togo,0,5,0,6,0,0,11,5,0,0,7,0,0,12,23
25573,Togo,2007,2007Togo,0,8,0,0,0,0,8,0,0,0,0,0,0,0,8
25574,Togo,2007,2007Togo,6,0,0,16,0,197,219,5,0,0,10,0,226,241,460
25575,Togo,2007,2007Togo,405,433,377,1471,43,0,2729,388,510,348,2200,33,0,3479,6208
25576,Togo,2007,2007Togo,658,704,387,1964,152,0,3865,641,669,386,1612,70,0,3378,7243
25577,Togo,2008,2008Togo,0,0,0,0,0,0,0,0,0,0,0,0,0,0,7900
25578,Togo,2008,2008Togo,0,0,0,0,0,0,0,0,0,0,5,0,0,5,10
25579,Togo,2008,2008Togo,0,0,0,0,0,0,0,0,0,0,14,0,0,14,14
25580,Togo,2008,2008Togo,0,0,0,0,0,32,32,0,0,0,0,0,80,80,112
25581,Togo,2008,2008Togo,0,0,0,0,0,172,172,0,0,0,0,0,414,414,586
25582,Togo,2008,2008Togo,0,0,0,6,0,0,6,0,5,0,0,0,0,5,11
25583,Togo,2008,2008Togo,0,0,0,7,0,0,7,0,0,0,10,0,0,10,17
25584,Togo,2008,2008Togo,0,0,0,7,0,0,7,0,0,7,42,0,0,49,56
25585,Togo,2008,2008Togo,0,0,6,6,0,0,12,0,5,0,34,0,0,39,51
25586,Togo,2008,2008Togo,0,5,0,5,0,0,10,7,0,0,9,0,0,16,26
25587,Togo,2008,2008Togo,5,0,0,9,0,0,14,0,0,0,17,0,0,17,31
25588,Togo,2008,2008Togo,5,0,0,19,0,227,251,6,0,0,12,0,255,273,524
25589,Togo,2008,2008Togo,96,146,109,388,77,0,816,108,110,111,629,22,0,980,1796
25590,Togo,2008,2008Togo,426,380,324,1290,40,0,2460,386,438,306,1981,29,0,3140,5600
25591,Togo,2009,2009Togo,0,0,0,0,0,0,0,0,0,0,0,0,0,0,5269
25592,Togo,2009,2009Togo,0,0,0,0,0,0,0,0,0,0,5,0,0,5,10
25593,Togo,2009,2009Togo,0,0,0,0,0,0,0,0,0,0,14,0,0,14,14
25594,Togo,2009,2009Togo,0,0,0,0,0,34,34,0,0,0,0,0,78,78,112
25595,Togo,2009,2009Togo,0,0,0,7,0,0,7,0,0,5,0,0,0,5,12
25596,Togo,2009,2009Togo,0,0,0,7,0,0,7,0,5,5,39,0,0,49,56
25597,Togo,2009,2009Togo,0,0,0,7,0,0,7,5,0,0,8,0,0,13,20
25598,Togo,2009,2009Togo,0,0,6,5,0,0,11,0,7,0,10,0,0,17,28
25599,Togo,2009,2009Togo,0,0,6,6,0,0,12,0,5,0,34,0,0,39,51
25600,Togo,2009,2009Togo,5,0,0,10,0,0,15,0,0,0,17,0,0,17,32
25601,Togo,2009,2009Togo,9,0,0,26,0,248,283,5,5,0,16,0,281,307,590
25602,Togo,2009,2009Togo,60,309,234,1169,5,0,1777,66,278,222,2233,16,0,2815,4592
25603,Togo,2009,2009Togo,91,163,118,392,25,0,789,102,137,91,512,25,0,867,1656
25604,Togo,2009,2009Togo,347,410,332,1386,42,0,2517,351,474,300,2245,34,0,3404,5921
25605,Togo,2010,2010Togo,0,0,0,0,0,0,0,0,0,0,0,0,0,0,4584
25606,Togo,2010,2010Togo,0,0,0,0,0,0,0,0,0,0,5,0,0,5,5
25607,Togo,2010,2010Togo,0,0,0,0,0,0,0,0,0,5,0,0,0,5,5
25608,Togo,2010,2010Togo,0,0,0,0,0,44,44,0,0,0,0,0,79,79,123
25609,Togo,2010,2010Togo,0,0,0,0,0,211,211,0,0,0,0,0,460,460,671
25610,Togo,2010,2010Togo,0,0,0,5,0,0,5,0,0,0,12,0,0,12,17
25611,Togo,2010,2010Togo,0,0,0,5,0,0,5,0,6,0,10,0,0,16,21
25612,Togo,2010,2010Togo,0,0,0,7,0,0,7,0,6,0,0,0,0,6,13
25613,Togo,2010,2010Togo,0,0,0,8,0,0,8,5,0,0,9,0,0,14,22
25614,Togo,2010,2010Togo,0,0,0,9,0,0,9,0,5,6,40,0,0,51,60
25615,Togo,2010,2010Togo,0,0,6,6,0,0,12,0,5,0,31,0,0,36,48
25616,Togo,2010,2010Togo,5,0,0,9,0,0,14,0,0,0,18,0,0,18,32
25617,Togo,2010,2010Togo,7,0,0,5,0,0,12,5,8,0,10,0,0,23,35
25618,Togo,2010,2010Togo,9,0,0,26,0,262,297,7,6,0,18,0,295,326,623
25619,Togo,2010,2010Togo,48,281,256,1138,6,0,1729,52,249,228,2103,21,0,2653,4382
25620,Togo,2010,2010Togo,110,176,126,412,27,0,851,109,147,112,511,25,0,904,1755
25621,Togo,2010,2010Togo,377,408,331,1362,41,0,2519,378,462,298,2228,27,0,3393,5912
25622,Togo,2011,2011Togo,0,0,0,0,0,0,0,0,0,0,0,0,0,0,4190
25623,Togo,2011,2011Togo,0,0,0,0,0,0,0,0,0,0,5,0,0,5,10
25624,Togo,2011,2011Togo,0,0,0,0,0,49,49,0,0,0,0,0,83,83,132
25625,Togo,2011,2011Togo,0,0,0,0,0,224,224,0,0,0,0,0,475,475,699
25626,Togo,2011,2011Togo,0,0,0,5,0,0,5,0,0,0,12,0,0,12,17
25627,Togo,2011,2011Togo,0,0,0,5,0,0,5,0,6,0,10,0,0,16,21
25628,Togo,2011,2011Togo,0,0,0,6,0,0,6,0,0,0,5,0,0,5,11
25629,Togo,2011,2011Togo,0,0,0,7,0,0,7,0,6,0,0,0,0,6,13
25630,Togo,2011,2011Togo,0,0,0,9,0,0,9,0,5,6,40,0,0,51,60
25631,Togo,2011,2011Togo,0,0,6,11,0,0,17,5,0,0,18,0,0,23,262
25632,Togo,2011,2011Togo,0,6,0,5,0,0,11,0,8,0,10,0,0,18,29
25633,Togo,2011,2011Togo,0,9,0,6,0,0,15,0,0,0,16,0,0,16,31
25634,Togo,2011,2011Togo,5,0,0,0,0,0,5,0,0,0,0,0,0,0,5
25635,Togo,2011,2011Togo,5,0,0,9,0,0,14,0,0,0,14,0,0,14,28
25636,Togo,2011,2011Togo,6,9,0,28,0,283,326,6,5,0,19,0,310,340,666
25637,Togo,2011,2011Togo,37,226,250,1056,8,0,1577,31,201,225,1948,25,0,2430,4007
25638,Togo,2011,2011Togo,124,227,80,410,21,0,862,134,200,73,500,20,0,927,1789
25639,Togo,2011,2011Togo,416,395,326,1335,39,0,2511,400,457,294,2196,25,0,3372,5883
25640,Togo,2012,2012Togo,0,0,0,0,0,0,0,0,0,0,0,0,0,0,3918
25641,Togo,2012,2012Togo,0,0,0,0,0,0,0,0,0,0,5,0,0,5,10
25642,Togo,2012,2012Togo,0,0,0,0,0,0,0,0,0,0,9,0,0,9,9
25643,Togo,2012,2012Togo,0,0,0,0,0,0,0,5,0,0,0,0,0,5,5
25644,Togo,2012,2012Togo,0,0,0,0,0,5,5,0,0,0,0,0,0,0,5
25645,Togo,2012,2012Togo,0,0,0,0,0,39,39,0,0,0,0,0,76,76,115
25646,Togo,2012,2012Togo,0,0,0,0,0,228,228,0,0,0,0,0,483,483,711
25647,Togo,2012,2012Togo,0,0,0,5,0,0,5,0,0,0,5,0,0,5,10
25648,Togo,2012,2012Togo,0,0,0,5,0,0,5,0,0,0,6,0,0,6,251
25649,Togo,2012,2012Togo,0,0,0,5,0,0,5,0,6,0,10,0,0,16,21
25650,Togo,2012,2012Togo,0,0,0,7,0,0,7,0,0,5,12,0,0,17,24
25651,Togo,2012,2012Togo,0,0,0,7,0,0,7,0,0,6,0,0,0,6,13
25652,Togo,2012,2012Togo,0,5,0,5,0,0,10,0,8,0,9,0,0,17,27
25653,Togo,2012,2012Togo,0,6,0,0,0,0,6,0,0,0,0,0,0,0,6
25654,Togo,2012,2012Togo,0,8,0,7,0,0,15,0,5,0,13,0,0,18,33
25655,Togo,2012,2012Togo,5,0,0,0,0,0,5,0,0,0,0,0,0,0,5
25656,Togo,2012,2012Togo,5,0,0,10,0,0,15,0,0,0,14,0,0,14,29
25657,Togo,2012,2012Togo,5,10,0,27,0,299,341,5,5,0,13,0,332,355,696
25658,Togo,2012,2012Togo,27,194,262,1047,9,0,1539,30,168,233,1907,28,0,2366,3905
25659,Togo,2012,2012Togo,75,185,62,534,11,0,867,84,170,38,529,14,0,835,1702
25660,Togo,2012,2012Togo,264,367,210,1035,27,0,1903,278,366,237,1382,22,0,2285,4188
25661,Togo,2013,2013Togo,0,0,0,0,0,0,0,0,0,0,0,0,0,0,3437
25662,Togo,2013,2013Togo,0,0,0,0,0,0,0,0,0,0,5,0,0,5,5
25663,Togo,2013,2013Togo,0,0,0,0,0,0,0,0,0,0,7,0,0,7,7
25664,Togo,2013,2013Togo,0,0,0,0,0,0,0,0,9,0,0,0,0,9,9
25665,Togo,2013,2013Togo,0,0,0,0,0,0,0,5,0,0,0,0,0,5,5
25666,Togo,2013,2013Togo,0,0,0,0,0,37,37,0,0,0,0,0,78,78,143
25667,Togo,2013,2013Togo,0,0,0,0,0,228,228,0,0,0,0,0,503,503,731
25668,Togo,2013,2013Togo,0,0,0,5,0,0,5,0,0,0,5,0,0,5,10
25669,Togo,2013,2013Togo,0,0,0,5,0,0,5,0,0,0,7,0,0,7,12
25670,Togo,2013,2013Togo,0,0,0,5,0,0,5,0,5,0,0,0,0,5,10
25671,Togo,2013,2013Togo,0,0,0,5,0,0,5,0,6,0,10,0,0,16,21
25672,Togo,2013,2013Togo,0,0,0,6,0,0,6,0,0,0,30,0,0,30,36
25673,Togo,2013,2013Togo,0,0,0,7,0,0,7,0,0,6,0,0,0,6,13
25674,Togo,2013,2013Togo,0,5,0,6,0,0,11,0,0,5,5,0,0,10,248
25675,Togo,2013,2013Togo,0,6,0,5,0,0,11,0,8,0,10,0,0,18,29
25676,Togo,2013,2013Togo,0,6,0,6,0,0,12,0,0,0,15,0,0,15,27
25677,Togo,2013,2013Togo,5,0,0,0,0,0,5,0,0,0,0,0,0,0,5
25678,Togo,2013,2013Togo,5,0,0,11,0,0,16,0,0,0,14,0,0,14,30
25679,Togo,2013,2013Togo,5,9,0,28,0,296,338,7,5,0,22,0,331,365,703
25680,Togo,2013,2013Togo,7,58,63,335,5,0,468,10,45,55,802,24,0,936,1404
25681,Togo,2013,2013Togo,369,248,228,639,41,0,1525,365,310,244,925,47,0,1891,3416
25682,Togo,2014,2014Togo,0,0,0,0,0,0,0,0,0,0,0,0,0,0,3177
25683,Togo,2014,2014Togo,0,0,0,0,0,0,0,0,0,0,0,0,8,8,8
25684,Togo,2014,2014Togo,0,0,0,0,0,0,0,0,0,0,5,0,0,5,10
25685,Togo,2014,2014Togo,0,0,0,0,0,0,0,0,0,0,7,0,0,7,7
25686,Togo,2014,2014Togo,0,0,0,0,0,0,0,0,0,0,8,0,0,8,8
25687,Togo,2014,2014Togo,0,0,0,0,0,0,0,0,0,0,9,0,0,9,18
25688,Togo,2014,2014Togo,0,0,0,0,0,0,0,5,0,0,0,0,0,5,5
25689,Togo,2014,2014Togo,0,0,0,0,0,5,5,0,0,0,0,0,0,0,5
25690,Togo,2014,2014Togo,0,0,0,0,0,220,220,0,0,0,0,0,479,479,699
25691,Togo,2014,2014Togo,0,0,0,5,0,0,5,0,0,0,8,0,0,8,224
25692,Togo,2014,2014Togo,0,0,0,6,0,0,6,0,0,0,5,0,0,5,11
25693,Togo,2014,2014Togo,0,0,0,6,0,0,6,0,0,0,7,0,0,7,13
25694,Togo,2014,2014Togo,0,0,6,0,0,0,6,5,5,7,9,0,0,26,32
25695,Togo,2014,2014Togo,0,6,0,0,0,0,6,0,0,7,0,0,0,7,13
25696,Togo,2014,2014Togo,0,6,0,5,0,0,11,0,9,0,10,0,0,19,30
25697,Togo,2014,2014Togo,0,6,0,8,0,0,14,5,0,0,11,0,0,16,30
25698,Togo,2014,2014Togo,0,8,0,0,0,0,8,0,0,0,5,0,0,5,13
25699,Togo,2014,2014Togo,5,0,0,0,0,0,5,0,0,0,0,0,0,0,5
25700,Togo,2014,2014Togo,5,46,48,315,7,0,421,7,35,47,756,27,0,872,1293
25701,Togo,2014,2014Togo,6,8,0,31,0,314,359,7,12,0,26,0,340,385,744
25702,Togo,2014,2014Togo,188,247,179,671,47,0,1332,183,259,166,927,59,0,1594,2926
25703,Togo,2015,2015Togo,0,0,0,0,0,0,0,0,0,0,0,0,0,0,2696
25704,Togo,2015,2015Togo,0,0,0,0,0,0,0,0,0,0,5,0,0,5,10
25705,Togo,2015,2015Togo,0,0,0,0,0,5,5,0,0,0,0,0,0,0,5
25706,Togo,2015,2015Togo,0,0,0,0,0,59,59,0,0,0,0,0,115,115,174
25707,Togo,2015,2015Togo,0,0,0,0,0,219,219,0,0,0,0,0,474,474,693
25708,Togo,2015,2015Togo,0,0,0,5,0,0,5,0,0,0,0,0,0,0,5
25709,Togo,2015,2015Togo,0,0,0,5,0,0,5,0,0,0,8,0,0,8,13
25710,Togo,2015,2015Togo,0,0,0,5,0,0,5,0,0,0,12,0,0,12,17
25711,Togo,2015,2015Togo,0,0,0,7,0,0,7,0,0,0,29,0,0,29,36
25712,Togo,2015,2015Togo,0,0,5,0,0,0,5,6,0,0,13,0,0,19,24
25713,Togo,2015,2015Togo,0,0,5,0,0,0,5,8,0,0,0,0,0,8,13
25714,Togo,2015,2015Togo,0,0,9,0,0,0,9,0,0,0,0,0,0,0,9
25715,Togo,2015,2015Togo,0,5,0,5,0,0,10,0,0,0,5,0,0,5,15
25716,Togo,2015,2015Togo,0,6,0,0,0,0,6,0,0,0,8,0,0,8,14
25717,Togo,2015,2015Togo,0,6,0,0,0,0,6,0,0,7,0,0,0,7,13
25718,Togo,2015,2015Togo,0,6,0,5,0,0,11,0,9,0,10,0,0,19,30
25719,Togo,2015,2015Togo,0,6,0,8,0,0,14,5,0,0,12,0,0,17,31
25720,Togo,2015,2015Togo,5,0,0,0,0,0,5,0,0,0,0,0,0,0,5
25721,Togo,2015,2015Togo,5,7,5,31,0,5,53,5,17,0,22,0,0,44,742
25722,Togo,2015,2015Togo,5,30,48,300,8,0,391,5,24,38,700,30,0,797,1188
25723,Togo,2015,2015Togo,182,259,186,625,67,0,1319,195,341,143,962,81,0,1722,3041
25724,Togo,2016,2016Togo,0,0,0,0,0,0,0,0,0,0,0,0,0,0,1930
25725,Togo,2016,2016Togo,0,0,0,0,0,0,0,0,0,0,0,0,5,5,5
25726,Togo,2016,2016Togo,0,0,0,0,0,0,0,0,0,0,5,0,0,5,15
25727,Togo,2016,2016Togo,0,0,0,0,0,0,0,0,0,0,7,0,0,7,7
25728,Togo,2016,2016Togo,0,0,0,0,0,61,61,0,0,0,0,0,115,115,176
25729,Togo,2016,2016Togo,0,0,0,0,0,228,228,0,0,0,0,0,469,469,697
25730,Togo,2016,2016Togo,0,0,0,6,0,0,6,0,0,0,23,0,0,23,29
25731,Togo,2016,2016Togo,0,0,0,6,0,0,6,7,0,0,7,0,0,14,20
25732,Togo,2016,2016Togo,0,0,0,7,0,0,7,0,8,0,0,0,0,8,15
25733,Togo,2016,2016Togo,0,0,0,8,0,0,8,0,0,0,29,0,0,29,37
25734,Togo,2016,2016Togo,0,0,0,9,0,0,9,0,0,0,19,0,0,19,112
25735,Togo,2016,2016Togo,0,0,0,9,0,0,9,8,0,0,0,0,0,8,17
25736,Togo,2016,2016Togo,0,0,5,0,0,0,5,6,0,0,13,0,0,19,24
25737,Togo,2016,2016Togo,0,5,0,0,0,0,5,0,0,0,0,0,0,0,5
25738,Togo,2016,2016Togo,0,5,0,5,0,0,10,0,0,0,6,0,0,6,16
25739,Togo,2016,2016Togo,0,5,0,9,0,0,14,0,5,0,12,0,0,17,31
25740,Togo,2016,2016Togo,0,6,0,0,0,0,6,0,0,0,8,0,0,8,14
25741,Togo,2016,2016Togo,0,6,0,0,0,0,6,0,5,0,5,0,0,10,16
25742,Togo,2016,2016Togo,0,23,39,296,8,0,366,0,19,29,664,40,0,752,1118
25743,Togo,2016,2016Togo,5,12,5,31,0,295,348,0,11,5,23,0,326,365,713
25744,Togo,2016,2016Togo,117,257,229,797,74,0,1474,105,302,210,1129,79,0,1825,3299
25745,Togo,2017,2017Togo,0,0,0,0,0,0,0,0,0,0,0,0,0,0,2013
25746,Togo,2017,2017Togo,0,0,0,0,0,0,0,0,0,0,5,0,0,5,5
25747,Togo,2017,2017Togo,0,0,0,0,0,0,0,0,0,0,8,0,0,8,8
25748,Togo,2017,2017Togo,0,0,0,0,0,0,0,0,5,0,0,0,0,5,5
25749,Togo,2017,2017Togo,0,0,0,0,0,235,235,0,0,0,0,0,484,484,719
25750,Togo,2017,2017Togo,0,0,0,6,0,0,6,7,0,0,7,0,0,14,20
25751,Togo,2017,2017Togo,0,0,0,7,0,0,7,0,0,8,0,0,0,8,15
25752,Togo,2017,2017Togo,0,0,0,8,0,0,8,0,0,0,29,0,0,29,37
25753,Togo,2017,2017Togo,0,0,6,9,0,0,15,5,0,0,10,0,0,15,30
25754,Togo,2017,2017Togo,0,5,0,0,0,0,5,0,0,0,0,0,0,0,5
25755,Togo,2017,2017Togo,0,5,0,0,0,0,5,0,5,0,5,0,0,10,15
25756,Togo,2017,2017Togo,0,5,0,0,0,0,5,6,0,0,12,0,0,18,23
25757,Togo,2017,2017Togo,0,6,0,0,0,0,6,0,0,0,8,0,0,8,14
25758,Togo,2017,2017Togo,0,6,0,0,0,0,6,0,11,0,0,0,0,11,17
25759,Togo,2017,2017Togo,0,9,0,0,0,0,9,0,0,0,5,0,0,5,14
25760,Togo,2017,2017Togo,5,10,5,30,0,308,358,0,14,0,20,0,277,311,669
25761,Togo,2017,2017Togo,5,16,34,286,12,0,353,0,16,24,642,46,0,728,1081
25762,Togo,2017,2017Togo,119,283,215,858,80,0,1555,117,289,234,1143,87,0,1870,3425
25763,Togo,2018,2018Togo,0,0,0,0,0,0,0,0,0,0,0,0,0,0,1855
25764,Togo,2018,2018Togo,0,0,0,0,0,0,0,0,0,0,5,0,0,5,5
25765,Togo,2018,2018Togo,0,0,0,0,0,0,0,0,0,0,7,0,0,7,7
25766,Togo,2018,2018Togo,0,0,0,0,0,0,0,0,0,0,8,0,0,8,8
25767,Togo,2018,2018Togo,0,0,0,0,0,0,0,0,0,0,17,0,0,17,17
25768,Togo,2018,2018Togo,0,0,0,0,0,0,0,0,5,0,0,0,0,5,5
25769,Togo,2018,2018Togo,0,0,0,0,0,242,242,0,0,0,0,0,501,501,743
25770,Togo,2018,2018Togo,0,0,0,6,0,0,6,7,0,0,7,0,0,14,20
25771,Togo,2018,2018Togo,0,0,0,7,0,0,7,0,0,8,0,0,0,8,15
25772,Togo,2018,2018Togo,0,0,0,13,0,0,13,0,0,0,23,0,0,23,121
25773,Togo,2018,2018Togo,0,0,5,0,0,0,5,0,5,0,5,0,0,10,15
25774,Togo,2018,2018Togo,0,0,6,6,0,0,12,5,0,0,7,0,0,12,24
25775,Togo,2018,2018Togo,0,6,0,0,0,0,6,0,0,0,0,0,0,0,6
25776,Togo,2018,2018Togo,0,6,0,0,0,0,6,0,0,0,8,0,0,8,14
25777,Togo,2018,2018Togo,0,6,0,0,0,0,6,0,11,0,0,0,0,11,17
25778,Togo,2018,2018Togo,0,9,0,0,0,0,9,0,5,0,0,0,0,5,14
25779,Togo,2018,2018Togo,5,5,7,27,0,265,309,0,13,0,17,0,299,329,638
25780,Togo,2018,2018Togo,8,20,30,285,14,0,357,0,17,20,631,49,0,717,1074
25781,Togo,2018,2018Togo,89,281,227,878,90,0,1565,95,269,230,1178,94,0,1866,3431
25782,Togo,2019,2019Togo,0,0,0,0,0,0,0,0,0,0,0,0,0,0,2001
25783,Togo,2019,2019Togo,0,0,0,0,0,0,0,0,0,0,5,0,0,5,10
25784,Togo,2019,2019Togo,0,0,0,0,0,0,0,0,0,0,9,0,0,9,9
25785,Togo,2019,2019Togo,0,0,0,0,0,0,0,0,0,0,19,0,0,19,19
25786,Togo,2019,2019Togo,0,0,0,0,0,242,242,0,0,0,0,0,517,517,759
25787,Togo,2019,2019Togo,0,0,0,5,0,0,5,0,0,6,0,0,0,6,11
25788,Togo,2019,2019Togo,0,0,0,6,0,0,6,0,0,0,12,0,0,12,18
25789,Togo,2019,2019Togo,0,0,0,6,0,0,6,0,6,0,5,0,0,11,17
25790,Togo,2019,2019Togo,0,0,0,6,0,0,6,7,0,0,7,0,0,14,20
25791,Togo,2019,2019Togo,0,0,5,5,0,0,10,0,5,0,6,0,0,11,21
25792,Togo,2019,2019Togo,0,0,5,6,0,0,11,0,5,0,7,0,0,12,23
25793,Togo,2019,2019Togo,0,6,0,0,0,0,6,0,11,0,0,0,0,11,17
25794,Togo,2019,2019Togo,0,9,0,0,0,0,9,0,0,0,5,0,0,5,14
25795,Togo,2019,2019Togo,5,5,5,23,0,0,38,0,6,5,17,0,0,28,576
25796,Togo,2019,2019Togo,12,19,31,286,17,0,365,5,14,17,598,61,0,695,1060
25797,Togo,2019,2019Togo,84,266,249,895,95,0,1589,92,247,242,1186,103,0,1870,3459
25798,Togo,2020,2020Togo,0,0,0,0,0,0,0,0,0,0,0,0,0,0,2305
25799,Togo,2020,2020Togo,0,0,0,0,0,0,0,0,0,0,0,0,8,8,8
25800,Togo,2020,2020Togo,0,0,0,0,0,0,0,0,0,0,5,0,0,5,10
25801,Togo,2020,2020Togo,0,0,0,0,0,0,0,0,0,0,6,0,0,6,6
25802,Togo,2020,2020Togo,0,0,0,0,0,0,0,0,0,0,21,0,0,21,21
25803,Togo,2020,2020Togo,0,0,0,0,0,56,56,0,0,0,0,0,107,107,163
25804,Togo,2020,2020Togo,0,0,0,5,0,0,5,0,7,0,0,0,0,7,12
25805,Togo,2020,2020Togo,0,0,0,6,0,0,6,0,0,6,5,0,0,11,17
25806,Togo,2020,2020Togo,0,0,5,0,0,0,5,0,0,0,5,0,0,5,10
25807,Togo,2020,2020Togo,0,0,5,5,0,0,10,0,5,0,6,0,0,11,21
25808,Togo,2020,2020Togo,0,0,5,6,0,0,11,6,0,0,7,0,0,13,24
25809,Togo,2020,2020Togo,0,0,9,0,0,0,9,0,0,0,6,0,0,6,15
25810,Togo,2020,2020Togo,0,5,0,0,0,0,5,0,6,0,7,0,0,13,18
25811,Togo,2020,2020Togo,0,5,0,5,0,0,10,0,6,0,10,0,0,16,26
25812,Togo,2020,2020Togo,0,7,0,0,0,0,7,0,10,0,0,0,0,10,17
25813,Togo,2020,2020Togo,0,8,7,24,0,0,39,0,6,5,16,0,0,27,556
25814,Togo,2020,2020Togo,10,18,27,273,17,0,345,5,11,11,550,74,0,651,996
25815,Togo,2020,2020Togo,65,244,256,922,106,0,1593,69,236,244,1209,128,0,1886,3479
25816,Togo,2021,2021Togo,0,0,0,0,0,0,0,0,0,0,0,0,0,0,2748
25817,Togo,2021,2021Togo,0,0,0,0,0,0,0,0,0,0,5,0,0,5,5
25818,Togo,2021,2021Togo,0,0,0,0,0,0,0,0,0,0,6,0,0,6,6
25819,Togo,2021,2021Togo,0,0,0,0,0,0,0,0,0,0,8,0,0,8,8
25820,Togo,2021,2021Togo,0,0,0,0,0,0,0,0,0,0,19,0,0,19,19
25821,Togo,2021,2021Togo,0,0,0,5,0,0,5,0,0,0,0,0,0,0,5
25822,Togo,2021,2021Togo,0,0,0,5,0,0,5,0,0,0,14,0,0,14,19
25823,Togo,2021,2021Togo,0,0,0,5,0,0,5,0,0,6,0,0,0,6,11
25824,Togo,2021,2021Togo,0,0,0,6,0,0,6,0,0,6,6,0,0,12,18
25825,Togo,2021,2021Togo,0,0,0,8,0,0,8,0,9,0,0,0,0,9,17
25826,Togo,2021,2021Togo,0,0,0,12,0,0,12,0,0,0,21,0,0,21,102
25827,Togo,2021,2021Togo,0,0,8,6,0,0,14,0,5,0,10,0,0,15,29
25828,Togo,2021,2021Togo,0,0,9,0,0,0,9,0,0,0,6,0,0,6,15
25829,Togo,2021,2021Togo,0,5,0,0,0,0,5,0,6,0,7,0,0,13,18
25830,Togo,2021,2021Togo,0,5,7,20,0,0,32,0,0,7,11,5,0,23,527
25831,Togo,2021,2021Togo,0,6,0,5,0,0,11,0,0,6,5,5,0,16,27
25832,Togo,2021,2021Togo,0,7,0,0,0,0,7,0,5,6,0,0,0,11,18
25833,Togo,2021,2021Togo,12,17,19,271,21,0,340,9,12,13,531,81,0,646,986
25834,Togo,2021,2021Togo,49,208,233,965,117,0,1572,44,214,231,1210,136,0,1835,3407
25835,TÃ¼rkiye,2001,2001TÃ¼rkiye,0,0,0,0,0,0,0,0,0,0,0,0,0,0,16893
25836,TÃ¼rkiye,2001,2001TÃ¼rkiye,0,0,0,0,0,0,0,0,0,0,0,0,8,8,8
25837,TÃ¼rkiye,2001,2001TÃ¼rkiye,0,0,0,0,0,0,0,0,0,0,5,0,0,5,5
25838,TÃ¼rkiye,2001,2001TÃ¼rkiye,0,0,0,0,0,0,0,0,0,0,6,0,0,6,45
25839,TÃ¼rkiye,2001,2001TÃ¼rkiye,0,0,0,0,0,0,0,5,0,0,0,0,0,5,5
25840,TÃ¼rkiye,2001,2001TÃ¼rkiye,0,0,0,0,0,551,551,0,0,0,0,0,626,626,1177
25841,TÃ¼rkiye,2001,2001TÃ¼rkiye,0,0,0,0,0,2632,2632,0,0,0,0,0,3539,3539,6171
25842,TÃ¼rkiye,2001,2001TÃ¼rkiye,0,0,0,0,0,3161,3161,0,0,0,0,0,6461,6461,9622
25843,TÃ¼rkiye,2001,2001TÃ¼rkiye,0,0,7,0,0,0,7,0,0,5,11,0,0,16,23
25844,TÃ¼rkiye,2001,2001TÃ¼rkiye,844,1545,1323,2617,231,0,6560,905,1563,1340,2550,218,0,6576,13136
25845,TÃ¼rkiye,2002,2002TÃ¼rkiye,0,0,0,0,0,0,0,0,0,0,0,0,0,0,164031
25846,TÃ¼rkiye,2002,2002TÃ¼rkiye,0,0,0,0,0,0,0,0,0,0,0,0,10,10,10
25847,TÃ¼rkiye,2002,2002TÃ¼rkiye,0,0,0,0,0,0,0,5,0,0,0,0,0,5,5
25848,TÃ¼rkiye,2002,2002TÃ¼rkiye,0,0,0,0,0,2067,2067,0,0,0,0,0,2896,2896,5859
25849,TÃ¼rkiye,2002,2002TÃ¼rkiye,0,0,0,0,0,3019,3019,0,0,0,0,0,6388,6388,9407
25850,TÃ¼rkiye,2002,2002TÃ¼rkiye,0,0,5,5,0,0,10,0,5,0,13,0,0,18,629
25851,TÃ¼rkiye,2002,2002TÃ¼rkiye,0,5,0,0,0,0,5,0,0,0,20,0,0,20,25
25852,TÃ¼rkiye,2002,2002TÃ¼rkiye,7,0,0,0,0,0,7,0,0,0,0,0,0,0,7
25853,TÃ¼rkiye,2002,2002TÃ¼rkiye,903,1561,1338,2424,752,0,6978,968,1531,1313,2174,760,0,6746,13724
25854,TÃ¼rkiye,2003,2003TÃ¼rkiye,0,0,0,0,0,0,0,0,0,0,0,0,0,0,156625
25855,TÃ¼rkiye,2003,2003TÃ¼rkiye,0,0,0,0,0,0,0,0,0,0,0,0,11,11,11
25856,TÃ¼rkiye,2003,2003TÃ¼rkiye,0,0,0,0,0,0,0,0,0,0,7,0,0,7,7
25857,TÃ¼rkiye,2003,2003TÃ¼rkiye,0,0,0,0,0,0,0,0,0,0,8,0,0,8,620
25858,TÃ¼rkiye,2003,2003TÃ¼rkiye,0,0,0,0,0,2040,2040,0,0,0,0,0,2913,2913,5779
25859,TÃ¼rkiye,2003,2003TÃ¼rkiye,0,0,0,0,0,2765,2765,0,0,0,0,0,6097,6097,8862
25860,TÃ¼rkiye,2003,2003TÃ¼rkiye,0,6,0,0,0,0,6,0,0,8,5,0,0,13,19
25861,TÃ¼rkiye,2003,2003TÃ¼rkiye,0,8,0,0,0,0,8,0,0,5,15,0,0,20,28
25862,TÃ¼rkiye,2003,2003TÃ¼rkiye,477,1499,1287,3090,287,0,6640,555,1579,1353,2750,258,0,6495,13135
25863,TÃ¼rkiye,2004,2004TÃ¼rkiye,0,0,0,0,0,0,0,0,0,0,0,0,0,0,154999
25864,TÃ¼rkiye,2004,2004TÃ¼rkiye,0,0,0,0,0,0,0,0,0,0,0,0,10,10,10
25865,TÃ¼rkiye,2004,2004TÃ¼rkiye,0,0,0,0,0,0,0,0,0,0,5,0,0,5,15
25866,TÃ¼rkiye,2004,2004TÃ¼rkiye,0,0,0,0,0,0,0,0,0,0,7,0,0,7,7
25867,TÃ¼rkiye,2004,2004TÃ¼rkiye,0,0,0,5,0,0,5,0,0,0,14,0,0,14,19
25868,TÃ¼rkiye,2004,2004TÃ¼rkiye,0,0,0,9,0,0,9,0,0,0,11,0,0,11,60
25869,TÃ¼rkiye,2004,2004TÃ¼rkiye,0,0,0,9,0,0,9,0,5,0,7,0,0,12,464
25870,TÃ¼rkiye,2004,2004TÃ¼rkiye,0,0,8,5,0,0,13,0,6,5,8,0,0,19,32
25871,TÃ¼rkiye,2004,2004TÃ¼rkiye,25,46,40,222,26,1990,2349,28,51,43,275,15,2852,3264,5613
25872,TÃ¼rkiye,2004,2004TÃ¼rkiye,584,1500,1288,3089,288,0,6749,662,1580,1354,2750,258,0,6604,13353
25873,TÃ¼rkiye,2005,2005TÃ¼rkiye,0,0,0,0,0,0,0,0,0,0,0,0,0,0,141472
25874,TÃ¼rkiye,2005,2005TÃ¼rkiye,0,0,0,0,0,0,0,0,0,0,5,0,0,5,5
25875,TÃ¼rkiye,2005,2005TÃ¼rkiye,0,0,0,0,0,0,0,0,0,0,8,0,0,8,8
25876,TÃ¼rkiye,2005,2005TÃ¼rkiye,0,0,0,0,0,5,5,0,0,0,0,0,9,9,14
25877,TÃ¼rkiye,2005,2005TÃ¼rkiye,0,0,0,0,0,19,19,0,0,0,0,0,33,33,52
25878,TÃ¼rkiye,2005,2005TÃ¼rkiye,0,0,0,0,0,2861,2861,0,0,0,0,0,6815,6815,9676
25879,TÃ¼rkiye,2005,2005TÃ¼rkiye,0,0,0,5,0,0,5,0,0,0,7,0,0,7,65
25880,TÃ¼rkiye,2005,2005TÃ¼rkiye,0,0,0,5,0,0,5,0,0,0,13,0,0,13,18
25881,TÃ¼rkiye,2005,2005TÃ¼rkiye,0,0,0,5,0,0,5,5,0,0,0,0,0,5,10
25882,TÃ¼rkiye,2005,2005TÃ¼rkiye,0,0,0,6,0,0,6,0,0,0,0,0,0,0,6
25883,TÃ¼rkiye,2005,2005TÃ¼rkiye,0,0,0,7,0,0,7,0,0,0,9,0,0,9,392
25884,TÃ¼rkiye,2005,2005TÃ¼rkiye,6,0,0,0,0,0,6,0,0,0,0,0,0,0,6
25885,TÃ¼rkiye,2005,2005TÃ¼rkiye,27,51,44,231,19,1898,2270,28,52,44,275,13,2819,3231,5501
25886,TÃ¼rkiye,2005,2005TÃ¼rkiye,371,1090,935,2311,283,0,4990,418,1133,970,2048,237,0,4806,13332
25887,TÃ¼rkiye,2006,2006TÃ¼rkiye,0,0,0,0,0,0,0,0,0,0,0,0,0,0,194185
25888,TÃ¼rkiye,2006,2006TÃ¼rkiye,0,0,0,0,0,0,0,0,0,0,0,0,8,8,8
25889,TÃ¼rkiye,2006,2006TÃ¼rkiye,0,0,0,0,0,0,0,0,0,0,5,0,0,5,15
25890,TÃ¼rkiye,2006,2006TÃ¼rkiye,0,0,0,0,0,0,0,0,0,0,6,0,0,6,6
25891,TÃ¼rkiye,2006,2006TÃ¼rkiye,0,0,0,0,0,20,20,0,0,0,0,0,39,39,59
25892,TÃ¼rkiye,2006,2006TÃ¼rkiye,0,0,0,0,0,172,172,0,0,0,0,0,291,291,463
25893,TÃ¼rkiye,2006,2006TÃ¼rkiye,0,0,0,0,0,2274,2274,0,0,0,0,0,3242,3242,5516
25894,TÃ¼rkiye,2006,2006TÃ¼rkiye,0,0,0,0,0,2940,2940,0,0,0,0,0,7119,7119,10059
25895,TÃ¼rkiye,2006,2006TÃ¼rkiye,0,0,0,5,0,0,5,0,0,0,5,0,0,5,10
25896,TÃ¼rkiye,2006,2006TÃ¼rkiye,0,0,0,5,0,0,5,5,0,0,0,0,0,5,10
25897,TÃ¼rkiye,2006,2006TÃ¼rkiye,0,0,0,6,0,0,6,0,0,0,0,0,0,0,6
25898,TÃ¼rkiye,2006,2006TÃ¼rkiye,0,0,0,7,0,0,7,0,0,0,9,0,0,9,61
25899,TÃ¼rkiye,2006,2006TÃ¼rkiye,0,6,0,0,0,0,6,0,0,0,0,0,0,0,6
25900,TÃ¼rkiye,2006,2006TÃ¼rkiye,1045,1750,1437,3879,370,0,8481,1124,1753,1479,3656,339,0,8351,16832
25901,TÃ¼rkiye,2007,2007TÃ¼rkiye,0,0,0,0,0,0,0,0,0,0,0,0,0,0,190277
25902,TÃ¼rkiye,2007,2007TÃ¼rkiye,0,0,0,0,0,0,0,0,0,0,0,0,5,5,5
25903,TÃ¼rkiye,2007,2007TÃ¼rkiye,0,0,0,0,0,0,0,0,0,0,5,0,0,5,5
25904,TÃ¼rkiye,2007,2007TÃ¼rkiye,0,0,0,0,0,0,0,0,0,0,6,0,0,6,6
25905,TÃ¼rkiye,2007,2007TÃ¼rkiye,0,0,0,0,0,5,5,0,0,0,0,0,9,9,14
25906,TÃ¼rkiye,2007,2007TÃ¼rkiye,0,0,0,0,0,159,159,0,0,0,0,0,262,262,421
25907,TÃ¼rkiye,2007,2007TÃ¼rkiye,0,0,0,0,0,2980,2980,0,0,0,0,0,7296,7296,10276
25908,TÃ¼rkiye,2007,2007TÃ¼rkiye,0,0,0,5,0,0,5,0,5,0,0,0,0,5,10
25909,TÃ¼rkiye,2007,2007TÃ¼rkiye,0,0,0,6,0,0,6,0,0,0,0,0,0,0,6
25910,TÃ¼rkiye,2007,2007TÃ¼rkiye,0,7,0,0,0,0,7,0,0,0,0,0,0,0,7
25911,TÃ¼rkiye,2007,2007TÃ¼rkiye,5,0,0,0,0,0,5,7,0,0,0,0,0,7,12
25912,TÃ¼rkiye,2007,2007TÃ¼rkiye,28,53,45,254,19,1801,2200,19,49,53,264,13,2747,3145,5345
25913,TÃ¼rkiye,2007,2007TÃ¼rkiye,767,1563,1392,3821,354,0,7897,865,1722,1364,3441,264,0,7656,15553
25914,TÃ¼rkiye,2008,2008TÃ¼rkiye,0,0,0,0,0,0,0,0,0,0,0,0,0,0,182353
25915,TÃ¼rkiye,2008,2008TÃ¼rkiye,0,0,0,0,0,0,0,0,0,0,5,0,0,5,5
25916,TÃ¼rkiye,2008,2008TÃ¼rkiye,0,0,0,0,0,0,0,0,0,0,6,0,0,6,6
25917,TÃ¼rkiye,2008,2008TÃ¼rkiye,0,0,0,0,0,0,0,0,0,0,8,0,0,8,8
25918,TÃ¼rkiye,2008,2008TÃ¼rkiye,0,0,0,0,0,0,0,0,5,0,0,0,0,5,5
25919,TÃ¼rkiye,2008,2008TÃ¼rkiye,0,0,0,0,0,5,5,0,0,0,0,0,8,8,13
25920,TÃ¼rkiye,2008,2008TÃ¼rkiye,0,0,0,0,0,159,159,0,0,0,0,0,278,278,437
25921,TÃ¼rkiye,2008,2008TÃ¼rkiye,0,0,0,0,0,3005,3005,0,0,0,0,0,7559,7559,10564
25922,TÃ¼rkiye,2008,2008TÃ¼rkiye,0,0,5,0,0,0,5,8,0,0,0,0,0,8,13
25923,TÃ¼rkiye,2008,2008TÃ¼rkiye,26,48,58,264,18,1715,2129,29,54,55,278,11,2689,3116,5245
25924,TÃ¼rkiye,2008,2008TÃ¼rkiye,574,1607,1316,4097,374,0,7968,617,1757,1289,3788,297,0,7748,15716
25925,TÃ¼rkiye,2009,2009TÃ¼rkiye,0,0,0,0,0,0,0,0,0,0,0,0,0,0,29765
25926,TÃ¼rkiye,2009,2009TÃ¼rkiye,0,0,0,0,0,0,0,0,0,0,5,0,0,5,10
25927,TÃ¼rkiye,2009,2009TÃ¼rkiye,0,0,0,0,0,0,0,0,0,0,6,0,0,6,6
25928,TÃ¼rkiye,2009,2009TÃ¼rkiye,0,0,0,0,0,0,0,5,0,0,0,0,0,5,5
25929,TÃ¼rkiye,2009,2009TÃ¼rkiye,0,0,0,0,0,0,0,5,0,0,5,0,0,10,10
25930,TÃ¼rkiye,2009,2009TÃ¼rkiye,0,0,0,0,0,5,5,0,0,0,0,0,8,8,13
25931,TÃ¼rkiye,2009,2009TÃ¼rkiye,0,0,0,0,0,157,157,0,0,0,0,0,314,314,471
25932,TÃ¼rkiye,2009,2009TÃ¼rkiye,0,0,5,0,0,0,5,0,0,0,0,0,0,0,5
25933,TÃ¼rkiye,2009,2009TÃ¼rkiye,26,42,58,238,16,1560,1940,29,49,56,260,10,2556,2960,4900
25934,TÃ¼rkiye,2009,2009TÃ¼rkiye,386,905,884,2725,307,0,5207,392,951,884,2447,244,0,4918,10125
25935,TÃ¼rkiye,2009,2009TÃ¼rkiye,563,3364,5467,25569,3111,0,38074,610,3646,5807,50007,2924,0,62994,101068
25936,TÃ¼rkiye,2010,2010TÃ¼rkiye,0,0,0,0,0,0,0,0,0,0,0,0,0,0,17138
25937,TÃ¼rkiye,2010,2010TÃ¼rkiye,0,0,0,0,0,0,0,0,0,0,0,0,7,7,7
25938,TÃ¼rkiye,2010,2010TÃ¼rkiye,0,0,0,0,0,0,0,0,0,0,0,0,15,15,15
25939,TÃ¼rkiye,2010,2010TÃ¼rkiye,0,0,0,0,0,0,0,0,0,0,5,0,0,5,10
25940,TÃ¼rkiye,2010,2010TÃ¼rkiye,0,0,0,0,0,0,0,5,0,0,0,0,0,5,5
25941,TÃ¼rkiye,2010,2010TÃ¼rkiye,0,0,0,0,0,0,0,7,0,0,0,0,0,7,7
25942,TÃ¼rkiye,2010,2010TÃ¼rkiye,0,0,0,0,0,0,0,8,0,0,0,0,0,8,8
25943,TÃ¼rkiye,2010,2010TÃ¼rkiye,0,0,0,0,0,167,167,0,0,0,0,0,343,343,510
25944,TÃ¼rkiye,2010,2010TÃ¼rkiye,0,0,0,0,0,3123,3123,0,0,0,0,0,7886,7886,11009
25945,TÃ¼rkiye,2010,2010TÃ¼rkiye,0,0,5,0,0,0,5,0,0,0,0,0,0,0,5
25946,TÃ¼rkiye,2010,2010TÃ¼rkiye,19,49,54,214,16,1417,1769,27,45,50,238,9,2419,2788,4557
25947,TÃ¼rkiye,2010,2010TÃ¼rkiye,484,2765,5051,25143,3325,0,36768,590,2933,5351,48923,3343,0,61140,97908
25948,TÃ¼rkiye,2010,2010TÃ¼rkiye,1347,1571,1399,2499,860,0,7676,1438,1643,1495,2479,875,0,7930,15606
25949,TÃ¼rkiye,2011,2011TÃ¼rkiye,0,0,0,0,0,0,0,0,0,0,0,0,0,0,11783
25950,TÃ¼rkiye,2011,2011TÃ¼rkiye,0,0,0,0,0,0,0,0,0,0,0,0,19,19,19
25951,TÃ¼rkiye,2011,2011TÃ¼rkiye,0,0,0,0,0,0,0,0,0,0,5,0,0,5,5
25952,TÃ¼rkiye,2011,2011TÃ¼rkiye,0,0,0,0,0,0,0,0,9,0,0,0,0,9,18
25953,TÃ¼rkiye,2011,2011TÃ¼rkiye,0,0,0,0,0,0,0,6,0,0,0,0,0,6,6
25954,TÃ¼rkiye,2011,2011TÃ¼rkiye,0,0,0,0,0,160,160,0,0,0,0,0,352,352,512
25955,TÃ¼rkiye,2011,2011TÃ¼rkiye,0,0,0,0,0,3048,3048,0,0,0,0,0,7837,7837,10885
25956,TÃ¼rkiye,2011,2011TÃ¼rkiye,0,5,0,0,0,0,5,0,0,0,0,0,0,0,5
25957,TÃ¼rkiye,2011,2011TÃ¼rkiye,5,14,10,100,5,0,134,7,17,16,211,5,0,256,4255
25958,TÃ¼rkiye,2011,2011TÃ¼rkiye,13,44,43,202,14,1305,1621,26,35,42,232,9,2259,2603,4224
25959,TÃ¼rkiye,2011,2011TÃ¼rkiye,388,2141,4518,24355,3407,0,34809,458,2293,4758,47072,3578,0,58159,92968
25960,TÃ¼rkiye,2011,2011TÃ¼rkiye,1237,1945,841,3164,277,0,7464,1216,1879,882,3384,258,0,7619,15083
25961,TÃ¼rkiye,2012,2012TÃ¼rkiye,0,0,0,0,0,0,0,0,0,0,0,0,0,0,9799
25962,TÃ¼rkiye,2012,2012TÃ¼rkiye,0,0,0,0,0,0,0,0,0,0,0,0,11,11,11
25963,TÃ¼rkiye,2012,2012TÃ¼rkiye,0,0,0,0,0,0,0,0,0,0,9,0,0,9,41
25964,TÃ¼rkiye,2012,2012TÃ¼rkiye,0,0,0,0,0,0,0,5,0,0,0,0,0,5,5
25965,TÃ¼rkiye,2012,2012TÃ¼rkiye,0,0,0,0,0,0,0,7,0,0,0,0,0,7,7
25966,TÃ¼rkiye,2012,2012TÃ¼rkiye,0,0,0,0,0,5,5,0,0,0,0,0,15,15,20
25967,TÃ¼rkiye,2012,2012TÃ¼rkiye,0,0,0,0,0,7,7,0,0,0,0,0,12,12,19
25968,TÃ¼rkiye,2012,2012TÃ¼rkiye,0,0,0,0,0,152,152,0,0,0,0,0,362,362,514
25969,TÃ¼rkiye,2012,2012TÃ¼rkiye,0,0,0,0,0,3048,3048,0,0,0,0,0,7839,7839,10887
25970,TÃ¼rkiye,2012,2012TÃ¼rkiye,0,0,0,6,0,0,6,0,0,0,0,0,0,0,6
25971,TÃ¼rkiye,2012,2012TÃ¼rkiye,0,5,0,0,0,0,5,0,6,0,0,0,0,6,11
25972,TÃ¼rkiye,2012,2012TÃ¼rkiye,6,24,28,131,13,1297,1499,16,22,26,119,8,2236,2427,3926
25973,TÃ¼rkiye,2012,2012TÃ¼rkiye,9,0,0,45,0,0,54,0,6,5,97,0,0,108,3838
25974,TÃ¼rkiye,2012,2012TÃ¼rkiye,361,1842,4093,24162,3607,0,34065,418,1981,4201,46117,3991,0,56708,90773
25975,TÃ¼rkiye,2012,2012TÃ¼rkiye,1069,2017,1003,3311,272,0,7672,1038,1920,1103,3497,266,0,7824,15496
25976,TÃ¼rkiye,2013,2013TÃ¼rkiye,0,0,0,0,0,0,0,0,0,0,0,0,0,0,8094
25977,TÃ¼rkiye,2013,2013TÃ¼rkiye,0,0,0,0,0,0,0,0,0,0,15,0,0,15,15
25978,TÃ¼rkiye,2013,2013TÃ¼rkiye,0,0,0,0,0,0,0,0,10,0,0,0,0,10,10
25979,TÃ¼rkiye,2013,2013TÃ¼rkiye,0,0,0,0,0,0,0,5,0,0,0,0,0,5,10
25980,TÃ¼rkiye,2013,2013TÃ¼rkiye,0,0,0,0,0,6,6,0,0,0,0,0,13,13,19
25981,TÃ¼rkiye,2013,2013TÃ¼rkiye,0,0,0,0,0,136,136,0,0,0,0,0,336,336,472
25982,TÃ¼rkiye,2013,2013TÃ¼rkiye,0,0,0,0,0,3033,3033,0,0,0,0,0,7834,7834,10867
25983,TÃ¼rkiye,2013,2013TÃ¼rkiye,0,0,0,5,0,0,5,0,0,0,7,0,0,7,12
25984,TÃ¼rkiye,2013,2013TÃ¼rkiye,0,0,0,6,0,0,6,0,0,0,0,0,0,0,6
25985,TÃ¼rkiye,2013,2013TÃ¼rkiye,0,0,6,0,0,0,6,0,0,0,0,0,0,0,6
25986,TÃ¼rkiye,2013,2013TÃ¼rkiye,5,7,12,64,0,0,88,5,16,12,98,0,0,131,3464
25987,TÃ¼rkiye,2013,2013TÃ¼rkiye,9,31,23,170,13,1120,1366,14,23,31,187,7,2010,2272,3638
25988,TÃ¼rkiye,2013,2013TÃ¼rkiye,101,537,1129,6892,1745,0,10404,104,614,1193,10750,1384,0,14045,24449
25989,TÃ¼rkiye,2013,2013TÃ¼rkiye,974,2019,1035,3369,276,0,7673,942,1940,1131,3545,265,0,7823,15496
25990,TÃ¼rkiye,2014,2014TÃ¼rkiye,0,0,0,0,0,0,0,0,0,0,0,0,0,0,7723
25991,TÃ¼rkiye,2014,2014TÃ¼rkiye,0,0,0,0,0,0,0,0,0,0,0,0,5,5,5
25992,TÃ¼rkiye,2014,2014TÃ¼rkiye,0,0,0,0,0,0,0,5,0,0,0,0,0,5,10
25993,TÃ¼rkiye,2014,2014TÃ¼rkiye,0,0,0,0,0,6,6,0,0,0,0,0,13,13,19
25994,TÃ¼rkiye,2014,2014TÃ¼rkiye,0,0,0,0,0,7,7,0,0,0,0,0,0,0,7
25995,TÃ¼rkiye,2014,2014TÃ¼rkiye,0,0,0,0,0,2998,2998,0,0,0,0,0,7701,7701,10699
25996,TÃ¼rkiye,2014,2014TÃ¼rkiye,0,0,0,6,0,0,6,0,0,0,0,0,0,0,6
25997,TÃ¼rkiye,2014,2014TÃ¼rkiye,0,0,0,6,0,0,6,0,0,0,15,0,0,15,21
25998,TÃ¼rkiye,2014,2014TÃ¼rkiye,0,0,0,7,0,0,7,0,0,0,8,0,0,8,15
25999,TÃ¼rkiye,2014,2014TÃ¼rkiye,0,0,7,0,0,0,7,0,0,0,0,0,0,0,7
26000,TÃ¼rkiye,2014,2014TÃ¼rkiye,5,0,0,0,0,0,5,0,5,0,0,0,0,5,10
26001,TÃ¼rkiye,2014,2014TÃ¼rkiye,8,5,0,35,0,0,48,5,6,5,103,0,0,119,2863
26002,TÃ¼rkiye,2014,2014TÃ¼rkiye,12,26,29,175,14,1089,1345,12,33,23,193,7,2005,2273,3618
26003,TÃ¼rkiye,2014,2014TÃ¼rkiye,87,419,862,6347,1752,0,9467,87,481,930,9861,1416,0,12775,22242
26004,TÃ¼rkiye,2014,2014TÃ¼rkiye,1481,2025,962,3436,290,0,8194,1438,1953,1052,3730,270,0,8443,16637
26005,TÃ¼rkiye,2015,2015TÃ¼rkiye,0,0,0,0,0,0,0,0,0,0,0,0,0,0,8780
26006,TÃ¼rkiye,2015,2015TÃ¼rkiye,0,0,0,0,0,0,0,0,0,0,0,0,11,11,11
26007,TÃ¼rkiye,2015,2015TÃ¼rkiye,0,0,0,0,0,0,0,0,0,0,13,0,0,13,13
26008,TÃ¼rkiye,2015,2015TÃ¼rkiye,0,0,0,0,0,0,0,0,6,0,0,0,0,6,6
26009,TÃ¼rkiye,2015,2015TÃ¼rkiye,0,0,0,0,0,0,0,0,7,0,0,0,0,7,7
26010,TÃ¼rkiye,2015,2015TÃ¼rkiye,0,0,0,0,0,0,0,5,0,0,0,0,0,5,5
26011,TÃ¼rkiye,2015,2015TÃ¼rkiye,0,0,0,0,0,5,5,0,0,0,0,0,5,5,10
26012,TÃ¼rkiye,2015,2015TÃ¼rkiye,0,0,0,0,0,194,194,0,0,0,0,0,433,433,627
26013,TÃ¼rkiye,2015,2015TÃ¼rkiye,0,0,0,0,0,2997,2997,0,0,0,0,0,7655,7655,10652
26014,TÃ¼rkiye,2015,2015TÃ¼rkiye,0,0,0,5,0,0,5,0,0,0,6,0,0,6,11
26015,TÃ¼rkiye,2015,2015TÃ¼rkiye,0,0,0,5,0,0,5,0,0,0,8,0,0,8,13
26016,TÃ¼rkiye,2015,2015TÃ¼rkiye,0,0,0,6,0,0,6,0,0,0,16,0,0,16,22
26017,TÃ¼rkiye,2015,2015TÃ¼rkiye,0,6,0,0,0,0,6,0,0,0,0,0,0,0,6
26018,TÃ¼rkiye,2015,2015TÃ¼rkiye,19,21,34,178,13,0,265,17,34,32,140,8,0,231,3544
26019,TÃ¼rkiye,2015,2015TÃ¼rkiye,64,311,590,5947,1712,0,8624,51,341,648,9133,1484,0,11657,20281
26020,TÃ¼rkiye,2015,2015TÃ¼rkiye,227,1095,1271,4645,582,0,7820,273,1105,1374,4536,449,0,7737,15557
26021,TÃ¼rkiye,2016,2016TÃ¼rkiye,0,0,0,0,0,0,0,0,0,0,0,0,0,0,6668
26022,TÃ¼rkiye,2016,2016TÃ¼rkiye,0,0,0,0,0,0,0,0,0,0,0,0,14,14,14
26023,TÃ¼rkiye,2016,2016TÃ¼rkiye,0,0,0,0,0,0,0,0,0,0,5,0,0,5,10
26024,TÃ¼rkiye,2016,2016TÃ¼rkiye,0,0,0,0,0,0,0,0,0,0,6,0,0,6,6
26025,TÃ¼rkiye,2016,2016TÃ¼rkiye,0,0,0,0,0,0,0,0,0,0,13,0,0,13,13
26026,TÃ¼rkiye,2016,2016TÃ¼rkiye,0,0,0,0,0,0,0,0,0,5,0,0,0,5,5
26027,TÃ¼rkiye,2016,2016TÃ¼rkiye,0,0,0,0,0,0,0,0,5,0,0,0,0,5,5
26028,TÃ¼rkiye,2016,2016TÃ¼rkiye,0,0,0,0,0,0,0,0,7,0,0,0,0,7,7
26029,TÃ¼rkiye,2016,2016TÃ¼rkiye,0,0,0,0,0,0,0,0,8,0,0,0,0,8,8
26030,TÃ¼rkiye,2016,2016TÃ¼rkiye,0,0,0,0,0,11,11,0,0,0,0,0,13,13,24
26031,TÃ¼rkiye,2016,2016TÃ¼rkiye,0,0,0,0,0,177,177,0,0,0,0,0,410,410,587
26032,TÃ¼rkiye,2016,2016TÃ¼rkiye,0,0,0,0,0,3001,3001,0,0,0,0,0,7614,7614,10615
26033,TÃ¼rkiye,2016,2016TÃ¼rkiye,0,0,0,5,0,0,5,0,0,0,6,0,0,6,11
26034,TÃ¼rkiye,2016,2016TÃ¼rkiye,0,0,0,6,0,0,6,0,0,0,17,0,0,17,23
26035,TÃ¼rkiye,2016,2016TÃ¼rkiye,0,0,0,7,0,0,7,0,0,0,6,0,0,6,13
26036,TÃ¼rkiye,2016,2016TÃ¼rkiye,6,10,7,52,0,0,75,5,9,10,189,0,0,213,1609
26037,TÃ¼rkiye,2016,2016TÃ¼rkiye,13,24,17,164,15,1023,1256,17,28,23,190,7,1948,2213,3469
26038,TÃ¼rkiye,2016,2016TÃ¼rkiye,57,244,403,5666,1774,0,8144,57,247,499,8575,1614,0,10992,19136
26039,TÃ¼rkiye,2016,2016TÃ¼rkiye,257,944,1265,4791,610,0,7867,312,0,1364,4732,472,945,7825,15692
26040,TÃ¼rkiye,2017,2017TÃ¼rkiye,0,0,0,0,0,0,0,0,0,0,0,0,0,0,10236
26041,TÃ¼rkiye,2017,2017TÃ¼rkiye,0,0,0,0,0,0,0,0,0,0,0,0,14,14,14
26042,TÃ¼rkiye,2017,2017TÃ¼rkiye,0,0,0,0,0,0,0,0,0,0,5,0,0,5,20
26043,TÃ¼rkiye,2017,2017TÃ¼rkiye,0,0,0,0,0,0,0,0,0,0,14,0,0,14,14
26044,TÃ¼rkiye,2017,2017TÃ¼rkiye,0,0,0,0,0,0,0,0,5,0,0,0,0,5,5
26045,TÃ¼rkiye,2017,2017TÃ¼rkiye,0,0,0,0,0,0,0,0,7,0,0,0,0,7,14
26046,TÃ¼rkiye,2017,2017TÃ¼rkiye,0,0,0,0,0,0,0,0,8,0,0,0,0,8,8
26047,TÃ¼rkiye,2017,2017TÃ¼rkiye,0,0,0,0,0,3027,3027,0,0,0,0,0,7700,7700,10727
26048,TÃ¼rkiye,2017,2017TÃ¼rkiye,0,0,0,5,0,0,5,0,0,0,6,0,0,6,11
26049,TÃ¼rkiye,2017,2017TÃ¼rkiye,0,0,0,6,0,0,6,0,0,0,0,0,0,0,6
26050,TÃ¼rkiye,2017,2017TÃ¼rkiye,0,0,0,7,0,0,7,0,0,0,18,0,0,18,25
26051,TÃ¼rkiye,2017,2017TÃ¼rkiye,0,0,0,9,0,0,9,6,0,0,5,0,0,11,20
26052,TÃ¼rkiye,2017,2017TÃ¼rkiye,0,0,5,0,0,0,5,0,0,0,0,0,0,0,5
26053,TÃ¼rkiye,2017,2017TÃ¼rkiye,0,0,5,5,0,0,10,0,5,0,6,0,0,11,21
26054,TÃ¼rkiye,2017,2017TÃ¼rkiye,0,5,0,0,0,0,5,0,0,0,5,0,0,5,10
26055,TÃ¼rkiye,2017,2017TÃ¼rkiye,0,5,0,5,0,0,10,0,0,0,6,0,0,6,16
26056,TÃ¼rkiye,2017,2017TÃ¼rkiye,0,6,0,0,0,0,6,0,0,0,0,0,0,0,6
26057,TÃ¼rkiye,2017,2017TÃ¼rkiye,0,7,0,0,0,0,7,0,0,0,5,0,0,5,12
26058,TÃ¼rkiye,2017,2017TÃ¼rkiye,15,20,15,149,13,1934,2146,17,30,19,192,8,1028,1294,3440
26059,TÃ¼rkiye,2017,2017TÃ¼rkiye,16,12,0,39,0,0,67,20,15,0,37,0,0,72,139
26060,TÃ¼rkiye,2017,2017TÃ¼rkiye,238,797,1251,4872,617,0,7775,291,816,1332,4820,480,0,7739,15514
26061,TÃ¼rkiye,2017,2017TÃ¼rkiye,247,400,381,6187,1793,0,9008,222,467,461,9306,1656,0,12112,21120
26062,TÃ¼rkiye,2018,2018TÃ¼rkiye,0,0,0,0,0,0,0,0,0,0,0,0,0,0,9943
26063,TÃ¼rkiye,2018,2018TÃ¼rkiye,0,0,0,0,0,0,0,0,0,0,0,0,5,5,5
26064,TÃ¼rkiye,2018,2018TÃ¼rkiye,0,0,0,0,0,0,0,0,0,0,5,0,0,5,10
26065,TÃ¼rkiye,2018,2018TÃ¼rkiye,0,0,0,0,0,0,0,0,0,0,6,0,0,6,12
26066,TÃ¼rkiye,2018,2018TÃ¼rkiye,0,0,0,0,0,0,0,0,0,0,8,0,0,8,8
26067,TÃ¼rkiye,2018,2018TÃ¼rkiye,0,0,0,0,0,0,0,0,0,0,12,0,0,12,12
26068,TÃ¼rkiye,2018,2018TÃ¼rkiye,0,0,0,0,0,0,0,0,7,0,0,0,0,7,7
26069,TÃ¼rkiye,2018,2018TÃ¼rkiye,0,0,0,0,0,0,0,0,8,0,0,0,0,8,8
26070,TÃ¼rkiye,2018,2018TÃ¼rkiye,0,0,0,0,0,3182,3182,0,0,0,0,0,8014,8014,11196
26071,TÃ¼rkiye,2018,2018TÃ¼rkiye,0,0,0,5,0,0,5,0,0,0,5,0,0,5,10
26072,TÃ¼rkiye,2018,2018TÃ¼rkiye,0,0,0,6,0,0,6,0,0,0,0,0,0,0,6
26073,TÃ¼rkiye,2018,2018TÃ¼rkiye,0,0,0,6,0,0,6,0,0,0,9,0,0,9,15
26074,TÃ¼rkiye,2018,2018TÃ¼rkiye,0,0,0,6,0,0,6,0,0,5,14,0,0,19,25
26075,TÃ¼rkiye,2018,2018TÃ¼rkiye,0,0,0,7,0,0,7,0,0,0,10,0,0,10,17
26076,TÃ¼rkiye,2018,2018TÃ¼rkiye,0,0,0,9,0,0,9,6,0,0,5,0,0,11,20
26077,TÃ¼rkiye,2018,2018TÃ¼rkiye,0,0,5,0,0,0,5,0,0,0,0,0,0,0,5
26078,TÃ¼rkiye,2018,2018TÃ¼rkiye,0,0,5,5,0,0,10,0,0,5,8,0,0,13,23
26079,TÃ¼rkiye,2018,2018TÃ¼rkiye,0,0,5,5,0,0,10,0,5,0,6,0,0,11,21
26080,TÃ¼rkiye,2018,2018TÃ¼rkiye,0,5,6,0,0,0,11,0,0,0,0,0,0,0,11
26081,TÃ¼rkiye,2018,2018TÃ¼rkiye,0,7,0,11,0,0,18,5,5,0,11,0,0,21,39
26082,TÃ¼rkiye,2018,2018TÃ¼rkiye,0,8,0,0,0,0,8,0,0,0,0,0,0,0,8
26083,TÃ¼rkiye,2018,2018TÃ¼rkiye,5,0,0,0,0,0,5,0,0,0,0,0,0,0,5
26084,TÃ¼rkiye,2018,2018TÃ¼rkiye,5,0,0,6,0,0,11,0,0,5,5,0,0,10,21
26085,TÃ¼rkiye,2018,2018TÃ¼rkiye,5,0,0,7,0,0,12,0,6,0,9,0,0,15,27
26086,TÃ¼rkiye,2018,2018TÃ¼rkiye,5,8,5,16,0,0,34,6,5,5,13,0,0,29,63
26087,TÃ¼rkiye,2018,2018TÃ¼rkiye,15,20,18,144,12,1079,1288,18,35,17,191,9,1981,2251,3539
26088,TÃ¼rkiye,2018,2018TÃ¼rkiye,16,14,5,45,0,0,80,21,18,0,43,0,0,82,162
26089,TÃ¼rkiye,2018,2018TÃ¼rkiye,22,79,43,290,0,0,434,28,75,62,423,5,0,593,4241
26090,TÃ¼rkiye,2018,2018TÃ¼rkiye,233,650,1257,4936,643,0,7719,276,682,1291,4941,496,0,7686,15405
26091,TÃ¼rkiye,2018,2018TÃ¼rkiye,429,716,440,6855,1806,0,10246,405,742,547,10348,1748,0,13790,24036
26092,TÃ¼rkiye,2019,2019TÃ¼rkiye,0,0,0,0,0,0,0,0,0,0,0,0,0,0,22979
26093,TÃ¼rkiye,2019,2019TÃ¼rkiye,0,0,0,0,0,0,0,0,0,0,0,0,7,7,7
26094,TÃ¼rkiye,2019,2019TÃ¼rkiye,0,0,0,0,0,0,0,0,0,0,5,0,0,5,10
26095,TÃ¼rkiye,2019,2019TÃ¼rkiye,0,0,0,0,0,0,0,0,0,0,6,0,0,6,6
26096,TÃ¼rkiye,2019,2019TÃ¼rkiye,0,0,0,0,0,0,0,0,0,0,7,0,0,7,7
26097,TÃ¼rkiye,2019,2019TÃ¼rkiye,0,0,0,0,0,0,0,0,0,0,8,0,0,8,8
26098,TÃ¼rkiye,2019,2019TÃ¼rkiye,0,0,0,0,0,0,0,0,0,0,9,0,0,9,9
26099,TÃ¼rkiye,2019,2019TÃ¼rkiye,0,0,0,0,0,0,0,0,0,7,0,0,0,7,7
26100,TÃ¼rkiye,2019,2019TÃ¼rkiye,0,0,0,0,0,0,0,0,6,0,0,0,0,6,6
26101,TÃ¼rkiye,2019,2019TÃ¼rkiye,0,0,0,0,0,3335,3335,0,0,0,0,0,8528,8528,11863
26102,TÃ¼rkiye,2019,2019TÃ¼rkiye,0,0,0,5,0,0,5,0,0,0,5,0,0,5,10
26103,TÃ¼rkiye,2019,2019TÃ¼rkiye,0,0,0,7,0,0,7,0,0,0,12,0,0,12,19
26104,TÃ¼rkiye,2019,2019TÃ¼rkiye,0,0,0,10,0,0,10,0,5,0,11,0,0,16,26
26105,TÃ¼rkiye,2019,2019TÃ¼rkiye,0,0,5,0,0,0,5,0,0,0,0,0,0,0,10
26106,TÃ¼rkiye,2019,2019TÃ¼rkiye,0,0,5,5,0,0,10,0,5,0,6,0,0,11,21
26107,TÃ¼rkiye,2019,2019TÃ¼rkiye,0,0,5,8,0,0,13,0,0,5,21,0,0,26,39
26108,TÃ¼rkiye,2019,2019TÃ¼rkiye,0,0,6,0,0,0,6,0,0,0,0,0,0,0,6
26109,TÃ¼rkiye,2019,2019TÃ¼rkiye,0,0,8,0,0,0,8,0,0,0,0,0,0,0,8
26110,TÃ¼rkiye,2019,2019TÃ¼rkiye,0,0,8,5,0,0,13,0,0,7,13,0,0,20,33
26111,TÃ¼rkiye,2019,2019TÃ¼rkiye,0,5,0,0,0,0,5,0,0,0,0,0,0,0,5
26112,TÃ¼rkiye,2019,2019TÃ¼rkiye,0,5,0,0,0,0,5,0,0,0,7,0,0,7,12
26113,TÃ¼rkiye,2019,2019TÃ¼rkiye,0,5,8,0,0,0,13,0,0,0,0,0,0,0,13
26114,TÃ¼rkiye,2019,2019TÃ¼rkiye,0,7,0,15,0,0,22,0,6,6,19,0,0,31,53
26115,TÃ¼rkiye,2019,2019TÃ¼rkiye,0,8,0,7,0,0,15,0,0,5,9,0,0,14,29
26116,TÃ¼rkiye,2019,2019TÃ¼rkiye,0,8,0,12,0,0,20,11,0,0,10,0,0,21,41
26117,TÃ¼rkiye,2019,2019TÃ¼rkiye,6,0,0,0,0,0,6,0,0,0,7,0,0,7,13
26118,TÃ¼rkiye,2019,2019TÃ¼rkiye,6,0,0,6,5,0,17,0,9,0,8,0,0,17,34
26119,TÃ¼rkiye,2019,2019TÃ¼rkiye,7,0,0,8,0,0,15,9,0,0,10,0,0,19,34
26120,TÃ¼rkiye,2019,2019TÃ¼rkiye,7,0,0,15,0,0,22,0,0,9,19,0,0,28,50
26121,TÃ¼rkiye,2019,2019TÃ¼rkiye,7,5,5,9,0,0,26,7,0,0,11,0,5,23,49
26122,TÃ¼rkiye,2019,2019TÃ¼rkiye,7,13,7,24,0,0,51,10,7,5,23,0,0,45,96
26123,TÃ¼rkiye,2019,2019TÃ¼rkiye,13,22,14,134,12,0,195,21,30,17,182,13,0,263,3925
26124,TÃ¼rkiye,2019,2019TÃ¼rkiye,16,15,6,48,0,0,85,14,21,5,49,0,0,89,174
26125,TÃ¼rkiye,2019,2019TÃ¼rkiye,200,546,1123,5045,650,0,7564,228,582,1170,5107,516,0,7603,15167
26126,TÃ¼rkiye,2019,2019TÃ¼rkiye,605,1158,631,7882,1809,0,12085,634,1165,725,12012,1849,0,16385,28470
26127,TÃ¼rkiye,2020,2020TÃ¼rkiye,0,0,0,0,0,0,0,0,0,0,0,0,0,0,29497
26128,TÃ¼rkiye,2020,2020TÃ¼rkiye,0,0,0,0,0,0,0,0,0,0,0,0,5,5,5
26129,TÃ¼rkiye,2020,2020TÃ¼rkiye,0,0,0,0,0,0,0,0,0,0,5,0,0,5,5
26130,TÃ¼rkiye,2020,2020TÃ¼rkiye,0,0,0,0,0,0,0,0,0,0,6,0,0,6,6
26131,TÃ¼rkiye,2020,2020TÃ¼rkiye,0,0,0,0,0,0,0,0,0,7,0,0,0,7,7
26132,TÃ¼rkiye,2020,2020TÃ¼rkiye,0,0,0,0,0,0,0,0,5,0,0,0,0,5,5
26133,TÃ¼rkiye,2020,2020TÃ¼rkiye,0,0,0,0,0,0,0,0,5,0,5,0,0,10,10
26134,TÃ¼rkiye,2020,2020TÃ¼rkiye,0,0,0,0,0,0,0,0,6,0,0,0,0,6,6
26135,TÃ¼rkiye,2020,2020TÃ¼rkiye,0,0,0,0,0,10,10,0,0,0,0,0,23,23,33
26136,TÃ¼rkiye,2020,2020TÃ¼rkiye,0,0,0,0,0,32,32,0,0,0,0,0,36,36,68
26137,TÃ¼rkiye,2020,2020TÃ¼rkiye,0,0,0,0,0,1063,1063,0,0,0,0,0,1583,1583,2646
26138,TÃ¼rkiye,2020,2020TÃ¼rkiye,0,0,0,5,0,0,5,0,0,0,0,0,0,0,10
26139,TÃ¼rkiye,2020,2020TÃ¼rkiye,0,0,0,5,0,0,5,0,0,0,8,0,0,8,13
26140,TÃ¼rkiye,2020,2020TÃ¼rkiye,0,0,0,5,0,0,5,0,0,0,11,0,0,11,16
26141,TÃ¼rkiye,2020,2020TÃ¼rkiye,0,0,0,6,0,0,6,0,0,0,10,0,0,10,16
26142,TÃ¼rkiye,2020,2020TÃ¼rkiye,0,0,0,7,0,0,7,0,0,0,0,0,0,0,7
26143,TÃ¼rkiye,2020,2020TÃ¼rkiye,0,0,0,8,0,0,8,0,0,0,16,0,0,16,24
26144,TÃ¼rkiye,2020,2020TÃ¼rkiye,0,0,0,11,0,0,11,0,0,5,5,0,0,10,21
26145,TÃ¼rkiye,2020,2020TÃ¼rkiye,0,0,0,21,0,0,21,0,6,0,26,0,0,32,53
26146,TÃ¼rkiye,2020,2020TÃ¼rkiye,0,0,5,0,0,0,5,0,0,0,0,0,0,0,20
26147,TÃ¼rkiye,2020,2020TÃ¼rkiye,0,0,6,0,0,0,6,0,0,0,0,0,0,0,6
26148,TÃ¼rkiye,2020,2020TÃ¼rkiye,0,0,6,5,5,0,16,5,5,0,7,0,0,17,33
26149,TÃ¼rkiye,2020,2020TÃ¼rkiye,0,0,8,0,0,0,8,0,0,0,0,0,0,0,8
26150,TÃ¼rkiye,2020,2020TÃ¼rkiye,0,0,8,11,0,0,19,0,0,8,22,0,0,30,49
26151,TÃ¼rkiye,2020,2020TÃ¼rkiye,0,0,18,10,0,0,28,5,10,0,11,0,0,26,54
26152,TÃ¼rkiye,2020,2020TÃ¼rkiye,0,5,0,0,0,0,5,0,0,0,0,0,0,0,5
26153,TÃ¼rkiye,2020,2020TÃ¼rkiye,0,5,0,0,0,0,5,0,0,0,5,0,0,5,10
26154,TÃ¼rkiye,2020,2020TÃ¼rkiye,0,7,0,6,0,0,13,0,0,0,6,0,0,6,19
26155,TÃ¼rkiye,2020,2020TÃ¼rkiye,0,7,5,21,0,0,33,0,8,6,22,5,0,41,74
26156,TÃ¼rkiye,2020,2020TÃ¼rkiye,0,9,0,0,0,0,9,0,0,0,0,0,0,0,9
26157,TÃ¼rkiye,2020,2020TÃ¼rkiye,0,9,0,11,0,0,20,0,7,5,12,0,0,24,44
26158,TÃ¼rkiye,2020,2020TÃ¼rkiye,0,11,6,32,0,0,49,12,13,0,34,0,0,59,108
26159,TÃ¼rkiye,2020,2020TÃ¼rkiye,0,27,0,184,0,37,248,0,27,28,326,0,40,421,6387
26160,TÃ¼rkiye,2020,2020TÃ¼rkiye,5,0,0,0,0,0,5,0,0,0,0,0,0,0,5
26161,TÃ¼rkiye,2020,2020TÃ¼rkiye,5,0,0,14,0,0,19,0,0,7,25,0,0,32,51
26162,TÃ¼rkiye,2020,2020TÃ¼rkiye,5,6,0,13,0,0,24,9,5,6,12,0,0,32,56
26163,TÃ¼rkiye,2020,2020TÃ¼rkiye,5,11,8,27,0,0,51,6,12,5,25,0,0,48,99
26164,TÃ¼rkiye,2020,2020TÃ¼rkiye,6,0,0,0,0,0,6,0,0,0,7,0,0,7,13
26165,TÃ¼rkiye,2020,2020TÃ¼rkiye,6,0,0,9,0,0,15,0,9,0,10,0,0,19,34
26166,TÃ¼rkiye,2020,2020TÃ¼rkiye,7,0,0,17,0,0,24,6,7,5,21,0,0,39,63
26167,TÃ¼rkiye,2020,2020TÃ¼rkiye,17,9,5,53,0,0,84,11,23,5,51,0,0,90,174
26168,TÃ¼rkiye,2020,2020TÃ¼rkiye,23,40,28,171,16,0,278,30,41,27,249,17,0,364,5447
26169,TÃ¼rkiye,2020,2020TÃ¼rkiye,162,453,1071,5172,713,0,7571,180,522,1083,5262,551,0,7598,15169
26170,TÃ¼rkiye,2020,2020TÃ¼rkiye,747,1673,880,8822,1869,0,13991,770,1673,993,13870,2038,0,19344,33345
26171,TÃ¼rkiye,2021,2021TÃ¼rkiye,0,0,0,0,0,0,0,0,0,0,0,0,0,0,40056
26172,TÃ¼rkiye,2021,2021TÃ¼rkiye,0,0,0,0,0,0,0,0,0,0,0,0,6,6,6
26173,TÃ¼rkiye,2021,2021TÃ¼rkiye,0,0,0,0,0,0,0,0,0,0,5,0,0,5,5
26174,TÃ¼rkiye,2021,2021TÃ¼rkiye,0,0,0,0,0,0,0,0,0,0,6,0,0,6,6
26175,TÃ¼rkiye,2021,2021TÃ¼rkiye,0,0,0,0,0,0,0,0,0,0,7,0,0,7,7
26176,TÃ¼rkiye,2021,2021TÃ¼rkiye,0,0,0,0,0,0,0,0,0,0,8,0,0,8,16
26177,TÃ¼rkiye,2021,2021TÃ¼rkiye,0,0,0,0,0,0,0,0,0,6,0,0,0,6,6
26178,TÃ¼rkiye,2021,2021TÃ¼rkiye,0,0,0,0,0,0,0,0,0,7,0,0,0,7,7
26179,TÃ¼rkiye,2021,2021TÃ¼rkiye,0,0,0,0,0,0,0,0,5,0,0,0,0,5,5
26180,TÃ¼rkiye,2021,2021TÃ¼rkiye,0,0,0,0,0,0,0,0,5,0,5,0,0,10,10
26181,TÃ¼rkiye,2021,2021TÃ¼rkiye,0,0,0,0,0,6,6,0,0,0,0,0,5,5,11
26182,TÃ¼rkiye,2021,2021TÃ¼rkiye,0,0,0,5,0,0,5,0,0,0,0,0,0,0,5
26183,TÃ¼rkiye,2021,2021TÃ¼rkiye,0,0,0,5,0,0,5,0,0,0,11,0,0,11,16
26184,TÃ¼rkiye,2021,2021TÃ¼rkiye,0,0,0,7,0,0,7,0,0,0,9,0,0,9,16
26185,TÃ¼rkiye,2021,2021TÃ¼rkiye,0,0,0,7,0,0,7,0,0,0,13,0,0,13,20
26186,TÃ¼rkiye,2021,2021TÃ¼rkiye,0,0,0,8,0,0,8,0,0,0,18,0,0,18,26
26187,TÃ¼rkiye,2021,2021TÃ¼rkiye,0,0,5,0,0,0,5,0,0,0,0,0,0,0,15
26188,TÃ¼rkiye,2021,2021TÃ¼rkiye,0,0,6,0,0,0,6,0,0,0,0,0,0,0,12
26189,TÃ¼rkiye,2021,2021TÃ¼rkiye,0,0,6,0,0,0,6,0,0,0,7,0,0,7,13
26190,TÃ¼rkiye,2021,2021TÃ¼rkiye,0,0,8,0,0,0,8,0,0,0,0,0,0,0,8
26191,TÃ¼rkiye,2021,2021TÃ¼rkiye,0,5,0,6,0,0,11,0,0,0,10,0,0,10,21
26192,TÃ¼rkiye,2021,2021TÃ¼rkiye,0,5,0,8,0,0,13,0,9,0,9,0,0,18,31
26193,TÃ¼rkiye,2021,2021TÃ¼rkiye,0,5,0,10,0,0,15,0,0,5,7,0,0,12,27
26194,TÃ¼rkiye,2021,2021TÃ¼rkiye,0,5,0,20,0,0,25,0,7,0,29,0,0,36,61
26195,TÃ¼rkiye,2021,2021TÃ¼rkiye,0,6,0,7,0,0,13,0,9,0,12,0,0,21,34
26196,TÃ¼rkiye,2021,2021TÃ¼rkiye,0,6,0,9,0,0,15,0,9,0,10,0,0,19,34
26197,TÃ¼rkiye,2021,2021TÃ¼rkiye,0,6,5,13,0,0,24,0,6,5,17,0,0,28,52
26198,TÃ¼rkiye,2021,2021TÃ¼rkiye,0,6,6,15,0,0,27,0,0,9,27,0,0,36,63
26199,TÃ¼rkiye,2021,2021TÃ¼rkiye,0,7,0,17,0,0,24,6,7,5,21,0,0,39,63
26200,TÃ¼rkiye,2021,2021TÃ¼rkiye,0,9,0,0,0,0,9,0,0,0,9,0,0,9,18
26201,TÃ¼rkiye,2021,2021TÃ¼rkiye,0,11,5,38,0,0,54,5,16,5,41,0,0,67,121
26202,TÃ¼rkiye,2021,2021TÃ¼rkiye,0,13,0,12,0,0,25,5,0,5,9,0,0,19,44
26203,TÃ¼rkiye,2021,2021TÃ¼rkiye,0,14,5,11,0,0,30,0,8,0,17,0,0,25,55
26204,TÃ¼rkiye,2021,2021TÃ¼rkiye,5,6,6,22,0,0,39,0,9,8,21,5,0,43,82
26205,TÃ¼rkiye,2021,2021TÃ¼rkiye,5,11,8,27,0,0,51,5,12,5,25,0,0,47,98
26206,TÃ¼rkiye,2021,2021TÃ¼rkiye,6,0,0,15,0,0,21,0,0,7,22,5,0,34,55
26207,TÃ¼rkiye,2021,2021TÃ¼rkiye,10,28,9,59,0,0,106,6,38,7,64,5,0,120,226
26208,TÃ¼rkiye,2021,2021TÃ¼rkiye,19,36,31,187,17,0,290,33,47,31,299,23,0,433,7234
26209,TÃ¼rkiye,2021,2021TÃ¼rkiye,25,54,26,409,0,37,551,28,58,65,808,5,40,1004,7085
26210,TÃ¼rkiye,2021,2021TÃ¼rkiye,412,1076,1130,3501,312,0,6431,458,1146,1147,3894,320,0,6965,13396
26211,TÃ¼rkiye,2021,2021TÃ¼rkiye,750,1976,1045,9306,1866,0,14943,803,2013,1186,14870,2138,0,21010,35953
26212,Uganda,2001,2001Uganda,0,0,0,0,0,0,0,0,0,0,0,0,0,0,34005
26213,Uganda,2001,2001Uganda,0,0,0,0,0,0,0,0,0,0,0,0,6,6,6
26214,Uganda,2001,2001Uganda,0,0,0,0,0,0,0,0,0,0,5,0,0,5,10
26215,Uganda,2001,2001Uganda,0,0,0,0,0,0,0,0,0,0,6,0,0,6,6
26216,Uganda,2001,2001Uganda,0,0,0,0,0,7,7,0,0,0,0,0,21,21,28
26217,Uganda,2001,2001Uganda,0,0,0,0,0,17,17,0,0,0,0,0,24,24,41
26218,Uganda,2001,2001Uganda,0,0,0,5,0,0,5,0,0,0,25,0,0,25,30
26219,Uganda,2001,2001Uganda,0,5,0,7,26,0,38,0,9,0,23,20,0,52,90
26220,Uganda,2001,2001Uganda,0,5,0,12,0,0,17,0,0,5,23,0,0,28,45
26221,Uganda,2001,2001Uganda,0,5,5,7,0,0,17,0,0,9,8,0,0,17,34
26222,Uganda,2001,2001Uganda,0,8,0,8,0,0,16,0,7,6,5,0,0,18,34
26223,Uganda,2001,2001Uganda,529,448,383,1090,0,0,2450,420,479,410,2034,11,0,3354,5804
26224,Uganda,2002,2002Uganda,0,0,0,0,0,0,0,0,0,0,0,0,0,0,12610
26225,Uganda,2002,2002Uganda,0,0,0,0,0,0,0,0,0,0,5,0,0,5,5
26226,Uganda,2002,2002Uganda,0,0,0,0,0,0,0,0,0,0,6,0,0,6,6
26227,Uganda,2002,2002Uganda,0,0,0,0,0,6,6,0,0,0,0,0,20,20,26
26228,Uganda,2002,2002Uganda,0,0,0,0,0,17,17,0,0,0,0,0,23,23,40
26229,Uganda,2002,2002Uganda,0,0,0,5,0,0,5,0,0,0,27,0,0,27,32
26230,Uganda,2002,2002Uganda,0,0,0,12,0,0,12,0,0,6,27,0,0,33,45
26231,Uganda,2002,2002Uganda,0,0,5,0,0,0,5,0,0,0,10,0,0,10,15
26232,Uganda,2002,2002Uganda,0,0,6,15,0,0,21,0,0,5,0,0,0,5,26
26233,Uganda,2002,2002Uganda,0,5,0,9,0,0,14,0,0,0,9,5,0,14,28
26234,Uganda,2002,2002Uganda,0,7,0,15,0,0,22,0,7,6,10,0,0,23,45
26235,Uganda,2002,2002Uganda,8,15,0,18,0,0,41,5,22,0,24,0,0,51,92
26236,Uganda,2002,2002Uganda,354,500,429,821,154,0,2258,291,368,316,711,87,0,1773,23012
26237,Uganda,2002,2002Uganda,402,342,292,833,0,0,1869,321,366,315,1550,11,0,2563,4432
26238,Uganda,2003,2003Uganda,0,0,0,0,0,0,0,0,0,0,0,0,0,0,11523
26239,Uganda,2003,2003Uganda,0,0,0,0,0,0,0,0,0,0,5,0,0,5,5
26240,Uganda,2003,2003Uganda,0,0,0,0,0,0,0,0,0,0,8,0,0,8,8
26241,Uganda,2003,2003Uganda,0,0,0,0,0,0,0,0,0,5,5,0,0,10,10
26242,Uganda,2003,2003Uganda,0,0,0,0,0,9,9,0,0,0,0,0,20,20,29
26243,Uganda,2003,2003Uganda,0,0,0,0,0,16,16,0,0,0,0,0,21,21,37
26244,Uganda,2003,2003Uganda,0,0,0,5,0,0,5,0,0,0,42,0,0,42,47
26245,Uganda,2003,2003Uganda,0,0,0,12,0,0,12,0,0,5,26,0,0,31,43
26246,Uganda,2003,2003Uganda,0,0,0,12,0,0,12,0,0,6,10,0,0,16,28
26247,Uganda,2003,2003Uganda,0,0,8,17,0,0,25,0,5,0,0,0,0,5,30
26248,Uganda,2003,2003Uganda,8,8,5,16,0,0,37,5,13,8,26,0,0,52,89
26249,Uganda,2003,2003Uganda,177,250,215,415,77,0,1134,146,184,158,373,49,0,910,18953
26250,Uganda,2003,2003Uganda,394,346,296,836,0,0,1872,319,370,317,1550,10,0,2566,4438
26251,Uganda,2004,2004Uganda,0,0,0,0,0,0,0,0,0,0,0,0,0,0,3878
26252,Uganda,2004,2004Uganda,0,0,0,0,0,0,0,0,0,0,5,0,0,5,5
26253,Uganda,2004,2004Uganda,0,0,0,0,0,0,0,0,0,5,5,0,0,10,10
26254,Uganda,2004,2004Uganda,0,0,0,0,0,15,15,0,0,0,0,0,21,21,36
26255,Uganda,2004,2004Uganda,0,0,0,0,0,3161,3161,0,0,0,0,0,4740,4740,7901
26256,Uganda,2004,2004Uganda,0,0,0,5,0,0,5,0,0,0,8,0,0,8,13
26257,Uganda,2004,2004Uganda,0,0,0,12,0,0,12,0,0,5,26,0,0,31,43
26258,Uganda,2004,2004Uganda,0,0,0,15,0,0,15,0,11,10,52,0,0,73,88
26259,Uganda,2004,2004Uganda,0,0,5,12,0,0,17,0,8,0,11,0,0,19,36
26260,Uganda,2004,2004Uganda,0,6,0,0,0,0,6,0,0,0,0,0,0,0,6
26261,Uganda,2004,2004Uganda,8,8,5,16,0,0,37,13,11,0,21,0,0,45,82
26262,Uganda,2004,2004Uganda,53,117,110,147,11,0,438,60,95,80,220,11,0,466,904
26263,Uganda,2004,2004Uganda,177,250,215,415,77,0,1134,146,184,158,373,49,0,910,18953
26264,Uganda,2005,2005Uganda,0,0,0,0,0,0,0,0,0,0,0,0,0,0,12151
26265,Uganda,2005,2005Uganda,0,0,0,0,0,0,0,0,0,0,5,0,0,5,5
26266,Uganda,2005,2005Uganda,0,0,0,0,0,0,0,0,0,9,0,0,0,9,9
26267,Uganda,2005,2005Uganda,0,0,0,0,0,0,0,0,5,0,0,0,0,5,5
26268,Uganda,2005,2005Uganda,0,0,0,0,0,8,8,0,0,0,0,0,21,21,29
26269,Uganda,2005,2005Uganda,0,0,0,0,0,15,15,0,0,0,0,0,20,20,35
26270,Uganda,2005,2005Uganda,0,0,0,5,0,0,5,0,0,0,8,0,0,8,13
26271,Uganda,2005,2005Uganda,0,0,0,12,0,0,12,0,0,5,26,0,0,31,43
26272,Uganda,2005,2005Uganda,0,0,5,11,0,0,16,0,0,7,11,0,0,18,34
26273,Uganda,2005,2005Uganda,0,5,0,8,0,0,13,0,0,5,28,0,0,33,46
26274,Uganda,2005,2005Uganda,0,7,0,0,0,0,7,0,0,0,0,0,0,0,7
26275,Uganda,2005,2005Uganda,8,5,7,0,0,0,20,0,7,7,9,0,0,23,43
26276,Uganda,2005,2005Uganda,39,210,173,618,122,0,1162,108,364,312,711,177,0,1672,2834
26277,Uganda,2005,2005Uganda,177,250,215,415,77,0,1134,146,184,158,373,49,0,910,18954
26278,Uganda,2006,2006Uganda,0,0,0,0,0,0,0,0,0,0,0,0,0,0,4802
26279,Uganda,2006,2006Uganda,0,0,0,0,0,0,0,0,0,0,0,0,7,7,7
26280,Uganda,2006,2006Uganda,0,0,0,0,0,0,0,0,0,0,5,0,0,5,5
26281,Uganda,2006,2006Uganda,0,0,0,0,0,8,8,0,0,0,0,0,21,21,29
26282,Uganda,2006,2006Uganda,0,0,0,0,0,14,14,0,0,0,0,0,19,19,33
26283,Uganda,2006,2006Uganda,0,0,0,5,0,0,5,0,0,0,13,0,0,13,18
26284,Uganda,2006,2006Uganda,0,0,0,6,0,0,6,0,0,0,6,0,0,6,12
26285,Uganda,2006,2006Uganda,0,0,0,6,0,0,6,0,0,0,7,0,0,7,13
26286,Uganda,2006,2006Uganda,0,0,0,10,0,0,10,0,0,5,6,0,0,11,21
26287,Uganda,2006,2006Uganda,0,0,0,12,0,0,12,0,0,5,26,0,0,31,43
26288,Uganda,2006,2006Uganda,0,13,6,0,0,0,19,0,0,5,14,0,0,19,38
26289,Uganda,2006,2006Uganda,37,286,94,615,117,0,1149,107,453,211,708,182,0,1661,2810
26290,Uganda,2006,2006Uganda,1945,2087,0,1966,1331,0,7329,1772,1866,0,1581,1356,0,6575,13904
26291,Uganda,2007,2007Uganda,0,0,0,0,0,0,0,0,0,0,0,0,0,0,18299
26292,Uganda,2007,2007Uganda,0,0,0,0,0,0,0,0,0,0,0,0,5,5,5
26293,Uganda,2007,2007Uganda,0,0,0,0,0,0,0,0,0,0,0,0,8,8,8
26294,Uganda,2007,2007Uganda,0,0,0,0,0,0,0,0,0,0,5,0,0,5,15
26295,Uganda,2007,2007Uganda,0,0,0,0,0,0,0,0,0,5,0,0,0,5,5
26296,Uganda,2007,2007Uganda,0,0,0,0,0,9,9,0,0,0,0,0,23,23,32
26297,Uganda,2007,2007Uganda,0,0,0,0,0,15,15,0,0,0,0,0,17,17,32
26298,Uganda,2007,2007Uganda,0,0,0,5,0,0,5,0,0,0,5,0,0,5,10
26299,Uganda,2007,2007Uganda,0,0,0,5,0,0,5,0,0,0,8,0,0,8,13
26300,Uganda,2007,2007Uganda,0,0,0,6,0,0,6,0,0,0,6,0,0,6,12
26301,Uganda,2007,2007Uganda,0,0,0,12,0,0,12,0,0,5,26,0,0,31,43
26302,Uganda,2007,2007Uganda,0,0,5,0,0,0,5,0,0,6,33,0,0,39,44
26303,Uganda,2007,2007Uganda,31,282,96,622,117,0,1148,97,456,211,717,178,0,1659,2807
26304,Uganda,2008,2008Uganda,0,0,0,0,0,0,0,0,0,0,0,0,0,0,4391
26305,Uganda,2008,2008Uganda,0,0,0,0,0,0,0,0,0,0,5,0,0,5,25
26306,Uganda,2008,2008Uganda,0,0,0,0,0,0,0,0,0,0,6,0,0,6,6
26307,Uganda,2008,2008Uganda,0,0,0,0,0,0,0,0,0,0,9,0,0,9,9
26308,Uganda,2008,2008Uganda,0,0,0,0,0,0,0,0,9,0,0,0,0,9,9
26309,Uganda,2008,2008Uganda,0,0,0,0,0,8,8,0,0,0,0,0,0,0,8
26310,Uganda,2008,2008Uganda,0,0,0,0,0,11,11,0,0,0,0,0,27,27,38
26311,Uganda,2008,2008Uganda,0,0,0,0,0,14,14,0,0,0,0,0,19,19,33
26312,Uganda,2008,2008Uganda,0,0,0,6,0,0,6,0,0,0,6,0,0,6,12
26313,Uganda,2008,2008Uganda,0,0,0,12,0,0,12,0,0,5,26,0,0,31,43
26314,Uganda,2008,2008Uganda,0,0,5,5,0,0,10,0,0,8,0,0,0,8,18
26315,Uganda,2008,2008Uganda,0,0,17,0,0,0,17,0,7,0,10,0,0,17,34
26316,Uganda,2008,2008Uganda,5,0,0,0,0,0,5,0,0,0,5,0,0,5,10
26317,Uganda,2008,2008Uganda,8,9,6,28,0,0,51,0,5,5,47,0,0,57,108
26318,Uganda,2008,2008Uganda,187,206,91,606,0,0,1090,34,151,196,1108,210,0,1699,2789
26319,Uganda,2009,2009Uganda,0,0,0,0,0,0,0,0,0,0,0,0,0,0,4185
26320,Uganda,2009,2009Uganda,0,0,0,0,0,0,0,0,0,0,5,0,0,5,25
26321,Uganda,2009,2009Uganda,0,0,0,0,0,0,0,0,0,0,6,0,0,6,6
26322,Uganda,2009,2009Uganda,0,0,0,0,0,9,9,0,0,0,0,0,0,0,9
26323,Uganda,2009,2009Uganda,0,0,0,0,0,13,13,0,0,0,0,0,17,17,30
26324,Uganda,2009,2009Uganda,0,0,0,5,0,0,5,0,0,0,0,0,0,0,5
26325,Uganda,2009,2009Uganda,0,0,0,5,0,0,5,0,0,0,5,0,0,5,10
26326,Uganda,2009,2009Uganda,0,0,0,6,0,0,6,0,0,0,6,0,0,6,12
26327,Uganda,2009,2009Uganda,0,0,0,7,0,0,7,0,0,0,0,0,0,0,7
26328,Uganda,2009,2009Uganda,0,0,0,12,0,0,12,0,0,5,26,0,0,31,43
26329,Uganda,2009,2009Uganda,0,0,6,0,0,0,6,0,5,0,5,0,0,10,16
26330,Uganda,2009,2009Uganda,0,0,9,0,0,0,9,0,0,8,0,0,0,8,17
26331,Uganda,2009,2009Uganda,0,8,0,0,0,0,8,0,0,0,0,0,0,0,8
26332,Uganda,2009,2009Uganda,0,14,12,102,0,0,128,6,12,14,94,6,0,132,260
26333,Uganda,2009,2009Uganda,6,8,9,28,0,0,51,0,10,0,49,0,0,59,110
26334,Uganda,2009,2009Uganda,8,0,0,0,0,0,8,0,0,0,0,0,0,0,8
26335,Uganda,2009,2009Uganda,8,5,8,0,0,0,21,0,6,0,5,0,0,11,32
26336,Uganda,2009,2009Uganda,95,134,100,845,0,0,1174,27,71,100,1232,156,0,1586,2760
26337,Uganda,2010,2010Uganda,0,0,0,0,0,0,0,0,0,0,0,0,0,0,4110
26338,Uganda,2010,2010Uganda,0,0,0,0,0,0,0,0,0,0,5,0,0,5,10
26339,Uganda,2010,2010Uganda,0,0,0,0,0,0,0,0,0,5,0,0,0,5,10
26340,Uganda,2010,2010Uganda,0,0,0,0,0,0,0,5,0,0,0,0,0,5,5
26341,Uganda,2010,2010Uganda,0,0,0,0,0,7,7,0,0,0,0,0,6,6,13
26342,Uganda,2010,2010Uganda,0,0,0,0,0,16,16,0,0,0,0,0,31,31,47
26343,Uganda,2010,2010Uganda,0,0,0,0,0,476,476,0,0,0,0,0,476,476,952
26344,Uganda,2010,2010Uganda,0,0,0,5,0,0,5,0,0,0,0,0,0,0,5
26345,Uganda,2010,2010Uganda,0,0,0,5,0,0,5,0,5,0,0,0,0,5,10
26346,Uganda,2010,2010Uganda,0,0,0,6,0,0,6,0,0,0,6,0,0,6,12
26347,Uganda,2010,2010Uganda,0,0,0,11,0,0,11,5,0,0,0,0,0,5,16
26348,Uganda,2010,2010Uganda,0,0,6,0,0,0,6,0,5,0,5,0,0,10,16
26349,Uganda,2010,2010Uganda,0,5,0,0,0,0,5,0,0,5,0,0,0,5,10
26350,Uganda,2010,2010Uganda,0,10,0,0,0,0,10,8,0,0,16,0,0,24,34
26351,Uganda,2010,2010Uganda,0,13,12,106,5,0,136,9,13,15,105,8,0,150,286
26352,Uganda,2010,2010Uganda,5,0,0,0,0,9,14,0,0,0,5,0,15,20,34
26353,Uganda,2010,2010Uganda,5,5,14,20,5,0,49,5,5,5,45,5,0,65,114
26354,Uganda,2010,2010Uganda,41,54,58,168,5,0,326,33,59,47,263,9,0,411,737
26355,Uganda,2011,2011Uganda,0,0,0,0,0,0,0,0,0,0,0,0,0,0,3489
26356,Uganda,2011,2011Uganda,0,0,0,0,0,0,0,0,0,0,5,0,0,5,15
26357,Uganda,2011,2011Uganda,0,0,0,0,0,0,0,0,0,5,0,0,0,5,5
26358,Uganda,2011,2011Uganda,0,0,0,0,0,0,0,0,9,0,0,0,0,9,9
26359,Uganda,2011,2011Uganda,0,0,0,0,0,0,0,5,0,0,0,0,0,5,5
26360,Uganda,2011,2011Uganda,0,0,0,0,0,8,8,0,0,0,0,0,8,8,16
26361,Uganda,2011,2011Uganda,0,0,0,0,0,13,13,0,0,0,5,0,18,23,36
26362,Uganda,2011,2011Uganda,0,0,0,0,0,16,16,0,0,0,0,0,31,31,53
26363,Uganda,2011,2011Uganda,0,0,0,0,0,110,110,0,0,0,0,0,110,110,220
26364,Uganda,2011,2011Uganda,0,0,0,5,0,0,5,0,0,0,0,0,0,0,5
26365,Uganda,2011,2011Uganda,0,0,0,6,0,0,6,0,0,0,6,0,0,6,12
26366,Uganda,2011,2011Uganda,0,0,0,9,0,0,9,0,0,0,17,0,0,17,26
26367,Uganda,2011,2011Uganda,0,0,5,0,0,0,5,0,0,0,0,0,0,0,5
26368,Uganda,2011,2011Uganda,0,0,5,0,0,0,5,0,0,6,0,0,0,6,11
26369,Uganda,2011,2011Uganda,0,0,6,0,0,0,6,0,5,0,5,0,0,10,16
26370,Uganda,2011,2011Uganda,0,0,12,67,0,0,79,0,6,7,69,0,0,82,749
26371,Uganda,2011,2011Uganda,0,5,8,9,0,0,22,0,0,0,27,5,0,32,54
26372,Uganda,2011,2011Uganda,5,0,0,8,0,0,13,5,0,0,0,0,0,5,18
26373,Uganda,2011,2011Uganda,5,6,0,0,0,0,11,0,8,0,10,0,0,18,29
26374,Uganda,2011,2011Uganda,5,9,7,95,5,0,121,5,15,9,100,8,0,137,258
26375,Uganda,2011,2011Uganda,41,43,54,135,5,0,278,30,62,51,195,11,0,349,627
26376,Uganda,2012,2012Uganda,0,0,0,0,0,0,0,0,0,0,0,0,0,0,3312
26377,Uganda,2012,2012Uganda,0,0,0,0,0,0,0,0,0,0,5,0,0,5,20
26378,Uganda,2012,2012Uganda,0,0,0,0,0,0,0,0,0,0,7,0,0,7,7
26379,Uganda,2012,2012Uganda,0,0,0,0,0,0,0,5,0,0,0,0,0,5,5
26380,Uganda,2012,2012Uganda,0,0,0,0,0,0,0,7,0,0,0,0,0,7,12
26381,Uganda,2012,2012Uganda,0,0,0,0,0,10,10,0,0,0,0,0,9,9,19
26382,Uganda,2012,2012Uganda,0,0,0,0,0,11,11,0,0,0,5,0,16,21,32
26383,Uganda,2012,2012Uganda,0,0,0,0,0,21,21,0,0,0,0,0,40,40,61
26384,Uganda,2012,2012Uganda,0,0,0,0,0,107,107,0,0,0,5,0,107,112,219
26385,Uganda,2012,2012Uganda,0,0,0,5,0,0,5,0,0,0,0,0,0,0,5
26386,Uganda,2012,2012Uganda,0,0,0,9,0,0,9,0,0,0,18,0,0,18,27
26387,Uganda,2012,2012Uganda,0,0,0,15,0,0,15,0,0,0,0,0,0,0,15
26388,Uganda,2012,2012Uganda,0,0,5,0,0,0,5,0,0,0,0,0,0,0,5
26389,Uganda,2012,2012Uganda,0,5,0,20,0,0,25,0,0,0,22,0,0,22,809
26390,Uganda,2012,2012Uganda,0,5,5,0,0,0,10,0,5,0,5,0,0,10,20
26391,Uganda,2012,2012Uganda,0,8,5,31,5,0,49,0,9,0,48,6,0,63,112
26392,Uganda,2012,2012Uganda,5,0,0,10,0,0,15,5,0,0,0,0,0,5,20
26393,Uganda,2012,2012Uganda,5,0,5,0,0,0,10,0,5,0,5,0,0,10,20
26394,Uganda,2012,2012Uganda,5,9,11,99,6,0,130,5,17,14,97,9,0,142,272
26395,Uganda,2012,2012Uganda,39,52,55,110,10,0,266,48,52,56,160,14,0,330,596
26396,Uganda,2013,2013Uganda,0,0,0,0,0,0,0,0,0,0,0,0,0,0,3305
26397,Uganda,2013,2013Uganda,0,0,0,0,0,0,0,0,0,0,5,0,0,5,10
26398,Uganda,2013,2013Uganda,0,0,0,0,0,0,0,0,0,0,7,0,0,7,7
26399,Uganda,2013,2013Uganda,0,0,0,0,0,0,0,0,0,7,0,0,0,7,12
26400,Uganda,2013,2013Uganda,0,0,0,0,0,0,0,0,5,0,0,0,0,5,5
26401,Uganda,2013,2013Uganda,0,0,0,0,0,0,0,5,0,0,0,0,0,5,5
26402,Uganda,2013,2013Uganda,0,0,0,0,0,9,9,0,0,0,0,0,9,9,18
26403,Uganda,2013,2013Uganda,0,0,0,0,0,25,25,0,0,0,0,0,45,45,70
26404,Uganda,2013,2013Uganda,0,0,0,0,0,107,107,0,0,0,5,0,107,112,219
26405,Uganda,2013,2013Uganda,0,0,0,5,0,6,11,0,0,0,6,0,14,20,31
26406,Uganda,2013,2013Uganda,0,0,0,7,0,0,7,0,0,0,0,0,0,0,7
26407,Uganda,2013,2013Uganda,0,0,0,9,0,0,9,0,0,0,18,0,0,18,27
26408,Uganda,2013,2013Uganda,0,0,0,17,0,0,17,0,0,0,0,0,0,0,17
26409,Uganda,2013,2013Uganda,0,0,5,0,0,0,5,0,0,0,0,0,0,0,5
26410,Uganda,2013,2013Uganda,0,0,7,46,5,0,58,0,6,5,46,5,0,62,120
26411,Uganda,2013,2013Uganda,0,5,0,13,0,0,18,0,5,0,11,0,0,16,34
26412,Uganda,2013,2013Uganda,0,5,5,0,0,0,10,0,5,0,5,0,0,10,20
26413,Uganda,2013,2013Uganda,0,6,5,22,0,0,33,0,5,5,11,0,0,21,844
26414,Uganda,2013,2013Uganda,0,8,0,30,5,0,43,0,6,7,41,5,0,59,102
26415,Uganda,2013,2013Uganda,5,0,0,10,0,0,15,5,0,0,0,0,0,5,20
26416,Uganda,2013,2013Uganda,39,47,50,138,0,0,274,45,37,48,187,11,0,328,602
26417,Uganda,2013,2013Uganda,275,433,222,585,66,0,1581,297,461,242,100,5,0,1105,2686
26418,Uganda,2014,2014Uganda,0,0,0,0,0,0,0,0,0,0,0,0,0,0,3370
26419,Uganda,2014,2014Uganda,0,0,0,0,0,0,0,0,0,0,5,0,0,5,25
26420,Uganda,2014,2014Uganda,0,0,0,0,0,0,0,0,0,0,8,0,0,8,8
26421,Uganda,2014,2014Uganda,0,0,0,0,0,0,0,0,5,0,0,0,0,5,15
26422,Uganda,2014,2014Uganda,0,0,0,0,0,30,30,0,0,0,0,0,50,50,80
26423,Uganda,2014,2014Uganda,0,0,0,0,0,200,200,0,0,0,0,0,496,496,696
26424,Uganda,2014,2014Uganda,0,0,0,5,0,6,11,0,0,0,5,0,14,19,30
26425,Uganda,2014,2014Uganda,0,0,0,9,0,0,9,0,0,0,18,0,0,18,27
26426,Uganda,2014,2014Uganda,0,0,0,10,0,0,10,0,0,0,17,0,0,17,804
26427,Uganda,2014,2014Uganda,0,0,0,18,0,0,18,0,0,0,5,0,0,5,23
26428,Uganda,2014,2014Uganda,0,0,5,0,0,0,5,0,0,0,0,0,0,0,5
26429,Uganda,2014,2014Uganda,0,0,8,46,5,0,59,0,6,5,45,5,0,61,120
26430,Uganda,2014,2014Uganda,0,0,9,0,0,0,9,0,0,6,0,0,0,6,15
26431,Uganda,2014,2014Uganda,0,5,0,11,0,0,16,0,0,0,7,0,0,7,23
26432,Uganda,2014,2014Uganda,0,5,5,0,0,0,10,0,0,6,6,0,0,12,22
26433,Uganda,2014,2014Uganda,0,7,5,28,5,0,45,0,0,5,49,6,0,60,105
26434,Uganda,2014,2014Uganda,5,0,0,0,0,0,5,0,0,0,0,0,0,0,5
26435,Uganda,2014,2014Uganda,29,41,41,120,0,0,231,36,44,37,233,10,0,360,591
26436,Uganda,2014,2014Uganda,126,206,104,255,28,0,719,127,206,114,47,0,0,494,1213
26437,Uganda,2015,2015Uganda,0,0,0,0,0,0,0,0,0,0,0,0,0,0,5062
26438,Uganda,2015,2015Uganda,0,0,0,0,0,0,0,0,0,0,5,0,0,5,20
26439,Uganda,2015,2015Uganda,0,0,0,0,0,0,0,0,0,0,7,0,0,7,7
26440,Uganda,2015,2015Uganda,0,0,0,0,0,0,0,0,0,0,8,0,0,8,8
26441,Uganda,2015,2015Uganda,0,0,0,0,0,0,0,0,5,0,0,0,0,5,15
26442,Uganda,2015,2015Uganda,0,0,0,0,0,15,15,0,0,0,0,0,12,12,27
26443,Uganda,2015,2015Uganda,0,0,0,0,0,24,24,0,0,0,0,0,11,11,35
26444,Uganda,2015,2015Uganda,0,0,0,0,0,41,41,0,0,0,0,0,59,59,100
26445,Uganda,2015,2015Uganda,0,0,0,6,0,0,6,0,0,0,0,0,0,0,6
26446,Uganda,2015,2015Uganda,0,0,0,9,0,0,9,0,0,0,0,0,0,0,9
26447,Uganda,2015,2015Uganda,0,0,0,9,0,0,9,0,0,0,13,0,0,13,22
26448,Uganda,2015,2015Uganda,0,0,5,0,0,0,5,0,0,0,0,0,0,0,5
26449,Uganda,2015,2015Uganda,0,0,5,42,5,0,52,0,5,5,44,6,0,60,112
26450,Uganda,2015,2015Uganda,0,5,0,0,0,0,5,0,0,0,0,0,0,0,5
26451,Uganda,2015,2015Uganda,0,5,0,11,0,0,16,0,8,0,0,0,0,8,24
26452,Uganda,2015,2015Uganda,0,5,0,18,0,0,23,0,5,0,13,0,0,18,41
26453,Uganda,2015,2015Uganda,0,5,5,0,0,0,10,0,0,7,6,0,0,13,23
26454,Uganda,2015,2015Uganda,0,7,5,26,0,0,38,0,0,11,48,8,0,67,105
26455,Uganda,2015,2015Uganda,0,11,0,0,0,0,11,0,0,5,10,0,0,15,26
26456,Uganda,2015,2015Uganda,5,0,0,17,0,0,22,0,0,0,0,0,0,0,22
26457,Uganda,2015,2015Uganda,30,47,47,143,0,0,267,44,45,38,228,15,0,370,637
26458,Uganda,2016,2016Uganda,0,0,0,0,0,0,0,0,0,0,0,0,0,0,3939
26459,Uganda,2016,2016Uganda,0,0,0,0,0,0,0,0,0,0,5,0,0,5,20
26460,Uganda,2016,2016Uganda,0,0,0,0,0,0,0,0,0,0,6,0,0,6,6
26461,Uganda,2016,2016Uganda,0,0,0,0,0,0,0,0,0,0,7,0,0,7,7
26462,Uganda,2016,2016Uganda,0,0,0,0,0,0,0,0,0,5,0,0,0,5,5
26463,Uganda,2016,2016Uganda,0,0,0,0,0,0,0,0,5,0,0,0,0,5,10
26464,Uganda,2016,2016Uganda,0,0,0,0,0,0,0,0,6,0,0,0,0,6,6
26465,Uganda,2016,2016Uganda,0,0,0,0,0,12,12,0,0,0,0,0,8,8,20
26466,Uganda,2016,2016Uganda,0,0,0,0,0,47,47,0,0,0,0,0,62,62,109
26467,Uganda,2016,2016Uganda,0,0,0,0,0,158,158,0,0,0,0,0,394,394,552
26468,Uganda,2016,2016Uganda,0,0,0,5,0,0,5,0,0,0,0,0,0,0,5
26469,Uganda,2016,2016Uganda,0,0,0,6,0,0,6,0,0,0,0,0,0,0,6
26470,Uganda,2016,2016Uganda,0,0,0,8,0,0,8,0,0,0,0,0,0,0,8
26471,Uganda,2016,2016Uganda,0,0,0,9,0,0,9,0,0,0,13,0,0,13,22
26472,Uganda,2016,2016Uganda,0,0,0,9,0,8,17,0,0,0,0,0,18,18,35
26473,Uganda,2016,2016Uganda,0,0,6,45,8,0,59,0,8,0,43,5,0,56,115
26474,Uganda,2016,2016Uganda,0,5,0,0,0,0,5,0,0,0,0,0,0,0,5
26475,Uganda,2016,2016Uganda,0,5,0,5,0,0,10,0,0,7,6,0,0,13,23
26476,Uganda,2016,2016Uganda,0,5,0,17,0,0,22,0,5,0,13,0,0,18,40
26477,Uganda,2016,2016Uganda,0,5,6,0,0,0,11,0,0,7,6,0,0,13,24
26478,Uganda,2016,2016Uganda,0,6,0,12,0,0,18,0,9,0,0,0,0,9,27
26479,Uganda,2016,2016Uganda,0,7,5,25,5,0,42,5,0,5,43,10,0,63,105
26480,Uganda,2016,2016Uganda,0,8,0,42,0,0,50,0,10,0,20,0,0,30,486
26481,Uganda,2016,2016Uganda,5,0,0,12,0,0,17,0,0,0,6,0,0,6,23
26482,Uganda,2016,2016Uganda,28,51,42,134,5,0,260,43,43,31,237,17,0,371,631
26483,Uganda,2017,2017Uganda,0,0,0,0,0,0,0,0,0,0,0,0,0,0,4647
26484,Uganda,2017,2017Uganda,0,0,0,0,0,0,0,0,0,0,0,0,6,6,6
26485,Uganda,2017,2017Uganda,0,0,0,0,0,0,0,0,0,0,5,0,0,5,20
26486,Uganda,2017,2017Uganda,0,0,0,0,0,0,0,0,0,0,6,0,0,6,6
26487,Uganda,2017,2017Uganda,0,0,0,0,0,0,0,0,0,0,7,0,0,7,7
26488,Uganda,2017,2017Uganda,0,0,0,0,0,0,0,0,0,0,8,0,0,8,8
26489,Uganda,2017,2017Uganda,0,0,0,0,0,0,0,0,0,5,0,0,0,5,5
26490,Uganda,2017,2017Uganda,0,0,0,0,0,0,0,0,5,0,0,0,0,5,5
26491,Uganda,2017,2017Uganda,0,0,0,0,0,0,0,0,7,0,0,0,0,7,7
26492,Uganda,2017,2017Uganda,0,0,0,0,0,53,53,0,0,0,0,0,67,67,120
26493,Uganda,2017,2017Uganda,0,0,0,0,0,154,154,0,0,0,0,0,395,395,549
26494,Uganda,2017,2017Uganda,0,0,0,5,0,0,5,0,0,5,0,0,0,5,10
26495,Uganda,2017,2017Uganda,0,0,0,5,0,0,5,0,0,7,6,0,0,13,18
26496,Uganda,2017,2017Uganda,0,0,0,6,0,0,6,0,0,0,0,0,0,0,6
26497,Uganda,2017,2017Uganda,0,0,0,7,0,19,26,6,0,0,0,0,8,14,40
26498,Uganda,2017,2017Uganda,0,0,0,8,0,0,8,0,0,0,13,0,0,13,21
26499,Uganda,2017,2017Uganda,0,0,8,59,8,0,75,0,9,0,71,5,0,85,160
26500,Uganda,2017,2017Uganda,0,5,0,0,0,0,5,0,0,0,0,0,0,0,5
26501,Uganda,2017,2017Uganda,0,5,0,19,0,0,24,0,5,0,13,0,0,18,42
26502,Uganda,2017,2017Uganda,0,6,6,0,0,0,12,0,0,7,6,0,0,13,25
26503,Uganda,2017,2017Uganda,0,9,0,0,0,0,9,0,0,12,0,0,0,12,21
26504,Uganda,2017,2017Uganda,5,0,0,13,0,0,18,0,0,0,6,0,0,6,24
26505,Uganda,2017,2017Uganda,8,0,0,14,0,0,22,0,9,0,0,0,0,9,31
26506,Uganda,2017,2017Uganda,25,50,41,142,0,0,258,33,46,42,229,18,0,368,626
26507,Uganda,2018,2018Uganda,0,0,0,0,0,0,0,0,0,0,0,0,0,0,5037
26508,Uganda,2018,2018Uganda,0,0,0,0,0,0,0,0,0,0,5,0,0,5,15
26509,Uganda,2018,2018Uganda,0,0,0,0,0,0,0,0,0,0,7,0,0,7,7
26510,Uganda,2018,2018Uganda,0,0,0,0,0,0,0,0,0,6,5,0,0,11,11
26511,Uganda,2018,2018Uganda,0,0,0,0,0,0,0,0,5,0,0,0,0,5,5
26512,Uganda,2018,2018Uganda,0,0,0,0,0,58,58,0,0,0,0,0,75,75,133
26513,Uganda,2018,2018Uganda,0,0,0,6,0,0,6,0,0,0,0,0,0,0,6
26514,Uganda,2018,2018Uganda,0,0,0,6,0,0,6,0,0,5,0,0,0,5,11
26515,Uganda,2018,2018Uganda,0,0,0,7,0,0,7,0,0,0,13,0,0,13,20
26516,Uganda,2018,2018Uganda,0,0,0,9,0,8,17,0,0,0,0,0,19,19,36
26517,Uganda,2018,2018Uganda,0,0,0,11,0,0,11,0,0,0,6,0,0,6,17
26518,Uganda,2018,2018Uganda,0,5,0,0,0,0,5,0,0,0,0,0,0,0,5
26519,Uganda,2018,2018Uganda,0,5,0,5,0,0,10,8,0,5,5,0,0,18,28
26520,Uganda,2018,2018Uganda,0,5,0,15,0,0,20,0,5,0,9,0,0,14,34
26521,Uganda,2018,2018Uganda,0,7,0,0,0,0,7,0,0,0,9,0,0,9,16
26522,Uganda,2018,2018Uganda,0,8,0,15,0,0,23,0,6,0,5,0,0,11,34
26523,Uganda,2018,2018Uganda,0,14,13,49,0,0,76,5,22,9,52,0,0,88,559
26524,Uganda,2018,2018Uganda,5,0,0,0,0,0,5,0,0,0,0,0,0,0,5
26525,Uganda,2018,2018Uganda,5,0,0,10,0,0,15,0,0,0,0,0,0,0,15
26526,Uganda,2018,2018Uganda,7,0,7,67,8,0,89,5,6,0,92,5,0,108,197
26527,Uganda,2018,2018Uganda,26,64,37,205,0,0,332,42,51,41,354,23,0,511,843
26528,Uganda,2019,2019Uganda,0,0,0,0,0,0,0,0,0,0,0,0,0,0,5751
26529,Uganda,2019,2019Uganda,0,0,0,0,0,0,0,0,0,0,0,5,0,5,5
26530,Uganda,2019,2019Uganda,0,0,0,0,0,0,0,0,0,0,5,0,0,5,10
26531,Uganda,2019,2019Uganda,0,0,0,0,0,0,0,0,0,0,7,0,0,7,7
26532,Uganda,2019,2019Uganda,0,0,0,0,0,0,0,0,0,0,8,0,0,8,8
26533,Uganda,2019,2019Uganda,0,0,0,0,0,0,0,0,5,0,0,0,0,5,5
26534,Uganda,2019,2019Uganda,0,0,0,0,0,0,0,0,6,7,6,0,0,19,19
26535,Uganda,2019,2019Uganda,0,0,0,0,0,69,69,0,0,0,0,0,90,90,159
26536,Uganda,2019,2019Uganda,0,0,0,5,0,0,5,0,0,0,0,0,0,0,10
26537,Uganda,2019,2019Uganda,0,0,0,6,0,0,6,0,0,0,0,0,0,0,6
26538,Uganda,2019,2019Uganda,0,0,0,6,0,0,6,0,0,0,12,0,0,12,18
26539,Uganda,2019,2019Uganda,0,0,0,7,0,0,7,0,0,0,6,0,0,6,13
26540,Uganda,2019,2019Uganda,0,0,0,8,0,0,8,0,0,0,5,0,0,5,42
26541,Uganda,2019,2019Uganda,0,0,0,9,0,0,9,0,0,0,0,0,0,0,9
26542,Uganda,2019,2019Uganda,0,0,0,9,0,0,9,0,8,0,0,0,0,8,17
26543,Uganda,2019,2019Uganda,0,0,5,17,0,0,22,0,0,5,10,0,0,15,37
26544,Uganda,2019,2019Uganda,0,5,0,10,0,0,15,0,8,5,13,5,0,31,46
26545,Uganda,2019,2019Uganda,0,8,0,0,0,0,8,0,0,5,0,0,0,5,13
26546,Uganda,2019,2019Uganda,5,0,0,0,0,0,5,0,0,0,0,0,0,0,5
26547,Uganda,2019,2019Uganda,5,0,0,0,0,0,5,0,0,9,0,0,0,9,14
26548,Uganda,2019,2019Uganda,9,0,5,75,8,0,97,7,0,6,99,8,0,120,217
26549,Uganda,2019,2019Uganda,34,65,35,208,5,0,347,33,58,42,383,27,0,543,890
26550,Uganda,2020,2020Uganda,0,0,0,0,0,0,0,0,0,0,0,0,0,0,4821
26551,Uganda,2020,2020Uganda,0,0,0,0,0,0,0,0,0,0,0,0,5,5,5
26552,Uganda,2020,2020Uganda,0,0,0,0,0,0,0,0,0,0,0,0,7,7,7
26553,Uganda,2020,2020Uganda,0,0,0,0,0,0,0,0,0,0,5,0,0,5,25
26554,Uganda,2020,2020Uganda,0,0,0,0,0,0,0,0,0,0,9,0,0,9,9
26555,Uganda,2020,2020Uganda,0,0,0,0,0,0,0,0,0,5,0,0,0,5,5
26556,Uganda,2020,2020Uganda,0,0,0,0,0,0,0,0,0,7,0,0,0,7,14
26557,Uganda,2020,2020Uganda,0,0,0,0,0,0,0,0,5,0,5,0,0,10,10
26558,Uganda,2020,2020Uganda,0,0,0,0,0,0,0,0,7,0,0,0,0,7,7
26559,Uganda,2020,2020Uganda,0,0,0,0,0,14,14,0,0,0,0,0,10,10,24
26560,Uganda,2020,2020Uganda,0,0,0,0,0,23,23,0,0,0,0,0,14,14,37
26561,Uganda,2020,2020Uganda,0,0,0,5,0,0,5,0,0,0,0,0,0,0,5
26562,Uganda,2020,2020Uganda,0,0,0,6,0,0,6,0,0,0,0,0,0,0,6
26563,Uganda,2020,2020Uganda,0,0,0,6,0,0,6,0,0,0,14,0,0,14,20
26564,Uganda,2020,2020Uganda,0,0,0,7,0,0,7,0,0,0,6,0,0,6,13
26565,Uganda,2020,2020Uganda,0,0,0,9,0,0,9,0,0,0,0,0,0,0,9
26566,Uganda,2020,2020Uganda,0,0,0,73,0,22,95,0,0,0,63,0,23,86,660
26567,Uganda,2020,2020Uganda,0,0,5,19,0,0,24,0,0,5,11,0,0,16,40
26568,Uganda,2020,2020Uganda,0,5,0,0,0,0,5,0,0,9,0,0,0,9,14
26569,Uganda,2020,2020Uganda,0,5,0,8,0,0,13,8,0,0,0,0,0,8,51
26570,Uganda,2020,2020Uganda,0,7,7,106,6,0,126,0,8,0,320,5,0,333,459
26571,Uganda,2020,2020Uganda,0,9,0,5,0,0,14,0,0,0,9,0,0,9,23
26572,Uganda,2020,2020Uganda,5,0,0,0,0,0,5,0,0,0,0,0,0,0,5
26573,Uganda,2020,2020Uganda,6,8,0,15,0,0,29,0,5,8,55,11,0,79,108
26574,Uganda,2020,2020Uganda,10,0,5,73,9,0,97,5,12,5,102,7,0,131,228
26575,Uganda,2020,2020Uganda,30,71,38,191,5,0,335,24,58,44,353,23,0,502,837
26576,Uganda,2021,2021Uganda,0,0,0,0,0,0,0,0,0,0,0,0,0,0,4897
26577,Uganda,2021,2021Uganda,0,0,0,0,0,0,0,0,0,0,5,0,0,5,25
26578,Uganda,2021,2021Uganda,0,0,0,0,0,0,0,0,0,0,7,0,0,7,7
26579,Uganda,2021,2021Uganda,0,0,0,0,0,0,0,0,0,0,9,0,0,9,9
26580,Uganda,2021,2021Uganda,0,0,0,0,0,0,0,0,0,0,19,0,0,19,19
26581,Uganda,2021,2021Uganda,0,0,0,0,0,0,0,0,0,5,0,0,0,5,5
26582,Uganda,2021,2021Uganda,0,0,0,0,0,0,0,0,7,0,0,0,0,7,7
26583,Uganda,2021,2021Uganda,0,0,0,0,0,5,5,0,0,0,0,0,0,0,5
26584,Uganda,2021,2021Uganda,0,0,0,5,0,0,5,0,0,0,0,0,0,0,10
26585,Uganda,2021,2021Uganda,0,0,0,6,0,0,6,0,0,0,0,0,0,0,6
26586,Uganda,2021,2021Uganda,0,0,0,6,0,0,6,5,0,5,5,0,0,15,21
26587,Uganda,2021,2021Uganda,0,0,0,8,0,0,8,0,0,0,5,0,0,5,13
26588,Uganda,2021,2021Uganda,0,0,5,11,0,0,16,0,0,8,0,0,0,8,58
26589,Uganda,2021,2021Uganda,0,0,5,22,0,0,27,0,0,5,13,0,0,18,45
26590,Uganda,2021,2021Uganda,0,0,9,0,0,0,9,0,0,0,0,0,0,0,9
26591,Uganda,2021,2021Uganda,0,5,0,0,0,0,5,0,0,5,0,0,0,5,10
26592,Uganda,2021,2021Uganda,0,5,0,0,0,0,5,8,0,0,0,0,0,8,13
26593,Uganda,2021,2021Uganda,0,5,6,110,7,0,128,0,0,6,314,12,0,332,460
26594,Uganda,2021,2021Uganda,0,6,0,0,0,0,6,0,0,0,9,0,0,9,15
26595,Uganda,2021,2021Uganda,0,8,0,6,0,0,14,0,0,5,6,0,0,11,25
26596,Uganda,2021,2021Uganda,5,0,0,0,0,0,5,0,0,0,0,0,0,0,5
26597,Uganda,2021,2021Uganda,5,24,0,28,0,0,57,6,6,7,120,12,0,151,208
26598,Uganda,2021,2021Uganda,7,12,7,233,0,22,281,9,7,5,235,0,23,279,974
26599,Uganda,2021,2021Uganda,11,9,0,77,11,0,108,7,12,6,107,7,0,139,247
26600,Uganda,2021,2021Uganda,28,59,41,195,5,0,328,30,57,49,299,31,0,466,794
26601,Ukraine,2001,2001Ukraine,0,0,0,0,0,0,0,0,0,0,0,0,0,0,26087
26602,Ukraine,2001,2001Ukraine,0,0,0,0,0,0,0,0,6,0,0,0,0,6,6
26603,Ukraine,2001,2001Ukraine,0,0,0,0,0,10,10,0,0,0,0,0,0,0,10
26604,Ukraine,2001,2001Ukraine,0,0,0,0,0,82,82,0,0,0,0,0,106,106,188
26605,Ukraine,2001,2001Ukraine,0,0,0,0,0,202,202,0,0,0,0,0,205,205,407
26606,Ukraine,2001,2001Ukraine,0,0,0,0,9,0,9,0,0,0,5,0,0,5,14
26607,Ukraine,2002,2002Ukraine,0,0,0,0,0,0,0,0,0,0,0,0,0,0,84786
26608,Ukraine,2002,2002Ukraine,0,0,0,0,0,0,0,0,0,0,0,0,9,9,14
26609,Ukraine,2002,2002Ukraine,0,0,0,0,0,0,0,0,0,0,6,0,0,6,6
26610,Ukraine,2002,2002Ukraine,0,0,0,0,0,226,226,0,0,0,0,0,212,212,438
26611,Ukraine,2002,2002Ukraine,0,0,0,8,0,0,8,0,0,0,6,0,0,6,14
26612,Ukraine,2003,2003Ukraine,0,0,0,0,0,0,0,0,0,0,0,0,0,0,93606
26613,Ukraine,2003,2003Ukraine,0,0,0,0,0,8,8,0,0,0,0,0,8,8,16
26614,Ukraine,2003,2003Ukraine,0,0,0,0,0,273,273,0,0,0,0,0,246,246,519
26615,Ukraine,2004,2004Ukraine,0,0,0,0,0,0,0,0,0,0,0,0,0,0,89532
26616,Ukraine,2004,2004Ukraine,0,0,0,0,0,0,0,0,0,5,0,0,0,5,5
26617,Ukraine,2004,2004Ukraine,0,0,0,5,0,0,5,0,0,0,5,0,0,5,10
26618,Ukraine,2004,2004Ukraine,0,0,0,5,0,7,12,0,0,5,0,0,6,11,23
26619,Ukraine,2004,2004Ukraine,0,0,0,6,0,0,6,0,0,0,6,0,0,6,12
26620,Ukraine,2005,2005Ukraine,0,0,0,0,0,0,0,0,0,0,0,0,0,0,83514
26621,Ukraine,2005,2005Ukraine,0,0,0,0,0,6,6,0,0,0,0,0,6,6,12
26622,Ukraine,2005,2005Ukraine,0,0,0,0,0,343,343,0,0,0,0,0,300,300,643
26623,Ukraine,2005,2005Ukraine,0,0,0,5,0,0,5,0,0,0,6,0,0,6,11
26624,Ukraine,2005,2005Ukraine,0,0,0,6,0,0,6,0,0,0,6,0,0,6,12
26625,Ukraine,2005,2005Ukraine,0,0,6,7,0,6,19,0,0,0,5,0,7,12,31
26626,Ukraine,2006,2006Ukraine,0,0,0,0,0,0,0,0,0,0,0,0,0,0,62862
26627,Ukraine,2006,2006Ukraine,0,0,0,0,0,7,7,0,0,0,0,0,7,7,14
26628,Ukraine,2006,2006Ukraine,0,0,0,0,0,18,18,0,0,0,0,0,10,10,28
26629,Ukraine,2006,2006Ukraine,0,0,0,0,0,65,65,0,0,0,0,0,61,61,126
26630,Ukraine,2006,2006Ukraine,0,0,0,0,0,357,357,0,0,0,0,0,306,306,663
26631,Ukraine,2006,2006Ukraine,0,0,0,5,0,0,5,0,0,0,6,0,0,6,11
26632,Ukraine,2006,2006Ukraine,0,0,0,6,0,0,6,0,0,0,6,0,0,6,12
26633,Ukraine,2007,2007Ukraine,0,0,0,0,0,0,0,0,0,0,0,0,0,0,25136
26634,Ukraine,2007,2007Ukraine,0,0,0,0,0,57,57,0,0,0,0,0,52,52,109
26635,Ukraine,2007,2007Ukraine,0,0,0,0,0,363,363,0,0,0,0,0,310,310,673
26636,Ukraine,2007,2007Ukraine,0,0,0,5,0,0,5,0,0,0,6,0,0,6,11
26637,Ukraine,2007,2007Ukraine,0,0,0,6,0,0,6,0,0,0,6,0,0,6,12
26638,Ukraine,2007,2007Ukraine,0,0,0,8,0,0,8,0,0,0,10,0,0,10,18
26639,Ukraine,2007,2007Ukraine,0,0,5,0,0,6,11,0,5,0,0,0,5,10,21
26640,Ukraine,2008,2008Ukraine,0,0,0,0,0,0,0,0,0,0,0,0,0,0,27586
26641,Ukraine,2008,2008Ukraine,0,0,0,0,0,52,52,0,0,0,0,0,48,48,100
26642,Ukraine,2008,2008Ukraine,0,0,0,0,0,365,365,0,0,0,0,0,313,313,678
26643,Ukraine,2008,2008Ukraine,0,0,0,6,0,0,6,0,0,0,6,0,0,6,12
26644,Ukraine,2008,2008Ukraine,0,0,0,8,0,0,8,0,0,0,10,0,0,10,18
26645,Ukraine,2008,2008Ukraine,7,0,0,0,0,6,13,0,0,9,0,0,0,9,22
26646,Ukraine,2009,2009Ukraine,0,0,0,0,0,0,0,0,0,0,0,0,0,0,5955
26647,Ukraine,2009,2009Ukraine,0,0,0,0,0,47,47,0,0,0,0,0,42,42,89
26648,Ukraine,2009,2009Ukraine,0,0,0,6,0,0,6,0,0,0,6,0,0,6,12
26649,Ukraine,2009,2009Ukraine,0,0,0,8,0,0,8,0,0,0,10,0,0,10,18
26650,Ukraine,2009,2009Ukraine,5,0,0,5,0,5,15,0,6,0,5,0,0,11,26
26651,Ukraine,2009,2009Ukraine,64,394,882,5719,2235,0,9294,61,412,973,5805,1867,0,9118,18412
26652,Ukraine,2010,2010Ukraine,0,0,0,0,0,0,0,0,0,0,0,0,0,0,4847
26653,Ukraine,2010,2010Ukraine,0,0,0,0,0,45,45,0,0,0,0,0,41,41,86
26654,Ukraine,2010,2010Ukraine,0,0,0,0,0,385,385,0,0,0,0,0,327,327,712
26655,Ukraine,2010,2010Ukraine,0,0,0,6,0,0,6,0,0,0,6,0,0,6,12
26656,Ukraine,2010,2010Ukraine,0,0,0,8,0,0,8,0,0,0,10,0,0,10,18
26657,Ukraine,2010,2010Ukraine,5,0,0,8,0,5,18,0,6,0,5,0,0,11,29
26658,Ukraine,2010,2010Ukraine,57,360,833,6048,2525,0,9823,50,383,914,6166,2062,0,9575,19398
26659,Ukraine,2011,2011Ukraine,0,0,0,0,0,0,0,0,0,0,0,0,0,0,2788
26660,Ukraine,2011,2011Ukraine,0,0,0,0,0,44,44,0,0,0,0,0,40,40,84
26661,Ukraine,2011,2011Ukraine,0,0,0,0,0,387,387,0,0,0,0,0,329,329,716
26662,Ukraine,2011,2011Ukraine,0,0,0,6,0,0,6,0,0,0,6,0,0,6,12
26663,Ukraine,2011,2011Ukraine,0,0,0,7,0,0,7,0,0,0,11,0,0,11,18
26664,Ukraine,2011,2011Ukraine,0,0,0,8,0,0,8,0,0,0,10,0,0,10,18
26665,Ukraine,2011,2011Ukraine,0,0,5,7,0,5,17,0,9,0,0,0,0,9,26
26666,Ukraine,2011,2011Ukraine,0,0,5,89,22,0,116,0,5,0,72,5,0,82,1788
26667,Ukraine,2011,2011Ukraine,39,333,757,6233,2746,0,10108,48,338,807,6366,2255,0,9814,19922
26668,Ukraine,2012,2012Ukraine,0,0,0,0,0,0,0,0,0,0,0,0,0,0,2480
26669,Ukraine,2012,2012Ukraine,0,0,0,0,0,43,43,0,0,0,0,0,62,62,105
26670,Ukraine,2012,2012Ukraine,0,0,0,0,0,45,45,0,0,0,0,0,40,40,85
26671,Ukraine,2012,2012Ukraine,0,0,0,0,0,388,388,0,0,0,0,0,331,331,719
26672,Ukraine,2012,2012Ukraine,0,0,0,6,0,0,6,0,0,0,5,0,0,5,11
26673,Ukraine,2012,2012Ukraine,0,0,0,7,0,0,7,0,0,0,11,0,0,11,18
26674,Ukraine,2012,2012Ukraine,0,0,0,8,0,0,8,0,0,0,10,0,0,10,18
26675,Ukraine,2012,2012Ukraine,0,0,0,36,8,0,44,0,5,0,23,0,0,28,1737
26676,Ukraine,2012,2012Ukraine,0,0,5,6,0,0,11,0,5,0,0,0,0,5,16
26677,Ukraine,2012,2012Ukraine,37,273,682,6299,2903,0,10194,39,286,702,6435,2403,0,9865,20059
26678,Ukraine,2013,2013Ukraine,0,0,0,0,0,0,0,0,0,0,0,0,0,0,2342
26679,Ukraine,2013,2013Ukraine,0,0,0,0,0,18,18,0,0,0,0,0,15,15,33
26680,Ukraine,2013,2013Ukraine,0,0,0,0,0,397,397,0,0,0,0,0,335,335,732
26681,Ukraine,2013,2013Ukraine,0,0,0,5,0,0,5,0,0,0,0,0,0,0,5
26682,Ukraine,2013,2013Ukraine,0,0,0,6,0,0,6,0,0,0,5,0,0,5,11
26683,Ukraine,2013,2013Ukraine,0,0,0,8,0,0,8,0,0,0,10,0,0,10,18
26684,Ukraine,2013,2013Ukraine,0,0,0,8,0,0,8,0,5,0,11,0,0,16,24
26685,Ukraine,2013,2013Ukraine,0,0,0,9,0,0,9,0,5,0,5,0,0,10,19
26686,Ukraine,2013,2013Ukraine,0,0,5,43,5,0,53,0,0,6,45,0,0,51,104
26687,Ukraine,2013,2013Ukraine,0,5,5,41,0,0,51,0,6,5,30,0,0,41,1605
26688,Ukraine,2013,2013Ukraine,7,20,18,77,12,0,134,9,23,18,68,9,0,127,261
26689,Ukraine,2014,2014Ukraine,0,0,0,0,0,0,0,0,0,0,0,0,0,0,2860
26690,Ukraine,2014,2014Ukraine,0,0,0,0,0,0,0,0,0,0,0,0,5,5,5
26691,Ukraine,2014,2014Ukraine,0,0,0,0,0,0,0,0,0,5,0,0,0,5,5
26692,Ukraine,2014,2014Ukraine,0,0,0,0,0,8,8,0,0,0,0,0,0,0,8
26693,Ukraine,2014,2014Ukraine,0,0,0,0,0,397,397,0,0,0,0,0,340,340,737
26694,Ukraine,2014,2014Ukraine,0,0,0,0,0,162251,162251,0,0,0,0,0,69536,69536,231787
26695,Ukraine,2014,2014Ukraine,0,0,0,6,0,0,6,0,0,0,0,5,0,5,11
26696,Ukraine,2014,2014Ukraine,0,0,0,6,0,0,6,0,0,0,7,0,0,7,13
26697,Ukraine,2014,2014Ukraine,0,0,0,6,6,0,12,0,0,5,0,0,0,5,17
26698,Ukraine,2014,2014Ukraine,0,0,0,7,0,0,7,0,5,0,5,0,0,10,17
26699,Ukraine,2014,2014Ukraine,0,0,0,8,0,0,8,0,5,0,11,0,0,16,24
26700,Ukraine,2014,2014Ukraine,0,0,5,0,0,0,5,0,0,0,0,0,0,0,5
26701,Ukraine,2014,2014Ukraine,0,0,9,0,0,0,9,0,0,6,0,0,0,6,34
26702,Ukraine,2014,2014Ukraine,0,7,5,82,12,0,106,0,5,5,93,5,0,108,1468
26703,Ukraine,2014,2014Ukraine,0,31,16,86,17,0,150,5,23,11,85,10,0,134,284
26704,Ukraine,2014,2014Ukraine,5,5,0,17,0,0,27,0,6,0,10,0,0,16,43
26705,Ukraine,2014,2014Ukraine,9,29,23,81,15,0,157,13,26,21,73,9,0,142,299
26706,Ukraine,2015,2015Ukraine,0,0,0,0,0,0,0,0,0,0,0,0,0,0,318650
26707,Ukraine,2015,2015Ukraine,0,0,0,0,0,0,0,0,0,0,0,0,6,6,6
26708,Ukraine,2015,2015Ukraine,0,0,0,0,0,0,0,0,0,0,9,0,0,9,9
26709,Ukraine,2015,2015Ukraine,0,0,0,0,0,0,0,0,0,5,0,0,0,5,5
26710,Ukraine,2015,2015Ukraine,0,0,0,0,0,0,0,0,5,0,0,0,0,5,5
26711,Ukraine,2015,2015Ukraine,0,0,0,0,0,59,59,0,0,0,0,0,63,63,122
26712,Ukraine,2015,2015Ukraine,0,0,0,0,0,585,585,0,0,0,0,0,453,453,1038
26713,Ukraine,2015,2015Ukraine,0,0,0,5,0,0,5,0,0,0,0,0,0,0,10
26714,Ukraine,2015,2015Ukraine,0,0,0,5,0,0,5,0,0,0,5,0,0,5,10
26715,Ukraine,2015,2015Ukraine,0,0,0,6,0,0,6,0,0,0,0,5,0,5,11
26716,Ukraine,2015,2015Ukraine,0,0,0,6,0,0,6,0,0,0,10,0,0,10,16
26717,Ukraine,2015,2015Ukraine,0,0,0,7,0,0,7,0,0,0,8,0,0,8,15
26718,Ukraine,2015,2015Ukraine,0,0,0,12,5,0,17,0,0,5,22,0,0,27,44
26719,Ukraine,2015,2015Ukraine,0,0,0,42,6,0,48,0,0,5,50,0,0,55,103
26720,Ukraine,2015,2015Ukraine,0,0,5,12,0,0,17,6,0,0,14,0,0,20,37
26721,Ukraine,2015,2015Ukraine,0,0,9,16,7,0,32,6,0,8,13,0,0,27,59
26722,Ukraine,2015,2015Ukraine,0,5,5,20,0,0,30,0,10,0,20,0,0,30,60
26723,Ukraine,2015,2015Ukraine,0,9,0,37,21,0,67,0,0,6,22,7,0,35,102
26724,Ukraine,2015,2015Ukraine,8,31,20,110,16,0,185,12,22,17,74,10,0,135,320
26725,Ukraine,2015,2015Ukraine,10,10,0,40,0,0,60,5,10,9,25,0,0,49,109
26726,Ukraine,2015,2015Ukraine,27,32,19,137,20,0,235,15,27,12,82,11,0,147,668
26727,Ukraine,2016,2016Ukraine,0,0,0,0,0,0,0,0,0,0,0,0,0,0,233646
26728,Ukraine,2016,2016Ukraine,0,0,0,0,0,0,0,0,0,0,0,0,6,6,6
26729,Ukraine,2016,2016Ukraine,0,0,0,0,0,0,0,0,0,0,5,0,0,5,1184
26730,Ukraine,2016,2016Ukraine,0,0,0,0,0,0,0,0,0,5,0,0,0,5,10
26731,Ukraine,2016,2016Ukraine,0,0,0,0,0,6,6,0,0,0,0,0,8,8,14
26732,Ukraine,2016,2016Ukraine,0,0,0,0,0,82,82,0,0,0,0,0,84,84,166
26733,Ukraine,2016,2016Ukraine,0,0,0,0,0,769,769,0,0,0,0,0,613,613,1382
26734,Ukraine,2016,2016Ukraine,0,0,0,5,0,0,5,0,0,0,9,0,0,9,14
26735,Ukraine,2016,2016Ukraine,0,0,0,6,0,0,6,0,0,0,0,5,0,5,11
26736,Ukraine,2016,2016Ukraine,0,0,0,7,0,0,7,0,0,0,0,0,0,0,7
26737,Ukraine,2016,2016Ukraine,0,0,0,7,0,0,7,0,0,0,7,0,0,7,14
26738,Ukraine,2016,2016Ukraine,0,0,0,8,0,0,8,0,0,0,0,0,0,0,8
26739,Ukraine,2016,2016Ukraine,0,0,0,9,0,0,9,0,0,0,0,0,0,0,9
26740,Ukraine,2016,2016Ukraine,0,0,5,0,0,0,5,0,0,0,0,0,0,0,5
26741,Ukraine,2016,2016Ukraine,0,0,5,15,0,0,20,0,0,5,14,0,0,19,39
26742,Ukraine,2016,2016Ukraine,0,0,7,12,5,5,29,0,0,0,6,0,0,6,35
26743,Ukraine,2016,2016Ukraine,0,5,0,25,5,0,35,0,0,9,34,5,0,48,83
26744,Ukraine,2016,2016Ukraine,0,5,0,26,17,0,48,0,0,6,12,8,0,26,74
26745,Ukraine,2016,2016Ukraine,0,5,0,40,5,0,50,0,5,0,53,0,0,58,108
26746,Ukraine,2016,2016Ukraine,0,5,6,54,0,0,65,0,7,6,74,0,0,87,1077
26747,Ukraine,2016,2016Ukraine,8,27,17,137,31,0,220,9,18,20,74,14,0,135,355
26748,Ukraine,2016,2016Ukraine,10,12,0,42,0,0,64,5,10,9,25,0,0,49,113
26749,Ukraine,2016,2016Ukraine,25,41,18,161,22,0,267,17,30,16,88,13,0,164,702
26750,Ukraine,2017,2017Ukraine,0,0,0,0,0,0,0,0,0,0,0,0,0,0,134438
26751,Ukraine,2017,2017Ukraine,0,0,0,0,0,0,0,0,0,0,5,0,0,5,1699
26752,Ukraine,2017,2017Ukraine,0,0,0,0,0,0,0,0,0,5,0,0,0,5,10
26753,Ukraine,2017,2017Ukraine,0,0,0,0,0,7,7,0,0,0,0,0,10,10,17
26754,Ukraine,2017,2017Ukraine,0,0,0,0,0,895,895,0,0,0,0,0,710,710,1605
26755,Ukraine,2017,2017Ukraine,0,0,0,5,0,0,5,0,0,0,0,0,0,0,5
26756,Ukraine,2017,2017Ukraine,0,0,0,5,0,0,5,0,0,0,10,0,0,10,15
26757,Ukraine,2017,2017Ukraine,0,0,0,6,0,0,6,0,0,0,0,0,0,0,6
26758,Ukraine,2017,2017Ukraine,0,0,0,6,0,0,6,0,0,0,0,5,0,5,11
26759,Ukraine,2017,2017Ukraine,0,0,0,23,18,0,41,0,0,5,8,6,0,19,60
26760,Ukraine,2017,2017Ukraine,0,0,5,0,0,0,5,0,0,0,0,0,0,0,5
26761,Ukraine,2017,2017Ukraine,0,0,5,14,0,0,19,5,0,0,13,0,0,18,37
26762,Ukraine,2017,2017Ukraine,0,5,0,6,0,0,11,0,0,0,6,0,0,6,17
26763,Ukraine,2017,2017Ukraine,0,5,0,7,0,0,12,0,0,0,0,0,0,0,12
26764,Ukraine,2017,2017Ukraine,0,5,0,39,6,0,50,0,5,0,50,5,0,60,110
26765,Ukraine,2017,2017Ukraine,0,6,0,15,8,0,29,0,0,0,8,0,5,13,42
26766,Ukraine,2017,2017Ukraine,0,6,0,30,7,0,43,0,7,0,39,5,0,51,94
26767,Ukraine,2017,2017Ukraine,9,11,0,45,0,0,65,5,8,9,26,0,0,48,113
26768,Ukraine,2017,2017Ukraine,15,39,20,143,22,0,239,8,34,13,81,14,0,150,654
26769,Ukraine,2017,2017Ukraine,26,43,23,226,71,0,389,32,42,34,107,27,0,242,631
26770,Ukraine,2018,2018Ukraine,0,0,0,0,0,0,0,0,0,0,0,0,0,0,88334
26771,Ukraine,2018,2018Ukraine,0,0,0,0,0,950,950,0,0,0,0,0,765,765,1715
26772,Ukraine,2018,2018Ukraine,0,0,0,5,0,0,5,0,0,0,0,0,0,0,10
26773,Ukraine,2018,2018Ukraine,0,0,0,6,0,0,6,0,0,0,0,5,0,5,11
26774,Ukraine,2018,2018Ukraine,0,0,0,7,0,0,7,0,0,0,7,0,0,7,14
26775,Ukraine,2018,2018Ukraine,0,0,0,8,0,0,8,0,0,0,0,0,0,0,8
26776,Ukraine,2018,2018Ukraine,0,0,0,11,0,0,11,0,0,0,8,0,0,8,19
26777,Ukraine,2018,2018Ukraine,0,0,0,15,0,0,15,0,0,0,13,0,0,13,28
26778,Ukraine,2018,2018Ukraine,0,0,0,21,18,0,39,0,0,5,9,5,0,19,58
26779,Ukraine,2018,2018Ukraine,0,0,5,0,0,0,5,0,0,0,0,0,0,0,5
26780,Ukraine,2018,2018Ukraine,0,0,5,9,0,0,14,0,0,0,0,0,0,0,14
26781,Ukraine,2018,2018Ukraine,0,5,0,26,5,0,36,0,5,0,37,0,0,42,78
26782,Ukraine,2018,2018Ukraine,0,8,0,35,7,0,50,0,8,0,43,5,0,56,106
26783,Ukraine,2018,2018Ukraine,0,9,0,18,8,8,43,0,7,0,6,0,0,13,56
26784,Ukraine,2018,2018Ukraine,5,10,10,97,5,0,127,5,12,10,94,5,0,126,1319
26785,Ukraine,2018,2018Ukraine,9,11,0,45,0,0,65,5,8,9,28,0,0,50,115
26786,Ukraine,2018,2018Ukraine,20,65,32,225,39,0,381,10,50,22,131,23,0,236,617
26787,Ukraine,2018,2018Ukraine,28,46,34,249,98,0,455,35,55,28,126,42,0,286,741
26788,Ukraine,2019,2019Ukraine,0,0,0,0,0,0,0,0,0,0,0,0,0,0,56341
26789,Ukraine,2019,2019Ukraine,0,0,0,0,0,0,0,0,0,0,8,0,0,8,8
26790,Ukraine,2019,2019Ukraine,0,0,0,0,0,0,0,0,5,0,0,0,0,5,5
26791,Ukraine,2019,2019Ukraine,0,0,0,0,0,1019,1019,0,0,0,0,0,820,820,1839
26792,Ukraine,2019,2019Ukraine,0,0,0,5,0,0,5,0,0,0,0,0,0,0,5
26793,Ukraine,2019,2019Ukraine,0,0,0,6,0,0,6,0,0,0,0,5,0,5,11
26794,Ukraine,2019,2019Ukraine,0,0,0,8,5,0,13,5,0,0,5,0,0,10,23
26795,Ukraine,2019,2019Ukraine,0,0,0,13,0,0,13,0,0,0,9,0,0,9,22
26796,Ukraine,2019,2019Ukraine,0,0,0,20,15,0,35,0,0,5,8,5,0,18,53
26797,Ukraine,2019,2019Ukraine,0,0,5,0,0,0,5,0,0,0,0,0,0,0,5
26798,Ukraine,2019,2019Ukraine,0,5,0,25,5,0,35,0,5,0,41,0,0,46,81
26799,Ukraine,2019,2019Ukraine,0,9,0,38,7,0,54,0,8,0,50,5,0,63,117
26800,Ukraine,2019,2019Ukraine,0,46,21,117,19,0,203,0,27,17,48,11,0,103,306
26801,Ukraine,2019,2019Ukraine,5,6,0,22,8,0,41,0,6,0,8,0,0,14,65
26802,Ukraine,2019,2019Ukraine,10,11,0,44,0,0,65,5,9,9,28,0,0,51,116
26803,Ukraine,2019,2019Ukraine,33,56,39,267,116,0,511,40,63,38,145,50,0,336,847
26804,Ukraine,2020,2020Ukraine,0,0,0,0,0,0,0,0,0,0,0,0,0,0,31755
26805,Ukraine,2020,2020Ukraine,0,0,0,0,0,0,0,0,0,0,0,0,5,5,5
26806,Ukraine,2020,2020Ukraine,0,0,0,0,0,0,0,0,0,0,8,0,0,8,8
26807,Ukraine,2020,2020Ukraine,0,0,0,0,0,0,0,0,0,5,0,0,0,5,5
26808,Ukraine,2020,2020Ukraine,0,0,0,0,0,0,0,0,5,0,0,0,0,5,5
26809,Ukraine,2020,2020Ukraine,0,0,0,0,0,7,7,0,0,0,0,0,7,7,14
26810,Ukraine,2020,2020Ukraine,0,0,0,0,0,9,9,0,0,0,0,0,5,5,14
26811,Ukraine,2020,2020Ukraine,0,0,0,0,0,30,30,0,0,0,20,0,22,42,1205
26812,Ukraine,2020,2020Ukraine,0,0,0,0,0,129,129,0,0,0,0,0,125,125,254
26813,Ukraine,2020,2020Ukraine,0,0,0,0,6,0,6,0,0,0,0,5,0,5,11
26814,Ukraine,2020,2020Ukraine,0,0,0,5,0,0,5,0,0,0,0,0,0,0,5
26815,Ukraine,2020,2020Ukraine,0,0,0,6,0,0,6,0,0,0,9,0,0,9,15
26816,Ukraine,2020,2020Ukraine,0,0,0,10,0,0,10,0,5,0,6,0,0,11,21
26817,Ukraine,2020,2020Ukraine,0,0,0,12,0,0,12,0,0,0,8,0,0,8,20
26818,Ukraine,2020,2020Ukraine,0,0,0,13,12,0,25,0,0,0,8,0,0,8,33
26819,Ukraine,2020,2020Ukraine,0,0,8,39,7,0,54,0,7,0,51,6,0,64,118
26820,Ukraine,2020,2020Ukraine,0,6,0,28,5,0,39,0,6,0,40,0,0,46,85
26821,Ukraine,2020,2020Ukraine,0,50,34,171,38,0,293,5,33,21,110,31,0,200,493
26822,Ukraine,2020,2020Ukraine,5,5,5,26,8,0,49,0,8,0,7,5,0,20,80
26823,Ukraine,2020,2020Ukraine,10,11,0,43,0,0,64,5,9,9,28,0,0,51,115
26824,Ukraine,2020,2020Ukraine,26,61,47,282,125,0,541,33,78,36,156,51,0,354,895
26825,Ukraine,2021,2021Ukraine,0,0,0,0,0,0,0,0,0,0,0,0,0,0,21808
26826,Ukraine,2021,2021Ukraine,0,0,0,0,0,0,0,0,0,0,5,0,0,5,5
26827,Ukraine,2021,2021Ukraine,0,0,0,0,0,0,0,0,0,0,8,0,0,8,8
26828,Ukraine,2021,2021Ukraine,0,0,0,0,6,0,6,0,0,0,0,5,0,5,11
26829,Ukraine,2021,2021Ukraine,0,0,0,5,0,0,5,0,0,0,0,0,0,0,5
26830,Ukraine,2021,2021Ukraine,0,0,0,5,0,115,120,0,0,0,0,0,105,105,225
26831,Ukraine,2021,2021Ukraine,0,0,0,6,0,0,6,0,0,0,9,0,0,9,15
26832,Ukraine,2021,2021Ukraine,0,0,0,6,7,0,13,0,0,0,0,5,0,5,18
26833,Ukraine,2021,2021Ukraine,0,0,0,10,0,0,10,0,0,0,7,0,0,7,17
26834,Ukraine,2021,2021Ukraine,0,0,0,10,0,0,10,0,0,0,8,0,0,8,18
26835,Ukraine,2021,2021Ukraine,0,0,5,6,0,0,11,0,0,0,8,0,0,8,19
26836,Ukraine,2021,2021Ukraine,0,0,8,40,8,0,56,0,6,0,53,6,0,65,121
26837,Ukraine,2021,2021Ukraine,0,5,0,25,5,0,35,0,7,0,37,0,0,44,79
26838,Ukraine,2021,2021Ukraine,0,5,0,36,5,29,75,0,5,5,84,0,22,116,1228
26839,Ukraine,2021,2021Ukraine,5,5,5,31,9,0,55,0,5,8,7,5,0,25,91
26840,Ukraine,2021,2021Ukraine,5,41,32,169,40,0,287,5,28,22,104,35,0,194,481
26841,Ukraine,2021,2021Ukraine,10,12,0,43,0,0,65,5,9,9,29,0,0,52,117
26842,Ukraine,2021,2021Ukraine,17,69,50,281,135,0,552,22,84,53,154,53,0,366,918
26843,Ukraine,2021,2021Ukraine,73,190,98,760,121,0,1242,103,234,105,635,59,0,1136,2378
26844,Unknown ,2001,2001Unknown ,0,0,0,0,0,0,0,0,0,0,0,0,0,0,1060483
26845,Unknown ,2001,2001Unknown ,0,0,0,0,0,0,0,0,0,0,0,0,23,23,23
26846,Unknown ,2001,2001Unknown ,0,0,0,0,0,0,0,0,0,0,0,5,0,5,5
26847,Unknown ,2001,2001Unknown ,0,0,0,0,0,0,0,0,0,0,5,0,0,5,5
26848,Unknown ,2001,2001Unknown ,0,0,0,0,0,0,0,0,0,0,8,0,0,8,8
26849,Unknown ,2001,2001Unknown ,0,0,0,0,0,71,71,0,0,0,0,0,95,95,1272
26850,Unknown ,2001,2001Unknown ,0,0,0,0,0,471,471,0,0,0,0,0,668,668,1139
26851,Unknown ,2001,2001Unknown ,0,0,0,0,0,1219,1219,0,0,0,0,0,1148,1148,32367
26852,Unknown ,2001,2001Unknown ,0,0,0,6,0,0,6,0,0,0,0,0,0,0,6
26853,Unknown ,2001,2001Unknown ,0,0,0,6,0,0,6,0,5,6,19,0,0,30,36
26854,Unknown ,2001,2001Unknown ,0,0,0,8,0,645,653,0,0,0,0,0,829,829,1482
26855,Unknown ,2001,2001Unknown ,0,0,8,8,0,0,16,0,0,9,34,0,0,43,59
26856,Unknown ,2001,2001Unknown ,0,9,0,18,0,0,27,0,5,0,33,0,0,38,65
26857,Unknown ,2001,2001Unknown ,0,31,32,144,0,0,207,0,41,41,511,0,0,593,800
26858,Unknown ,2001,2001Unknown ,7,0,0,6,9,0,22,5,0,0,8,8,0,21,43
26859,Unknown ,2001,2001Unknown ,204,142,121,358,15,0,840,201,146,126,396,12,0,881,1745
26860,Unknown ,2002,2002Unknown ,0,0,0,0,0,0,0,0,0,0,0,0,0,0,155679
26861,Unknown ,2002,2002Unknown ,0,0,0,0,0,0,0,0,0,0,5,0,0,5,5
26862,Unknown ,2002,2002Unknown ,0,0,0,0,0,0,0,0,0,6,0,0,0,6,6
26863,Unknown ,2002,2002Unknown ,0,0,0,0,0,23,23,0,0,0,0,0,38,38,61
26864,Unknown ,2002,2002Unknown ,0,0,0,0,0,24,24,0,0,0,0,0,51,51,1347
26865,Unknown ,2002,2002Unknown ,0,0,0,0,0,25,25,0,0,0,0,0,63,63,88
26866,Unknown ,2002,2002Unknown ,0,0,0,0,0,275,275,0,0,0,0,0,569,569,30000
26867,Unknown ,2002,2002Unknown ,0,0,0,0,0,1320,1320,0,0,0,0,0,1749,1749,3069
26868,Unknown ,2002,2002Unknown ,0,0,0,0,0,38548,38548,0,0,0,0,0,56396,56396,94944
26869,Unknown ,2002,2002Unknown ,0,0,0,5,0,0,5,0,0,0,0,0,0,0,10
26870,Unknown ,2002,2002Unknown ,0,0,0,5,0,0,5,0,0,7,12,0,0,19,24
26871,Unknown ,2002,2002Unknown ,0,0,0,6,0,0,6,0,0,0,0,0,0,0,6
26872,Unknown ,2002,2002Unknown ,0,0,0,6,0,150,156,0,0,0,0,0,183,183,339
26873,Unknown ,2002,2002Unknown ,0,0,0,12,0,0,12,0,5,0,32,0,0,37,54
26874,Unknown ,2002,2002Unknown ,0,0,5,11,0,0,16,0,6,0,40,0,0,46,62
26875,Unknown ,2002,2002Unknown ,0,0,6,8,7,0,21,0,5,0,12,8,0,25,46
26876,Unknown ,2002,2002Unknown ,0,9,0,18,0,0,27,0,5,0,33,0,0,38,65
26877,Unknown ,2002,2002Unknown ,18,24,21,78,0,0,141,22,30,26,132,0,0,210,351
26878,Unknown ,2002,2002Unknown ,145,151,124,341,52,9,822,135,145,124,311,50,0,765,1613
26879,Unknown ,2002,2002Unknown ,235,164,140,421,20,0,980,235,171,146,459,10,0,1021,2001
26880,Unknown ,2003,2003Unknown ,0,0,0,0,0,0,0,0,0,0,0,0,0,0,315588
26881,Unknown ,2003,2003Unknown ,0,0,0,0,0,0,0,0,0,0,86,0,0,86,86
26882,Unknown ,2003,2003Unknown ,0,0,0,0,0,20,20,0,0,0,0,0,48,48,1130
26883,Unknown ,2003,2003Unknown ,0,0,0,0,0,25,25,0,0,0,0,0,63,63,88
26884,Unknown ,2003,2003Unknown ,0,0,0,0,21,0,21,0,0,0,0,22,0,22,43
26885,Unknown ,2003,2003Unknown ,0,0,0,5,0,0,5,0,0,0,0,0,0,0,5
26886,Unknown ,2003,2003Unknown ,0,0,0,6,0,0,6,0,0,0,0,0,0,0,6
26887,Unknown ,2003,2003Unknown ,0,0,0,7,0,0,7,0,0,9,8,0,0,17,24
26888,Unknown ,2003,2003Unknown ,0,0,5,12,0,0,17,0,6,0,40,0,0,46,63
26889,Unknown ,2003,2003Unknown ,0,6,0,6,0,0,12,0,5,0,5,0,0,10,22
26890,Unknown ,2003,2003Unknown ,0,9,0,18,0,0,27,0,6,0,33,0,0,39,66
26891,Unknown ,2003,2003Unknown ,0,9,8,65,0,0,82,0,9,8,82,0,0,99,181
26892,Unknown ,2003,2003Unknown ,6,0,0,27,7,0,40,0,6,6,90,27,0,129,178
26893,Unknown ,2003,2003Unknown ,21,41,36,120,5,0,223,32,43,35,189,10,0,309,585
26894,Unknown ,2003,2003Unknown ,340,167,144,430,21,0,1102,140,174,150,470,11,0,945,2047
26895,Unknown ,2004,2004Unknown ,0,0,0,0,0,0,0,0,0,0,0,0,0,0,196712
26896,Unknown ,2004,2004Unknown ,0,0,0,0,0,0,0,0,0,0,0,0,72,72,72
26897,Unknown ,2004,2004Unknown ,0,0,0,0,0,0,0,0,0,0,7,0,0,7,7
26898,Unknown ,2004,2004Unknown ,0,0,0,0,0,0,0,0,0,0,86,0,0,86,86
26899,Unknown ,2004,2004Unknown ,0,0,0,0,0,27,27,0,0,0,0,0,66,66,93
26900,Unknown ,2004,2004Unknown ,0,0,0,0,0,511,511,0,0,0,0,0,759,759,1270
26901,Unknown ,2004,2004Unknown ,0,0,0,0,0,12638,12638,0,0,0,0,0,17452,17452,30090
26902,Unknown ,2004,2004Unknown ,0,0,0,0,0,49110,49110,0,0,0,0,0,61747,61747,110857
26903,Unknown ,2004,2004Unknown ,0,0,0,0,21,0,21,0,0,0,0,22,0,22,43
26904,Unknown ,2004,2004Unknown ,0,0,0,6,0,0,6,0,0,0,0,0,0,0,6
26905,Unknown ,2004,2004Unknown ,0,0,5,5,0,0,10,0,0,9,0,0,0,9,1853
26906,Unknown ,2004,2004Unknown ,0,0,5,35,0,0,40,0,0,0,19,0,0,19,59
26907,Unknown ,2004,2004Unknown ,0,5,0,0,0,0,5,0,0,0,0,0,0,0,5
26908,Unknown ,2004,2004Unknown ,0,6,0,0,0,0,6,0,7,0,0,0,0,7,13
26909,Unknown ,2004,2004Unknown ,0,7,6,9,0,0,22,0,0,8,37,0,0,45,67
26910,Unknown ,2004,2004Unknown ,0,9,0,18,0,0,27,0,6,0,33,0,0,39,66
26911,Unknown ,2004,2004Unknown ,5,14,12,61,6,0,98,0,7,0,93,5,0,105,203
26912,Unknown ,2004,2004Unknown ,6,0,0,32,7,0,45,0,6,13,90,27,0,136,181
26913,Unknown ,2004,2004Unknown ,15,24,21,115,5,4625,4805,13,38,39,160,15,4442,4707,9512
26914,Unknown ,2005,2005Unknown ,0,0,0,0,0,0,0,0,0,0,0,0,0,0,154137
26915,Unknown ,2005,2005Unknown ,0,0,0,0,0,0,0,0,0,0,6,0,0,6,6
26916,Unknown ,2005,2005Unknown ,0,0,0,0,0,0,0,0,0,0,86,0,0,86,86
26917,Unknown ,2005,2005Unknown ,0,0,0,0,0,32,32,0,0,0,0,0,59,59,19172
26918,Unknown ,2005,2005Unknown ,0,0,0,0,0,34,34,0,0,0,0,0,87,87,121
26919,Unknown ,2005,2005Unknown ,0,0,0,0,0,567,567,0,0,0,0,0,703,703,1270
26920,Unknown ,2005,2005Unknown ,0,0,0,5,0,0,5,0,0,0,5,0,0,5,10
26921,Unknown ,2005,2005Unknown ,0,0,0,6,0,0,6,0,0,0,10,0,0,10,66
26922,Unknown ,2005,2005Unknown ,0,5,0,0,0,0,5,0,0,0,0,0,0,0,5
26923,Unknown ,2005,2005Unknown ,0,6,0,0,0,0,6,0,7,0,0,0,0,7,13
26924,Unknown ,2005,2005Unknown ,0,7,0,22,0,0,29,0,8,8,25,0,0,41,70
26925,Unknown ,2005,2005Unknown ,0,9,0,18,0,0,27,0,6,0,33,0,0,39,66
26926,Unknown ,2005,2005Unknown ,5,0,0,5,0,0,10,5,0,0,9,0,0,14,24
26927,Unknown ,2005,2005Unknown ,7,0,0,33,7,0,47,0,6,11,92,27,0,136,183
26928,Unknown ,2005,2005Unknown ,15,33,21,133,5,0,207,17,48,36,182,15,0,298,9556
26929,Unknown ,2005,2005Unknown ,224,220,188,449,16,0,1097,275,227,195,623,10,0,1330,2427
26930,Unknown ,2006,2006Unknown ,0,0,0,0,0,0,0,0,0,0,0,0,0,0,209590
26931,Unknown ,2006,2006Unknown ,0,0,0,0,0,0,0,0,0,0,0,0,110,110,22610
26932,Unknown ,2006,2006Unknown ,0,0,0,0,0,0,0,0,0,0,5,0,0,5,5
26933,Unknown ,2006,2006Unknown ,0,0,0,0,0,0,0,0,0,0,13,0,0,13,13
26934,Unknown ,2006,2006Unknown ,0,0,0,0,0,0,0,0,0,0,86,0,0,86,86
26935,Unknown ,2006,2006Unknown ,0,0,0,0,0,9,9,0,0,0,0,0,0,0,9
26936,Unknown ,2006,2006Unknown ,0,0,0,0,0,35,35,0,0,0,0,0,44,44,79
26937,Unknown ,2006,2006Unknown ,0,0,0,0,0,41,41,0,0,0,0,0,94,94,135
26938,Unknown ,2006,2006Unknown ,0,0,0,0,0,75,75,0,0,0,0,0,97,97,172
26939,Unknown ,2006,2006Unknown ,0,0,0,0,0,95,95,0,0,0,0,0,143,143,243
26940,Unknown ,2006,2006Unknown ,0,0,0,0,0,716,716,0,0,0,0,0,994,994,1710
26941,Unknown ,2006,2006Unknown ,0,0,5,0,0,0,5,0,0,0,0,0,0,0,5
26942,Unknown ,2006,2006Unknown ,0,0,6,0,0,0,6,5,5,0,0,0,0,10,16
26943,Unknown ,2006,2006Unknown ,0,0,9,18,0,0,27,0,5,0,33,0,0,38,65
26944,Unknown ,2006,2006Unknown ,0,0,10,24,0,0,34,0,0,17,24,0,0,41,75
26945,Unknown ,2006,2006Unknown ,12,16,47,133,5,0,213,13,23,70,153,15,0,274,9542
26946,Unknown ,2006,2006Unknown ,176,198,213,801,11,0,1399,132,201,231,624,9,0,1197,2596
26947,Unknown ,2007,2007Unknown ,0,0,0,0,0,0,0,0,0,0,0,0,0,0,158402
26948,Unknown ,2007,2007Unknown ,0,0,0,0,0,0,0,0,0,0,86,0,0,86,86
26949,Unknown ,2007,2007Unknown ,0,0,0,0,0,47,47,0,0,0,0,0,82,82,129
26950,Unknown ,2007,2007Unknown ,0,0,0,0,0,51,51,0,0,0,0,0,74,74,21936
26951,Unknown ,2007,2007Unknown ,0,0,0,0,0,1533,1533,0,0,0,0,0,1872,1872,3405
26952,Unknown ,2007,2007Unknown ,0,0,0,0,5,0,5,0,0,0,5,15,0,20,25
26953,Unknown ,2007,2007Unknown ,0,0,5,0,0,0,5,0,0,0,0,0,0,0,5
26954,Unknown ,2007,2007Unknown ,0,0,5,0,0,0,5,0,0,5,13,0,0,18,23
26955,Unknown ,2007,2007Unknown ,0,0,6,0,0,0,6,0,9,0,0,0,0,9,15
26956,Unknown ,2007,2007Unknown ,0,0,9,18,0,0,27,0,5,0,33,0,0,38,65
26957,Unknown ,2007,2007Unknown ,0,0,13,29,0,0,42,0,5,17,29,0,0,51,93
26958,Unknown ,2007,2007Unknown ,11,9,6,24,0,11,61,13,6,8,28,0,15,70,131
26959,Unknown ,2007,2007Unknown ,15,10,25,28,5,0,83,19,20,23,50,0,0,112,195
26960,Unknown ,2007,2007Unknown ,29,43,56,119,5,0,252,39,39,73,109,6,0,266,9553
26961,Unknown ,2008,2008Unknown ,0,0,0,0,0,0,0,0,0,0,0,0,0,0,132660
26962,Unknown ,2008,2008Unknown ,0,0,0,0,0,43,43,0,0,0,0,0,71,71,114
26963,Unknown ,2008,2008Unknown ,0,0,0,0,0,76,76,0,0,0,0,0,98,98,33174
26964,Unknown ,2008,2008Unknown ,0,0,0,0,0,195,195,0,0,0,0,0,377,377,572
26965,Unknown ,2008,2008Unknown ,0,0,0,0,0,1899,1899,0,0,0,0,0,2375,2375,4274
26966,Unknown ,2008,2008Unknown ,0,0,0,0,0,6263,6263,0,0,0,0,0,6849,6849,13112
26967,Unknown ,2008,2008Unknown ,0,0,0,0,5,0,5,0,0,0,5,13,0,18,68
26968,Unknown ,2008,2008Unknown ,0,0,0,545,0,0,545,0,0,0,556,0,0,556,1101
26969,Unknown ,2008,2008Unknown ,0,0,5,0,0,0,5,7,5,0,0,0,0,12,17
26970,Unknown ,2008,2008Unknown ,0,9,0,0,0,0,9,0,5,0,13,0,0,18,5286
26971,Unknown ,2008,2008Unknown ,5,5,0,6,0,0,16,0,0,7,25,0,0,32,71
26972,Unknown ,2008,2008Unknown ,44,11,9,55,0,0,119,38,12,14,56,0,0,120,239
26973,Unknown ,2009,2009Unknown ,0,0,0,0,0,0,0,0,0,0,0,0,0,0,161820
26974,Unknown ,2009,2009Unknown ,0,0,0,0,0,38,38,0,0,0,0,0,84,84,122
26975,Unknown ,2009,2009Unknown ,0,0,0,0,0,71,71,0,0,5,0,0,483,488,609
26976,Unknown ,2009,2009Unknown ,0,0,0,0,0,535,535,0,0,0,7,0,533,540,1075
26977,Unknown ,2009,2009Unknown ,0,0,0,0,0,1144,1144,0,0,0,0,0,1537,1537,2681
26978,Unknown ,2009,2009Unknown ,0,0,0,0,5,0,5,0,0,0,5,9,0,14,19
26979,Unknown ,2009,2009Unknown ,0,0,6,0,0,0,6,6,0,5,0,0,0,11,17
26980,Unknown ,2009,2009Unknown ,0,9,0,0,0,0,9,0,5,0,13,0,0,18,5286
26981,Unknown ,2009,2009Unknown ,12,0,5,8,0,0,25,5,11,5,12,0,0,33,58
26982,Unknown ,2009,2009Unknown ,13,12,17,51,0,0,93,7,21,10,55,0,0,93,186
26983,Unknown ,2009,2009Unknown ,45,26,16,73,5,0,165,55,27,17,91,5,0,195,360
26984,Unknown ,2009,2009Unknown ,367,916,821,3693,407,0,6204,357,918,888,5579,501,0,8243,14447
26985,Unknown ,2010,2010Unknown ,0,0,0,0,0,0,0,0,0,0,0,0,0,0,104568
26986,Unknown ,2010,2010Unknown ,0,0,0,0,0,39,39,0,0,0,162,0,408,570,609
26987,Unknown ,2010,2010Unknown ,0,0,0,0,0,59,59,0,0,0,7,0,58,65,124
26988,Unknown ,2010,2010Unknown ,0,0,0,0,0,74,74,0,0,0,0,0,132,132,206
26989,Unknown ,2010,2010Unknown ,0,0,0,0,0,85,85,0,0,0,0,0,117,117,42230
26990,Unknown ,2010,2010Unknown ,0,0,0,0,0,1978,1978,0,0,0,0,0,2500,2500,4478
26991,Unknown ,2010,2010Unknown ,0,0,0,0,5,0,5,0,0,0,5,9,0,14,19
26992,Unknown ,2010,2010Unknown ,0,0,6,0,0,0,6,8,0,0,5,0,0,13,19
26993,Unknown ,2010,2010Unknown ,39,28,12,71,5,39,194,55,25,13,87,0,56,236,430
26994,Unknown ,2010,2010Unknown ,342,882,843,3765,465,0,6297,315,902,830,5556,532,0,8135,14432
26995,Unknown ,2011,2011Unknown ,0,0,0,0,0,0,0,0,0,0,0,0,0,0,81199
26996,Unknown ,2011,2011Unknown ,0,0,0,0,0,59,59,0,0,0,0,0,59,59,118
26997,Unknown ,2011,2011Unknown ,0,0,0,0,0,76,76,0,0,0,0,0,159,159,42659
26998,Unknown ,2011,2011Unknown ,0,0,0,0,0,82,82,0,0,0,0,0,148,148,230
26999,Unknown ,2011,2011Unknown ,0,0,0,0,0,3137,3137,0,0,0,0,0,3923,3923,7060
27000,Unknown ,2011,2011Unknown ,0,0,0,5,0,0,5,0,0,0,5,9,0,14,19
27001,Unknown ,2011,2011Unknown ,0,5,0,0,0,0,5,0,0,0,0,0,0,0,105
27002,Unknown ,2011,2011Unknown ,34,28,28,35,9,0,134,26,31,41,19,0,0,117,251
27003,Unknown ,2011,2011Unknown ,43,23,13,73,6,47,205,43,27,13,102,0,80,265,470
27004,Unknown ,2011,2011Unknown ,249,689,686,3442,491,0,5557,230,666,664,5268,549,0,7377,12934
27005,Unknown ,2012,2012Unknown ,0,0,0,0,0,0,0,0,0,0,0,0,0,0,70703
27006,Unknown ,2012,2012Unknown ,0,0,0,0,0,0,0,0,0,0,0,0,8,8,208
27007,Unknown ,2012,2012Unknown ,0,0,0,0,0,58,58,0,0,0,0,0,58,58,116
27008,Unknown ,2012,2012Unknown ,0,0,0,0,0,87,87,0,0,0,0,0,111,111,42289
27009,Unknown ,2012,2012Unknown ,0,0,0,0,0,2343,2343,0,0,0,0,0,2983,2983,5326
27010,Unknown ,2012,2012Unknown ,0,0,0,5,0,0,5,0,0,0,5,9,0,14,19
27011,Unknown ,2012,2012Unknown ,0,6,0,0,0,0,6,0,0,0,0,0,0,0,87
27012,Unknown ,2012,2012Unknown ,32,16,12,59,5,79,203,26,20,8,80,5,132,271,474
27013,Unknown ,2012,2012Unknown ,36,30,19,39,6,0,130,21,19,26,41,6,0,113,243
27014,Unknown ,2012,2012Unknown ,260,672,690,3549,526,0,5697,277,672,704,5412,576,0,7641,13338
27015,Unknown ,2013,2013Unknown ,0,0,0,0,0,0,0,0,0,0,0,0,0,0,50115
27016,Unknown ,2013,2013Unknown ,0,0,0,0,0,0,0,0,0,0,7,0,0,7,7
27017,Unknown ,2013,2013Unknown ,0,0,0,0,0,58,58,0,0,0,0,0,58,58,116
27018,Unknown ,2013,2013Unknown ,0,0,0,0,0,65,65,0,0,0,0,0,159,159,224
27019,Unknown ,2013,2013Unknown ,0,0,0,0,0,80,80,0,0,0,0,0,96,96,47676
27020,Unknown ,2013,2013Unknown ,0,0,0,0,0,90,90,0,0,0,0,0,201,201,2435
27021,Unknown ,2013,2013Unknown ,0,0,0,0,0,167,167,0,0,0,0,0,448,448,615
27022,Unknown ,2013,2013Unknown ,0,0,0,5,0,0,5,0,0,0,5,6,0,11,16
27023,Unknown ,2013,2013Unknown ,0,0,0,7,154,0,161,0,0,0,17,372,0,389,550
27024,Unknown ,2013,2013Unknown ,0,0,0,8,0,0,8,0,0,0,12,0,0,12,20
27025,Unknown ,2013,2013Unknown ,0,9,0,0,0,0,9,0,0,0,8,0,0,8,70
27026,Unknown ,2013,2013Unknown ,27,24,19,31,6,0,107,23,21,13,34,13,0,104,211
27027,Unknown ,2013,2013Unknown ,33,41,17,81,5,69,246,30,45,22,158,6,118,379,625
27028,Unknown ,2013,2013Unknown ,100,229,209,1167,232,0,1937,133,249,225,1647,332,0,2586,4523
27029,Unknown ,2014,2014Unknown ,0,0,0,0,0,0,0,0,0,0,0,0,0,0,93586
27030,Unknown ,2014,2014Unknown ,0,0,0,0,0,0,0,0,0,0,7,0,0,7,7
27031,Unknown ,2014,2014Unknown ,0,0,0,0,0,6,6,0,0,0,0,0,0,0,6
27032,Unknown ,2014,2014Unknown ,0,0,0,0,0,10,10,0,0,0,0,0,10,10,20
27033,Unknown ,2014,2014Unknown ,0,0,0,0,0,27,27,0,0,0,0,0,37,37,64
27034,Unknown ,2014,2014Unknown ,0,0,0,0,0,37,37,0,0,0,0,0,39,39,441
27035,Unknown ,2014,2014Unknown ,0,0,0,0,0,40,40,0,0,0,0,0,125,125,165
27036,Unknown ,2014,2014Unknown ,0,0,0,0,0,58,58,0,0,0,0,0,58,58,116
27037,Unknown ,2014,2014Unknown ,0,0,0,0,0,63,63,0,0,0,0,0,498,498,615
27038,Unknown ,2014,2014Unknown ,0,0,0,0,0,71,71,0,0,0,0,0,158,158,249
27039,Unknown ,2014,2014Unknown ,0,0,0,7,154,0,161,0,0,0,17,372,0,389,550
27040,Unknown ,2014,2014Unknown ,0,0,0,8,0,0,8,0,0,0,8,0,0,8,16
27041,Unknown ,2014,2014Unknown ,0,5,0,0,0,0,5,0,0,0,0,0,0,0,59
27042,Unknown ,2014,2014Unknown ,5,0,0,0,0,0,5,0,0,0,0,0,0,0,5
27043,Unknown ,2014,2014Unknown ,11,17,5,33,5,0,71,7,17,16,37,0,0,77,148
27044,Unknown ,2014,2014Unknown ,48,47,24,123,9,0,251,43,51,22,188,10,0,314,565
27045,Unknown ,2014,2014Unknown ,172,315,252,1040,103,0,1882,202,391,258,1675,118,0,2644,4526
27046,Unknown ,2015,2015Unknown ,0,0,0,0,0,0,0,0,0,0,0,0,0,0,24146
27047,Unknown ,2015,2015Unknown ,0,0,0,0,0,0,0,0,0,0,0,0,7,7,7
27048,Unknown ,2015,2015Unknown ,0,0,0,0,0,0,0,0,0,0,0,0,12,12,12
27049,Unknown ,2015,2015Unknown ,0,0,0,0,0,12,12,0,0,0,0,0,12,12,24
27050,Unknown ,2015,2015Unknown ,0,0,0,0,0,26,26,0,0,0,0,0,25,25,51
27051,Unknown ,2015,2015Unknown ,0,0,0,0,0,43,43,0,0,0,0,0,43,43,86
27052,Unknown ,2015,2015Unknown ,0,0,0,0,0,46,46,0,0,0,0,0,63,63,109
27053,Unknown ,2015,2015Unknown ,0,0,0,0,0,72,72,0,0,0,0,0,91,91,68443
27054,Unknown ,2015,2015Unknown ,0,0,0,0,0,93,93,0,0,0,0,0,92,92,185
27055,Unknown ,2015,2015Unknown ,0,0,0,0,0,186,186,0,0,0,0,0,429,429,615
27056,Unknown ,2015,2015Unknown ,0,0,0,0,0,226,226,0,0,0,0,0,986,986,1212
27057,Unknown ,2015,2015Unknown ,0,0,0,0,0,1306,1306,0,0,0,0,0,1306,1306,2612
27058,Unknown ,2015,2015Unknown ,0,0,0,0,0,1452,1452,0,0,0,0,0,1451,1451,2903
27059,Unknown ,2015,2015Unknown ,0,0,0,0,0,3625,3625,0,0,0,0,0,4720,4720,8345
27060,Unknown ,2015,2015Unknown ,0,0,0,9,146,0,155,0,0,0,17,360,0,377,532
27061,Unknown ,2015,2015Unknown ,0,0,5,212,0,0,217,0,0,5,219,0,0,224,441
27062,Unknown ,2015,2015Unknown ,6,14,11,37,5,0,73,14,7,11,32,0,0,64,137
27063,Unknown ,2015,2015Unknown ,39,51,19,168,14,0,291,35,49,30,229,16,0,359,1173
27064,Unknown ,2015,2015Unknown ,253,518,374,1788,157,0,3090,318,653,541,4294,193,0,5999,9089
27065,Unknown ,2016,2016Unknown ,0,0,0,0,0,0,0,0,0,0,0,0,0,0,105509
27066,Unknown ,2016,2016Unknown ,0,0,0,0,0,0,0,0,0,0,8,0,0,8,8
27067,Unknown ,2016,2016Unknown ,0,0,0,0,0,0,0,5,0,0,0,0,0,5,5
27068,Unknown ,2016,2016Unknown ,0,0,0,0,0,202,202,0,0,0,0,0,413,413,615
27069,Unknown ,2016,2016Unknown ,0,0,0,0,0,3095,3095,0,0,0,0,0,4408,4408,7503
27070,Unknown ,2016,2016Unknown ,0,0,0,0,142,0,142,0,0,0,0,384,0,384,526
27071,Unknown ,2016,2016Unknown ,0,0,0,8,0,0,8,0,0,0,7,0,0,7,435
27072,Unknown ,2016,2016Unknown ,0,0,5,0,0,0,5,0,0,0,0,0,0,0,20
27073,Unknown ,2016,2016Unknown ,13,28,50,175,11,0,277,10,28,35,215,19,0,307,1687
27074,Unknown ,2016,2016Unknown ,21,11,5,46,6,0,89,7,19,8,51,0,0,85,174
27075,Unknown ,2016,2016Unknown ,49,51,37,205,15,255,612,50,62,45,268,18,340,783,1395
27076,Unknown ,2016,2016Unknown ,842,1235,728,4211,283,0,7299,849,1450,1062,9893,357,0,13611,20910
27077,Unknown ,2017,2017Unknown ,0,0,0,0,0,0,0,0,0,0,0,0,0,0,124744
27078,Unknown ,2017,2017Unknown ,0,0,0,0,0,79,79,0,0,0,0,0,158,158,237
27079,Unknown ,2017,2017Unknown ,0,0,0,0,0,274,274,0,0,0,0,0,341,341,615
27080,Unknown ,2017,2017Unknown ,0,0,0,5,0,0,5,0,0,0,0,0,0,0,433
27081,Unknown ,2017,2017Unknown ,0,0,7,0,5,0,12,0,5,0,0,9,0,14,45026
27082,Unknown ,2017,2017Unknown ,0,0,8,0,0,0,8,0,0,0,0,0,0,0,8
27083,Unknown ,2017,2017Unknown ,5,0,0,0,0,0,5,0,0,0,0,0,0,0,5
27084,Unknown ,2017,2017Unknown ,13,23,14,68,8,0,126,11,21,17,70,0,0,119,245
27085,Unknown ,2017,2017Unknown ,46,61,42,227,14,373,763,48,64,39,320,17,276,764,1527
27086,Unknown ,2017,2017Unknown ,102,68,30,131,6,0,337,91,67,34,85,0,0,277,1072
27087,Unknown ,2017,2017Unknown ,1496,1611,1034,5626,381,0,10148,1566,1846,1577,12663,478,0,18130,28278
27088,Unknown ,2018,2018Unknown ,0,0,0,0,0,0,0,0,0,0,0,0,0,0,132291
27089,Unknown ,2018,2018Unknown ,0,0,0,0,0,0,0,0,0,0,0,0,26,26,49976
27090,Unknown ,2018,2018Unknown ,0,0,0,0,0,0,0,6,0,0,0,0,0,6,6
27091,Unknown ,2018,2018Unknown ,0,0,0,0,0,173,173,0,0,0,0,0,442,442,615
27092,Unknown ,2018,2018Unknown ,0,0,0,9,0,0,9,0,0,0,0,0,0,0,432
27093,Unknown ,2018,2018Unknown ,0,0,0,9,0,0,9,0,0,5,6,0,0,11,20
27094,Unknown ,2018,2018Unknown ,0,0,0,36,0,0,36,0,0,0,35,0,0,35,71
27095,Unknown ,2018,2018Unknown ,20,23,12,58,16,0,129,22,24,26,51,5,0,128,257
27096,Unknown ,2018,2018Unknown ,41,64,35,258,18,307,723,46,60,40,374,26,400,946,1669
27097,Unknown ,2018,2018Unknown ,1685,1767,1215,6330,442,0,11439,1792,2016,1673,13718,565,0,19764,31203
27098,Unknown ,2019,2019Unknown ,0,0,0,0,0,0,0,0,0,0,0,0,0,0,44412
27099,Unknown ,2019,2019Unknown ,0,0,0,0,0,0,0,0,0,0,5,0,0,5,5
27100,Unknown ,2019,2019Unknown ,0,0,0,0,0,86,86,0,0,0,0,0,122,122,101068
27101,Unknown ,2019,2019Unknown ,0,0,0,5,0,0,5,0,0,0,0,0,0,0,437
27102,Unknown ,2019,2019Unknown ,0,0,0,35,0,0,35,0,0,0,36,0,0,36,71
27103,Unknown ,2019,2019Unknown ,0,0,0,335,0,0,335,0,0,0,309,0,0,309,644
27104,Unknown ,2019,2019Unknown ,0,29,27,68,12,0,136,7,33,33,121,26,0,220,356
27105,Unknown ,2019,2019Unknown ,5,0,0,0,0,0,5,7,0,0,0,0,0,7,12
27106,Unknown ,2019,2019Unknown ,39,59,27,262,18,0,405,42,54,45,377,27,0,545,1715
27107,Unknown ,2019,2019Unknown ,2076,1976,1437,7011,503,0,13003,2182,2196,1863,14501,652,0,21394,34397
27108,Unknown ,2020,2020Unknown ,0,0,0,0,0,0,0,0,0,0,0,0,0,0,133827
27109,Unknown ,2020,2020Unknown ,0,0,0,0,0,0,0,0,0,0,5,0,0,5,5
27110,Unknown ,2020,2020Unknown ,0,0,0,0,0,0,0,0,0,0,7,0,0,7,7
27111,Unknown ,2020,2020Unknown ,0,0,0,0,0,0,0,0,0,7,0,0,0,7,433
27112,Unknown ,2020,2020Unknown ,0,0,0,0,0,292,292,0,0,0,0,0,334,334,643
27113,Unknown ,2020,2020Unknown ,0,0,0,0,0,373,373,0,0,0,0,0,568,568,941
27114,Unknown ,2020,2020Unknown ,0,0,0,0,0,2847,2847,0,0,0,0,0,3832,3832,6679
27115,Unknown ,2020,2020Unknown ,0,0,0,0,9,0,9,0,0,0,11,11,0,22,31
27116,Unknown ,2020,2020Unknown ,0,0,0,5,0,0,5,0,0,0,0,0,0,0,5
27117,Unknown ,2020,2020Unknown ,0,0,0,35,0,0,35,0,0,0,36,0,0,36,71
27118,Unknown ,2020,2020Unknown ,0,0,5,0,0,0,5,0,0,0,0,0,0,0,5
27119,Unknown ,2020,2020Unknown ,0,6,5,7,0,0,18,0,0,14,23,0,0,37,55
27120,Unknown ,2020,2020Unknown ,6,0,0,0,0,0,6,5,5,0,0,0,0,10,16
27121,Unknown ,2020,2020Unknown ,38,49,37,258,22,0,404,41,50,39,377,30,0,537,1724
27122,Unknown ,2020,2020Unknown ,51,70,68,707,77,0,973,47,101,72,749,47,0,1016,4340
27123,Unknown ,2020,2020Unknown ,2393,2025,1576,7126,525,0,13645,2554,2259,2005,14081,702,0,21601,35285
27124,Unknown ,2021,2021Unknown ,0,0,0,0,0,0,0,0,0,0,0,0,0,0,50696
27125,Unknown ,2021,2021Unknown ,0,0,0,0,0,0,0,0,0,0,0,5,0,5,5
27126,Unknown ,2021,2021Unknown ,0,0,0,0,0,0,0,0,0,0,5,0,0,5,5
27127,Unknown ,2021,2021Unknown ,0,0,0,0,8,0,8,0,0,0,8,10,0,18,26
27128,Unknown ,2021,2021Unknown ,0,0,0,35,0,0,35,0,0,0,36,0,0,36,71
27129,Unknown ,2021,2021Unknown ,9,26,13,168,9,0,225,9,22,13,160,5,0,209,434
27130,Unknown ,2021,2021Unknown ,12,0,0,0,0,0,12,11,5,0,0,0,0,16,28
27131,Unknown ,2021,2021Unknown ,28,45,38,229,23,0,363,35,55,30,315,31,0,466,1649
27132,Unknown ,2021,2021Unknown ,140,292,251,2746,253,0,3682,156,328,309,3035,148,0,3976,10016
27133,Unknown ,2021,2021Unknown ,2358,2340,1752,7707,789,0,14946,2454,2614,2089,14538,1061,0,22756,37702
27134,Uzbekistan,2001,2001Uzbekistan,0,0,0,0,0,0,0,0,0,0,0,0,0,0,3429
27135,Uzbekistan,2001,2001Uzbekistan,0,0,0,0,0,0,0,0,0,0,0,0,6,6,6
27136,Uzbekistan,2001,2001Uzbekistan,0,0,0,0,0,12,12,0,0,0,0,0,7,7,19
27137,Uzbekistan,2002,2002Uzbekistan,0,0,0,0,0,0,0,0,0,0,0,0,0,0,6842
27138,Uzbekistan,2002,2002Uzbekistan,0,0,0,0,0,0,0,0,0,0,0,0,7,7,7
27139,Uzbekistan,2002,2002Uzbekistan,0,0,0,0,0,20,20,0,0,0,0,0,13,13,33
27140,Uzbekistan,2003,2003Uzbekistan,0,0,0,0,0,0,0,0,0,0,0,0,0,0,7316
27141,Uzbekistan,2003,2003Uzbekistan,0,0,0,0,0,0,0,0,0,0,0,0,7,7,7
27142,Uzbekistan,2003,2003Uzbekistan,0,0,0,0,0,34,34,0,0,0,0,0,22,22,56
27143,Uzbekistan,2003,2003Uzbekistan,0,0,0,6,0,0,6,0,0,0,9,0,0,9,15
27144,Uzbekistan,2004,2004Uzbekistan,0,0,0,0,0,0,0,0,0,0,0,0,0,0,7262
27145,Uzbekistan,2004,2004Uzbekistan,0,0,0,0,0,0,0,0,0,0,0,0,8,8,8
27146,Uzbekistan,2004,2004Uzbekistan,0,0,0,0,0,0,0,0,0,5,0,0,0,5,5
27147,Uzbekistan,2004,2004Uzbekistan,0,5,0,0,0,0,5,0,0,0,0,0,0,0,5
27148,Uzbekistan,2004,2004Uzbekistan,0,6,0,0,0,0,6,0,0,6,0,0,0,6,12
27149,Uzbekistan,2005,2005Uzbekistan,0,0,0,0,0,0,0,0,0,0,0,0,0,0,7660
27150,Uzbekistan,2005,2005Uzbekistan,0,0,0,0,0,0,0,0,0,0,5,0,0,5,5
27151,Uzbekistan,2005,2005Uzbekistan,0,0,0,0,0,0,0,0,0,5,0,0,0,5,5
27152,Uzbekistan,2005,2005Uzbekistan,0,0,0,0,0,5,5,0,0,0,0,0,0,0,5
27153,Uzbekistan,2005,2005Uzbekistan,0,0,0,0,0,8,8,0,0,0,0,0,13,13,21
27154,Uzbekistan,2005,2005Uzbekistan,0,0,0,0,0,91,91,0,0,0,0,0,59,59,150
27155,Uzbekistan,2005,2005Uzbekistan,0,0,0,5,0,0,5,0,0,0,12,0,0,12,17
27156,Uzbekistan,2005,2005Uzbekistan,0,0,0,11,0,0,11,0,0,7,6,0,0,13,24
27157,Uzbekistan,2005,2005Uzbekistan,0,5,9,8,0,0,22,8,0,7,10,0,0,25,47
27158,Uzbekistan,2005,2005Uzbekistan,0,6,7,46,0,0,59,0,8,0,298,0,0,306,365
27159,Uzbekistan,2005,2005Uzbekistan,0,8,0,0,0,0,8,0,0,5,10,0,0,15,23
27160,Uzbekistan,2006,2006Uzbekistan,0,0,0,0,0,0,0,0,0,0,0,0,0,0,8597
27161,Uzbekistan,2006,2006Uzbekistan,0,0,0,0,0,0,0,0,0,0,5,0,0,5,5
27162,Uzbekistan,2006,2006Uzbekistan,0,0,0,0,0,0,0,0,0,5,0,0,0,5,5
27163,Uzbekistan,2006,2006Uzbekistan,0,0,0,0,0,5,5,0,0,0,0,0,0,0,5
27164,Uzbekistan,2006,2006Uzbekistan,0,0,0,0,0,10,10,0,0,0,0,0,21,21,31
27165,Uzbekistan,2006,2006Uzbekistan,0,0,0,0,0,23,23,0,0,0,0,0,13,13,36
27166,Uzbekistan,2006,2006Uzbekistan,0,0,0,0,0,98,98,0,0,0,0,0,64,64,162
27167,Uzbekistan,2006,2006Uzbekistan,5,7,5,20,0,0,37,9,5,0,43,0,0,57,94
27168,Uzbekistan,2006,2006Uzbekistan,5,12,5,15,0,0,37,6,13,6,22,0,0,47,84
27169,Uzbekistan,2006,2006Uzbekistan,6,8,5,17,0,0,36,9,11,0,20,0,0,40,76
27170,Uzbekistan,2007,2007Uzbekistan,0,0,0,0,0,0,0,0,0,0,0,0,0,0,5053
27171,Uzbekistan,2007,2007Uzbekistan,0,0,0,0,0,0,0,0,0,0,7,0,0,7,7
27172,Uzbekistan,2007,2007Uzbekistan,0,0,0,0,0,0,0,0,0,5,0,0,0,5,5
27173,Uzbekistan,2007,2007Uzbekistan,0,0,0,0,0,5,5,0,0,0,0,0,0,0,5
27174,Uzbekistan,2007,2007Uzbekistan,0,0,0,0,0,20,20,0,0,0,0,0,16,16,36
27175,Uzbekistan,2007,2007Uzbekistan,0,0,0,0,0,27,27,0,0,0,0,0,32,32,59
27176,Uzbekistan,2007,2007Uzbekistan,0,0,0,0,0,98,98,0,0,0,0,0,66,66,164
27177,Uzbekistan,2007,2007Uzbekistan,0,0,0,5,0,14,19,0,0,0,7,0,17,24,43
27178,Uzbekistan,2007,2007Uzbekistan,0,5,0,0,0,0,5,0,0,0,0,0,0,0,5
27179,Uzbekistan,2007,2007Uzbekistan,5,0,0,0,0,0,5,0,0,0,0,0,0,0,5
27180,Uzbekistan,2007,2007Uzbekistan,5,6,10,14,0,0,35,11,10,0,7,0,0,28,63
27181,Uzbekistan,2007,2007Uzbekistan,7,0,18,18,0,0,43,0,5,0,15,0,0,20,63
27182,Uzbekistan,2007,2007Uzbekistan,8,19,7,36,0,0,70,16,19,11,34,0,0,80,150
27183,Uzbekistan,2008,2008Uzbekistan,0,0,0,0,0,0,0,0,0,0,0,0,0,0,5698
27184,Uzbekistan,2008,2008Uzbekistan,0,0,0,0,0,0,0,0,0,0,7,0,0,7,7
27185,Uzbekistan,2008,2008Uzbekistan,0,0,0,0,0,0,0,0,0,5,0,0,0,5,5
27186,Uzbekistan,2008,2008Uzbekistan,0,0,0,0,0,0,0,0,5,5,0,0,0,10,10
27187,Uzbekistan,2008,2008Uzbekistan,0,0,0,0,0,0,0,5,0,0,0,0,0,5,5
27188,Uzbekistan,2008,2008Uzbekistan,0,0,0,0,0,0,0,7,0,0,0,0,0,7,7
27189,Uzbekistan,2008,2008Uzbekistan,0,0,0,0,0,16,16,0,0,0,0,0,17,17,33
27190,Uzbekistan,2008,2008Uzbekistan,0,0,0,0,0,104,104,0,0,0,0,0,67,67,171
27191,Uzbekistan,2008,2008Uzbekistan,0,0,0,5,0,0,5,0,0,0,5,0,0,5,10
27192,Uzbekistan,2008,2008Uzbekistan,0,0,0,5,0,15,20,0,0,0,6,0,19,25,45
27193,Uzbekistan,2008,2008Uzbekistan,0,0,7,10,0,0,17,5,8,0,11,0,0,24,41
27194,Uzbekistan,2008,2008Uzbekistan,0,5,0,0,0,0,5,0,0,0,0,0,0,0,5
27195,Uzbekistan,2008,2008Uzbekistan,5,14,5,24,0,0,48,5,15,5,15,0,0,40,88
27196,Uzbekistan,2008,2008Uzbekistan,7,0,5,18,0,0,30,7,0,0,0,0,0,7,37
27197,Uzbekistan,2008,2008Uzbekistan,7,14,10,33,0,0,64,11,20,8,32,0,0,71,135
27198,Uzbekistan,2009,2009Uzbekistan,0,0,0,0,0,0,0,0,0,0,0,0,0,0,4253
27199,Uzbekistan,2009,2009Uzbekistan,0,0,0,0,0,0,0,0,0,0,7,0,0,7,7
27200,Uzbekistan,2009,2009Uzbekistan,0,0,0,0,0,0,0,0,0,5,0,0,0,5,5
27201,Uzbekistan,2009,2009Uzbekistan,0,0,0,0,0,0,0,0,5,0,0,0,0,5,11
27202,Uzbekistan,2009,2009Uzbekistan,0,0,0,0,0,0,0,7,0,0,0,0,0,7,7
27203,Uzbekistan,2009,2009Uzbekistan,0,0,0,0,0,17,17,0,0,0,0,0,19,19,36
27204,Uzbekistan,2009,2009Uzbekistan,0,0,0,0,0,19,19,0,0,0,0,0,20,20,39
27205,Uzbekistan,2009,2009Uzbekistan,0,0,0,8,0,0,8,0,0,0,7,0,0,7,15
27206,Uzbekistan,2009,2009Uzbekistan,0,0,5,0,0,0,5,0,0,0,0,0,0,0,5
27207,Uzbekistan,2009,2009Uzbekistan,0,0,8,19,0,0,27,7,0,5,10,0,0,22,49
27208,Uzbekistan,2009,2009Uzbekistan,0,5,6,9,0,0,20,5,7,0,9,0,0,21,41
27209,Uzbekistan,2009,2009Uzbekistan,5,11,5,20,0,0,41,0,14,5,19,0,0,38,79
27210,Uzbekistan,2009,2009Uzbekistan,8,55,89,750,107,0,1009,6,74,97,664,83,0,924,1933
27211,Uzbekistan,2009,2009Uzbekistan,11,16,18,39,0,0,84,14,27,11,46,0,0,98,182
27212,Uzbekistan,2010,2010Uzbekistan,0,0,0,0,0,0,0,0,0,0,0,0,0,0,4267
27213,Uzbekistan,2010,2010Uzbekistan,0,0,0,0,0,0,0,0,0,0,5,0,0,5,5
27214,Uzbekistan,2010,2010Uzbekistan,0,0,0,0,0,0,0,0,0,0,7,0,0,7,14
27215,Uzbekistan,2010,2010Uzbekistan,0,0,0,0,0,0,0,0,0,5,0,0,0,5,16
27216,Uzbekistan,2010,2010Uzbekistan,0,0,0,0,0,0,0,0,6,0,0,0,0,6,6
27217,Uzbekistan,2010,2010Uzbekistan,0,0,0,0,0,0,0,7,0,0,0,0,0,7,7
27218,Uzbekistan,2010,2010Uzbekistan,0,0,0,0,0,17,17,0,0,0,0,0,17,17,34
27219,Uzbekistan,2010,2010Uzbekistan,0,0,0,0,0,18,18,0,0,0,0,0,15,15,33
27220,Uzbekistan,2010,2010Uzbekistan,0,0,0,0,0,38,38,0,0,0,0,0,33,33,2021
27221,Uzbekistan,2010,2010Uzbekistan,0,0,0,0,0,117,117,0,0,0,0,0,80,80,197
27222,Uzbekistan,2010,2010Uzbekistan,0,0,0,5,0,17,22,0,0,0,5,0,17,22,44
27223,Uzbekistan,2010,2010Uzbekistan,0,0,0,8,0,0,8,0,0,0,0,0,0,0,8
27224,Uzbekistan,2010,2010Uzbekistan,0,0,5,0,0,0,5,0,0,0,0,0,0,0,5
27225,Uzbekistan,2010,2010Uzbekistan,0,0,7,20,0,0,27,5,9,0,16,0,0,30,57
27226,Uzbekistan,2010,2010Uzbekistan,0,0,9,8,0,0,17,0,10,7,11,0,0,28,45
27227,Uzbekistan,2010,2010Uzbekistan,8,48,87,805,138,0,1086,6,68,92,731,99,0,996,2082
27228,Uzbekistan,2011,2011Uzbekistan,0,0,0,0,0,0,0,0,0,0,0,0,0,0,4014
27229,Uzbekistan,2011,2011Uzbekistan,0,0,0,0,0,0,0,0,0,0,5,0,0,5,5
27230,Uzbekistan,2011,2011Uzbekistan,0,0,0,0,0,0,0,0,0,0,7,0,0,7,14
27231,Uzbekistan,2011,2011Uzbekistan,0,0,0,0,0,0,0,0,0,5,0,0,0,5,5
27232,Uzbekistan,2011,2011Uzbekistan,0,0,0,0,0,0,0,0,9,0,0,0,0,9,9
27233,Uzbekistan,2011,2011Uzbekistan,0,0,0,0,0,0,0,7,0,0,0,0,0,7,7
27234,Uzbekistan,2011,2011Uzbekistan,0,0,0,0,0,19,19,0,0,0,0,0,13,13,32
27235,Uzbekistan,2011,2011Uzbekistan,0,0,0,0,0,117,117,0,0,0,0,0,84,84,201
27236,Uzbekistan,2011,2011Uzbekistan,0,0,0,5,0,0,5,0,0,0,0,0,0,0,10
27237,Uzbekistan,2011,2011Uzbekistan,0,0,0,5,0,19,24,0,0,0,5,0,19,24,48
27238,Uzbekistan,2011,2011Uzbekistan,0,0,0,6,0,0,6,0,0,0,0,0,0,0,6
27239,Uzbekistan,2011,2011Uzbekistan,0,0,5,0,0,0,5,0,0,0,0,0,0,0,5
27240,Uzbekistan,2011,2011Uzbekistan,0,0,7,20,0,0,27,5,9,0,16,0,0,30,57
27241,Uzbekistan,2011,2011Uzbekistan,0,0,8,7,0,0,15,0,10,7,14,0,0,31,46
27242,Uzbekistan,2011,2011Uzbekistan,0,5,8,21,5,0,39,0,8,5,25,5,0,43,259
27243,Uzbekistan,2011,2011Uzbekistan,0,6,0,12,0,0,18,0,0,7,18,0,0,25,61
27244,Uzbekistan,2011,2011Uzbekistan,0,7,0,5,0,0,12,0,5,8,7,0,0,20,32
27245,Uzbekistan,2011,2011Uzbekistan,0,27,20,50,0,0,97,0,20,25,18,0,0,63,5660
27246,Uzbekistan,2011,2011Uzbekistan,5,0,0,0,0,0,5,0,0,0,0,0,0,0,5
27247,Uzbekistan,2011,2011Uzbekistan,6,53,83,842,156,0,1140,5,62,100,772,112,0,1051,2191
27248,Uzbekistan,2012,2012Uzbekistan,0,0,0,0,0,0,0,0,0,0,0,0,0,0,3924
27249,Uzbekistan,2012,2012Uzbekistan,0,0,0,0,0,0,0,0,0,0,5,0,0,5,10
27250,Uzbekistan,2012,2012Uzbekistan,0,0,0,0,0,0,0,0,0,0,7,0,0,7,7
27251,Uzbekistan,2012,2012Uzbekistan,0,0,0,0,0,0,0,0,0,5,0,0,0,5,5
27252,Uzbekistan,2012,2012Uzbekistan,0,0,0,0,0,0,0,5,0,0,0,0,0,5,5
27253,Uzbekistan,2012,2012Uzbekistan,0,0,0,0,0,0,0,7,0,0,0,0,0,7,7
27254,Uzbekistan,2012,2012Uzbekistan,0,0,0,0,0,8,8,0,0,0,0,0,10,10,18
27255,Uzbekistan,2012,2012Uzbekistan,0,0,0,0,0,25,25,0,0,0,0,0,22,22,4551
27256,Uzbekistan,2012,2012Uzbekistan,0,0,0,0,0,34,34,0,0,0,0,0,33,33,67
27257,Uzbekistan,2012,2012Uzbekistan,0,0,0,0,0,38,38,0,0,0,0,0,56,56,94
27258,Uzbekistan,2012,2012Uzbekistan,0,0,0,0,0,117,117,0,0,0,0,0,89,89,206
27259,Uzbekistan,2012,2012Uzbekistan,0,0,0,0,5,22,27,0,0,0,0,0,27,27,54
27260,Uzbekistan,2012,2012Uzbekistan,0,0,0,6,0,0,6,0,0,0,0,0,0,0,6
27261,Uzbekistan,2012,2012Uzbekistan,0,0,0,7,0,0,7,0,0,0,17,0,0,17,274
27262,Uzbekistan,2012,2012Uzbekistan,0,0,0,8,0,0,8,0,0,0,0,0,0,0,8
27263,Uzbekistan,2012,2012Uzbekistan,0,0,0,8,0,0,8,0,0,7,5,0,0,12,20
27264,Uzbekistan,2012,2012Uzbekistan,0,0,5,0,0,0,5,0,0,0,0,0,0,0,17
27265,Uzbekistan,2012,2012Uzbekistan,0,0,7,20,0,0,27,5,9,0,13,0,0,27,54
27266,Uzbekistan,2012,2012Uzbekistan,0,6,5,10,0,0,21,5,0,13,17,0,0,35,56
27267,Uzbekistan,2012,2012Uzbekistan,5,0,0,0,0,0,5,0,5,0,0,0,0,5,10
27268,Uzbekistan,2012,2012Uzbekistan,5,41,92,853,172,0,1163,0,49,93,775,120,0,1037,2200
27269,Uzbekistan,2013,2013Uzbekistan,0,0,0,0,0,0,0,0,0,0,0,0,0,0,4036
27270,Uzbekistan,2013,2013Uzbekistan,0,0,0,0,0,0,0,0,0,0,7,0,0,7,7
27271,Uzbekistan,2013,2013Uzbekistan,0,0,0,0,0,0,0,0,0,5,0,0,0,5,5
27272,Uzbekistan,2013,2013Uzbekistan,0,0,0,0,0,0,0,5,0,0,0,0,0,5,5
27273,Uzbekistan,2013,2013Uzbekistan,0,0,0,0,0,0,0,7,0,0,0,0,0,7,7
27274,Uzbekistan,2013,2013Uzbekistan,0,0,0,0,0,8,8,0,0,0,0,0,10,10,23
27275,Uzbekistan,2013,2013Uzbekistan,0,0,0,0,0,122,122,0,0,0,0,0,95,95,217
27276,Uzbekistan,2013,2013Uzbekistan,0,0,0,5,0,0,5,0,0,0,0,0,0,0,10
27277,Uzbekistan,2013,2013Uzbekistan,0,0,0,5,0,0,5,0,0,0,12,0,0,12,273
27278,Uzbekistan,2013,2013Uzbekistan,0,0,0,5,0,22,27,0,0,0,5,0,22,27,54
27279,Uzbekistan,2013,2013Uzbekistan,0,0,0,6,0,0,6,0,0,0,0,0,0,0,6
27280,Uzbekistan,2013,2013Uzbekistan,0,0,0,8,0,0,8,0,0,0,0,0,0,0,8
27281,Uzbekistan,2013,2013Uzbekistan,0,0,0,13,0,0,13,0,0,0,13,0,0,13,26
27282,Uzbekistan,2013,2013Uzbekistan,0,0,5,0,0,0,5,0,0,0,0,0,0,0,5
27283,Uzbekistan,2013,2013Uzbekistan,0,0,7,19,0,0,26,5,8,0,12,0,0,25,51
27284,Uzbekistan,2013,2013Uzbekistan,0,6,0,5,0,0,11,0,0,9,0,0,0,9,20
27285,Uzbekistan,2013,2013Uzbekistan,0,9,0,11,0,0,20,7,0,12,18,0,0,37,57
27286,Uzbekistan,2013,2013Uzbekistan,0,9,0,15,0,0,24,0,8,0,12,0,0,20,44
27287,Uzbekistan,2013,2013Uzbekistan,5,0,0,0,0,0,5,0,6,0,0,0,0,6,11
27288,Uzbekistan,2013,2013Uzbekistan,5,5,10,22,6,0,48,0,5,5,25,5,0,40,88
27289,Uzbekistan,2014,2014Uzbekistan,0,0,0,0,0,0,0,0,0,0,0,0,0,0,3949
27290,Uzbekistan,2014,2014Uzbekistan,0,0,0,0,0,0,0,0,0,5,0,0,0,5,20
27291,Uzbekistan,2014,2014Uzbekistan,0,0,0,0,0,0,0,0,0,7,0,0,0,7,7
27292,Uzbekistan,2014,2014Uzbekistan,0,0,0,0,0,0,0,5,0,0,0,0,0,5,5
27293,Uzbekistan,2014,2014Uzbekistan,0,0,0,0,0,0,0,7,0,0,0,0,0,7,7
27294,Uzbekistan,2014,2014Uzbekistan,0,0,0,0,0,126,126,0,0,0,0,0,95,95,221
27295,Uzbekistan,2014,2014Uzbekistan,0,0,0,5,0,0,5,0,0,0,0,0,0,0,5
27296,Uzbekistan,2014,2014Uzbekistan,0,0,0,5,0,0,5,0,0,0,6,0,0,6,11
27297,Uzbekistan,2014,2014Uzbekistan,0,0,0,5,0,23,28,0,0,0,5,0,23,28,56
27298,Uzbekistan,2014,2014Uzbekistan,0,0,0,7,0,0,7,0,0,0,0,0,0,0,7
27299,Uzbekistan,2014,2014Uzbekistan,0,0,0,8,0,0,8,0,0,0,0,0,0,0,8
27300,Uzbekistan,2014,2014Uzbekistan,0,0,0,9,0,0,9,0,0,0,0,0,0,0,9
27301,Uzbekistan,2014,2014Uzbekistan,0,0,0,9,0,0,9,0,0,0,18,0,0,18,271
27302,Uzbekistan,2014,2014Uzbekistan,0,0,9,10,0,0,19,0,7,0,11,0,0,18,37
27303,Uzbekistan,2014,2014Uzbekistan,0,0,9,17,0,0,26,9,0,12,18,0,0,39,65
27304,Uzbekistan,2014,2014Uzbekistan,0,5,8,21,6,0,40,0,6,6,28,5,0,45,85
27305,Uzbekistan,2014,2014Uzbekistan,0,6,0,9,0,0,15,0,0,6,6,0,0,12,27
27306,Uzbekistan,2015,2015Uzbekistan,0,0,0,0,0,0,0,0,0,0,0,0,0,0,3571
27307,Uzbekistan,2015,2015Uzbekistan,0,0,0,0,0,0,0,0,0,5,0,0,0,5,5
27308,Uzbekistan,2015,2015Uzbekistan,0,0,0,0,0,0,0,0,0,7,0,0,0,7,7
27309,Uzbekistan,2015,2015Uzbekistan,0,0,0,0,0,0,0,0,9,0,0,0,0,9,9
27310,Uzbekistan,2015,2015Uzbekistan,0,0,0,0,0,0,0,5,0,0,0,0,0,5,5
27311,Uzbekistan,2015,2015Uzbekistan,0,0,0,0,0,11,11,0,0,0,0,0,11,11,22
27312,Uzbekistan,2015,2015Uzbekistan,0,0,0,0,0,20,20,0,0,0,0,0,39,39,59
27313,Uzbekistan,2015,2015Uzbekistan,0,0,0,0,0,125,125,0,0,0,0,0,91,91,216
27314,Uzbekistan,2015,2015Uzbekistan,0,0,0,5,0,0,5,0,0,0,0,0,0,0,59
27315,Uzbekistan,2015,2015Uzbekistan,0,0,0,7,0,0,7,0,0,0,0,0,0,0,7
27316,Uzbekistan,2015,2015Uzbekistan,0,0,0,8,0,0,8,0,0,0,0,0,0,0,8
27317,Uzbekistan,2015,2015Uzbekistan,0,0,0,11,0,0,11,0,0,0,12,0,0,12,23
27318,Uzbekistan,2015,2015Uzbekistan,0,0,5,0,0,0,5,0,0,0,0,0,0,0,5
27319,Uzbekistan,2015,2015Uzbekistan,0,5,5,17,0,0,27,5,0,12,22,0,0,39,66
27320,Uzbekistan,2015,2015Uzbekistan,0,6,0,8,0,0,14,0,0,5,7,0,0,12,26
27321,Uzbekistan,2015,2015Uzbekistan,0,8,0,0,0,0,8,0,0,6,12,0,0,18,26
27322,Uzbekistan,2015,2015Uzbekistan,5,0,0,0,0,0,5,0,0,0,0,0,0,0,5
27323,Uzbekistan,2015,2015Uzbekistan,5,0,5,18,6,0,34,0,8,5,26,5,0,44,78
27324,Uzbekistan,2016,2016Uzbekistan,0,0,0,0,0,0,0,0,0,0,0,0,0,0,3057
27325,Uzbekistan,2016,2016Uzbekistan,0,0,0,0,0,0,0,0,0,5,0,0,0,5,5
27326,Uzbekistan,2016,2016Uzbekistan,0,0,0,0,0,0,0,0,0,7,0,0,0,7,7
27327,Uzbekistan,2016,2016Uzbekistan,0,0,0,0,0,0,0,5,0,0,0,0,0,5,5
27328,Uzbekistan,2016,2016Uzbekistan,0,0,0,0,0,0,0,9,0,0,0,0,0,9,9
27329,Uzbekistan,2016,2016Uzbekistan,0,0,0,0,0,15,15,0,0,0,0,0,17,17,32
27330,Uzbekistan,2016,2016Uzbekistan,0,0,0,0,0,21,21,0,0,0,0,0,34,34,55
27331,Uzbekistan,2016,2016Uzbekistan,0,0,0,0,0,25,25,0,0,0,0,0,25,25,50
27332,Uzbekistan,2016,2016Uzbekistan,0,0,0,0,0,124,124,0,0,0,0,0,96,96,220
27333,Uzbekistan,2016,2016Uzbekistan,0,0,0,6,0,0,6,0,0,0,0,0,0,0,6
27334,Uzbekistan,2016,2016Uzbekistan,0,0,0,6,5,0,11,0,0,0,13,0,0,13,24
27335,Uzbekistan,2016,2016Uzbekistan,0,0,0,8,0,0,8,0,0,0,0,0,0,0,8
27336,Uzbekistan,2016,2016Uzbekistan,0,0,0,9,0,0,9,0,0,0,0,0,0,0,9
27337,Uzbekistan,2016,2016Uzbekistan,0,0,0,9,0,0,9,0,0,6,8,0,0,14,23
27338,Uzbekistan,2016,2016Uzbekistan,0,0,6,18,0,0,24,0,0,5,21,0,0,26,50
27339,Uzbekistan,2016,2016Uzbekistan,0,0,7,0,0,0,7,0,0,0,0,0,0,0,7
27340,Uzbekistan,2016,2016Uzbekistan,0,0,9,18,7,0,34,5,5,5,26,5,0,46,80
27341,Uzbekistan,2016,2016Uzbekistan,0,5,0,0,0,0,5,0,0,0,7,0,0,7,12
27342,Uzbekistan,2016,2016Uzbekistan,0,6,0,9,0,0,15,0,11,0,11,0,0,22,165
27343,Uzbekistan,2017,2017Uzbekistan,0,0,0,0,0,0,0,0,0,0,0,0,0,0,2829
27344,Uzbekistan,2017,2017Uzbekistan,0,0,0,0,0,0,0,0,0,0,9,0,0,9,9
27345,Uzbekistan,2017,2017Uzbekistan,0,0,0,0,0,0,0,0,0,5,0,0,0,5,5
27346,Uzbekistan,2017,2017Uzbekistan,0,0,0,0,0,0,0,0,0,7,0,0,0,7,7
27347,Uzbekistan,2017,2017Uzbekistan,0,0,0,0,0,0,0,0,0,9,0,0,0,9,9
27348,Uzbekistan,2017,2017Uzbekistan,0,0,0,0,0,0,0,0,5,0,0,0,0,5,5
27349,Uzbekistan,2017,2017Uzbekistan,0,0,0,0,0,22,22,0,0,0,0,0,38,38,60
27350,Uzbekistan,2017,2017Uzbekistan,0,0,0,0,0,25,25,0,0,0,0,0,25,25,50
27351,Uzbekistan,2017,2017Uzbekistan,0,0,0,0,0,118,118,0,0,0,0,0,94,94,212
27352,Uzbekistan,2017,2017Uzbekistan,0,0,0,5,0,0,5,0,0,0,0,0,0,0,5
27353,Uzbekistan,2017,2017Uzbekistan,0,0,0,6,5,0,11,0,0,0,13,0,0,13,24
27354,Uzbekistan,2017,2017Uzbekistan,0,0,0,8,0,0,8,0,0,0,0,0,0,0,8
27355,Uzbekistan,2017,2017Uzbekistan,0,0,0,8,0,0,8,0,5,0,5,0,0,10,18
27356,Uzbekistan,2017,2017Uzbekistan,0,5,0,0,0,0,5,0,0,0,7,0,0,7,12
27357,Uzbekistan,2017,2017Uzbekistan,0,5,0,14,0,0,19,0,5,5,22,0,0,32,51
27358,Uzbekistan,2017,2017Uzbekistan,0,5,8,21,9,0,43,5,9,5,32,7,0,58,101
27359,Uzbekistan,2018,2018Uzbekistan,0,0,0,0,0,0,0,0,0,0,0,0,0,0,2599
27360,Uzbekistan,2018,2018Uzbekistan,0,0,0,0,0,0,0,0,0,0,5,0,0,5,5
27361,Uzbekistan,2018,2018Uzbekistan,0,0,0,0,0,0,0,0,0,7,0,0,0,7,7
27362,Uzbekistan,2018,2018Uzbekistan,0,0,0,0,0,0,0,0,9,0,0,0,0,9,9
27363,Uzbekistan,2018,2018Uzbekistan,0,0,0,0,0,118,118,0,0,0,0,0,94,94,212
27364,Uzbekistan,2018,2018Uzbekistan,0,0,0,0,6,25,31,0,0,0,0,0,24,24,55
27365,Uzbekistan,2018,2018Uzbekistan,0,0,0,5,0,0,5,0,0,0,5,0,0,5,10
27366,Uzbekistan,2018,2018Uzbekistan,0,0,0,7,0,0,7,0,0,0,8,0,0,8,15
27367,Uzbekistan,2018,2018Uzbekistan,0,0,0,8,0,0,8,0,0,0,9,0,0,9,17
27368,Uzbekistan,2018,2018Uzbekistan,0,0,0,9,0,0,9,0,0,0,0,0,0,0,9
27369,Uzbekistan,2018,2018Uzbekistan,0,5,0,9,0,0,14,0,0,10,21,0,0,31,45
27370,Uzbekistan,2018,2018Uzbekistan,0,8,5,25,8,0,46,5,9,6,34,7,0,61,107
27371,Uzbekistan,2018,2018Uzbekistan,0,13,11,28,0,0,52,5,11,0,20,0,0,36,181
27372,Uzbekistan,2018,2018Uzbekistan,5,0,0,0,0,0,5,0,0,0,0,0,0,0,5
27373,Uzbekistan,2019,2019Uzbekistan,0,0,0,0,0,0,0,0,0,0,0,0,0,0,2734
27374,Uzbekistan,2019,2019Uzbekistan,0,0,0,0,0,0,0,0,0,0,5,0,0,5,5
27375,Uzbekistan,2019,2019Uzbekistan,0,0,0,0,0,0,0,0,0,0,6,0,0,6,6
27376,Uzbekistan,2019,2019Uzbekistan,0,0,0,0,0,0,0,0,0,0,7,0,0,7,7
27377,Uzbekistan,2019,2019Uzbekistan,0,0,0,0,0,0,0,0,5,0,0,0,0,5,5
27378,Uzbekistan,2019,2019Uzbekistan,0,0,0,0,0,0,0,0,9,0,0,0,0,9,9
27379,Uzbekistan,2019,2019Uzbekistan,0,0,0,0,0,8,8,0,0,0,0,0,22,22,30
27380,Uzbekistan,2019,2019Uzbekistan,0,0,0,0,0,118,118,0,0,0,0,0,96,96,214
27381,Uzbekistan,2019,2019Uzbekistan,0,0,0,0,6,0,6,0,0,0,0,0,0,0,54
27382,Uzbekistan,2019,2019Uzbekistan,0,0,0,7,0,0,7,0,0,6,0,0,0,6,13
27383,Uzbekistan,2019,2019Uzbekistan,0,0,0,8,0,0,8,0,0,0,9,0,0,9,17
27384,Uzbekistan,2019,2019Uzbekistan,0,8,11,33,7,0,59,5,10,5,36,8,0,64,123
27385,Uzbekistan,2020,2020Uzbekistan,0,0,0,0,0,0,0,0,0,0,0,0,0,0,2755
27386,Uzbekistan,2020,2020Uzbekistan,0,0,0,0,0,0,0,0,0,0,5,0,0,5,5
27387,Uzbekistan,2020,2020Uzbekistan,0,0,0,0,0,0,0,0,0,0,7,0,0,7,7
27388,Uzbekistan,2020,2020Uzbekistan,0,0,0,0,0,0,0,0,5,0,0,0,0,5,5
27389,Uzbekistan,2020,2020Uzbekistan,0,0,0,0,0,0,0,0,9,0,0,0,0,9,9
27390,Uzbekistan,2020,2020Uzbekistan,0,0,0,0,0,6,6,0,0,0,0,0,0,0,6
27391,Uzbekistan,2020,2020Uzbekistan,0,0,0,0,0,9,9,0,0,0,0,0,0,0,9
27392,Uzbekistan,2020,2020Uzbekistan,0,0,0,0,0,9,9,0,0,0,0,0,23,23,32
27393,Uzbekistan,2020,2020Uzbekistan,0,0,0,0,0,20,20,0,0,0,0,0,17,17,37
27394,Uzbekistan,2020,2020Uzbekistan,0,0,0,5,0,0,5,0,0,0,0,0,0,0,5
27395,Uzbekistan,2020,2020Uzbekistan,0,0,0,7,0,0,7,0,0,6,0,0,0,6,13
27396,Uzbekistan,2020,2020Uzbekistan,0,0,0,7,0,0,7,0,5,0,0,0,0,5,60
27397,Uzbekistan,2020,2020Uzbekistan,0,0,0,8,0,0,8,0,0,0,0,0,0,0,8
27398,Uzbekistan,2020,2020Uzbekistan,0,0,0,8,0,0,8,0,0,0,9,0,0,9,17
27399,Uzbekistan,2020,2020Uzbekistan,5,0,0,0,0,0,5,0,0,0,0,0,0,0,5
27400,Uzbekistan,2020,2020Uzbekistan,5,8,12,37,9,0,71,0,15,8,38,7,0,68,139
27401,Uzbekistan,2021,2021Uzbekistan,0,0,0,0,0,0,0,0,0,0,0,0,0,0,2541
27402,Uzbekistan,2021,2021Uzbekistan,0,0,0,0,0,0,0,0,0,0,5,0,0,5,126
27403,Uzbekistan,2021,2021Uzbekistan,0,0,0,0,0,0,0,0,0,0,7,0,0,7,7
27404,Uzbekistan,2021,2021Uzbekistan,0,0,0,0,0,0,0,0,5,0,0,0,0,5,5
27405,Uzbekistan,2021,2021Uzbekistan,0,0,0,0,0,0,0,0,9,0,0,0,0,9,9
27406,Uzbekistan,2021,2021Uzbekistan,0,0,0,0,0,10,10,0,0,0,0,0,30,30,40
27407,Uzbekistan,2021,2021Uzbekistan,0,0,0,0,0,17,17,0,0,0,0,0,18,18,35
27408,Uzbekistan,2021,2021Uzbekistan,0,0,0,5,0,0,5,0,0,0,0,0,0,0,10
27409,Uzbekistan,2021,2021Uzbekistan,0,0,0,8,0,0,8,0,0,0,0,0,0,0,8
27410,Uzbekistan,2021,2021Uzbekistan,0,0,0,8,0,0,8,0,0,0,9,0,0,9,17
27411,Uzbekistan,2021,2021Uzbekistan,0,0,6,0,0,0,6,0,5,0,0,0,0,5,57
27412,Uzbekistan,2021,2021Uzbekistan,5,0,0,0,0,0,5,0,0,0,0,0,0,0,5
27413,Uzbekistan,2021,2021Uzbekistan,5,8,10,48,10,0,81,0,14,9,43,7,0,73,154
27414,Venezuela (Bolivarian Republic of),2001,2001Venezuela (Bolivarian Republic of),0,0,0,0,0,0,0,0,0,0,0,0,0,0,464
27415,Venezuela (Bolivarian Republic of),2002,2002Venezuela (Bolivarian Republic of),0,0,0,0,0,0,0,0,0,0,0,0,0,0,525
27416,Venezuela (Bolivarian Republic of),2003,2003Venezuela (Bolivarian Republic of),0,0,0,0,0,0,0,0,0,0,0,0,0,0,593
27417,Venezuela (Bolivarian Republic of),2003,2003Venezuela (Bolivarian Republic of),0,0,0,0,0,0,0,0,0,0,5,0,0,5,5
27418,Venezuela (Bolivarian Republic of),2004,2004Venezuela (Bolivarian Republic of),0,0,0,0,0,0,0,0,0,0,0,0,0,0,1242
27419,Venezuela (Bolivarian Republic of),2004,2004Venezuela (Bolivarian Republic of),0,0,0,0,0,0,0,0,0,0,9,0,0,9,9
27420,Venezuela (Bolivarian Republic of),2005,2005Venezuela (Bolivarian Republic of),0,0,0,0,0,0,0,0,0,0,0,0,0,0,2564
27421,Venezuela (Bolivarian Republic of),2005,2005Venezuela (Bolivarian Republic of),0,8,0,0,0,0,8,0,0,0,9,0,0,9,17
27422,Venezuela (Bolivarian Republic of),2006,2006Venezuela (Bolivarian Republic of),0,0,0,0,0,0,0,0,0,0,0,0,0,0,3807
27423,Venezuela (Bolivarian Republic of),2006,2006Venezuela (Bolivarian Republic of),0,7,0,0,0,0,7,0,0,0,7,0,0,7,14
27424,Venezuela (Bolivarian Republic of),2007,2007Venezuela (Bolivarian Republic of),0,0,0,0,0,0,0,0,0,0,0,0,0,0,4939
27425,Venezuela (Bolivarian Republic of),2007,2007Venezuela (Bolivarian Republic of),0,0,0,0,0,0,0,0,0,0,0,0,7,7,7
27426,Venezuela (Bolivarian Republic of),2007,2007Venezuela (Bolivarian Republic of),0,0,0,0,0,0,0,0,0,0,5,0,0,5,10
27427,Venezuela (Bolivarian Republic of),2007,2007Venezuela (Bolivarian Republic of),0,0,6,0,0,0,6,0,0,0,11,0,0,11,17
27428,Venezuela (Bolivarian Republic of),2007,2007Venezuela (Bolivarian Republic of),0,6,6,35,0,0,47,5,5,5,42,5,0,62,109
27429,Venezuela (Bolivarian Republic of),2007,2007Venezuela (Bolivarian Republic of),0,7,0,0,0,0,7,0,0,0,0,0,0,0,7
27430,Venezuela (Bolivarian Republic of),2008,2008Venezuela (Bolivarian Republic of),0,0,0,0,0,0,0,0,0,0,0,0,0,0,5601
27431,Venezuela (Bolivarian Republic of),2008,2008Venezuela (Bolivarian Republic of),0,0,0,0,0,0,0,0,0,0,0,0,8,8,8
27432,Venezuela (Bolivarian Republic of),2008,2008Venezuela (Bolivarian Republic of),0,0,0,0,0,0,0,0,0,0,5,0,0,5,10
27433,Venezuela (Bolivarian Republic of),2008,2008Venezuela (Bolivarian Republic of),0,0,7,0,0,0,7,0,0,5,7,0,0,12,19
27434,Venezuela (Bolivarian Republic of),2008,2008Venezuela (Bolivarian Republic of),0,5,0,5,0,0,10,0,0,0,0,0,0,0,10
27435,Venezuela (Bolivarian Republic of),2008,2008Venezuela (Bolivarian Republic of),5,6,6,48,0,0,65,5,8,9,61,5,0,88,153
27436,Venezuela (Bolivarian Republic of),2009,2009Venezuela (Bolivarian Republic of),0,0,0,0,0,0,0,0,0,0,0,0,0,0,5951
27437,Venezuela (Bolivarian Republic of),2009,2009Venezuela (Bolivarian Republic of),0,0,0,0,0,0,0,0,0,0,6,0,0,6,6
27438,Venezuela (Bolivarian Republic of),2009,2009Venezuela (Bolivarian Republic of),0,0,9,10,0,0,19,0,0,7,9,0,0,16,35
27439,Venezuela (Bolivarian Republic of),2009,2009Venezuela (Bolivarian Republic of),0,7,0,0,0,0,7,0,0,0,5,0,0,5,12
27440,Venezuela (Bolivarian Republic of),2009,2009Venezuela (Bolivarian Republic of),0,7,0,0,0,0,7,0,0,0,11,0,0,11,18
27441,Venezuela (Bolivarian Republic of),2009,2009Venezuela (Bolivarian Republic of),5,8,9,62,0,0,84,5,11,11,78,5,0,110,194
27442,Venezuela (Bolivarian Republic of),2010,2010Venezuela (Bolivarian Republic of),0,0,0,0,0,0,0,0,0,0,0,0,0,0,6407
27443,Venezuela (Bolivarian Republic of),2010,2010Venezuela (Bolivarian Republic of),0,0,0,0,0,0,0,0,0,0,5,0,0,5,5
27444,Venezuela (Bolivarian Republic of),2010,2010Venezuela (Bolivarian Republic of),0,0,0,0,0,0,0,0,0,0,9,0,0,9,9
27445,Venezuela (Bolivarian Republic of),2010,2010Venezuela (Bolivarian Republic of),0,0,5,0,0,0,5,0,0,0,0,0,0,0,5
27446,Venezuela (Bolivarian Republic of),2010,2010Venezuela (Bolivarian Republic of),0,0,5,8,0,0,13,0,0,0,11,0,0,11,24
27447,Venezuela (Bolivarian Republic of),2010,2010Venezuela (Bolivarian Republic of),0,0,8,0,0,0,8,0,0,0,5,0,0,5,13
27448,Venezuela (Bolivarian Republic of),2010,2010Venezuela (Bolivarian Republic of),0,7,0,0,0,0,7,0,0,0,10,0,0,10,17
27449,Venezuela (Bolivarian Republic of),2010,2010Venezuela (Bolivarian Republic of),6,11,11,66,0,0,94,7,13,13,85,5,0,123,217
27450,Venezuela (Bolivarian Republic of),2011,2011Venezuela (Bolivarian Republic of),0,0,0,0,0,0,0,0,0,0,0,0,0,0,6512
27451,Venezuela (Bolivarian Republic of),2011,2011Venezuela (Bolivarian Republic of),0,0,0,0,0,0,0,0,0,0,0,0,7,7,7
27452,Venezuela (Bolivarian Republic of),2011,2011Venezuela (Bolivarian Republic of),0,0,0,0,0,0,0,0,0,0,5,0,0,5,5
27453,Venezuela (Bolivarian Republic of),2011,2011Venezuela (Bolivarian Republic of),0,0,0,0,0,0,0,0,0,0,11,0,0,11,16
27454,Venezuela (Bolivarian Republic of),2011,2011Venezuela (Bolivarian Republic of),0,0,0,5,0,0,5,0,0,0,5,0,0,5,10
27455,Venezuela (Bolivarian Republic of),2011,2011Venezuela (Bolivarian Republic of),0,0,5,6,0,0,11,0,0,0,0,0,0,0,11
27456,Venezuela (Bolivarian Republic of),2011,2011Venezuela (Bolivarian Republic of),0,0,5,6,0,0,11,0,0,5,8,0,0,13,24
27457,Venezuela (Bolivarian Republic of),2011,2011Venezuela (Bolivarian Republic of),0,5,0,0,0,0,5,0,0,0,0,0,0,0,5
27458,Venezuela (Bolivarian Republic of),2011,2011Venezuela (Bolivarian Republic of),0,7,0,0,0,0,7,0,0,0,10,0,0,10,17
27459,Venezuela (Bolivarian Republic of),2011,2011Venezuela (Bolivarian Republic of),0,18,12,80,0,0,110,0,14,19,78,0,0,111,742
27460,Venezuela (Bolivarian Republic of),2011,2011Venezuela (Bolivarian Republic of),5,0,0,0,0,0,5,0,0,0,0,0,0,0,5
27461,Venezuela (Bolivarian Republic of),2011,2011Venezuela (Bolivarian Republic of),6,11,11,68,0,0,96,7,13,13,87,5,0,125,221
27462,Venezuela (Bolivarian Republic of),2012,2012Venezuela (Bolivarian Republic of),0,0,0,0,0,0,0,0,0,0,0,0,0,0,7076
27463,Venezuela (Bolivarian Republic of),2012,2012Venezuela (Bolivarian Republic of),0,0,0,0,0,0,0,0,0,0,0,0,7,7,7
27464,Venezuela (Bolivarian Republic of),2012,2012Venezuela (Bolivarian Republic of),0,0,0,0,0,0,0,0,0,0,9,0,0,9,9
27465,Venezuela (Bolivarian Republic of),2012,2012Venezuela (Bolivarian Republic of),0,0,0,10,0,0,10,0,0,0,7,0,0,7,17
27466,Venezuela (Bolivarian Republic of),2012,2012Venezuela (Bolivarian Republic of),0,0,5,0,0,0,5,0,0,0,8,0,0,8,13
27467,Venezuela (Bolivarian Republic of),2012,2012Venezuela (Bolivarian Republic of),0,0,5,6,0,0,11,0,0,0,7,0,0,7,18
27468,Venezuela (Bolivarian Republic of),2012,2012Venezuela (Bolivarian Republic of),0,0,5,13,0,0,18,0,0,5,7,0,0,12,30
27469,Venezuela (Bolivarian Republic of),2012,2012Venezuela (Bolivarian Republic of),0,0,7,0,0,0,7,0,0,0,0,0,0,0,7
27470,Venezuela (Bolivarian Republic of),2012,2012Venezuela (Bolivarian Republic of),0,5,0,0,0,0,5,0,0,0,0,0,0,0,10
27471,Venezuela (Bolivarian Republic of),2012,2012Venezuela (Bolivarian Republic of),0,8,7,28,0,0,43,0,0,8,23,0,0,31,797
27472,Venezuela (Bolivarian Republic of),2012,2012Venezuela (Bolivarian Republic of),6,11,11,68,0,0,96,7,13,13,86,5,0,124,220
27473,Venezuela (Bolivarian Republic of),2013,2013Venezuela (Bolivarian Republic of),0,0,0,0,0,0,0,0,0,0,0,0,0,0,7242
27474,Venezuela (Bolivarian Republic of),2013,2013Venezuela (Bolivarian Republic of),0,0,0,0,0,0,0,0,0,5,0,0,0,5,5
27475,Venezuela (Bolivarian Republic of),2013,2013Venezuela (Bolivarian Republic of),0,0,0,0,0,8,8,0,0,0,0,0,0,0,8
27476,Venezuela (Bolivarian Republic of),2013,2013Venezuela (Bolivarian Republic of),0,0,0,5,0,0,5,0,0,0,5,0,0,5,10
27477,Venezuela (Bolivarian Republic of),2013,2013Venezuela (Bolivarian Republic of),0,0,5,0,0,0,5,0,0,0,9,0,0,9,14
27478,Venezuela (Bolivarian Republic of),2013,2013Venezuela (Bolivarian Republic of),0,0,5,6,0,0,11,0,0,0,7,0,0,7,18
27479,Venezuela (Bolivarian Republic of),2013,2013Venezuela (Bolivarian Republic of),0,0,7,0,0,0,7,0,0,0,0,0,0,0,7
27480,Venezuela (Bolivarian Republic of),2013,2013Venezuela (Bolivarian Republic of),0,5,0,0,0,0,5,0,0,0,0,0,0,0,5
27481,Venezuela (Bolivarian Republic of),2013,2013Venezuela (Bolivarian Republic of),0,5,0,5,0,0,10,0,0,0,5,0,0,5,15
27482,Venezuela (Bolivarian Republic of),2013,2013Venezuela (Bolivarian Republic of),0,5,0,17,0,0,22,0,8,0,20,0,0,28,837
27483,Venezuela (Bolivarian Republic of),2013,2013Venezuela (Bolivarian Republic of),0,8,0,0,0,0,8,0,0,0,6,0,0,6,14
27484,Venezuela (Bolivarian Republic of),2013,2013Venezuela (Bolivarian Republic of),6,11,11,68,0,0,96,7,13,13,87,5,0,125,221
27485,Venezuela (Bolivarian Republic of),2014,2014Venezuela (Bolivarian Republic of),0,0,0,0,0,0,0,0,0,0,0,0,0,0,7053
27486,Venezuela (Bolivarian Republic of),2014,2014Venezuela (Bolivarian Republic of),0,0,0,0,0,0,0,0,5,0,0,0,0,5,5
27487,Venezuela (Bolivarian Republic of),2014,2014Venezuela (Bolivarian Republic of),0,0,0,0,0,6,6,0,0,0,0,0,6,6,12
27488,Venezuela (Bolivarian Republic of),2014,2014Venezuela (Bolivarian Republic of),0,0,0,7,0,0,7,0,0,0,10,0,0,10,17
27489,Venezuela (Bolivarian Republic of),2014,2014Venezuela (Bolivarian Republic of),0,0,5,0,0,0,5,0,0,0,9,0,0,9,14
27490,Venezuela (Bolivarian Republic of),2014,2014Venezuela (Bolivarian Republic of),0,0,5,7,0,0,12,0,0,0,15,0,0,15,27
27491,Venezuela (Bolivarian Republic of),2014,2014Venezuela (Bolivarian Republic of),0,0,7,10,0,0,17,0,0,0,10,0,0,10,27
27492,Venezuela (Bolivarian Republic of),2014,2014Venezuela (Bolivarian Republic of),0,5,0,0,0,0,5,0,0,0,0,0,0,0,5
27493,Venezuela (Bolivarian Republic of),2014,2014Venezuela (Bolivarian Republic of),5,9,0,27,0,0,41,0,9,0,40,0,0,49,849
27494,Venezuela (Bolivarian Republic of),2015,2015Venezuela (Bolivarian Republic of),0,0,0,0,0,0,0,0,0,0,0,0,0,0,7310
27495,Venezuela (Bolivarian Republic of),2015,2015Venezuela (Bolivarian Republic of),0,0,0,0,0,0,0,0,0,0,6,0,0,6,6
27496,Venezuela (Bolivarian Republic of),2015,2015Venezuela (Bolivarian Republic of),0,0,0,0,0,6,6,0,0,0,0,0,0,0,6
27497,Venezuela (Bolivarian Republic of),2015,2015Venezuela (Bolivarian Republic of),0,0,0,0,0,15,15,0,0,0,0,0,17,17,32
27498,Venezuela (Bolivarian Republic of),2015,2015Venezuela (Bolivarian Republic of),0,0,0,5,0,0,5,0,0,0,0,0,0,0,5
27499,Venezuela (Bolivarian Republic of),2015,2015Venezuela (Bolivarian Republic of),0,0,5,8,0,0,13,0,0,0,15,0,0,15,28
27500,Venezuela (Bolivarian Republic of),2015,2015Venezuela (Bolivarian Republic of),0,0,5,13,0,0,18,5,0,5,11,0,0,21,39
27501,Venezuela (Bolivarian Republic of),2015,2015Venezuela (Bolivarian Republic of),0,0,7,0,0,0,7,0,0,0,0,0,0,0,7
27502,Venezuela (Bolivarian Republic of),2015,2015Venezuela (Bolivarian Republic of),0,5,0,0,0,0,5,0,0,0,0,0,0,0,5
27503,Venezuela (Bolivarian Republic of),2015,2015Venezuela (Bolivarian Republic of),0,5,0,0,0,0,5,0,5,0,7,0,0,12,17
27504,Venezuela (Bolivarian Republic of),2016,2016Venezuela (Bolivarian Republic of),0,0,0,0,0,0,0,0,0,0,0,0,0,0,6110
27505,Venezuela (Bolivarian Republic of),2016,2016Venezuela (Bolivarian Republic of),0,0,0,0,0,0,0,0,0,0,7,0,0,7,7
27506,Venezuela (Bolivarian Republic of),2016,2016Venezuela (Bolivarian Republic of),0,0,0,0,0,0,0,5,0,0,0,0,0,5,5
27507,Venezuela (Bolivarian Republic of),2016,2016Venezuela (Bolivarian Republic of),0,0,0,0,0,6,6,0,0,0,0,0,0,0,6
27508,Venezuela (Bolivarian Republic of),2016,2016Venezuela (Bolivarian Republic of),0,0,0,0,0,23,23,0,0,0,0,0,25,25,48
27509,Venezuela (Bolivarian Republic of),2016,2016Venezuela (Bolivarian Republic of),0,0,0,0,0,108,108,0,0,0,0,0,161,161,269
27510,Venezuela (Bolivarian Republic of),2016,2016Venezuela (Bolivarian Republic of),0,0,0,5,0,0,5,0,0,0,0,0,0,0,5
27511,Venezuela (Bolivarian Republic of),2016,2016Venezuela (Bolivarian Republic of),0,0,5,9,0,0,14,0,0,0,16,0,0,16,30
27512,Venezuela (Bolivarian Republic of),2016,2016Venezuela (Bolivarian Republic of),0,0,5,16,0,0,21,5,0,5,12,0,0,22,43
27513,Venezuela (Bolivarian Republic of),2016,2016Venezuela (Bolivarian Republic of),0,0,6,0,0,0,6,0,0,0,0,0,0,0,6
27514,Venezuela (Bolivarian Republic of),2016,2016Venezuela (Bolivarian Republic of),0,0,8,51,0,0,59,0,0,0,59,5,0,64,963
27515,Venezuela (Bolivarian Republic of),2016,2016Venezuela (Bolivarian Republic of),0,5,0,0,0,0,5,0,0,0,0,0,0,0,5
27516,Venezuela (Bolivarian Republic of),2016,2016Venezuela (Bolivarian Republic of),0,5,0,0,0,0,5,0,0,0,11,0,0,11,16
27517,Venezuela (Bolivarian Republic of),2016,2016Venezuela (Bolivarian Republic of),0,5,0,8,0,0,13,0,5,0,12,0,0,17,30
27518,Venezuela (Bolivarian Republic of),2017,2017Venezuela (Bolivarian Republic of),0,0,0,0,0,0,0,0,0,0,0,0,0,0,8539
27519,Venezuela (Bolivarian Republic of),2017,2017Venezuela (Bolivarian Republic of),0,0,0,0,0,0,0,0,0,0,5,0,0,5,10
27520,Venezuela (Bolivarian Republic of),2017,2017Venezuela (Bolivarian Republic of),0,0,0,0,0,5,5,0,0,0,0,0,5,5,10
27521,Venezuela (Bolivarian Republic of),2017,2017Venezuela (Bolivarian Republic of),0,0,0,0,0,69,69,0,0,0,0,0,54,54,123
27522,Venezuela (Bolivarian Republic of),2017,2017Venezuela (Bolivarian Republic of),0,0,0,0,0,136,136,0,0,0,0,0,202,202,338
27523,Venezuela (Bolivarian Republic of),2017,2017Venezuela (Bolivarian Republic of),0,0,0,0,5,0,5,0,0,0,0,0,0,0,5
27524,Venezuela (Bolivarian Republic of),2017,2017Venezuela (Bolivarian Republic of),0,0,0,5,0,0,5,0,0,0,6,0,0,6,11
27525,Venezuela (Bolivarian Republic of),2017,2017Venezuela (Bolivarian Republic of),0,0,5,0,0,0,5,0,0,0,0,0,0,0,5
27526,Venezuela (Bolivarian Republic of),2017,2017Venezuela (Bolivarian Republic of),0,0,5,12,0,0,17,0,0,0,16,0,0,16,33
27527,Venezuela (Bolivarian Republic of),2017,2017Venezuela (Bolivarian Republic of),0,0,8,17,0,0,25,0,0,5,17,0,0,22,47
27528,Venezuela (Bolivarian Republic of),2017,2017Venezuela (Bolivarian Republic of),0,5,0,0,0,0,5,0,0,0,0,0,0,0,10
27529,Venezuela (Bolivarian Republic of),2017,2017Venezuela (Bolivarian Republic of),5,0,9,5,7,0,26,11,0,7,12,5,0,35,61
27530,Venezuela (Bolivarian Republic of),2017,2017Venezuela (Bolivarian Republic of),7,5,0,20,0,0,32,6,5,0,37,0,0,48,80
27531,Venezuela (Bolivarian Republic of),2018,2018Venezuela (Bolivarian Republic of),0,0,0,0,0,0,0,0,0,0,0,0,0,0,18502
27532,Venezuela (Bolivarian Republic of),2018,2018Venezuela (Bolivarian Republic of),0,0,0,0,0,169,169,0,0,0,0,0,135,135,304
27533,Venezuela (Bolivarian Republic of),2018,2018Venezuela (Bolivarian Republic of),0,0,0,5,0,0,5,0,5,0,0,0,0,5,15
27534,Venezuela (Bolivarian Republic of),2018,2018Venezuela (Bolivarian Republic of),0,0,0,8,0,0,8,0,0,0,8,0,0,8,16
27535,Venezuela (Bolivarian Republic of),2018,2018Venezuela (Bolivarian Republic of),0,0,0,10,0,0,10,0,0,5,14,0,0,19,29
27536,Venezuela (Bolivarian Republic of),2018,2018Venezuela (Bolivarian Republic of),0,0,5,0,0,0,5,0,0,0,0,0,0,0,5
27537,Venezuela (Bolivarian Republic of),2018,2018Venezuela (Bolivarian Republic of),0,0,5,6,0,0,11,0,0,0,6,0,0,6,17
27538,Venezuela (Bolivarian Republic of),2018,2018Venezuela (Bolivarian Republic of),0,0,14,24,0,0,38,18,5,7,26,0,0,56,94
27539,Venezuela (Bolivarian Republic of),2018,2018Venezuela (Bolivarian Republic of),0,6,0,0,0,0,6,0,0,0,0,0,0,0,6
27540,Venezuela (Bolivarian Republic of),2018,2018Venezuela (Bolivarian Republic of),6,23,15,133,7,0,184,9,23,16,136,10,0,194,1876
27541,Venezuela (Bolivarian Republic of),2018,2018Venezuela (Bolivarian Republic of),8,7,7,49,9,0,80,11,14,0,78,0,0,103,183
27542,Venezuela (Bolivarian Republic of),2019,2019Venezuela (Bolivarian Republic of),0,0,0,0,0,0,0,0,0,0,0,0,0,0,91494
27543,Venezuela (Bolivarian Republic of),2019,2019Venezuela (Bolivarian Republic of),0,0,0,0,0,303,303,0,0,0,0,0,248,248,551
27544,Venezuela (Bolivarian Republic of),2019,2019Venezuela (Bolivarian Republic of),0,0,0,5,0,0,5,0,0,0,5,0,0,5,15
27545,Venezuela (Bolivarian Republic of),2019,2019Venezuela (Bolivarian Republic of),0,0,0,14,5,0,19,0,0,5,22,0,0,27,46
27546,Venezuela (Bolivarian Republic of),2019,2019Venezuela (Bolivarian Republic of),0,0,5,0,0,0,5,0,0,0,0,0,0,0,5
27547,Venezuela (Bolivarian Republic of),2019,2019Venezuela (Bolivarian Republic of),0,14,9,36,0,136,195,0,7,5,40,6,172,230,425
27548,Venezuela (Bolivarian Republic of),2019,2019Venezuela (Bolivarian Republic of),5,5,0,25,6,0,41,0,7,0,26,0,0,33,74
27549,Venezuela (Bolivarian Republic of),2019,2019Venezuela (Bolivarian Republic of),6,9,6,111,7,0,139,11,10,7,137,5,0,170,309
27550,Venezuela (Bolivarian Republic of),2019,2019Venezuela (Bolivarian Republic of),11,21,14,87,12,0,145,11,24,11,124,5,0,175,320
27551,Venezuela (Bolivarian Republic of),2020,2020Venezuela (Bolivarian Republic of),0,0,0,0,0,0,0,0,0,0,0,0,0,0,163052
27552,Venezuela (Bolivarian Republic of),2020,2020Venezuela (Bolivarian Republic of),0,0,0,0,0,0,0,0,0,0,0,0,5,5,5
27553,Venezuela (Bolivarian Republic of),2020,2020Venezuela (Bolivarian Republic of),0,0,0,0,0,205,205,0,0,0,0,0,194,194,399
27554,Venezuela (Bolivarian Republic of),2020,2020Venezuela (Bolivarian Republic of),0,0,0,5,0,0,5,0,0,0,0,0,0,0,5
27555,Venezuela (Bolivarian Republic of),2020,2020Venezuela (Bolivarian Republic of),0,0,0,6,5,0,11,0,0,0,14,0,0,14,39
27556,Venezuela (Bolivarian Republic of),2020,2020Venezuela (Bolivarian Republic of),0,0,0,9,0,0,9,0,0,0,5,0,0,5,14
27557,Venezuela (Bolivarian Republic of),2020,2020Venezuela (Bolivarian Republic of),0,0,5,0,0,0,5,0,0,0,0,0,0,0,5
27558,Venezuela (Bolivarian Republic of),2020,2020Venezuela (Bolivarian Republic of),0,7,0,34,7,0,48,9,0,0,39,5,0,53,101
27559,Venezuela (Bolivarian Republic of),2020,2020Venezuela (Bolivarian Republic of),0,23,0,189,76,27,315,0,27,0,138,39,26,230,3524
27560,Venezuela (Bolivarian Republic of),2020,2020Venezuela (Bolivarian Republic of),5,10,6,110,11,0,142,10,11,5,138,6,0,170,312
27561,Venezuela (Bolivarian Republic of),2020,2020Venezuela (Bolivarian Republic of),8,20,10,65,11,0,114,13,23,7,62,6,0,111,225
27562,Venezuela (Bolivarian Republic of),2020,2020Venezuela (Bolivarian Republic of),9,34,26,127,5,0,201,13,42,30,119,5,0,209,410
27563,Venezuela (Bolivarian Republic of),2020,2020Venezuela (Bolivarian Republic of),18,48,70,239,0,0,375,38,63,66,224,5,0,396,771
27564,Venezuela (Bolivarian Republic of),2020,2020Venezuela (Bolivarian Republic of),19,20,6,66,0,0,111,24,20,8,74,5,0,131,242
27565,Venezuela (Bolivarian Republic of),2020,2020Venezuela (Bolivarian Republic of),24,35,31,224,43,0,357,24,49,31,278,18,0,400,757
27566,Venezuela (Bolivarian Republic of),2020,2020Venezuela (Bolivarian Republic of),31,52,38,373,16,0,510,40,62,32,544,8,0,686,1251
27567,Venezuela (Bolivarian Republic of),2021,2021Venezuela (Bolivarian Republic of),0,0,0,0,0,0,0,0,0,0,0,0,0,0,166770
27568,Venezuela (Bolivarian Republic of),2021,2021Venezuela (Bolivarian Republic of),0,0,0,0,0,0,0,0,0,7,0,0,0,7,7
27569,Venezuela (Bolivarian Republic of),2021,2021Venezuela (Bolivarian Republic of),0,0,0,5,0,0,5,0,0,0,0,0,0,0,5
27570,Venezuela (Bolivarian Republic of),2021,2021Venezuela (Bolivarian Republic of),0,0,0,7,0,0,7,0,0,0,5,0,0,5,12
27571,Venezuela (Bolivarian Republic of),2021,2021Venezuela (Bolivarian Republic of),0,0,0,8,5,0,13,0,0,0,16,0,0,16,53
27572,Venezuela (Bolivarian Republic of),2021,2021Venezuela (Bolivarian Republic of),0,0,5,0,0,0,5,0,0,0,0,0,0,0,5
27573,Venezuela (Bolivarian Republic of),2021,2021Venezuela (Bolivarian Republic of),0,0,5,0,0,0,5,0,0,0,7,0,0,7,12
27574,Venezuela (Bolivarian Republic of),2021,2021Venezuela (Bolivarian Republic of),0,0,5,7,0,0,12,0,0,5,5,0,0,10,22
27575,Venezuela (Bolivarian Republic of),2021,2021Venezuela (Bolivarian Republic of),0,0,5,13,0,0,18,0,6,0,12,0,0,18,36
27576,Venezuela (Bolivarian Republic of),2021,2021Venezuela (Bolivarian Republic of),0,7,0,43,12,0,62,5,5,0,63,5,0,78,140
27577,Venezuela (Bolivarian Republic of),2021,2021Venezuela (Bolivarian Republic of),0,14,10,110,12,0,146,5,14,5,138,7,0,169,315
27578,Venezuela (Bolivarian Republic of),2021,2021Venezuela (Bolivarian Republic of),5,106,102,457,0,0,670,14,125,85,393,10,0,627,1297
27579,Venezuela (Bolivarian Republic of),2021,2021Venezuela (Bolivarian Republic of),11,49,26,412,171,27,696,12,62,25,325,94,26,544,4108
27580,Venezuela (Bolivarian Republic of),2021,2021Venezuela (Bolivarian Republic of),13,61,43,261,9,0,387,22,81,48,253,7,0,411,798
27581,Venezuela (Bolivarian Republic of),2021,2021Venezuela (Bolivarian Republic of),15,37,19,123,12,0,206,18,45,20,120,5,0,208,414
27582,Venezuela (Bolivarian Republic of),2021,2021Venezuela (Bolivarian Republic of),17,192,183,1438,52,0,1882,44,227,166,1701,78,0,2216,4098
27583,Venezuela (Bolivarian Republic of),2021,2021Venezuela (Bolivarian Republic of),32,58,43,340,63,0,536,36,61,43,412,25,0,577,1113
27584,Venezuela (Bolivarian Republic of),2021,2021Venezuela (Bolivarian Republic of),76,166,112,1061,80,0,1495,76,176,116,1501,48,0,1917,3412
27585,Venezuela (Bolivarian Republic of),2021,2021Venezuela (Bolivarian Republic of),204,750,441,6585,658,0,8638,216,718,525,6123,365,0,7947,16585
27586,Viet Nam,2001,2001Viet Nam,0,0,0,0,0,0,0,0,0,0,0,0,0,0,40732
27587,Viet Nam,2001,2001Viet Nam,0,0,0,0,0,0,0,0,0,0,7,0,0,7,7
27588,Viet Nam,2001,2001Viet Nam,0,0,0,0,0,0,0,0,0,5,7,0,0,12,12
27589,Viet Nam,2001,2001Viet Nam,0,0,0,0,0,110,110,0,0,0,0,0,146,146,256
27590,Viet Nam,2001,2001Viet Nam,0,0,0,0,0,921,921,0,0,0,0,0,1363,1363,2284
27591,Viet Nam,2001,2001Viet Nam,0,0,0,0,0,1284,1284,0,0,0,0,0,1452,1452,2736
27592,Viet Nam,2001,2001Viet Nam,0,0,0,0,0,5389,5389,0,0,0,0,0,6428,6428,11817
27593,Viet Nam,2001,2001Viet Nam,0,0,0,5,0,0,5,0,0,0,5,0,0,5,10
27594,Viet Nam,2001,2001Viet Nam,0,0,5,25,9,0,39,0,0,5,24,7,0,36,75
27595,Viet Nam,2001,2001Viet Nam,0,0,6,0,0,0,6,0,0,0,0,0,0,0,6
27596,Viet Nam,2001,2001Viet Nam,5105,11432,9797,51787,11399,51256,140776,7449,12876,11038,54572,11143,57422,154500,295276
27597,Viet Nam,2002,2002Viet Nam,0,0,0,0,0,0,0,0,0,0,0,0,0,0,61021
27598,Viet Nam,2002,2002Viet Nam,0,0,0,0,0,0,0,0,0,0,5,0,0,5,10
27599,Viet Nam,2002,2002Viet Nam,0,0,0,0,0,0,0,0,0,0,6,0,0,6,6
27600,Viet Nam,2002,2002Viet Nam,0,0,0,0,0,0,0,0,0,5,0,0,0,5,5
27601,Viet Nam,2002,2002Viet Nam,0,0,0,0,0,963,963,0,0,0,0,0,943,943,1906
27602,Viet Nam,2002,2002Viet Nam,0,0,0,0,0,1164,1164,0,0,0,0,0,1334,1334,2513
27603,Viet Nam,2002,2002Viet Nam,0,0,0,0,0,4917,4917,0,0,0,0,0,5901,5901,10818
27604,Viet Nam,2002,2002Viet Nam,6,0,0,25,10,0,41,0,0,5,24,6,0,35,76
27605,Viet Nam,2002,2002Viet Nam,10,8,7,27,0,0,52,6,11,9,80,0,0,106,158
27606,Viet Nam,2002,2002Viet Nam,7663,16627,14252,84431,17821,0,140794,10786,19181,16440,92711,17307,0,156425,297219
27607,Viet Nam,2003,2003Viet Nam,0,0,0,0,0,0,0,0,0,0,0,0,0,0,50400
27608,Viet Nam,2003,2003Viet Nam,0,0,0,0,0,0,0,0,0,0,6,0,0,6,6
27609,Viet Nam,2003,2003Viet Nam,0,0,0,0,0,0,0,0,0,5,0,0,0,5,5
27610,Viet Nam,2003,2003Viet Nam,0,0,0,0,0,700,700,0,0,0,0,0,991,991,1691
27611,Viet Nam,2003,2003Viet Nam,0,0,0,0,0,1091,1091,0,0,0,0,0,1260,1260,2363
27612,Viet Nam,2003,2003Viet Nam,0,0,0,0,0,4235,4235,0,0,0,0,0,5039,5039,9274
27613,Viet Nam,2003,2003Viet Nam,0,0,0,8,0,0,8,0,0,0,0,0,0,0,8
27614,Viet Nam,2003,2003Viet Nam,0,0,0,9,0,0,9,0,0,0,24,0,0,24,33
27615,Viet Nam,2003,2003Viet Nam,0,0,5,8,0,0,13,0,0,5,9,0,0,14,27
27616,Viet Nam,2003,2003Viet Nam,6,0,0,25,10,0,41,0,0,5,24,6,0,35,76
27617,Viet Nam,2003,2003Viet Nam,8061,17023,14596,84339,18454,0,142473,11197,19424,16649,91944,17600,0,156814,299287
27618,Viet Nam,2004,2004Viet Nam,0,0,0,0,0,0,0,0,0,0,0,0,0,0,46341
27619,Viet Nam,2004,2004Viet Nam,0,0,0,0,0,0,0,0,0,0,6,0,0,6,6
27620,Viet Nam,2004,2004Viet Nam,0,0,0,0,0,0,0,0,0,0,9,0,0,9,9
27621,Viet Nam,2004,2004Viet Nam,0,0,0,0,0,0,0,0,0,5,0,0,0,5,5
27622,Viet Nam,2004,2004Viet Nam,0,0,0,0,0,560,560,0,0,0,0,0,859,859,1419
27623,Viet Nam,2004,2004Viet Nam,0,0,0,0,0,143658,143658,0,0,0,0,0,155629,155629,299287
27624,Viet Nam,2004,2004Viet Nam,0,0,0,5,0,0,5,0,0,0,8,0,0,8,13
27625,Viet Nam,2004,2004Viet Nam,0,0,0,6,0,1020,1026,5,0,0,0,0,1183,1188,2214
27626,Viet Nam,2004,2004Viet Nam,0,0,0,17,0,0,17,0,0,0,11,5,0,16,33
27627,Viet Nam,2004,2004Viet Nam,0,0,5,8,0,0,13,0,0,5,9,0,0,14,27
27628,Viet Nam,2004,2004Viet Nam,0,0,6,0,0,0,6,0,0,0,0,0,0,0,6
27629,Viet Nam,2004,2004Viet Nam,6,0,0,25,10,0,41,0,0,5,24,6,0,35,76
27630,Viet Nam,2004,2004Viet Nam,8,15,13,48,0,0,84,8,24,17,224,0,0,273,357
27631,Viet Nam,2005,2005Viet Nam,0,0,0,0,0,0,0,0,0,0,0,0,0,0,43068
27632,Viet Nam,2005,2005Viet Nam,0,0,0,0,0,0,0,0,0,0,5,0,0,5,10
27633,Viet Nam,2005,2005Viet Nam,0,0,0,0,0,0,0,0,0,5,0,0,0,5,5
27634,Viet Nam,2005,2005Viet Nam,0,0,0,0,0,520,520,0,0,0,0,0,765,765,1285
27635,Viet Nam,2005,2005Viet Nam,0,0,0,0,0,4039,4039,0,0,0,0,0,4793,4793,8832
27636,Viet Nam,2005,2005Viet Nam,0,0,0,5,0,956,961,5,0,0,0,0,1106,1111,2072
27637,Viet Nam,2005,2005Viet Nam,0,0,0,11,0,0,11,0,0,0,8,0,0,8,19
27638,Viet Nam,2005,2005Viet Nam,0,0,0,17,0,0,17,0,0,0,11,5,0,16,33
27639,Viet Nam,2005,2005Viet Nam,0,0,5,8,0,0,13,0,0,5,9,0,0,14,27
27640,Viet Nam,2005,2005Viet Nam,0,0,6,0,0,0,6,0,0,0,0,0,0,0,6
27641,Viet Nam,2005,2005Viet Nam,0,0,8,22,15,0,45,0,9,0,17,5,0,31,76
27642,Viet Nam,2005,2005Viet Nam,0,5,0,0,0,697,702,0,5,0,0,0,1121,1126,1828
27643,Viet Nam,2005,2005Viet Nam,0,13,7,23,0,0,43,10,5,5,47,0,0,67,110
27644,Viet Nam,2005,2005Viet Nam,8380,16326,13995,84970,20241,0,143912,11370,18557,15906,91532,19620,0,156985,300897
27645,Viet Nam,2006,2006Viet Nam,0,0,0,0,0,0,0,0,0,0,0,0,0,0,360239
27646,Viet Nam,2006,2006Viet Nam,0,0,0,0,0,0,0,0,0,0,0,0,5,5,5
27647,Viet Nam,2006,2006Viet Nam,0,0,0,0,0,0,0,0,0,0,5,0,0,5,10
27648,Viet Nam,2006,2006Viet Nam,0,0,0,0,0,0,0,0,0,5,0,0,0,5,5
27649,Viet Nam,2006,2006Viet Nam,0,0,0,0,0,36,36,0,0,0,0,0,52,52,88
27650,Viet Nam,2006,2006Viet Nam,0,0,0,0,0,340,340,0,0,0,0,0,792,792,1132
27651,Viet Nam,2006,2006Viet Nam,0,0,0,0,0,905,905,0,0,0,0,0,1039,1039,1944
27652,Viet Nam,2006,2006Viet Nam,0,0,0,0,0,3988,3988,0,0,0,0,0,4762,4762,8750
27653,Viet Nam,2006,2006Viet Nam,0,0,0,5,0,697,702,0,0,5,5,0,1117,1127,1829
27654,Viet Nam,2006,2006Viet Nam,0,0,0,13,13,0,26,0,0,0,17,7,0,24,50
27655,Viet Nam,2006,2006Viet Nam,0,0,0,17,0,0,17,0,0,0,10,5,0,15,32
27656,Viet Nam,2006,2006Viet Nam,0,0,5,8,0,0,13,0,0,5,9,0,0,14,27
27657,Viet Nam,2006,2006Viet Nam,0,0,6,0,0,0,6,0,0,0,0,0,0,0,6
27658,Viet Nam,2006,2006Viet Nam,0,5,5,12,0,0,22,0,0,10,36,0,0,46,68
27659,Viet Nam,2006,2006Viet Nam,6,7,8,21,0,0,42,9,9,12,21,0,0,51,93
27660,Viet Nam,2007,2007Viet Nam,0,0,0,0,0,0,0,0,0,0,0,0,0,0,315917
27661,Viet Nam,2007,2007Viet Nam,0,0,0,0,0,0,0,0,0,0,5,0,0,5,15
27662,Viet Nam,2007,2007Viet Nam,0,0,0,0,0,0,0,0,0,0,6,0,0,6,6
27663,Viet Nam,2007,2007Viet Nam,0,0,0,0,0,0,0,0,0,5,0,0,0,5,5
27664,Viet Nam,2007,2007Viet Nam,0,0,0,0,0,0,0,0,0,7,0,0,0,7,7
27665,Viet Nam,2007,2007Viet Nam,0,0,0,0,0,31,31,0,0,0,0,0,49,49,80
27666,Viet Nam,2007,2007Viet Nam,0,0,0,0,0,351,351,0,0,0,0,0,624,624,975
27667,Viet Nam,2007,2007Viet Nam,0,0,0,0,0,3900,3900,0,0,0,0,0,4768,4768,8668
27668,Viet Nam,2007,2007Viet Nam,0,0,0,5,0,848,853,0,0,0,0,0,986,986,1839
27669,Viet Nam,2007,2007Viet Nam,0,0,0,12,0,0,12,0,0,6,11,0,0,17,29
27670,Viet Nam,2007,2007Viet Nam,0,0,0,17,0,0,17,0,0,0,10,5,0,15,32
27671,Viet Nam,2007,2007Viet Nam,0,0,5,0,0,0,5,0,0,0,0,0,0,0,5
27672,Viet Nam,2007,2007Viet Nam,0,0,6,0,0,0,6,0,0,0,0,0,0,0,6
27673,Viet Nam,2007,2007Viet Nam,0,0,8,7,0,0,15,0,5,5,7,0,0,17,32
27674,Viet Nam,2007,2007Viet Nam,5,5,16,41,0,0,67,0,19,10,58,0,0,87,154
27675,Viet Nam,2008,2008Viet Nam,0,0,0,0,0,0,0,0,0,0,0,0,0,0,316707
27676,Viet Nam,2008,2008Viet Nam,0,0,0,0,0,0,0,0,0,0,5,0,0,5,15
27677,Viet Nam,2008,2008Viet Nam,0,0,0,0,0,0,0,0,0,0,7,0,0,7,7
27678,Viet Nam,2008,2008Viet Nam,0,0,0,0,0,0,0,0,0,5,0,0,0,5,5
27679,Viet Nam,2008,2008Viet Nam,0,0,0,0,0,26,26,0,0,0,0,0,45,45,71
27680,Viet Nam,2008,2008Viet Nam,0,0,0,0,0,321,321,0,0,0,0,0,546,546,867
27681,Viet Nam,2008,2008Viet Nam,0,0,0,0,0,3886,3886,0,0,0,0,0,4697,4697,8583
27682,Viet Nam,2008,2008Viet Nam,0,0,0,5,0,788,793,0,0,0,6,0,907,913,1706
27683,Viet Nam,2008,2008Viet Nam,0,0,0,13,0,0,13,0,0,6,10,0,0,16,29
27684,Viet Nam,2008,2008Viet Nam,0,0,5,0,0,0,5,0,0,0,0,0,0,0,5
27685,Viet Nam,2008,2008Viet Nam,0,0,6,0,0,0,6,0,0,0,0,0,0,0,6
27686,Viet Nam,2008,2008Viet Nam,0,5,0,0,0,0,5,0,0,0,0,0,0,0,10
27687,Viet Nam,2008,2008Viet Nam,0,5,0,5,0,0,10,0,6,0,8,0,0,14,24
27688,Viet Nam,2008,2008Viet Nam,5,9,18,38,0,0,70,5,19,10,36,0,0,70,140
27689,Viet Nam,2009,2009Viet Nam,0,0,0,0,0,0,0,0,0,0,0,0,0,0,311493
27690,Viet Nam,2009,2009Viet Nam,0,0,0,0,0,0,0,0,0,0,5,0,0,5,20
27691,Viet Nam,2009,2009Viet Nam,0,0,0,0,0,0,0,0,0,0,7,0,0,7,7
27692,Viet Nam,2009,2009Viet Nam,0,0,0,0,0,0,0,0,0,5,0,0,0,5,5
27693,Viet Nam,2009,2009Viet Nam,0,0,0,0,0,22,22,0,0,0,0,0,42,42,64
27694,Viet Nam,2009,2009Viet Nam,0,0,0,0,0,214,214,0,0,0,0,0,476,476,709
27695,Viet Nam,2009,2009Viet Nam,0,0,0,5,0,0,5,0,0,0,0,0,0,0,5
27696,Viet Nam,2009,2009Viet Nam,0,0,0,5,0,725,730,0,0,0,5,0,852,857,1587
27697,Viet Nam,2009,2009Viet Nam,0,0,0,6,0,0,6,0,0,0,0,0,0,0,6
27698,Viet Nam,2009,2009Viet Nam,0,0,0,13,0,0,13,0,5,0,10,0,0,15,28
27699,Viet Nam,2009,2009Viet Nam,0,0,5,0,0,0,5,0,0,0,0,0,0,0,5
27700,Viet Nam,2009,2009Viet Nam,0,5,0,0,0,0,5,0,0,0,0,0,0,0,10
27701,Viet Nam,2009,2009Viet Nam,0,9,14,34,0,0,57,0,17,10,23,0,0,50,107
27702,Viet Nam,2009,2009Viet Nam,7,0,0,9,0,0,16,0,6,0,11,5,0,22,38
27703,Viet Nam,2009,2009Viet Nam,69,260,1172,9167,786,0,11454,75,314,1213,11681,478,0,13761,25215
27704,Viet Nam,2010,2010Viet Nam,0,0,0,0,0,0,0,0,0,0,0,0,0,0,1837
27705,Viet Nam,2010,2010Viet Nam,0,0,0,0,0,0,0,0,0,0,5,0,0,5,25
27706,Viet Nam,2010,2010Viet Nam,0,0,0,0,0,0,0,0,0,0,7,0,0,7,7
27707,Viet Nam,2010,2010Viet Nam,0,0,0,0,0,21,21,0,0,0,0,0,38,38,59
27708,Viet Nam,2010,2010Viet Nam,0,0,0,0,0,246,246,0,0,0,0,0,338,338,584
27709,Viet Nam,2010,2010Viet Nam,0,0,0,0,0,3935,3935,0,0,0,0,0,4784,4784,8719
27710,Viet Nam,2010,2010Viet Nam,0,0,0,0,0,143912,143912,0,0,0,0,0,156985,156985,300897
27711,Viet Nam,2010,2010Viet Nam,0,0,0,5,0,676,681,0,0,0,6,0,797,803,1484
27712,Viet Nam,2010,2010Viet Nam,0,0,0,6,0,0,6,0,0,0,0,0,0,0,12
27713,Viet Nam,2010,2010Viet Nam,0,0,0,7,0,0,7,0,0,0,9,5,0,14,21
27714,Viet Nam,2010,2010Viet Nam,0,0,5,0,0,0,5,0,0,0,0,0,0,0,5
27715,Viet Nam,2010,2010Viet Nam,0,0,7,8,0,0,15,0,0,5,8,0,0,13,28
27716,Viet Nam,2010,2010Viet Nam,0,5,0,0,0,0,5,0,0,0,0,0,0,0,10
27717,Viet Nam,2010,2010Viet Nam,5,5,15,27,0,0,52,0,14,9,26,0,0,49,101
27718,Viet Nam,2010,2010Viet Nam,57,225,865,9257,823,0,11227,74,261,885,11949,522,0,13691,24918
27719,Viet Nam,2011,2011Viet Nam,0,0,0,0,0,0,0,0,0,0,0,0,0,0,1718
27720,Viet Nam,2011,2011Viet Nam,0,0,0,0,0,0,0,0,0,0,5,0,0,5,30
27721,Viet Nam,2011,2011Viet Nam,0,0,0,0,0,0,0,0,0,0,7,0,0,7,7
27722,Viet Nam,2011,2011Viet Nam,0,0,0,0,0,0,0,0,0,0,8,0,0,8,8
27723,Viet Nam,2011,2011Viet Nam,0,0,0,0,0,18,18,0,0,0,0,0,34,34,52
27724,Viet Nam,2011,2011Viet Nam,0,0,0,0,0,214,214,0,0,0,0,0,279,279,493
27725,Viet Nam,2011,2011Viet Nam,0,0,0,0,0,3894,3894,0,0,0,0,0,4760,4760,8654
27726,Viet Nam,2011,2011Viet Nam,0,0,0,0,0,143912,143912,0,0,0,0,0,156985,156985,300897
27727,Viet Nam,2011,2011Viet Nam,0,0,0,5,0,629,634,0,0,0,6,0,757,763,1397
27728,Viet Nam,2011,2011Viet Nam,0,0,0,6,0,0,6,0,0,0,0,0,0,0,6
27729,Viet Nam,2011,2011Viet Nam,0,0,0,9,0,0,9,0,5,0,8,0,0,13,22
27730,Viet Nam,2011,2011Viet Nam,0,0,0,9,0,0,9,0,6,0,16,0,0,22,31
27731,Viet Nam,2011,2011Viet Nam,0,0,5,0,0,0,5,0,0,0,0,0,0,0,5
27732,Viet Nam,2011,2011Viet Nam,0,0,7,22,0,0,29,5,8,5,34,0,0,52,81
27733,Viet Nam,2011,2011Viet Nam,0,5,0,0,0,0,5,0,0,0,0,0,0,0,5
27734,Viet Nam,2011,2011Viet Nam,5,6,9,32,0,0,52,0,8,14,13,0,0,35,161
27735,Viet Nam,2011,2011Viet Nam,57,201,615,9150,855,0,10878,58,228,617,11935,545,0,13383,24261
27736,Viet Nam,2012,2012Viet Nam,0,0,0,0,0,0,0,0,0,0,0,0,0,0,1479
27737,Viet Nam,2012,2012Viet Nam,0,0,0,0,0,0,0,0,0,0,5,0,0,5,20
27738,Viet Nam,2012,2012Viet Nam,0,0,0,0,0,0,0,0,0,0,7,0,0,7,7
27739,Viet Nam,2012,2012Viet Nam,0,0,0,0,0,0,0,0,0,0,8,0,0,8,8
27740,Viet Nam,2012,2012Viet Nam,0,0,0,0,0,0,0,0,9,0,0,0,0,9,9
27741,Viet Nam,2012,2012Viet Nam,0,0,0,0,0,14,14,0,0,0,0,0,34,34,48
27742,Viet Nam,2012,2012Viet Nam,0,0,0,0,0,14,14,0,0,0,0,0,51,51,65
27743,Viet Nam,2012,2012Viet Nam,0,0,0,0,0,125,125,0,0,0,0,0,233,233,358
27744,Viet Nam,2012,2012Viet Nam,0,0,0,0,0,3872,3872,0,0,0,0,0,4733,4733,8605
27745,Viet Nam,2012,2012Viet Nam,0,0,0,0,0,143912,143912,0,0,0,0,0,156985,156985,300897
27746,Viet Nam,2012,2012Viet Nam,0,0,0,5,0,608,613,0,0,0,0,0,727,727,1340
27747,Viet Nam,2012,2012Viet Nam,0,0,0,6,0,0,6,0,0,0,0,0,0,0,6
27748,Viet Nam,2012,2012Viet Nam,0,0,0,7,0,0,7,0,5,0,5,0,0,10,17
27749,Viet Nam,2012,2012Viet Nam,0,0,0,8,0,0,8,0,0,0,0,0,0,0,148
27750,Viet Nam,2012,2012Viet Nam,0,0,0,9,0,0,9,0,0,6,18,0,0,24,33
27751,Viet Nam,2012,2012Viet Nam,0,5,0,0,0,0,5,0,0,0,0,0,0,0,5
27752,Viet Nam,2012,2012Viet Nam,5,0,6,25,0,0,36,5,9,6,36,0,0,56,92
27753,Viet Nam,2012,2012Viet Nam,59,193,394,9012,923,0,10581,57,217,447,11907,590,0,13218,23799
27754,Viet Nam,2013,2013Viet Nam,0,0,0,0,0,0,0,0,0,0,0,0,0,0,1346
27755,Viet Nam,2013,2013Viet Nam,0,0,0,0,0,0,0,0,0,0,5,0,0,5,25
27756,Viet Nam,2013,2013Viet Nam,0,0,0,0,0,0,0,0,0,0,7,0,0,7,7
27757,Viet Nam,2013,2013Viet Nam,0,0,0,0,0,0,0,0,0,0,8,0,0,8,8
27758,Viet Nam,2013,2013Viet Nam,0,0,0,0,0,5,5,0,0,0,0,0,10,10,15
27759,Viet Nam,2013,2013Viet Nam,0,0,0,0,0,61,61,0,0,0,0,0,151,151,212
27760,Viet Nam,2013,2013Viet Nam,0,0,0,0,0,3810,3810,0,0,0,0,0,4718,4718,8528
27761,Viet Nam,2013,2013Viet Nam,0,0,0,0,0,143911,143911,0,0,0,0,0,156985,156985,300896
27762,Viet Nam,2013,2013Viet Nam,0,0,0,5,0,0,5,0,5,0,0,0,0,5,10
27763,Viet Nam,2013,2013Viet Nam,0,0,0,5,5,0,10,0,0,7,18,0,0,25,35
27764,Viet Nam,2013,2013Viet Nam,0,0,0,6,0,0,6,0,0,0,0,0,0,0,6
27765,Viet Nam,2013,2013Viet Nam,0,0,0,6,0,0,6,0,0,0,9,0,0,9,15
27766,Viet Nam,2013,2013Viet Nam,0,0,5,0,0,570,575,0,0,0,5,0,675,680,1255
27767,Viet Nam,2013,2013Viet Nam,0,5,0,0,0,0,5,0,0,0,0,0,0,0,137
27768,Viet Nam,2013,2013Viet Nam,5,9,5,34,0,0,53,6,6,8,41,5,0,66,119
27769,Viet Nam,2013,2013Viet Nam,6,21,23,353,127,0,530,6,24,28,756,151,0,965,1495
27770,Viet Nam,2014,2014Viet Nam,0,0,0,0,0,0,0,0,0,0,0,0,0,0,1210
27771,Viet Nam,2014,2014Viet Nam,0,0,0,0,0,0,0,0,0,0,8,0,0,8,8
27772,Viet Nam,2014,2014Viet Nam,0,0,0,0,0,0,0,0,0,0,9,0,0,9,9
27773,Viet Nam,2014,2014Viet Nam,0,0,0,0,0,21,21,0,0,0,0,0,47,47,68
27774,Viet Nam,2014,2014Viet Nam,0,0,0,0,0,3685,3685,0,0,0,0,0,4596,4596,8281
27775,Viet Nam,2014,2014Viet Nam,0,0,0,0,0,143911,143911,0,0,0,0,0,156985,156985,300896
27776,Viet Nam,2014,2014Viet Nam,0,0,0,5,0,0,5,0,0,0,0,0,0,0,131
27777,Viet Nam,2014,2014Viet Nam,0,0,0,5,5,0,10,0,0,0,18,5,0,23,33
27778,Viet Nam,2014,2014Viet Nam,0,0,0,6,0,0,6,0,0,0,0,0,0,0,6
27779,Viet Nam,2014,2014Viet Nam,0,0,0,6,0,0,6,0,0,0,9,0,0,9,15
27780,Viet Nam,2014,2014Viet Nam,0,0,0,7,0,0,7,0,0,0,0,0,0,0,7
27781,Viet Nam,2014,2014Viet Nam,0,0,5,0,0,542,547,0,0,0,5,0,651,656,1203
27782,Viet Nam,2014,2014Viet Nam,0,5,0,0,0,0,5,0,0,0,0,0,0,0,5
27783,Viet Nam,2014,2014Viet Nam,0,16,8,28,0,0,52,9,8,7,23,0,0,47,99
27784,Viet Nam,2014,2014Viet Nam,10,27,25,323,132,0,517,5,28,30,709,160,0,932,1449
27785,Viet Nam,2015,2015Viet Nam,0,0,0,0,0,0,0,0,0,0,0,0,0,0,302185
27786,Viet Nam,2015,2015Viet Nam,0,0,0,0,0,0,0,0,0,0,0,0,5,5,5
27787,Viet Nam,2015,2015Viet Nam,0,0,0,0,0,0,0,0,0,0,5,0,0,5,10
27788,Viet Nam,2015,2015Viet Nam,0,0,0,0,0,0,0,0,0,0,7,0,0,7,7
27789,Viet Nam,2015,2015Viet Nam,0,0,0,0,0,0,0,0,0,0,9,0,0,9,9
27790,Viet Nam,2015,2015Viet Nam,0,0,0,0,0,13,13,0,0,0,0,0,29,29,42
27791,Viet Nam,2015,2015Viet Nam,0,0,0,0,0,3612,3612,0,0,0,0,0,4520,4520,8132
27792,Viet Nam,2015,2015Viet Nam,0,0,0,5,5,0,10,0,0,0,30,5,0,35,45
27793,Viet Nam,2015,2015Viet Nam,0,0,0,6,0,0,6,0,0,0,0,0,0,0,6
27794,Viet Nam,2015,2015Viet Nam,0,0,0,7,0,0,7,0,0,0,0,0,0,0,1130
27795,Viet Nam,2015,2015Viet Nam,0,0,0,7,0,0,7,0,0,0,8,0,0,8,15
27796,Viet Nam,2015,2015Viet Nam,0,0,8,0,0,0,8,0,0,0,0,0,0,0,8
27797,Viet Nam,2015,2015Viet Nam,5,12,19,306,134,0,476,5,27,11,670,168,0,881,1357
27798,Viet Nam,2015,2015Viet Nam,8,23,13,47,5,0,96,18,16,17,49,5,0,105,201
27799,Viet Nam,2016,2016Viet Nam,0,0,0,0,0,0,0,0,0,0,0,0,0,0,318549
27800,Viet Nam,2016,2016Viet Nam,0,0,0,0,0,0,0,0,0,0,5,0,0,5,5
27801,Viet Nam,2016,2016Viet Nam,0,0,0,0,0,0,0,0,0,0,7,0,0,7,7
27802,Viet Nam,2016,2016Viet Nam,0,0,0,0,0,9,9,0,0,0,0,0,26,26,40
27803,Viet Nam,2016,2016Viet Nam,0,0,0,0,0,3548,3548,0,0,0,0,0,4460,4460,8008
27804,Viet Nam,2016,2016Viet Nam,0,0,0,0,5,0,5,0,0,0,0,0,0,0,5
27805,Viet Nam,2016,2016Viet Nam,0,0,0,6,0,0,6,0,0,0,9,0,0,9,15
27806,Viet Nam,2016,2016Viet Nam,0,0,0,8,0,482,490,0,0,0,0,0,594,594,1084
27807,Viet Nam,2016,2016Viet Nam,0,0,0,9,0,0,9,0,0,0,23,0,0,23,32
27808,Viet Nam,2016,2016Viet Nam,0,0,5,5,0,0,10,0,0,0,11,0,0,11,21
27809,Viet Nam,2016,2016Viet Nam,5,7,13,293,146,0,464,5,17,8,641,176,0,847,1311
27810,Viet Nam,2016,2016Viet Nam,13,24,20,59,5,0,121,23,26,19,70,5,0,143,264
27811,Viet Nam,2017,2017Viet Nam,0,0,0,0,0,0,0,0,0,0,0,0,0,0,323325
27812,Viet Nam,2017,2017Viet Nam,0,0,0,0,0,0,0,0,0,0,5,0,0,5,5
27813,Viet Nam,2017,2017Viet Nam,0,0,0,0,0,0,0,0,0,0,7,0,0,7,7
27814,Viet Nam,2017,2017Viet Nam,0,0,0,0,0,6,6,0,0,0,9,0,0,9,15
27815,Viet Nam,2017,2017Viet Nam,0,0,0,0,0,542,542,0,0,0,8,0,446,454,996
27816,Viet Nam,2017,2017Viet Nam,0,0,0,0,0,3502,3502,0,0,0,0,0,4409,4409,7911
27817,Viet Nam,2017,2017Viet Nam,0,0,0,0,5,0,5,0,0,0,0,0,0,0,5
27818,Viet Nam,2017,2017Viet Nam,0,0,0,6,0,0,6,0,0,0,0,0,0,0,6
27819,Viet Nam,2017,2017Viet Nam,0,0,0,6,0,0,6,0,0,0,9,0,0,9,15
27820,Viet Nam,2017,2017Viet Nam,0,0,0,9,0,0,9,0,0,5,18,0,0,23,32
27821,Viet Nam,2017,2017Viet Nam,0,0,7,5,0,0,12,0,0,6,0,0,0,6,18
27822,Viet Nam,2017,2017Viet Nam,5,7,13,273,156,0,454,5,12,7,607,194,0,825,1279
27823,Viet Nam,2017,2017Viet Nam,16,39,30,99,9,0,193,29,45,39,135,9,0,257,450
27824,Viet Nam,2018,2018Viet Nam,0,0,0,0,0,0,0,0,0,0,0,0,0,0,323694
27825,Viet Nam,2018,2018Viet Nam,0,0,0,0,0,8,8,0,0,0,0,0,0,0,8
27826,Viet Nam,2018,2018Viet Nam,0,0,0,0,0,415,415,0,0,0,7,0,508,515,930
27827,Viet Nam,2018,2018Viet Nam,0,0,0,0,0,3454,3454,0,0,0,0,0,4367,4367,7821
27828,Viet Nam,2018,2018Viet Nam,0,0,0,0,5,0,5,0,0,0,0,0,0,0,5
27829,Viet Nam,2018,2018Viet Nam,0,0,0,6,0,0,6,0,0,0,9,0,0,9,15
27830,Viet Nam,2018,2018Viet Nam,0,0,7,10,0,0,17,7,7,0,8,0,0,22,53
27831,Viet Nam,2018,2018Viet Nam,0,6,0,7,0,0,13,0,0,0,7,0,0,7,20
27832,Viet Nam,2018,2018Viet Nam,0,10,13,258,164,0,445,5,10,6,555,215,0,791,1236
27833,Viet Nam,2018,2018Viet Nam,32,63,37,163,13,0,308,39,63,45,215,12,0,374,682
27834,Viet Nam,2019,2019Viet Nam,0,0,0,0,0,0,0,0,0,0,0,0,0,0,305862
27835,Viet Nam,2019,2019Viet Nam,0,0,0,0,0,0,0,0,0,0,6,0,0,6,848
27836,Viet Nam,2019,2019Viet Nam,0,0,0,0,0,3400,3400,0,0,0,0,0,4335,4335,7735
27837,Viet Nam,2019,2019Viet Nam,0,0,0,0,5,0,5,0,0,0,0,0,0,0,5
27838,Viet Nam,2019,2019Viet Nam,0,0,0,5,0,0,5,0,0,0,0,0,0,0,10
27839,Viet Nam,2019,2019Viet Nam,0,0,0,6,0,0,6,0,0,0,9,0,0,9,15
27840,Viet Nam,2019,2019Viet Nam,0,0,6,7,0,0,13,0,0,0,7,0,0,7,20
27841,Viet Nam,2019,2019Viet Nam,0,9,12,231,180,0,432,5,5,8,504,237,0,759,1191
27842,Viet Nam,2019,2019Viet Nam,5,0,0,0,0,6,11,0,0,0,0,0,0,0,11
27843,Viet Nam,2019,2019Viet Nam,31,62,45,185,16,0,339,41,73,49,230,12,0,405,744
27844,Viet Nam,2020,2020Viet Nam,0,0,0,0,0,0,0,0,0,0,0,0,0,0,313870
27845,Viet Nam,2020,2020Viet Nam,0,0,0,0,0,0,0,0,0,0,5,0,0,5,5
27846,Viet Nam,2020,2020Viet Nam,0,0,0,0,0,5,5,0,0,0,0,0,18,18,23
27847,Viet Nam,2020,2020Viet Nam,0,0,0,0,5,0,5,0,0,0,0,0,0,0,5
27848,Viet Nam,2020,2020Viet Nam,0,0,0,5,0,0,5,0,0,0,0,0,0,0,796
27849,Viet Nam,2020,2020Viet Nam,0,0,0,6,0,0,6,0,0,0,0,0,0,0,6
27850,Viet Nam,2020,2020Viet Nam,0,0,0,6,0,0,6,0,0,0,9,0,0,9,15
27851,Viet Nam,2020,2020Viet Nam,0,0,0,11,0,0,11,0,0,0,5,0,0,5,16
27852,Viet Nam,2020,2020Viet Nam,0,0,5,7,0,0,12,0,0,0,8,0,0,8,20
27853,Viet Nam,2020,2020Viet Nam,0,10,9,199,191,0,409,0,6,7,443,273,0,729,1138
27854,Viet Nam,2020,2020Viet Nam,35,67,50,207,19,0,378,45,78,53,264,16,0,456,834
27855,Viet Nam,2021,2021Viet Nam,0,0,0,0,0,0,0,0,0,0,0,0,0,0,314817
27856,Viet Nam,2021,2021Viet Nam,0,0,0,0,0,0,0,0,0,0,5,0,0,5,5
27857,Viet Nam,2021,2021Viet Nam,0,0,0,0,0,0,0,0,0,5,0,0,0,5,760
27858,Viet Nam,2021,2021Viet Nam,0,0,0,0,0,5,5,0,0,0,0,0,9,9,14
27859,Viet Nam,2021,2021Viet Nam,0,0,0,0,5,0,5,0,0,0,0,0,0,0,5
27860,Viet Nam,2021,2021Viet Nam,0,0,0,0,6,0,6,0,0,0,5,5,0,10,16
27861,Viet Nam,2021,2021Viet Nam,0,0,0,5,0,0,5,0,0,0,0,0,0,0,5
27862,Viet Nam,2021,2021Viet Nam,0,0,0,5,0,0,5,0,0,0,5,0,0,5,10
27863,Viet Nam,2021,2021Viet Nam,0,0,0,6,0,0,6,0,0,0,9,0,0,9,15
27864,Viet Nam,2021,2021Viet Nam,0,0,0,9,0,0,9,0,0,0,6,0,0,6,15
27865,Viet Nam,2021,2021Viet Nam,0,0,0,18,0,0,18,0,0,0,0,0,0,0,18
27866,Viet Nam,2021,2021Viet Nam,0,10,6,187,196,0,399,0,7,6,402,282,0,697,1096
27867,Viet Nam,2021,2021Viet Nam,36,78,58,240,21,0,433,50,82,59,320,17,0,528,961
27868,Western Sahara,2001,2001Western Sahara,0,0,0,0,0,0,0,0,0,0,0,0,7,7,7
27869,Western Sahara,2001,2001Western Sahara,0,0,0,27,0,0,27,0,159,136,579,0,0,874,901
27870,Western Sahara,2001,2001Western Sahara,13038,15752,13501,33630,185,0,76106,13001,17095,14653,33658,917,0,79324,165000
27871,Western Sahara,2002,2002Western Sahara,0,0,0,0,0,0,0,0,0,0,0,0,6,6,6
27872,Western Sahara,2002,2002Western Sahara,0,0,0,5,0,0,5,0,199,170,504,0,0,873,878
27873,Western Sahara,2002,2002Western Sahara,11347,11550,9899,39014,6373,0,78183,11658,11717,10043,38389,5440,0,77247,165000
27874,Western Sahara,2003,2003Western Sahara,0,0,0,0,0,0,0,0,0,0,0,0,8,8,8
27875,Western Sahara,2003,2003Western Sahara,0,0,0,8,0,0,8,0,160,138,415,0,0,713,721
27876,Western Sahara,2003,2003Western Sahara,14538,14856,12734,23705,10271,0,76104,14502,16200,13886,24464,10274,0,79326,165000
27877,Western Sahara,2004,2004Western Sahara,0,0,0,0,0,0,0,0,0,0,0,0,9,9,9
27878,Western Sahara,2004,2004Western Sahara,0,0,0,10,0,0,10,0,137,118,454,0,0,709,719
27879,Western Sahara,2004,2004Western Sahara,14538,14856,12734,23705,10271,0,76104,14502,16200,13886,24464,10274,0,79326,165000
27880,Western Sahara,2005,2005Western Sahara,0,0,0,0,0,0,0,0,0,0,0,0,9,9,9
27881,Western Sahara,2005,2005Western Sahara,0,0,0,7,0,0,7,0,94,81,459,0,0,634,641
27882,Western Sahara,2005,2005Western Sahara,8418,8602,7374,13726,5947,0,44067,8397,9381,8040,14166,5949,0,45933,90000
27883,Western Sahara,2006,2006Western Sahara,0,0,0,0,0,0,0,0,0,0,0,0,0,0,90000
27884,Western Sahara,2006,2006Western Sahara,0,0,0,0,0,0,0,0,0,0,0,0,7,7,7
27885,Western Sahara,2006,2006Western Sahara,0,0,0,0,0,0,0,0,0,0,0,0,9,9,9
27886,Western Sahara,2006,2006Western Sahara,0,0,0,0,0,0,0,0,0,94,501,0,0,595,595
27887,Western Sahara,2007,2007Western Sahara,0,0,0,0,0,0,0,0,0,0,0,0,0,0,116000
27888,Western Sahara,2007,2007Western Sahara,0,0,0,0,0,0,0,0,0,0,0,0,7,7,7
27889,Western Sahara,2007,2007Western Sahara,0,0,0,0,0,0,0,0,0,0,5,0,0,5,5
27890,Western Sahara,2007,2007Western Sahara,0,0,0,0,0,0,0,0,0,47,527,0,0,574,574
27891,Western Sahara,2007,2007Western Sahara,0,0,0,0,0,8,8,0,0,0,0,0,0,0,8
27892,Western Sahara,2008,2008Western Sahara,0,0,0,0,0,0,0,0,0,0,0,0,0,0,116000
27893,Western Sahara,2008,2008Western Sahara,0,0,0,0,0,0,0,0,0,0,0,0,11,11,11
27894,Western Sahara,2008,2008Western Sahara,0,0,0,0,0,0,0,0,0,0,5,0,0,5,5
27895,Western Sahara,2008,2008Western Sahara,0,0,0,0,0,0,0,0,0,21,483,0,0,504,504
27896,Western Sahara,2008,2008Western Sahara,0,0,0,0,0,8,8,0,0,0,0,0,0,0,8
27897,Western Sahara,2009,2009Western Sahara,0,0,0,0,0,0,0,0,0,0,0,0,0,0,116011
27898,Western Sahara,2009,2009Western Sahara,0,0,0,0,0,0,0,0,0,0,5,0,0,5,10
27899,Western Sahara,2009,2009Western Sahara,0,0,0,0,0,0,0,0,0,5,435,0,0,440,440
27900,Western Sahara,2009,2009Western Sahara,0,0,0,0,0,8,8,0,0,0,0,0,0,0,8
27901,Western Sahara,2010,2010Western Sahara,0,0,0,0,0,0,0,0,0,0,0,0,0,0,116000
27902,Western Sahara,2010,2010Western Sahara,0,0,0,0,0,0,0,0,0,0,0,0,5,5,10
27903,Western Sahara,2010,2010Western Sahara,0,0,0,0,0,0,0,0,0,0,5,0,0,5,5
27904,Western Sahara,2010,2010Western Sahara,0,0,0,7,0,0,7,0,0,0,389,0,0,389,396
27905,Western Sahara,2011,2011Western Sahara,0,0,0,0,0,0,0,0,0,0,0,0,0,0,116023
27906,Western Sahara,2011,2011Western Sahara,0,0,0,0,0,0,0,0,0,0,0,0,5,5,5
27907,Western Sahara,2011,2011Western Sahara,0,0,0,0,0,0,0,0,0,0,5,0,0,5,5
27908,Western Sahara,2011,2011Western Sahara,0,0,0,0,0,5,5,0,0,0,0,0,14,14,19
27909,Western Sahara,2011,2011Western Sahara,0,0,0,9,0,0,9,0,0,0,353,0,0,353,362
27910,Western Sahara,2012,2012Western Sahara,0,0,0,0,0,0,0,0,0,0,0,0,0,0,116047
27911,Western Sahara,2012,2012Western Sahara,0,0,0,0,0,0,0,0,0,0,5,0,0,5,5
27912,Western Sahara,2012,2012Western Sahara,0,0,0,0,0,7,7,0,0,0,0,0,45,45,52
27913,Western Sahara,2012,2012Western Sahara,0,0,0,14,0,0,14,0,0,0,333,0,0,333,347
27914,Western Sahara,2013,2013Western Sahara,0,0,0,0,0,0,0,0,0,0,0,0,0,0,116051
27915,Western Sahara,2013,2013Western Sahara,0,0,0,0,0,0,0,0,0,0,5,0,0,5,5
27916,Western Sahara,2013,2013Western Sahara,0,0,0,0,0,11,11,0,0,0,0,0,80,80,91
27917,Western Sahara,2013,2013Western Sahara,0,0,0,21,0,0,21,0,0,0,332,0,0,332,353
27918,Western Sahara,2014,2014Western Sahara,0,0,0,0,0,0,0,0,0,0,0,0,0,0,116040
27919,Western Sahara,2014,2014Western Sahara,0,0,0,0,0,0,0,0,0,0,0,0,7,7,7
27920,Western Sahara,2014,2014Western Sahara,0,0,0,0,0,23,23,0,0,0,0,0,162,162,185
27921,Western Sahara,2014,2014Western Sahara,0,0,0,18,0,0,18,0,0,0,228,0,0,228,246
27922,Western Sahara,2015,2015Western Sahara,0,0,0,0,0,0,0,0,0,0,0,0,0,0,116052
27923,Western Sahara,2015,2015Western Sahara,0,0,0,0,0,0,0,0,0,0,5,0,0,5,5
27924,Western Sahara,2015,2015Western Sahara,0,0,0,0,0,7,7,0,0,0,0,0,0,0,7
27925,Western Sahara,2015,2015Western Sahara,0,0,0,0,0,31,31,0,0,0,0,0,266,266,297
27926,Western Sahara,2015,2015Western Sahara,0,0,0,17,0,0,17,0,0,0,164,0,0,164,181
27927,Western Sahara,2016,2016Western Sahara,0,0,0,0,0,0,0,0,0,0,0,0,0,0,26051
27928,Western Sahara,2016,2016Western Sahara,0,0,0,0,0,0,0,0,0,0,0,0,8,8,8
27929,Western Sahara,2016,2016Western Sahara,0,0,0,0,0,55,55,0,0,0,0,0,365,365,420
27930,Western Sahara,2016,2016Western Sahara,0,0,0,0,0,44064,44064,0,0,0,0,0,45936,45936,90000
27931,Western Sahara,2016,2016Western Sahara,0,0,0,5,0,0,5,0,0,0,6,0,0,6,11
27932,Western Sahara,2016,2016Western Sahara,0,0,0,18,0,0,18,0,0,0,140,0,0,140,158
27933,Western Sahara,2017,2017Western Sahara,0,0,0,0,0,0,0,0,0,0,0,0,0,0,26044
27934,Western Sahara,2017,2017Western Sahara,0,0,0,0,0,0,0,0,0,0,0,0,18,18,18
27935,Western Sahara,2017,2017Western Sahara,0,0,0,0,0,0,0,0,0,0,5,0,0,5,5
27936,Western Sahara,2017,2017Western Sahara,0,0,0,0,0,7,7,0,0,0,0,0,0,0,7
27937,Western Sahara,2017,2017Western Sahara,0,0,0,0,0,81,81,0,0,0,0,0,431,431,512
27938,Western Sahara,2017,2017Western Sahara,0,0,0,0,0,44064,44064,0,0,0,0,0,45936,45936,90000
27939,Western Sahara,2017,2017Western Sahara,0,0,0,26,0,0,26,0,0,0,150,0,0,150,176
27940,Western Sahara,2018,2018Western Sahara,0,0,0,0,0,0,0,0,0,0,0,0,0,0,116063
27941,Western Sahara,2018,2018Western Sahara,0,0,0,0,0,0,0,0,0,0,0,0,9,9,9
27942,Western Sahara,2018,2018Western Sahara,0,0,0,0,0,98,98,0,0,0,0,0,475,475,573
27943,Western Sahara,2018,2018Western Sahara,0,0,0,5,0,0,5,0,0,0,6,0,0,6,11
27944,Western Sahara,2018,2018Western Sahara,0,0,0,26,0,0,26,0,0,0,108,0,0,108,134
27945,Western Sahara,2019,2019Western Sahara,0,0,0,0,0,0,0,0,0,0,0,0,0,0,116075
27946,Western Sahara,2019,2019Western Sahara,0,0,0,0,0,129,129,0,0,0,0,0,586,586,715
27947,Western Sahara,2019,2019Western Sahara,0,0,0,5,0,0,5,0,0,0,6,0,0,6,11
27948,Western Sahara,2019,2019Western Sahara,0,0,0,19,0,0,19,0,0,0,88,0,0,88,107
27949,Western Sahara,2020,2020Western Sahara,0,0,0,0,0,0,0,0,0,0,0,0,0,0,116814
27950,Western Sahara,2020,2020Western Sahara,0,0,0,0,0,0,0,0,0,0,5,0,0,5,5
27951,Western Sahara,2020,2020Western Sahara,0,0,0,5,0,0,5,0,0,0,6,0,0,6,11
27952,Western Sahara,2020,2020Western Sahara,0,0,0,19,0,0,19,0,0,0,76,0,0,76,95
27953,Western Sahara,2021,2021Western Sahara,0,0,0,0,0,0,0,0,0,0,0,0,0,0,116926
27954,Western Sahara,2021,2021Western Sahara,0,0,0,0,0,0,0,0,0,0,5,0,0,5,5
27955,Western Sahara,2021,2021Western Sahara,0,0,0,5,0,0,5,0,0,0,6,0,0,6,11
27956,Western Sahara,2021,2021Western Sahara,0,0,0,22,0,0,22,0,0,0,77,0,0,77,99
27957,Yemen,2001,2001Yemen,0,0,0,0,0,0,0,0,0,0,0,0,0,0,600
27958,Yemen,2001,2001Yemen,0,0,0,0,0,0,0,0,0,0,6,0,0,6,6
27959,Yemen,2001,2001Yemen,0,0,0,0,0,13,13,0,0,0,0,0,15,15,28
27960,Yemen,2001,2001Yemen,0,0,5,0,0,0,5,0,0,0,6,0,0,6,11
27961,Yemen,2001,2001Yemen,0,6,6,13,0,0,25,9,0,0,7,0,0,16,41
27962,Yemen,2001,2001Yemen,21,65,55,153,9,0,303,19,50,42,209,5,0,325,628
27963,Yemen,2001,2001Yemen,28,69,59,152,7,0,315,31,69,59,183,5,0,347,662
27964,Yemen,2002,2002Yemen,0,0,0,0,0,0,0,0,0,0,0,0,0,0,948
27965,Yemen,2002,2002Yemen,0,0,0,0,0,0,0,0,0,0,7,0,0,7,7
27966,Yemen,2002,2002Yemen,0,0,0,0,0,13,13,0,0,0,0,0,15,15,42
27967,Yemen,2002,2002Yemen,0,0,5,0,0,0,5,0,5,0,0,0,0,5,10
27968,Yemen,2002,2002Yemen,0,7,0,8,0,0,15,0,6,0,7,0,0,13,28
27969,Yemen,2002,2002Yemen,5,0,0,0,0,0,5,0,0,0,0,0,0,0,5
27970,Yemen,2002,2002Yemen,5,11,11,43,0,0,70,5,12,10,46,0,0,73,143
27971,Yemen,2002,2002Yemen,10,39,33,109,6,0,197,9,30,26,145,5,0,215,412
27972,Yemen,2003,2003Yemen,0,0,0,0,0,0,0,0,0,0,0,0,0,0,1047
27973,Yemen,2003,2003Yemen,0,0,0,0,0,22,22,0,0,0,0,0,25,25,62
27974,Yemen,2003,2003Yemen,0,0,5,0,0,0,5,0,5,0,0,0,0,5,10
27975,Yemen,2003,2003Yemen,0,0,9,7,0,0,16,0,0,5,5,0,0,10,26
27976,Yemen,2003,2003Yemen,0,9,7,26,0,0,42,0,9,7,35,0,0,51,93
27977,Yemen,2003,2003Yemen,6,0,0,0,0,0,6,0,0,0,0,0,0,0,6
27978,Yemen,2003,2003Yemen,8,27,24,96,5,0,160,7,24,20,127,6,0,184,344
27979,Yemen,2004,2004Yemen,0,0,0,0,0,0,0,0,0,0,0,0,0,0,1089
27980,Yemen,2004,2004Yemen,0,0,0,9,0,0,9,0,0,0,0,0,0,0,9
27981,Yemen,2004,2004Yemen,0,0,5,5,0,25,35,0,5,0,5,0,29,39,74
27982,Yemen,2004,2004Yemen,0,5,0,7,0,0,12,0,0,0,6,0,0,6,18
27983,Yemen,2004,2004Yemen,0,6,5,28,0,0,39,0,9,7,30,0,0,46,85
27984,Yemen,2004,2004Yemen,5,0,0,0,0,0,5,0,0,0,0,0,0,0,5
27985,Yemen,2004,2004Yemen,6,26,23,92,5,0,152,6,20,17,118,6,0,167,319
27986,Yemen,2005,2005Yemen,0,0,0,0,0,0,0,0,0,0,0,0,0,0,916
27987,Yemen,2005,2005Yemen,0,0,5,0,0,0,5,0,5,0,0,0,0,5,10
27988,Yemen,2005,2005Yemen,0,0,6,7,0,31,44,0,0,5,5,0,32,42,86
27989,Yemen,2005,2005Yemen,0,6,0,0,0,0,6,0,0,5,0,0,0,5,11
27990,Yemen,2005,2005Yemen,0,6,5,28,0,0,39,0,9,7,30,0,0,46,85
27991,Yemen,2005,2005Yemen,0,17,15,61,5,0,98,5,11,10,79,6,0,111,209
27992,Yemen,2005,2005Yemen,5,0,0,0,0,0,5,0,0,0,0,0,0,0,5
27993,Yemen,2006,2006Yemen,0,0,0,0,0,0,0,0,0,0,0,0,0,0,948
27994,Yemen,2006,2006Yemen,0,0,0,0,0,0,0,0,0,0,0,0,5,5,5
27995,Yemen,2006,2006Yemen,0,0,0,0,0,0,0,0,0,0,6,0,0,6,6
27996,Yemen,2006,2006Yemen,0,0,0,0,0,5,5,0,0,0,0,0,11,11,16
27997,Yemen,2006,2006Yemen,0,0,0,0,0,43,43,0,0,0,0,0,50,50,93
27998,Yemen,2006,2006Yemen,0,0,0,7,0,0,7,0,0,0,0,0,0,0,7
27999,Yemen,2006,2006Yemen,0,5,6,28,0,0,39,0,5,11,30,0,0,46,85
28000,Yemen,2006,2006Yemen,0,10,16,65,5,0,96,0,12,7,79,10,0,108,204
28001,Yemen,2007,2007Yemen,0,0,0,0,0,0,0,0,0,0,0,0,0,0,1224
28002,Yemen,2007,2007Yemen,0,0,0,0,0,0,0,0,0,0,0,0,5,5,5
28003,Yemen,2007,2007Yemen,0,0,0,0,0,5,5,0,0,0,0,0,7,7,12
28004,Yemen,2007,2007Yemen,0,0,0,6,0,0,6,0,0,0,0,0,0,0,6
28005,Yemen,2007,2007Yemen,0,0,6,19,0,0,25,0,0,9,19,0,0,28,53
28006,Yemen,2007,2007Yemen,0,0,7,12,0,35,54,0,9,0,11,0,43,63,117
28007,Yemen,2007,2007Yemen,0,8,14,68,6,0,96,0,10,8,75,15,0,108,204
28008,Yemen,2008,2008Yemen,0,0,0,0,0,0,0,0,0,0,0,0,0,0,1320
28009,Yemen,2008,2008Yemen,0,0,0,0,0,0,0,0,0,0,0,0,5,5,10
28010,Yemen,2008,2008Yemen,0,0,0,5,0,0,5,0,0,0,0,0,0,0,5
28011,Yemen,2008,2008Yemen,0,0,6,19,0,0,25,0,5,5,19,0,0,29,54
28012,Yemen,2008,2008Yemen,0,7,7,20,0,39,73,5,5,5,21,0,57,93,166
28013,Yemen,2008,2008Yemen,0,8,14,68,6,0,96,0,10,8,75,15,0,108,204
28014,Yemen,2008,2008Yemen,5,0,0,0,0,0,5,0,0,0,0,0,0,0,5
28015,Yemen,2009,2009Yemen,0,0,0,0,0,0,0,0,0,0,0,0,0,0,1067
28016,Yemen,2009,2009Yemen,0,0,0,0,0,0,0,0,0,0,0,0,5,5,5
28017,Yemen,2009,2009Yemen,0,0,0,0,0,0,0,0,0,9,0,0,0,9,9
28018,Yemen,2009,2009Yemen,0,0,0,0,0,0,0,0,5,0,0,0,0,5,5
28019,Yemen,2009,2009Yemen,0,0,0,5,0,0,5,0,0,0,0,0,0,0,5
28020,Yemen,2009,2009Yemen,0,0,0,6,0,0,6,0,0,5,7,0,0,12,18
28021,Yemen,2009,2009Yemen,0,0,5,0,0,0,5,0,0,0,0,0,0,0,5
28022,Yemen,2009,2009Yemen,0,6,13,70,8,0,97,0,7,8,75,18,0,108,205
28023,Yemen,2009,2009Yemen,5,0,0,0,0,0,5,0,0,0,0,0,0,0,5
28024,Yemen,2009,2009Yemen,5,5,5,23,0,59,97,5,8,5,24,0,68,110,207
28025,Yemen,2009,2009Yemen,16,32,24,83,0,0,155,14,42,36,144,5,0,241,396
28026,Yemen,2010,2010Yemen,0,0,0,0,0,0,0,0,0,0,0,0,0,0,1112
28027,Yemen,2010,2010Yemen,0,0,0,0,0,0,0,0,0,0,0,0,5,5,5
28028,Yemen,2010,2010Yemen,0,0,0,0,0,0,0,0,0,0,9,0,0,9,9
28029,Yemen,2010,2010Yemen,0,0,0,0,0,0,0,0,0,5,7,0,0,12,12
28030,Yemen,2010,2010Yemen,0,0,0,0,0,0,0,0,5,0,0,0,0,5,5
28031,Yemen,2010,2010Yemen,0,0,0,5,0,0,5,0,0,0,0,0,0,0,5
28032,Yemen,2010,2010Yemen,0,5,0,0,0,0,5,0,0,0,0,0,0,0,5
28033,Yemen,2010,2010Yemen,0,5,13,69,10,0,97,0,5,10,73,20,0,108,205
28034,Yemen,2010,2010Yemen,0,13,11,26,0,68,118,5,13,8,28,0,74,128,246
28035,Yemen,2010,2010Yemen,6,6,0,12,0,0,24,0,7,9,18,0,0,34,58
28036,Yemen,2010,2010Yemen,16,29,22,85,0,0,152,17,46,38,150,5,0,256,408
28037,Yemen,2011,2011Yemen,0,0,0,0,0,0,0,0,0,0,0,0,0,0,1061
28038,Yemen,2011,2011Yemen,0,0,0,0,0,0,0,0,5,0,0,0,0,5,5
28039,Yemen,2011,2011Yemen,0,0,0,0,0,5,5,0,0,0,0,0,6,6,11
28040,Yemen,2011,2011Yemen,0,0,0,7,0,0,7,0,0,0,0,0,0,0,7
28041,Yemen,2011,2011Yemen,0,0,5,16,0,0,21,0,0,8,20,0,0,28,266
28042,Yemen,2011,2011Yemen,0,0,8,0,0,0,8,0,8,0,6,0,0,14,22
28043,Yemen,2011,2011Yemen,0,0,13,71,13,0,97,0,10,6,72,20,0,108,205
28044,Yemen,2011,2011Yemen,0,5,0,0,0,0,5,0,0,0,0,0,0,0,5
28045,Yemen,2011,2011Yemen,5,8,9,24,0,74,120,5,11,7,31,0,77,131,251
28046,Yemen,2011,2011Yemen,6,0,0,0,0,0,6,0,0,5,7,0,0,12,18
28047,Yemen,2011,2011Yemen,7,0,9,21,0,0,37,6,10,0,15,0,0,31,68
28048,Yemen,2011,2011Yemen,17,33,19,88,0,0,157,11,46,40,142,6,0,245,402
28049,Yemen,2012,2012Yemen,0,0,0,0,0,0,0,0,0,0,0,0,0,0,1172
28050,Yemen,2012,2012Yemen,0,0,0,0,0,0,0,0,0,0,0,0,5,5,5
28051,Yemen,2012,2012Yemen,0,0,0,0,0,0,0,0,8,0,0,0,0,8,8
28052,Yemen,2012,2012Yemen,0,0,0,0,0,5,5,0,0,0,0,0,12,12,17
28053,Yemen,2012,2012Yemen,0,0,0,6,0,0,6,0,0,0,8,0,0,8,240
28054,Yemen,2012,2012Yemen,0,0,0,7,0,0,7,0,0,5,14,0,0,19,26
28055,Yemen,2012,2012Yemen,0,0,0,12,0,0,12,0,0,5,0,0,0,5,17
28056,Yemen,2012,2012Yemen,0,0,5,5,0,0,10,0,0,5,0,0,0,5,15
28057,Yemen,2012,2012Yemen,0,0,11,72,15,0,98,0,0,13,73,23,0,109,207
28058,Yemen,2012,2012Yemen,0,5,0,0,0,0,5,0,0,0,0,0,0,0,10
28059,Yemen,2012,2012Yemen,0,5,5,6,0,0,16,0,10,6,11,0,0,27,43
28060,Yemen,2012,2012Yemen,0,9,0,16,5,100,130,0,5,6,17,0,110,138,268
28061,Yemen,2012,2012Yemen,0,14,5,21,0,0,40,5,14,0,14,0,0,33,73
28062,Yemen,2012,2012Yemen,14,35,27,107,5,0,188,6,56,46,175,10,0,293,481
28063,Yemen,2013,2013Yemen,0,0,0,0,0,0,0,0,0,0,0,0,0,0,1321
28064,Yemen,2013,2013Yemen,0,0,0,0,0,0,0,0,0,0,0,0,6,6,6
28065,Yemen,2013,2013Yemen,0,0,0,0,0,0,0,0,0,0,5,0,0,5,5
28066,Yemen,2013,2013Yemen,0,0,0,0,0,6,6,0,0,0,0,0,14,14,20
28067,Yemen,2013,2013Yemen,0,0,0,5,0,0,5,0,0,0,0,0,0,0,10
28068,Yemen,2013,2013Yemen,0,0,6,5,0,0,11,0,23,0,0,0,0,23,34
28069,Yemen,2013,2013Yemen,0,0,10,76,14,0,100,0,0,16,77,23,0,116,216
28070,Yemen,2013,2013Yemen,0,5,0,0,0,0,5,0,0,0,0,0,0,0,10
28071,Yemen,2013,2013Yemen,0,5,0,5,0,0,10,0,0,5,0,0,0,5,15
28072,Yemen,2013,2013Yemen,0,5,0,8,0,0,13,0,0,0,7,0,0,7,251
28073,Yemen,2013,2013Yemen,0,7,5,16,0,0,28,0,8,7,15,0,0,30,58
28074,Yemen,2013,2013Yemen,0,9,0,17,0,0,26,0,7,6,21,0,0,34,60
28075,Yemen,2013,2013Yemen,5,0,0,5,0,0,10,0,0,5,21,0,0,26,36
28076,Yemen,2013,2013Yemen,5,0,6,28,0,0,39,0,5,10,58,0,0,73,112
28077,Yemen,2013,2013Yemen,5,6,7,22,5,78,123,5,9,9,28,0,78,129,252
28078,Yemen,2013,2013Yemen,7,0,0,0,0,0,7,0,0,0,0,0,0,0,7
28079,Yemen,2014,2014Yemen,0,0,0,0,0,0,0,0,0,0,0,0,0,0,1460
28080,Yemen,2014,2014Yemen,0,0,0,0,0,0,0,0,0,0,5,0,0,5,15
28081,Yemen,2014,2014Yemen,0,0,0,0,0,0,0,5,0,0,0,0,0,5,5
28082,Yemen,2014,2014Yemen,0,0,0,0,0,8,8,0,0,0,0,0,22,22,30
28083,Yemen,2014,2014Yemen,0,0,0,9,0,0,9,0,0,0,12,0,0,12,239
28084,Yemen,2014,2014Yemen,0,0,5,0,0,0,5,0,0,0,0,0,0,0,10
28085,Yemen,2014,2014Yemen,0,0,6,0,0,0,6,0,0,5,5,0,0,10,16
28086,Yemen,2014,2014Yemen,0,0,7,7,0,0,14,0,21,0,5,0,0,26,40
28087,Yemen,2014,2014Yemen,0,0,76,0,15,0,91,0,10,73,5,19,0,107,198
28088,Yemen,2014,2014Yemen,0,5,0,0,0,0,5,0,0,0,0,0,0,0,10
28089,Yemen,2014,2014Yemen,0,5,0,5,0,0,10,0,0,5,0,0,0,5,15
28090,Yemen,2014,2014Yemen,0,7,0,0,0,0,7,0,0,0,0,0,0,0,7
28091,Yemen,2014,2014Yemen,0,7,6,27,0,0,40,0,0,12,52,5,0,69,109
28092,Yemen,2014,2014Yemen,0,8,12,5,0,0,25,5,10,19,0,0,0,34,59
28093,Yemen,2014,2014Yemen,5,5,7,16,0,0,33,0,7,7,18,0,0,32,65
28094,Yemen,2014,2014Yemen,5,6,10,26,5,92,144,0,14,10,36,0,96,156,300
28095,Yemen,2014,2014Yemen,6,0,0,9,0,0,15,0,0,5,25,0,0,30,45
28096,Yemen,2015,2015Yemen,0,0,0,0,0,0,0,0,0,0,0,0,0,0,2017
28097,Yemen,2015,2015Yemen,0,0,0,0,0,0,0,0,0,0,0,7,0,7,7
28098,Yemen,2015,2015Yemen,0,0,0,0,0,0,0,0,0,0,5,0,0,5,30
28099,Yemen,2015,2015Yemen,0,0,0,0,0,0,0,0,0,0,6,0,0,6,6
28100,Yemen,2015,2015Yemen,0,0,0,0,0,0,0,0,0,5,0,0,0,5,5
28101,Yemen,2015,2015Yemen,0,0,0,0,0,0,0,0,5,0,0,0,0,5,5
28102,Yemen,2015,2015Yemen,0,0,0,0,0,0,0,0,6,5,0,0,0,11,11
28103,Yemen,2015,2015Yemen,0,0,0,0,0,0,0,5,0,0,0,0,0,5,10
28104,Yemen,2015,2015Yemen,0,0,0,0,0,8,8,0,0,0,0,0,19,19,27
28105,Yemen,2015,2015Yemen,0,0,0,0,0,19,19,0,0,0,0,0,44,44,63
28106,Yemen,2015,2015Yemen,0,0,0,5,0,0,5,0,0,0,0,0,0,0,5
28107,Yemen,2015,2015Yemen,0,0,0,7,0,0,7,0,0,0,0,0,0,0,7
28108,Yemen,2015,2015Yemen,0,0,0,10,0,0,10,0,0,5,0,0,0,5,15
28109,Yemen,2015,2015Yemen,0,0,5,0,0,0,5,0,0,0,0,0,0,0,5
28110,Yemen,2015,2015Yemen,0,0,5,26,0,0,31,0,22,6,42,0,0,70,101
28111,Yemen,2015,2015Yemen,0,0,6,0,0,0,6,0,0,0,7,0,0,7,13
28112,Yemen,2015,2015Yemen,0,0,9,0,0,0,9,0,0,0,0,0,0,0,9
28113,Yemen,2015,2015Yemen,0,5,5,17,0,0,27,0,7,5,15,0,0,27,54
28114,Yemen,2015,2015Yemen,0,5,7,8,0,0,20,0,16,0,11,0,0,27,47
28115,Yemen,2015,2015Yemen,0,9,0,10,0,0,19,0,0,7,29,0,0,36,55
28116,Yemen,2015,2015Yemen,5,0,0,0,0,0,5,0,0,0,0,0,0,0,5
28117,Yemen,2015,2015Yemen,5,0,5,16,5,0,31,0,7,0,22,0,0,29,323
28118,Yemen,2015,2015Yemen,5,8,0,9,0,0,22,5,6,5,14,0,0,30,52
28119,Yemen,2015,2015Yemen,5,8,8,35,0,0,56,0,5,7,67,5,0,84,140
28120,Yemen,2015,2015Yemen,26,24,6,77,0,0,133,23,41,15,249,0,0,328,461
28121,Yemen,2015,2015Yemen,47,111,88,318,17,0,581,54,94,74,269,16,0,507,1088
28122,Yemen,2015,2015Yemen,277,449,364,1265,113,0,2468,266,479,396,1471,103,0,2715,5183
28123,Yemen,2015,2015Yemen,331,455,351,1289,168,0,2594,313,463,396,2255,136,0,3563,6157
28124,Yemen,2016,2016Yemen,0,0,0,0,0,0,0,0,0,0,0,0,0,0,2478
28125,Yemen,2016,2016Yemen,0,0,0,0,0,0,0,0,0,0,0,0,5,5,5
28126,Yemen,2016,2016Yemen,0,0,0,0,0,0,0,0,0,0,5,0,0,5,15
28127,Yemen,2016,2016Yemen,0,0,0,0,0,0,0,0,5,0,0,0,0,5,5
28128,Yemen,2016,2016Yemen,0,0,0,0,0,0,0,0,5,0,6,0,0,11,11
28129,Yemen,2016,2016Yemen,0,0,0,0,0,0,0,0,6,6,0,0,0,12,12
28130,Yemen,2016,2016Yemen,0,0,0,0,0,0,0,5,0,0,0,0,0,5,10
28131,Yemen,2016,2016Yemen,0,0,0,0,0,0,0,5,0,0,13,0,0,18,18
28132,Yemen,2016,2016Yemen,0,0,0,0,0,9,9,0,0,0,0,0,15,15,24
28133,Yemen,2016,2016Yemen,0,0,0,0,0,50,50,0,0,0,0,0,93,93,143
28134,Yemen,2016,2016Yemen,0,0,0,5,0,0,5,0,0,0,0,0,0,0,5
28135,Yemen,2016,2016Yemen,0,0,0,5,0,0,5,0,0,5,0,0,0,5,10
28136,Yemen,2016,2016Yemen,0,0,0,5,0,0,5,0,0,5,14,0,0,19,24
28137,Yemen,2016,2016Yemen,0,0,0,5,0,0,5,5,0,0,14,0,0,19,24
28138,Yemen,2016,2016Yemen,0,0,0,7,0,0,7,0,0,0,0,0,0,0,7
28139,Yemen,2016,2016Yemen,0,0,0,7,0,0,7,5,0,0,7,0,0,12,19
28140,Yemen,2016,2016Yemen,0,0,0,9,0,0,9,0,0,0,5,0,0,5,14
28141,Yemen,2016,2016Yemen,0,0,0,10,0,0,10,0,0,5,0,0,0,5,15
28142,Yemen,2016,2016Yemen,0,0,0,26,0,0,26,0,5,0,82,5,0,92,390
28143,Yemen,2016,2016Yemen,0,0,5,0,0,0,5,0,0,0,28,0,0,28,33
28144,Yemen,2016,2016Yemen,0,0,9,0,0,0,9,0,0,0,0,0,0,0,9
28145,Yemen,2016,2016Yemen,0,5,0,0,0,0,5,0,0,0,0,0,0,0,5
28146,Yemen,2016,2016Yemen,0,5,0,0,0,0,5,0,0,0,6,0,0,6,11
28147,Yemen,2016,2016Yemen,0,8,0,0,0,0,8,0,0,0,0,0,0,0,8
28148,Yemen,2016,2016Yemen,0,8,0,5,0,0,13,0,0,7,7,0,0,14,27
28149,Yemen,2016,2016Yemen,0,11,5,17,0,0,33,0,0,8,25,0,0,33,66
28150,Yemen,2016,2016Yemen,0,14,0,5,0,0,19,0,11,0,10,0,0,21,40
28151,Yemen,2016,2016Yemen,0,17,15,45,0,0,77,5,19,18,37,0,0,79,156
28152,Yemen,2016,2016Yemen,5,5,0,18,0,0,28,7,0,0,16,0,0,23,51
28153,Yemen,2016,2016Yemen,5,8,10,34,5,95,157,0,9,11,48,5,109,182,339
28154,Yemen,2016,2016Yemen,7,19,18,62,0,0,106,5,14,11,39,5,0,74,180
28155,Yemen,2016,2016Yemen,8,16,14,61,5,0,104,11,17,8,146,5,0,187,291
28156,Yemen,2016,2016Yemen,25,22,12,89,0,0,148,20,49,14,254,0,0,337,485
28157,Yemen,2016,2016Yemen,35,124,104,457,20,0,740,26,119,110,402,26,0,683,1423
28158,Yemen,2016,2016Yemen,162,280,199,874,103,0,1618,142,298,241,1361,117,0,2159,3777
28159,Yemen,2016,2016Yemen,363,698,564,1832,173,0,3630,389,782,592,2714,190,0,4667,8297
28160,Yemen,2017,2017Yemen,0,0,0,0,0,0,0,0,0,0,0,0,0,0,3996
28161,Yemen,2017,2017Yemen,0,0,0,0,0,0,0,0,0,0,0,0,5,5,5
28162,Yemen,2017,2017Yemen,0,0,0,0,0,0,0,0,0,0,0,9,0,9,9
28163,Yemen,2017,2017Yemen,0,0,0,0,0,0,0,0,0,0,5,0,0,5,35
28164,Yemen,2017,2017Yemen,0,0,0,0,0,0,0,0,0,0,7,0,0,7,7
28165,Yemen,2017,2017Yemen,0,0,0,0,0,0,0,0,5,0,0,0,0,5,5
28166,Yemen,2017,2017Yemen,0,0,0,0,0,0,0,5,0,0,0,0,0,5,5
28167,Yemen,2017,2017Yemen,0,0,0,0,0,79,79,0,0,0,0,0,139,139,218
28168,Yemen,2017,2017Yemen,0,0,0,5,0,0,5,0,0,0,0,0,0,0,5
28169,Yemen,2017,2017Yemen,0,0,0,5,0,0,5,0,0,0,10,0,0,10,15
28170,Yemen,2017,2017Yemen,0,0,0,5,0,0,5,0,0,5,17,0,0,22,27
28171,Yemen,2017,2017Yemen,0,0,0,5,0,0,5,0,6,0,6,0,0,12,17
28172,Yemen,2017,2017Yemen,0,0,0,5,0,0,5,0,7,0,0,0,0,7,12
28173,Yemen,2017,2017Yemen,0,0,0,8,0,0,8,0,0,0,0,0,0,0,8
28174,Yemen,2017,2017Yemen,0,0,0,9,0,0,9,0,0,6,7,0,0,13,22
28175,Yemen,2017,2017Yemen,0,0,0,10,0,0,10,0,0,0,5,0,0,5,15
28176,Yemen,2017,2017Yemen,0,0,5,0,0,0,5,0,0,0,5,0,0,5,10
28177,Yemen,2017,2017Yemen,0,0,5,0,0,0,5,0,0,0,37,0,0,37,42
28178,Yemen,2017,2017Yemen,0,0,7,9,0,0,16,0,6,0,11,0,0,17,33
28179,Yemen,2017,2017Yemen,0,5,0,0,0,0,5,0,0,0,0,0,0,0,5
28180,Yemen,2017,2017Yemen,0,5,0,9,0,0,14,0,0,9,17,0,0,26,40
28181,Yemen,2017,2017Yemen,0,6,5,11,0,0,22,5,8,0,33,0,0,46,68
28182,Yemen,2017,2017Yemen,0,9,11,34,5,111,170,0,9,10,52,5,93,169,339
28183,Yemen,2017,2017Yemen,0,11,13,20,0,0,44,5,5,13,18,0,0,41,85
28184,Yemen,2017,2017Yemen,0,13,0,21,0,0,34,0,5,6,31,0,0,42,76
28185,Yemen,2017,2017Yemen,0,13,5,21,0,0,39,0,5,5,27,0,0,37,76
28186,Yemen,2017,2017Yemen,0,20,18,32,0,0,70,10,14,17,50,0,0,91,161
28187,Yemen,2017,2017Yemen,6,0,0,7,0,0,13,5,15,0,17,0,0,37,50
28188,Yemen,2017,2017Yemen,6,7,0,22,0,0,35,0,7,0,71,0,0,78,113
28189,Yemen,2017,2017Yemen,12,25,5,19,0,0,61,7,19,10,26,0,0,62,123
28190,Yemen,2017,2017Yemen,22,42,39,149,11,0,263,22,41,36,121,11,0,231,494
28191,Yemen,2017,2017Yemen,28,30,15,88,0,0,161,22,48,14,272,0,0,356,517
28192,Yemen,2017,2017Yemen,42,58,41,230,18,0,389,42,62,52,610,16,0,782,1171
28193,Yemen,2017,2017Yemen,45,132,106,491,22,0,796,47,135,118,452,30,0,782,1578
28194,Yemen,2017,2017Yemen,122,329,406,568,64,0,1489,130,344,447,990,68,0,1979,3468
28195,Yemen,2017,2017Yemen,416,832,676,2239,226,0,4389,421,928,767,3913,287,0,6316,10705
28196,Yemen,2018,2018Yemen,0,0,0,0,0,0,0,0,0,0,0,0,0,0,4533
28197,Yemen,2018,2018Yemen,0,0,0,0,0,0,0,0,0,0,5,0,0,5,5
28198,Yemen,2018,2018Yemen,0,0,0,0,0,0,0,0,0,0,7,0,0,7,7
28199,Yemen,2018,2018Yemen,0,0,0,0,0,0,0,0,0,9,0,0,0,9,9
28200,Yemen,2018,2018Yemen,0,0,0,0,0,0,0,0,5,0,0,0,0,5,5
28201,Yemen,2018,2018Yemen,0,0,0,0,0,0,0,5,0,0,0,0,0,5,5
28202,Yemen,2018,2018Yemen,0,0,0,0,0,5,5,0,0,0,0,0,7,7,12
28203,Yemen,2018,2018Yemen,0,0,0,0,0,123,123,0,0,0,0,0,215,215,338
28204,Yemen,2018,2018Yemen,0,0,0,5,0,0,5,0,0,0,0,0,0,0,5
28205,Yemen,2018,2018Yemen,0,0,0,5,0,0,5,0,0,0,5,0,0,5,20
28206,Yemen,2018,2018Yemen,0,0,0,5,0,0,5,0,0,5,23,0,0,28,33
28207,Yemen,2018,2018Yemen,0,0,0,5,0,0,5,0,6,0,6,0,0,12,17
28208,Yemen,2018,2018Yemen,0,0,0,5,0,0,5,0,7,0,0,0,0,7,12
28209,Yemen,2018,2018Yemen,0,0,0,5,0,0,5,5,0,0,0,0,10,15,20
28210,Yemen,2018,2018Yemen,0,0,0,5,0,0,5,5,0,0,13,0,0,18,23
28211,Yemen,2018,2018Yemen,0,0,0,8,0,0,8,0,0,0,0,0,0,0,8
28212,Yemen,2018,2018Yemen,0,0,0,8,0,0,8,5,0,0,7,0,0,12,20
28213,Yemen,2018,2018Yemen,0,0,0,9,0,0,9,0,0,6,7,0,0,13,22
28214,Yemen,2018,2018Yemen,0,0,0,9,0,0,9,0,0,9,14,0,0,23,32
28215,Yemen,2018,2018Yemen,0,0,0,10,0,0,10,0,0,0,5,0,0,5,15
28216,Yemen,2018,2018Yemen,0,0,0,11,0,0,11,0,8,0,8,0,0,16,27
28217,Yemen,2018,2018Yemen,0,0,6,0,0,0,6,0,0,0,5,0,0,5,11
28218,Yemen,2018,2018Yemen,0,0,9,0,0,0,9,0,0,0,0,0,0,0,9
28219,Yemen,2018,2018Yemen,0,0,12,26,0,0,38,16,10,6,413,0,0,445,483
28220,Yemen,2018,2018Yemen,0,5,0,0,0,0,5,0,0,0,0,0,0,0,5
28221,Yemen,2018,2018Yemen,0,5,0,5,0,0,10,0,0,0,10,0,0,10,20
28222,Yemen,2018,2018Yemen,0,5,0,6,0,0,11,0,0,0,7,0,0,7,18
28223,Yemen,2018,2018Yemen,0,7,0,10,0,0,17,5,5,5,34,0,0,49,66
28224,Yemen,2018,2018Yemen,0,11,14,22,0,0,47,5,7,11,30,0,0,53,100
28225,Yemen,2018,2018Yemen,0,13,23,43,0,0,79,0,20,17,53,0,0,90,169
28226,Yemen,2018,2018Yemen,0,17,8,22,0,0,47,0,6,7,45,0,0,58,105
28227,Yemen,2018,2018Yemen,5,7,5,37,5,95,154,5,5,5,49,5,113,182,336
28228,Yemen,2018,2018Yemen,7,0,0,12,0,0,19,0,8,0,23,0,0,31,50
28229,Yemen,2018,2018Yemen,7,8,5,23,0,0,43,9,0,0,76,0,0,85,128
28230,Yemen,2018,2018Yemen,8,0,0,0,0,0,8,0,0,0,0,0,0,0,8
28231,Yemen,2018,2018Yemen,9,14,10,49,0,0,82,7,14,11,44,5,0,81,163
28232,Yemen,2018,2018Yemen,11,17,16,101,8,0,153,7,34,13,171,8,0,233,1089
28233,Yemen,2018,2018Yemen,13,27,13,28,0,0,81,11,21,10,36,0,0,78,159
28234,Yemen,2018,2018Yemen,28,43,17,124,0,0,212,28,46,30,431,5,0,540,752
28235,Yemen,2018,2018Yemen,31,51,31,192,9,0,314,38,71,44,530,16,0,699,1013
28236,Yemen,2018,2018Yemen,37,46,45,190,13,0,331,21,67,39,167,17,0,311,642
28237,Yemen,2018,2018Yemen,39,141,110,521,27,0,838,48,137,127,511,37,0,860,1698
28238,Yemen,2018,2018Yemen,72,78,74,370,22,0,616,66,102,99,905,21,0,1193,1809
28239,Yemen,2018,2018Yemen,146,306,227,1012,132,0,1823,146,298,243,2037,147,0,2871,4694
28240,Yemen,2018,2018Yemen,397,904,702,2493,268,0,4764,414,971,829,5113,359,0,7686,12450
28241,Yemen,2019,2019Yemen,0,0,0,0,0,0,0,0,0,0,0,0,0,0,8553
28242,Yemen,2019,2019Yemen,0,0,0,0,0,0,0,0,0,0,5,0,0,5,15
28243,Yemen,2019,2019Yemen,0,0,0,0,0,0,0,0,0,0,7,0,0,7,7
28244,Yemen,2019,2019Yemen,0,0,0,0,0,0,0,0,0,0,8,0,0,8,8
28245,Yemen,2019,2019Yemen,0,0,0,0,0,0,0,0,5,0,0,0,0,5,5
28246,Yemen,2019,2019Yemen,0,0,0,0,0,0,0,5,0,0,0,0,0,5,5
28247,Yemen,2019,2019Yemen,0,0,0,0,0,5,5,0,0,0,0,0,0,0,5
28248,Yemen,2019,2019Yemen,0,0,0,0,0,161,161,0,0,0,0,0,293,293,454
28249,Yemen,2019,2019Yemen,0,0,0,5,0,0,5,0,0,0,0,0,0,0,5
28250,Yemen,2019,2019Yemen,0,0,0,5,0,0,5,0,0,0,6,0,0,6,11
28251,Yemen,2019,2019Yemen,0,0,0,5,0,0,5,0,0,0,9,0,0,9,14
28252,Yemen,2019,2019Yemen,0,0,0,5,0,0,5,0,0,0,10,0,0,10,15
28253,Yemen,2019,2019Yemen,0,0,0,5,0,0,5,0,0,0,11,0,0,11,16
28254,Yemen,2019,2019Yemen,0,0,0,5,0,0,5,0,0,0,19,0,0,19,24
28255,Yemen,2019,2019Yemen,0,0,0,5,0,0,5,0,0,5,19,0,0,24,29
28256,Yemen,2019,2019Yemen,0,0,0,5,0,0,5,0,9,0,0,0,0,9,14
28257,Yemen,2019,2019Yemen,0,0,0,5,0,0,5,5,0,0,12,0,0,17,22
28258,Yemen,2019,2019Yemen,0,0,0,6,0,0,6,0,0,5,0,0,0,5,11
28259,Yemen,2019,2019Yemen,0,0,0,9,0,0,9,0,0,0,0,0,0,0,9
28260,Yemen,2019,2019Yemen,0,0,0,9,0,0,9,0,0,5,8,0,0,13,22
28261,Yemen,2019,2019Yemen,0,0,0,12,0,0,12,0,8,0,7,0,0,15,27
28262,Yemen,2019,2019Yemen,0,0,5,5,0,0,10,0,6,5,16,0,0,27,37
28263,Yemen,2019,2019Yemen,0,0,5,7,0,0,12,0,0,0,7,0,0,7,19
28264,Yemen,2019,2019Yemen,0,0,7,0,0,0,7,0,0,0,0,0,0,0,7
28265,Yemen,2019,2019Yemen,0,5,0,0,0,0,5,0,0,0,5,0,0,5,10
28266,Yemen,2019,2019Yemen,0,5,0,0,0,0,5,0,7,0,0,0,0,7,12
28267,Yemen,2019,2019Yemen,0,5,0,5,0,0,10,0,6,0,0,0,0,6,16
28268,Yemen,2019,2019Yemen,0,5,0,7,0,0,12,0,0,5,10,0,0,15,27
28269,Yemen,2019,2019Yemen,0,5,0,10,0,0,15,0,0,0,8,0,0,8,23
28270,Yemen,2019,2019Yemen,0,5,0,11,0,0,16,0,9,0,35,0,0,44,60
28271,Yemen,2019,2019Yemen,0,5,23,32,0,0,60,5,13,10,38,0,0,66,126
28272,Yemen,2019,2019Yemen,0,6,0,0,0,0,6,0,0,5,0,0,0,5,11
28273,Yemen,2019,2019Yemen,0,6,13,15,0,0,34,0,5,5,41,0,0,51,85
28274,Yemen,2019,2019Yemen,5,6,7,36,7,0,61,5,6,5,48,5,0,69,130
28275,Yemen,2019,2019Yemen,7,13,5,25,0,0,50,5,0,5,77,0,0,87,137
28276,Yemen,2019,2019Yemen,9,0,0,7,0,0,16,0,0,0,16,0,0,16,32
28277,Yemen,2019,2019Yemen,9,7,5,33,5,0,59,5,8,6,179,0,0,198,257
28278,Yemen,2019,2019Yemen,9,15,13,57,5,0,99,12,11,15,61,8,0,107,206
28279,Yemen,2019,2019Yemen,13,25,16,25,0,0,79,10,24,10,36,0,0,80,159
28280,Yemen,2019,2019Yemen,26,53,42,235,13,0,369,31,83,49,665,30,0,858,1227
28281,Yemen,2019,2019Yemen,30,41,20,110,5,0,206,19,42,34,542,0,0,637,843
28282,Yemen,2019,2019Yemen,44,59,48,196,13,0,360,29,62,55,192,17,0,355,715
28283,Yemen,2019,2019Yemen,49,148,120,509,43,0,869,49,152,130,684,42,0,1057,1926
28284,Yemen,2019,2019Yemen,101,128,124,570,27,0,950,84,183,143,1235,34,0,1679,2629
28285,Yemen,2019,2019Yemen,149,283,244,1099,145,0,1920,151,304,254,2531,162,0,3402,5322
28286,Yemen,2019,2019Yemen,341,947,724,2597,269,0,4878,404,952,834,5764,403,0,8357,13235
28287,Yemen,2020,2020Yemen,0,0,0,0,0,0,0,0,0,0,0,0,0,0,7913
28288,Yemen,2020,2020Yemen,0,0,0,0,0,0,0,0,0,0,0,0,5,5,5
28289,Yemen,2020,2020Yemen,0,0,0,0,0,0,0,0,0,0,5,0,0,5,25
28290,Yemen,2020,2020Yemen,0,0,0,0,0,0,0,0,0,0,7,0,0,7,14
28291,Yemen,2020,2020Yemen,0,0,0,0,0,0,0,0,0,0,8,0,0,8,8
28292,Yemen,2020,2020Yemen,0,0,0,0,0,0,0,0,0,0,9,0,0,9,9
28293,Yemen,2020,2020Yemen,0,0,0,0,0,0,0,0,6,0,0,0,0,6,12
28294,Yemen,2020,2020Yemen,0,0,0,0,0,0,0,5,0,0,0,0,0,5,29
28295,Yemen,2020,2020Yemen,0,0,0,0,0,5,5,0,0,0,0,0,11,11,16
28296,Yemen,2020,2020Yemen,0,0,0,0,0,9,9,0,0,0,0,0,11,11,20
28297,Yemen,2020,2020Yemen,0,0,0,0,0,30,30,0,0,0,0,0,47,47,77
28298,Yemen,2020,2020Yemen,0,0,0,0,0,95,95,0,0,0,0,0,700,700,795
28299,Yemen,2020,2020Yemen,0,0,0,5,0,0,5,0,0,0,0,0,0,0,10
28300,Yemen,2020,2020Yemen,0,0,0,5,0,0,5,0,0,0,6,0,0,6,11
28301,Yemen,2020,2020Yemen,0,0,0,5,0,0,5,0,0,0,10,0,0,10,15
28302,Yemen,2020,2020Yemen,0,0,0,5,0,0,5,0,0,0,16,0,0,16,21
28303,Yemen,2020,2020Yemen,0,0,0,5,0,0,5,0,6,0,5,0,0,11,16
28304,Yemen,2020,2020Yemen,0,0,0,6,0,0,6,0,0,0,35,0,0,35,41
28305,Yemen,2020,2020Yemen,0,0,0,6,0,0,6,0,5,0,10,0,0,15,21
28306,Yemen,2020,2020Yemen,0,0,0,9,0,0,9,0,0,0,0,0,0,0,9
28307,Yemen,2020,2020Yemen,0,0,0,9,0,0,9,0,0,5,6,0,0,11,20
28308,Yemen,2020,2020Yemen,0,0,0,11,0,0,11,0,8,0,7,0,0,15,26
28309,Yemen,2020,2020Yemen,0,0,0,12,0,0,12,0,0,0,7,0,0,7,19
28310,Yemen,2020,2020Yemen,0,0,0,29,0,31,60,0,0,0,163,0,29,192,1949
28311,Yemen,2020,2020Yemen,0,0,5,0,0,0,5,0,0,0,9,0,0,9,14
28312,Yemen,2020,2020Yemen,0,0,5,5,0,0,10,0,6,5,11,5,0,27,37
28313,Yemen,2020,2020Yemen,0,0,6,0,0,0,6,0,0,0,0,0,0,0,6
28314,Yemen,2020,2020Yemen,0,0,6,0,0,0,6,0,0,0,5,0,0,5,11
28315,Yemen,2020,2020Yemen,0,0,7,0,0,0,7,0,0,0,0,0,0,0,7
28316,Yemen,2020,2020Yemen,0,5,0,5,0,0,10,0,0,0,15,0,0,15,25
28317,Yemen,2020,2020Yemen,0,5,0,6,0,0,11,0,0,0,9,0,0,9,20
28318,Yemen,2020,2020Yemen,0,5,0,7,0,0,12,0,0,5,10,0,0,15,27
28319,Yemen,2020,2020Yemen,0,5,0,20,0,0,25,0,10,0,50,0,0,60,85
28320,Yemen,2020,2020Yemen,0,6,0,10,0,0,16,0,0,5,8,0,0,13,29
28321,Yemen,2020,2020Yemen,0,6,6,33,8,0,53,5,6,5,50,6,0,72,341
28322,Yemen,2020,2020Yemen,0,6,12,20,0,0,38,5,8,6,39,0,0,58,96
28323,Yemen,2020,2020Yemen,0,7,0,8,0,0,15,0,7,0,14,0,0,21,36
28324,Yemen,2020,2020Yemen,0,7,20,43,5,0,75,5,14,11,44,5,0,79,154
28325,Yemen,2020,2020Yemen,5,0,5,9,0,0,19,0,5,0,16,0,0,21,40
28326,Yemen,2020,2020Yemen,5,5,5,23,0,0,38,0,6,5,53,0,0,64,102
28327,Yemen,2020,2020Yemen,5,14,5,26,0,0,50,0,5,5,77,0,0,87,137
28328,Yemen,2020,2020Yemen,6,0,0,5,0,0,11,0,0,0,19,0,0,19,30
28329,Yemen,2020,2020Yemen,6,6,5,37,5,0,59,0,8,6,188,0,0,202,261
28330,Yemen,2020,2020Yemen,9,0,0,0,0,0,9,0,0,5,0,0,0,5,14
28331,Yemen,2020,2020Yemen,10,18,14,68,5,0,115,10,17,20,65,5,0,117,232
28332,Yemen,2020,2020Yemen,10,26,19,24,0,0,79,11,20,11,37,0,0,79,158
28333,Yemen,2020,2020Yemen,27,65,58,279,16,0,445,35,92,61,878,40,0,1106,1551
28334,Yemen,2020,2020Yemen,41,64,56,220,15,0,396,33,71,53,248,17,0,422,818
28335,Yemen,2020,2020Yemen,50,126,128,542,52,0,898,47,153,132,768,47,0,1147,2045
28336,Yemen,2020,2020Yemen,102,153,149,659,31,0,1094,86,198,164,1455,42,0,1945,3039
28337,Yemen,2020,2020Yemen,138,301,262,1188,154,0,2043,128,317,269,2721,188,0,3623,5666
28338,Yemen,2020,2020Yemen,271,525,438,1263,109,0,2606,311,569,496,2224,165,0,3765,6371
28339,Yemen,2021,2021Yemen,0,0,0,0,0,0,0,0,0,0,0,0,0,0,10198
28340,Yemen,2021,2021Yemen,0,0,0,0,0,0,0,0,0,0,0,0,5,5,5
28341,Yemen,2021,2021Yemen,0,0,0,0,0,0,0,0,0,0,5,0,0,5,15
28342,Yemen,2021,2021Yemen,0,0,0,0,0,0,0,0,0,0,6,0,0,6,6
28343,Yemen,2021,2021Yemen,0,0,0,0,0,0,0,0,0,0,7,0,0,7,7
28344,Yemen,2021,2021Yemen,0,0,0,0,0,0,0,0,0,0,9,0,0,9,18
28345,Yemen,2021,2021Yemen,0,0,0,0,0,0,0,0,0,0,14,0,0,14,14
28346,Yemen,2021,2021Yemen,0,0,0,0,0,0,0,0,5,0,0,0,0,5,5
28347,Yemen,2021,2021Yemen,0,0,0,0,0,0,0,0,5,0,9,0,0,14,14
28348,Yemen,2021,2021Yemen,0,0,0,0,0,0,0,0,6,0,0,0,0,6,6
28349,Yemen,2021,2021Yemen,0,0,0,0,0,0,0,0,9,0,0,0,0,9,9
28350,Yemen,2021,2021Yemen,0,0,0,0,0,10,10,0,0,0,0,0,14,14,24
28351,Yemen,2021,2021Yemen,0,0,0,5,0,0,5,0,0,0,0,0,0,0,5
28352,Yemen,2021,2021Yemen,0,0,0,5,0,0,5,0,0,0,5,0,0,5,10
28353,Yemen,2021,2021Yemen,0,0,0,5,0,0,5,0,0,0,16,0,0,16,21
28354,Yemen,2021,2021Yemen,0,0,0,5,0,0,5,0,5,0,22,0,0,27,32
28355,Yemen,2021,2021Yemen,0,0,0,5,0,0,5,0,8,0,18,0,0,26,31
28356,Yemen,2021,2021Yemen,0,0,0,6,0,0,6,0,0,9,0,0,0,9,15
28357,Yemen,2021,2021Yemen,0,0,0,8,0,0,8,0,0,0,6,0,0,6,14
28358,Yemen,2021,2021Yemen,0,0,0,9,0,0,9,0,0,0,0,0,0,0,9
28359,Yemen,2021,2021Yemen,0,0,0,9,0,0,9,0,0,0,9,0,0,9,18
28360,Yemen,2021,2021Yemen,0,0,0,9,0,0,9,0,8,0,14,5,0,27,36
28361,Yemen,2021,2021Yemen,0,0,0,10,0,0,10,0,5,0,50,0,0,55,65
28362,Yemen,2021,2021Yemen,0,0,0,12,0,0,12,0,0,0,9,0,0,9,21
28363,Yemen,2021,2021Yemen,0,0,5,0,0,0,5,0,0,0,9,0,0,9,14
28364,Yemen,2021,2021Yemen,0,0,7,0,0,0,7,0,0,0,0,0,0,0,7
28365,Yemen,2021,2021Yemen,0,5,0,0,0,0,5,0,0,0,0,0,0,0,5
28366,Yemen,2021,2021Yemen,0,5,0,0,0,0,5,0,0,0,7,0,0,7,12
28367,Yemen,2021,2021Yemen,0,5,0,0,0,0,5,0,0,0,19,0,0,19,24
28368,Yemen,2021,2021Yemen,0,5,0,7,0,0,12,0,0,5,9,0,0,14,26
28369,Yemen,2021,2021Yemen,0,5,0,14,0,0,19,0,0,0,15,0,0,15,34
28370,Yemen,2021,2021Yemen,0,5,0,22,0,0,27,0,12,0,54,0,0,66,93
28371,Yemen,2021,2021Yemen,0,5,5,9,0,0,19,0,0,5,31,0,0,36,55
28372,Yemen,2021,2021Yemen,0,6,0,8,0,0,14,9,7,0,15,0,0,31,45
28373,Yemen,2021,2021Yemen,0,6,0,12,0,0,18,0,0,5,13,0,0,18,36
28374,Yemen,2021,2021Yemen,0,7,0,5,0,0,12,0,0,5,0,0,0,5,17
28375,Yemen,2021,2021Yemen,0,7,6,30,9,0,52,0,6,8,44,6,0,64,345
28376,Yemen,2021,2021Yemen,0,7,19,46,5,0,77,5,15,12,42,5,0,79,156
28377,Yemen,2021,2021Yemen,0,10,8,27,0,0,45,0,9,5,58,0,0,72,117
28378,Yemen,2021,2021Yemen,0,10,10,20,0,0,40,5,6,7,43,0,0,61,101
28379,Yemen,2021,2021Yemen,0,11,5,57,0,31,104,6,11,10,279,0,29,335,2127
28380,Yemen,2021,2021Yemen,5,0,0,0,0,0,5,0,0,0,8,0,0,8,13
28381,Yemen,2021,2021Yemen,5,0,0,7,0,0,12,0,0,5,10,0,0,15,27
28382,Yemen,2021,2021Yemen,5,14,5,26,0,0,50,0,5,5,77,0,0,87,137
28383,Yemen,2021,2021Yemen,5,24,25,25,0,0,79,10,15,14,43,0,0,82,161
28384,Yemen,2021,2021Yemen,6,0,0,5,0,0,11,0,0,0,19,0,0,19,30
28385,Yemen,2021,2021Yemen,6,6,5,37,5,0,59,0,8,6,194,0,0,208,267
28386,Yemen,2021,2021Yemen,9,31,23,104,7,0,174,12,24,27,78,6,0,147,321
28387,Yemen,2021,2021Yemen,22,71,82,344,19,0,538,24,108,77,996,52,0,1257,1795
28388,Yemen,2021,2021Yemen,62,76,51,262,18,0,469,66,62,57,352,18,0,555,1024
28389,Yemen,2021,2021Yemen,70,147,140,609,0,60,1026,57,168,145,920,57,0,1347,2373
28390,Yemen,2021,2021Yemen,102,153,139,644,37,0,1075,96,178,156,1531,46,0,2007,3082
28391,Yemen,2021,2021Yemen,153,299,280,1269,173,0,2174,141,317,304,3093,203,0,4058,6232
28392,Yemen,2021,2021Yemen,291,577,504,1549,138,0,3059,334,602,597,3515,234,0,5282,8341
28393,Zimbabwe,2001,2001Zimbabwe,0,0,0,0,0,0,0,0,0,0,0,0,0,0,252
28394,Zimbabwe,2001,2001Zimbabwe,0,0,0,0,0,0,0,0,0,0,5,0,0,5,5
28395,Zimbabwe,2002,2002Zimbabwe,0,0,0,0,0,0,0,0,0,0,0,0,0,0,3998
28396,Zimbabwe,2002,2002Zimbabwe,0,0,0,0,0,0,0,5,0,0,21,0,0,26,26
28397,Zimbabwe,2003,2003Zimbabwe,0,0,0,0,0,0,0,0,0,0,0,0,0,0,7154
28398,Zimbabwe,2004,2004Zimbabwe,0,0,0,0,0,0,0,0,0,0,0,0,0,0,9557
28399,Zimbabwe,2005,2005Zimbabwe,0,0,0,0,0,0,0,0,0,0,0,0,0,0,11138
28400,Zimbabwe,2005,2005Zimbabwe,0,0,0,0,0,0,0,0,5,0,0,0,0,5,5
28401,Zimbabwe,2005,2005Zimbabwe,0,0,0,0,0,5,5,0,0,0,0,0,6,6,11
28402,Zimbabwe,2005,2005Zimbabwe,0,0,0,5,0,0,5,0,0,0,0,0,0,0,5
28403,Zimbabwe,2005,2005Zimbabwe,0,6,0,16,0,0,22,0,0,0,58,0,0,58,87
28404,Zimbabwe,2006,2006Zimbabwe,0,0,0,0,0,0,0,0,0,0,0,0,0,0,12756
28405,Zimbabwe,2006,2006Zimbabwe,0,0,0,0,0,5,5,0,0,0,0,0,0,0,5
28406,Zimbabwe,2006,2006Zimbabwe,0,0,0,0,0,5,5,0,0,0,0,0,8,8,13
28407,Zimbabwe,2007,2007Zimbabwe,0,0,0,0,0,0,0,0,0,0,0,0,0,0,14334
28408,Zimbabwe,2007,2007Zimbabwe,0,0,0,0,0,0,0,5,0,0,0,0,0,5,5
28409,Zimbabwe,2007,2007Zimbabwe,0,0,0,0,0,8,8,0,0,0,0,0,0,0,8
28410,Zimbabwe,2007,2007Zimbabwe,0,0,0,0,0,8,8,0,0,0,0,0,11,11,19
28411,Zimbabwe,2008,2008Zimbabwe,0,0,0,0,0,0,0,0,0,0,0,0,0,0,15982
28412,Zimbabwe,2008,2008Zimbabwe,0,0,0,0,0,9,9,0,0,0,0,0,12,12,21
28413,Zimbabwe,2008,2008Zimbabwe,0,0,0,8,0,0,8,0,0,5,0,0,0,5,13
28414,Zimbabwe,2008,2008Zimbabwe,53,50,62,167,10,0,342,38,33,66,323,6,0,466,808
28415,Zimbabwe,2009,2009Zimbabwe,0,0,0,0,0,0,0,0,0,0,0,0,0,0,21468
28416,Zimbabwe,2009,2009Zimbabwe,0,0,0,0,0,0,0,0,0,0,5,0,0,5,10
28417,Zimbabwe,2009,2009Zimbabwe,0,0,0,0,0,0,0,0,5,0,0,0,0,5,5
28418,Zimbabwe,2009,2009Zimbabwe,0,0,0,5,0,0,5,0,5,0,5,0,0,10,15
28419,Zimbabwe,2009,2009Zimbabwe,0,0,0,5,0,5,10,7,0,0,0,0,0,7,17
28420,Zimbabwe,2009,2009Zimbabwe,0,0,0,6,0,0,6,0,0,0,0,0,0,0,6
28421,Zimbabwe,2009,2009Zimbabwe,0,0,0,8,0,0,8,0,5,5,0,0,0,10,18
28422,Zimbabwe,2009,2009Zimbabwe,0,6,0,16,0,0,22,0,0,0,20,0,0,20,42
28423,Zimbabwe,2009,2009Zimbabwe,59,48,62,188,15,0,372,48,36,71,325,8,0,488,860
28424,Zimbabwe,2010,2010Zimbabwe,0,0,0,0,0,0,0,0,0,0,0,0,0,0,23915
28425,Zimbabwe,2010,2010Zimbabwe,0,0,0,0,0,0,0,0,0,0,5,0,0,5,20
28426,Zimbabwe,2010,2010Zimbabwe,0,0,0,0,0,12,12,0,0,0,0,0,20,20,32
28427,Zimbabwe,2010,2010Zimbabwe,0,0,0,5,0,0,5,0,0,0,0,0,0,0,5
28428,Zimbabwe,2010,2010Zimbabwe,0,0,0,6,0,0,6,0,0,0,0,0,0,0,6
28429,Zimbabwe,2010,2010Zimbabwe,0,0,0,7,0,0,7,0,6,0,0,0,0,6,13
28430,Zimbabwe,2010,2010Zimbabwe,0,0,0,9,0,0,9,0,8,0,11,0,0,19,28
28431,Zimbabwe,2010,2010Zimbabwe,0,5,0,0,0,0,5,0,0,0,0,0,0,0,5
28432,Zimbabwe,2010,2010Zimbabwe,0,9,0,23,0,0,32,0,0,5,19,0,0,24,56
28433,Zimbabwe,2011,2011Zimbabwe,0,0,0,0,0,0,0,0,0,0,0,0,0,0,19698
28434,Zimbabwe,2011,2011Zimbabwe,0,0,0,0,0,0,0,0,0,0,5,0,0,5,15
28435,Zimbabwe,2011,2011Zimbabwe,0,0,0,0,0,0,0,0,0,0,6,0,0,6,12
28436,Zimbabwe,2011,2011Zimbabwe,0,0,0,0,0,11,11,0,0,0,0,0,21,21,32
28437,Zimbabwe,2011,2011Zimbabwe,0,0,0,5,0,0,5,0,0,0,0,0,0,0,5
28438,Zimbabwe,2011,2011Zimbabwe,0,0,0,6,0,0,6,0,0,0,0,0,0,0,6
28439,Zimbabwe,2011,2011Zimbabwe,0,0,0,8,0,0,8,0,6,0,0,0,0,6,14
28440,Zimbabwe,2011,2011Zimbabwe,0,0,0,10,0,0,10,0,6,0,8,0,0,14,24
28441,Zimbabwe,2011,2011Zimbabwe,0,5,0,0,0,0,5,0,0,0,0,0,0,0,5
28442,Zimbabwe,2011,2011Zimbabwe,0,9,0,19,5,0,33,0,0,6,17,0,0,23,56
28443,Zimbabwe,2011,2011Zimbabwe,0,17,20,213,12,0,262,0,9,23,169,8,0,209,4223
28444,Zimbabwe,2011,2011Zimbabwe,57,62,54,200,11,0,384,65,46,39,401,8,0,559,943
28445,Zimbabwe,2012,2012Zimbabwe,0,0,0,0,0,0,0,0,0,0,0,0,0,0,16598
28446,Zimbabwe,2012,2012Zimbabwe,0,0,0,0,0,0,0,0,0,0,5,0,0,5,15
28447,Zimbabwe,2012,2012Zimbabwe,0,0,0,0,0,0,0,0,0,0,6,0,0,6,6
28448,Zimbabwe,2012,2012Zimbabwe,0,0,0,0,0,0,0,0,0,0,8,0,0,8,8
28449,Zimbabwe,2012,2012Zimbabwe,0,0,0,0,0,13,13,0,0,0,0,0,22,22,35
28450,Zimbabwe,2012,2012Zimbabwe,0,0,0,5,0,0,5,0,0,0,5,0,0,5,10
28451,Zimbabwe,2012,2012Zimbabwe,0,0,0,6,0,0,6,0,0,0,0,0,0,0,6
28452,Zimbabwe,2012,2012Zimbabwe,0,0,0,9,0,0,9,0,5,0,0,0,0,5,14
28453,Zimbabwe,2012,2012Zimbabwe,0,0,0,10,0,0,10,0,6,0,8,0,0,14,24
28454,Zimbabwe,2012,2012Zimbabwe,0,0,0,17,5,0,22,0,0,0,10,0,0,10,4341
28455,Zimbabwe,2012,2012Zimbabwe,0,0,5,0,0,0,5,0,0,0,0,0,0,0,5
28456,Zimbabwe,2012,2012Zimbabwe,0,9,0,24,0,0,33,0,0,7,19,0,0,26,59
28457,Zimbabwe,2012,2012Zimbabwe,51,69,55,203,11,0,389,72,51,39,401,9,0,572,961
28458,Zimbabwe,2013,2013Zimbabwe,0,0,0,0,0,0,0,0,0,0,0,0,0,0,14404
28459,Zimbabwe,2013,2013Zimbabwe,0,0,0,0,0,0,0,0,0,0,5,0,0,5,15
28460,Zimbabwe,2013,2013Zimbabwe,0,0,0,0,0,0,0,0,0,0,8,0,0,8,8
28461,Zimbabwe,2013,2013Zimbabwe,0,0,0,0,0,0,0,0,0,6,0,0,0,6,6
28462,Zimbabwe,2013,2013Zimbabwe,0,0,0,0,0,15,15,0,0,0,0,0,22,22,37
28463,Zimbabwe,2013,2013Zimbabwe,0,0,0,6,0,0,6,0,0,0,0,0,0,0,6
28464,Zimbabwe,2013,2013Zimbabwe,0,0,0,9,0,0,9,0,5,0,0,0,0,5,14
28465,Zimbabwe,2013,2013Zimbabwe,0,0,5,0,0,0,5,0,0,0,0,0,0,0,5
28466,Zimbabwe,2013,2013Zimbabwe,0,0,9,30,5,0,44,0,0,10,23,5,0,38,3969
28467,Zimbabwe,2013,2013Zimbabwe,0,5,0,8,0,0,13,0,0,8,11,0,0,19,32
28468,Zimbabwe,2013,2013Zimbabwe,0,5,7,72,0,0,84,0,5,8,74,0,0,87,171
28469,Zimbabwe,2013,2013Zimbabwe,0,7,0,23,0,0,30,0,5,0,13,0,0,18,48
28470,Zimbabwe,2013,2013Zimbabwe,9,0,0,0,0,0,9,0,0,0,0,0,0,0,9
28471,Zimbabwe,2013,2013Zimbabwe,60,69,54,212,11,0,406,77,55,38,410,9,0,589,995
28472,Zimbabwe,2014,2014Zimbabwe,0,0,0,0,0,0,0,0,0,0,0,0,0,0,12370
28473,Zimbabwe,2014,2014Zimbabwe,0,0,0,0,0,0,0,0,0,0,5,0,0,5,10
28474,Zimbabwe,2014,2014Zimbabwe,0,0,0,0,0,0,0,0,0,6,0,0,0,6,6
28475,Zimbabwe,2014,2014Zimbabwe,0,0,0,0,0,0,0,5,0,0,0,0,0,5,5
28476,Zimbabwe,2014,2014Zimbabwe,0,0,0,0,0,15,15,0,0,0,0,0,22,22,37
28477,Zimbabwe,2014,2014Zimbabwe,0,0,0,0,0,2645,2645,0,0,0,0,0,3572,3572,6217
28478,Zimbabwe,2014,2014Zimbabwe,0,0,0,5,0,0,5,0,0,0,0,0,0,0,5
28479,Zimbabwe,2014,2014Zimbabwe,0,0,0,9,0,0,9,0,5,0,0,0,0,5,14
28480,Zimbabwe,2014,2014Zimbabwe,0,0,0,14,0,0,14,0,0,0,18,0,0,18,32
28481,Zimbabwe,2014,2014Zimbabwe,0,0,8,0,0,0,8,0,0,0,0,0,0,0,8
28482,Zimbabwe,2014,2014Zimbabwe,0,7,0,17,5,0,29,0,5,0,13,0,0,18,47
28483,Zimbabwe,2014,2014Zimbabwe,6,0,0,24,0,0,30,0,0,5,20,0,0,25,2767
28484,Zimbabwe,2014,2014Zimbabwe,7,0,0,0,0,0,7,0,0,0,0,0,0,0,14
28485,Zimbabwe,2014,2014Zimbabwe,52,71,53,199,9,0,384,62,59,32,399,10,0,562,946
28486,Zimbabwe,2015,2015Zimbabwe,0,0,0,0,0,0,0,0,0,0,0,0,0,0,20270
28487,Zimbabwe,2015,2015Zimbabwe,0,0,0,0,0,0,0,0,0,0,5,0,0,5,15
28488,Zimbabwe,2015,2015Zimbabwe,0,0,0,0,0,0,0,0,0,5,0,0,0,5,5
28489,Zimbabwe,2015,2015Zimbabwe,0,0,0,0,0,0,0,0,0,6,0,0,0,6,6
28490,Zimbabwe,2015,2015Zimbabwe,0,0,0,0,0,0,0,5,0,0,0,0,0,5,5
28491,Zimbabwe,2015,2015Zimbabwe,0,0,0,0,0,13,13,0,0,0,0,0,21,21,34
28492,Zimbabwe,2015,2015Zimbabwe,0,0,0,8,0,0,8,0,5,0,0,0,0,5,18
28493,Zimbabwe,2015,2015Zimbabwe,0,0,0,9,0,0,9,0,0,0,0,0,0,0,9
28494,Zimbabwe,2015,2015Zimbabwe,0,5,0,15,0,0,20,0,5,5,12,0,0,22,42
28495,Zimbabwe,2015,2015Zimbabwe,0,5,0,23,0,0,28,0,0,0,18,0,0,18,46
28496,Zimbabwe,2015,2015Zimbabwe,0,5,10,80,0,0,95,0,5,5,81,5,0,96,191
28497,Zimbabwe,2015,2015Zimbabwe,6,0,0,0,0,0,6,0,0,0,0,0,0,0,6
28498,Zimbabwe,2015,2015Zimbabwe,7,0,0,0,0,0,7,0,0,0,0,0,0,0,7
28499,Zimbabwe,2015,2015Zimbabwe,41,57,44,146,8,0,296,63,54,29,230,6,0,382,678
28500,Zimbabwe,2016,2016Zimbabwe,0,0,0,0,0,0,0,0,0,0,0,0,0,0,11166
28501,Zimbabwe,2016,2016Zimbabwe,0,0,0,0,0,0,0,0,0,0,5,0,0,5,5
28502,Zimbabwe,2016,2016Zimbabwe,0,0,0,0,0,0,0,0,0,7,0,0,0,7,7
28503,Zimbabwe,2016,2016Zimbabwe,0,0,0,0,0,0,0,7,0,0,0,0,0,7,7
28504,Zimbabwe,2016,2016Zimbabwe,0,0,0,0,0,16,16,0,0,0,0,0,21,21,37
28505,Zimbabwe,2016,2016Zimbabwe,0,0,0,0,0,2002,2002,0,0,0,0,0,2594,2594,4596
28506,Zimbabwe,2016,2016Zimbabwe,0,0,0,7,0,6,13,0,0,0,0,0,0,0,13
28507,Zimbabwe,2016,2016Zimbabwe,0,0,0,33,0,0,33,0,0,0,13,5,0,18,1261
28508,Zimbabwe,2016,2016Zimbabwe,0,5,0,0,0,0,5,0,0,0,0,0,0,0,5
28509,Zimbabwe,2016,2016Zimbabwe,0,5,0,0,0,0,5,0,0,0,5,0,0,5,10
28510,Zimbabwe,2016,2016Zimbabwe,0,5,0,22,0,0,27,0,0,6,19,0,0,25,52
28511,Zimbabwe,2016,2016Zimbabwe,0,8,0,13,0,0,21,0,6,6,15,0,0,27,48
28512,Zimbabwe,2016,2016Zimbabwe,5,0,0,0,0,0,5,0,0,0,0,0,0,0,5
28513,Zimbabwe,2016,2016Zimbabwe,5,8,6,100,0,0,119,0,7,9,89,5,0,110,229
28514,Zimbabwe,2016,2016Zimbabwe,7,0,0,0,0,0,7,0,0,0,0,0,0,0,7
28515,Zimbabwe,2016,2016Zimbabwe,37,63,42,156,8,0,306,62,57,26,235,7,0,387,693
28516,Zimbabwe,2017,2017Zimbabwe,0,0,0,0,0,0,0,0,0,0,0,0,0,0,11597
28517,Zimbabwe,2017,2017Zimbabwe,0,0,0,0,0,0,0,0,0,0,5,0,0,5,10
28518,Zimbabwe,2017,2017Zimbabwe,0,0,0,0,0,0,0,0,0,5,0,0,0,5,5
28519,Zimbabwe,2017,2017Zimbabwe,0,0,0,0,0,0,0,0,5,0,0,0,0,5,5
28520,Zimbabwe,2017,2017Zimbabwe,0,0,0,0,0,0,0,0,8,0,0,0,0,8,8
28521,Zimbabwe,2017,2017Zimbabwe,0,0,0,0,0,0,0,8,0,0,0,0,0,8,8
28522,Zimbabwe,2017,2017Zimbabwe,0,0,0,0,0,18,18,0,0,0,0,0,26,26,44
28523,Zimbabwe,2017,2017Zimbabwe,0,0,0,0,0,1983,1983,0,0,0,0,0,2575,2575,4558
28524,Zimbabwe,2017,2017Zimbabwe,0,0,0,8,0,0,8,0,0,0,0,0,7,7,15
28525,Zimbabwe,2017,2017Zimbabwe,0,5,0,0,0,0,5,0,0,0,0,0,0,0,5
28526,Zimbabwe,2017,2017Zimbabwe,0,6,0,0,0,0,6,0,0,0,6,0,0,6,12
28527,Zimbabwe,2017,2017Zimbabwe,5,5,7,57,5,0,79,5,8,11,51,0,0,75,154
28528,Zimbabwe,2017,2017Zimbabwe,5,7,0,18,0,0,30,0,8,6,20,0,0,34,64
28529,Zimbabwe,2017,2017Zimbabwe,5,9,5,111,0,0,130,5,5,7,100,5,0,122,252
28530,Zimbabwe,2017,2017Zimbabwe,7,0,0,0,0,0,7,0,0,0,0,0,0,0,7
28531,Zimbabwe,2017,2017Zimbabwe,42,51,39,161,8,0,301,53,60,29,227,6,0,375,676
28532,Zimbabwe,2018,2018Zimbabwe,0,0,0,0,0,0,0,0,0,0,0,0,0,0,13273
28533,Zimbabwe,2018,2018Zimbabwe,0,0,0,0,0,0,0,0,0,5,0,0,0,5,5
28534,Zimbabwe,2018,2018Zimbabwe,0,0,0,0,0,0,0,5,0,0,0,0,0,5,5
28535,Zimbabwe,2018,2018Zimbabwe,0,0,0,0,0,0,0,8,0,0,0,0,0,8,8
28536,Zimbabwe,2018,2018Zimbabwe,0,0,0,0,0,19,19,0,0,0,0,0,27,27,46
28537,Zimbabwe,2018,2018Zimbabwe,0,0,0,6,0,0,6,0,0,0,0,0,0,0,6
28538,Zimbabwe,2018,2018Zimbabwe,0,0,0,8,0,7,15,0,0,0,0,0,0,0,15
28539,Zimbabwe,2018,2018Zimbabwe,0,0,0,10,0,0,10,0,0,0,5,0,0,5,15
28540,Zimbabwe,2018,2018Zimbabwe,0,9,0,16,0,0,25,0,6,5,18,0,0,29,54
28541,Zimbabwe,2018,2018Zimbabwe,5,6,5,43,5,0,64,0,5,8,46,5,0,64,1018
28542,Zimbabwe,2018,2018Zimbabwe,5,12,11,150,0,0,178,6,11,5,114,5,0,141,319
28543,Zimbabwe,2018,2018Zimbabwe,7,0,0,0,0,0,7,0,0,0,0,0,0,0,7
28544,Zimbabwe,2018,2018Zimbabwe,11,11,11,74,5,0,112,6,8,15,63,0,0,92,204
28545,Zimbabwe,2018,2018Zimbabwe,29,53,40,154,6,0,282,48,61,32,214,6,0,361,643
28546,Zimbabwe,2019,2019Zimbabwe,0,0,0,0,0,0,0,0,0,0,0,0,0,0,8624
28547,Zimbabwe,2019,2019Zimbabwe,0,0,0,0,0,0,0,0,0,5,0,0,0,5,5
28548,Zimbabwe,2019,2019Zimbabwe,0,0,0,0,0,0,0,5,0,0,0,0,0,5,5
28549,Zimbabwe,2019,2019Zimbabwe,0,0,0,0,0,24,24,0,0,0,0,0,27,27,51
28550,Zimbabwe,2019,2019Zimbabwe,0,0,0,5,0,0,5,0,0,0,0,0,0,0,10
28551,Zimbabwe,2019,2019Zimbabwe,0,5,0,11,0,0,16,0,0,0,11,0,0,11,27
28552,Zimbabwe,2019,2019Zimbabwe,0,5,5,17,0,0,27,0,5,5,20,0,0,30,57
28553,Zimbabwe,2019,2019Zimbabwe,0,7,0,0,0,0,7,0,0,0,0,0,0,0,7
28554,Zimbabwe,2019,2019Zimbabwe,0,8,0,0,0,0,8,0,0,0,0,0,0,0,13
28555,Zimbabwe,2019,2019Zimbabwe,6,0,0,0,0,0,6,0,0,0,0,0,0,0,6
28556,Zimbabwe,2019,2019Zimbabwe,7,20,16,209,0,0,252,8,17,11,145,5,0,186,438
28557,Zimbabwe,2019,2019Zimbabwe,12,15,11,88,5,0,131,5,9,13,80,0,0,107,238
28558,Zimbabwe,2019,2019Zimbabwe,30,46,34,137,5,0,252,35,58,23,196,0,0,312,564
28559,Zimbabwe,2020,2020Zimbabwe,0,0,0,0,0,0,0,0,0,0,0,0,0,0,2928
28560,Zimbabwe,2020,2020Zimbabwe,0,0,0,0,0,0,0,0,0,0,0,0,5,5,5
28561,Zimbabwe,2020,2020Zimbabwe,0,0,0,0,0,0,0,0,0,0,5,0,0,5,5
28562,Zimbabwe,2020,2020Zimbabwe,0,0,0,0,0,0,0,0,5,0,0,0,0,5,5
28563,Zimbabwe,2020,2020Zimbabwe,0,0,0,0,0,0,0,5,0,0,0,0,0,5,5
28564,Zimbabwe,2020,2020Zimbabwe,0,0,0,0,0,0,0,9,0,0,0,0,0,9,9
28565,Zimbabwe,2020,2020Zimbabwe,0,0,0,5,0,0,5,0,0,0,0,0,0,0,10
28566,Zimbabwe,2020,2020Zimbabwe,0,0,0,8,0,0,8,0,6,0,6,0,0,12,20
28567,Zimbabwe,2020,2020Zimbabwe,0,0,0,59,0,16,75,0,0,0,45,0,15,60,629
28568,Zimbabwe,2020,2020Zimbabwe,0,0,5,17,0,0,22,0,0,6,15,0,0,21,43
28569,Zimbabwe,2020,2020Zimbabwe,0,0,10,17,0,0,27,0,10,0,20,0,0,30,57
28570,Zimbabwe,2020,2020Zimbabwe,0,7,0,0,0,0,7,0,0,0,0,0,0,0,12
28571,Zimbabwe,2020,2020Zimbabwe,0,8,0,0,0,0,8,0,0,0,0,0,0,0,8
28572,Zimbabwe,2020,2020Zimbabwe,0,73,175,1422,59,0,1729,5,74,163,1928,55,0,2225,3954
28573,Zimbabwe,2020,2020Zimbabwe,6,0,0,0,0,0,6,0,0,0,0,0,0,0,6
28574,Zimbabwe,2020,2020Zimbabwe,14,12,16,104,5,0,151,5,16,14,96,0,0,131,282
28575,Zimbabwe,2020,2020Zimbabwe,14,27,21,277,0,0,339,15,22,20,196,5,0,258,597
28576,Zimbabwe,2021,2021Zimbabwe,0,0,0,0,0,0,0,0,0,0,0,0,0,0,2377
28577,Zimbabwe,2021,2021Zimbabwe,0,0,0,0,0,0,0,0,0,0,6,0,0,6,6
28578,Zimbabwe,2021,2021Zimbabwe,0,0,0,0,0,0,0,0,5,0,0,0,0,5,10
28579,Zimbabwe,2021,2021Zimbabwe,0,0,0,0,0,0,0,0,6,0,0,0,0,6,6
28580,Zimbabwe,2021,2021Zimbabwe,0,0,0,0,0,0,0,9,0,0,0,0,0,9,9
28581,Zimbabwe,2021,2021Zimbabwe,0,0,0,6,0,0,6,0,0,0,0,0,0,0,6
28582,Zimbabwe,2021,2021Zimbabwe,0,0,0,7,0,0,7,0,0,0,8,0,0,8,15
28583,Zimbabwe,2021,2021Zimbabwe,0,0,5,16,0,0,21,0,0,6,15,0,0,21,42
28584,Zimbabwe,2021,2021Zimbabwe,0,0,7,0,0,0,7,0,0,0,0,0,0,0,7
28585,Zimbabwe,2021,2021Zimbabwe,0,0,11,12,0,0,23,0,8,0,17,0,0,25,48
28586,Zimbabwe,2021,2021Zimbabwe,0,8,6,140,7,16,177,5,8,0,112,0,15,140,590
28587,Zimbabwe,2021,2021Zimbabwe,0,9,0,0,0,0,9,0,0,0,0,0,0,0,9
28588,Zimbabwe,2021,2021Zimbabwe,0,43,146,1481,73,0,1743,0,40,137,1975,70,0,2222,3965
28589,Zimbabwe,2021,2021Zimbabwe,5,0,0,0,0,0,5,0,0,0,0,0,0,0,10
28590,Zimbabwe,2021,2021Zimbabwe,16,17,17,110,5,0,165,8,15,19,105,0,0,147,312
28591,Zimbabwe,2021,2021Zimbabwe,16,36,24,317,5,0,398,17,31,23,229,5,0,305,703
